,order_id,user_id,platform,personal_or_business,placement_date,placement_weekday,placement_time,confirm_date,confirm_weekday,confirm_time,arrival_pickup_date,arrive_pickup_weekday,arrive_time,pickup_date,pickup_weekday,pickup_time,arrival_dest_date,arrival_dest_weekday,arrival_dest_time,distance,temperature,pickup_lat,pickup_long,dest_lat,dest_long,rider_id,pickup_to_arrival_time,placement_to_confirm_time,confirm_to_pickup_time
0,4211,633,3,Business,9,5,34546,9,5,34810,9,5,36287,9,5,37650,9,5,38395,4,20.4,-1.3177547,36.8303703,-1.3004062,36.829741,432,745,264,2840
1,25375,2285,3,Personal,12,5,40576,12,5,41001,12,5,42022,12,5,42249,12,5,44242,16,26.4,-1.351453,36.899315,-1.2950041,36.8143583,856,1993,425,1248
2,1899,265,3,Business,30,2,45565,30,2,45764,30,2,46174,30,2,46383,30,2,46838,3,23.25888921888938,-1.3082842,36.8434194,-1.300921,36.828195,155,455,199,619
3,9336,1402,3,Business,15,5,33934,15,5,33965,15,5,34676,15,5,34986,15,5,36327,9,19.2,-1.2813012,36.8323962,-1.2571472,36.7950633,855,1341,31,1021
4,27883,1737,1,Personal,13,1,35718,13,1,35778,13,1,36233,13,1,36323,13,1,37537,9,15.4,-1.2665974,36.7921181,-1.2950408,36.8098172,770,1214,60,545
5,7408,1342,3,Business,14,5,54455,14,5,54537,14,5,55296,14,5,55830,14,5,59021,9,27.2,-1.3025826,36.7670807,-1.257309,36.8060084,124,3191,82,1293
6,22680,2803,3,Business,9,5,34425,9,5,35387,9,5,35592,9,5,35805,9,5,37185,5,20.3,-1.279395,36.825364,-1.2765736,36.8513646,114,1380,962,418
7,21578,1075,3,Business,11,1,51181,11,1,51253,11,1,51693,11,1,51760,11,1,52406,3,28.7,-1.2527958,36.8003131,-1.2551895,36.7822034,913,646,72,507
8,5234,733,3,Business,30,2,40244,30,2,40549,30,2,43998,30,2,44577,30,2,47975,9,23.25888921888938,-1.2551895,36.7822034,-1.3002554,36.8256566,394,3398,305,4028
9,1768,2112,3,Business,23,5,60534,23,5,62276,23,5,63161,23,5,63278,23,5,66717,14,24.6,-1.225322,36.80855,-1.2156006,36.8916865,660,3439,1742,1002
10,823,2820,3,Personal,15,3,33817,15,3,34287,15,3,36628,15,3,36893,15,3,37949,9,16.4,-1.3291184,36.7892374,-1.2903421,36.7885282,208,1056,470,2606
11,2533,704,1,Business,2,2,56600,2,2,56656,2,2,57558,2,2,58647,2,2,62545,17,26.1,-1.2584143,36.8048002,-1.2860183,36.8975338,937,3898,56,1991
12,7842,1990,3,Business,23,4,52662,23,4,52740,23,4,53367,23,4,54117,23,4,56759,10,24.6,-1.2558721,36.722296,-1.275442,36.7660207,868,2642,78,1377
13,6452,3295,3,Business,25,5,33128,25,5,33248,25,5,33293,25,5,34054,25,5,36958,21,20.9,-1.2571472,36.7950633,-1.3908674,36.7674236,536,2904,120,806
14,9463,248,3,Business,23,4,36304,23,4,36349,23,4,37071,23,4,37625,23,4,38032,1,23.25888921888938,-1.304735,36.7846054,-1.2993231,36.7753372,607,407,45,1276
15,21335,3599,3,Business,2,4,45230,2,4,46343,2,4,47877,2,4,49105,2,4,51011,13,23.25888921888938,-1.3302996,36.8707935,-1.2644742,36.8083457,427,1906,1113,2762
16,21307,198,3,Business,19,3,43075,19,3,43087,19,3,43673,19,3,44132,19,3,46440,17,23.25888921888938,-1.3396256,36.8863135,-1.2705297,36.7987172,265,2308,12,1045
17,8201,1500,3,Business,15,2,41668,15,2,41748,15,2,44398,15,2,44708,15,2,47347,13,24.4,-1.2574219,36.7927073,-1.3228003,36.8306435,725,2639,80,2960
18,11630,391,3,Business,14,3,33130,14,3,40917,14,3,41462,14,3,41611,14,3,43181,5,24.4,-1.2599563,36.7993439,-1.2867454,36.8259017,436,1570,7787,694
19,19866,3722,1,Personal,28,2,51173,28,2,51295,28,2,52942,28,2,53407,28,2,57627,5,19.4,-1.2872899,36.820434,-1.2898354,36.7872703,447,4220,122,2112
20,23338,1960,3,Personal,12,2,36251,12,2,37585,12,2,38492,12,2,38692,12,2,39804,7,20.8,-1.3023756,36.7949276,-1.2574088,36.799712,366,1112,1334,1107
21,14810,3698,3,Business,22,3,38539,22,3,38559,22,3,40469,22,3,40538,22,3,42662,24,23.3,-1.3244885,36.897792,-1.3107918,36.761794,856,2124,20,1979
22,12412,1362,1,Personal,10,4,70052,10,4,70073,10,4,71177,10,4,71349,10,4,72837,11,18.1,-1.2627555,36.7929553,-1.2105984,36.8109774,881,1488,21,1276
23,663,1404,2,Personal,11,5,36194,11,5,36249,11,5,37581,11,5,38125,11,5,39529,10,20.8,-1.3211235,36.7765164,-1.2869041,36.8240057,338,1404,55,1876
24,4818,2030,3,Business,11,2,56313,11,2,56528,11,2,57017,11,2,57197,11,2,60814,3,22.5,-1.2969741,36.7856612,-1.295908,36.791433,596,3617,215,669
25,8816,346,3,Business,3,3,43930,3,3,44009,3,3,46060,3,3,46368,3,3,48974,13,27.2,-1.2859912,36.8756811,-1.28878,36.8168312,76,2606,79,2359
26,17338,1582,1,Business,5,5,52947,5,5,53142,5,5,53997,5,5,54116,5,5,55265,5,26.5,-1.2735999,36.8218131,-1.2508229,36.7895263,407,1149,195,974
27,12130,627,3,Business,19,2,44922,19,2,44966,19,2,45055,19,2,45727,19,2,47458,17,27.3,-1.2551895,36.7822034,-1.3339943,36.7263409,630,1731,44,761
28,21312,3560,3,Business,14,3,50006,14,3,51401,14,3,51954,14,3,52090,14,3,55331,9,25.6,-1.279395,36.825364,-1.3242351,36.8202498,237,3241,1395,689
29,13398,2383,3,Business,28,3,30787,28,3,30801,28,3,31058,28,3,31510,28,3,32223,1,20.5,-1.2608993,36.799246,-1.263194,36.797624,407,713,14,709
30,13031,1346,3,Business,10,1,55589,10,1,55610,10,1,56869,10,1,57131,10,1,59352,20,18.8,-1.2917868,36.7872675,-1.3700383,36.9190174,622,2221,21,1521
31,17028,3184,3,Business,12,2,32659,12,2,32726,12,2,34971,12,2,35396,12,2,38362,11,16.1,-1.3067663,36.8438792,-1.3457877,36.8811894,302,2966,67,2670
32,15792,909,3,Business,17,3,58127,17,3,58698,17,3,59203,17,3,59778,17,3,61601,12,23.25888921888938,-1.225322,36.80855,-1.290894,36.822971,634,1823,571,1080
33,4861,3291,3,Business,22,2,58627,22,2,58673,22,2,59237,22,2,60476,22,2,61960,12,25.3,-1.228911,36.881876,-1.2600926,36.8088685,75,1484,46,1803
34,1211,3222,3,Business,13,4,52953,13,4,53034,13,4,53629,13,4,53893,13,4,54713,3,22.3,-1.2551895,36.7822034,-1.2676026,36.8103629,523,820,81,859
35,5857,788,3,Business,8,5,61268,8,5,61352,8,5,61633,8,5,61917,8,5,63546,7,25.3,-1.2584143,36.8048002,-1.225322,36.80855,903,1629,84,565
36,9676,393,3,Business,28,1,42443,28,1,46914,28,1,46928,28,1,48948,28,1,48950,4,26.3,-1.3167113,36.8301563,-1.3004062,36.829741,619,2,4471,2034
37,27859,142,3,Business,30,3,47849,30,3,47891,30,3,48527,30,3,48852,30,3,50234,8,29.2,-1.2570328,36.7869744,-1.2963097,36.7688221,328,1382,42,961
38,20416,1015,1,Personal,7,1,57681,7,1,58781,7,1,60106,7,1,61505,7,1,63489,9,20.0,-1.3331402,36.8925275,-1.3793096,36.9310421,521,1984,1100,2724
39,21067,1245,3,Business,14,4,30904,14,4,30970,14,4,31355,14,4,32116,14,4,34057,16,18.0,-1.2602337,36.7990548,-1.3198615,36.7110323,427,1941,66,1146
40,15011,2634,3,Business,31,5,41197,31,5,41346,31,5,41353,31,5,41596,31,5,44227,21,21.6,-1.2963097,36.7688221,-1.3160977,36.9131642,330,2631,149,250
41,18612,379,1,Personal,7,2,50363,7,2,50394,7,2,51822,7,2,52744,7,2,56549,8,24.8,-1.2655332,36.8094648,-1.2729217,36.7624829,229,3805,31,2350
42,4889,2869,3,Business,24,3,61048,24,3,61079,24,3,62171,24,3,64310,24,3,66397,16,23.25888921888938,-1.225322,36.80855,-1.3025826,36.7670807,484,2087,31,3231
43,27861,407,2,Personal,27,4,47754,27,4,47806,27,4,48082,27,4,48415,27,4,49955,21,23.0,-1.301796,36.8012024,-1.3533402,36.9078924,844,1540,52,609
44,2363,2869,3,Business,3,3,51109,3,3,51394,3,3,52627,3,3,52940,3,3,55066,9,28.1,-1.3025826,36.7670807,-1.2551895,36.7822034,477,2126,285,1546
45,13052,250,2,Personal,16,4,40786,16,4,40852,16,4,41586,16,4,41675,16,4,42303,2,14.7,-1.2642903,36.8002137,-1.269534,36.80697,650,628,66,823
46,14365,3641,3,Business,26,2,51749,26,2,53133,26,2,53395,26,2,53566,26,2,55085,8,23.25888921888938,-1.2551895,36.7822034,-1.2998903,36.8179213,726,1519,1384,433
47,16595,1119,1,Personal,27,4,54560,27,4,55510,27,4,57235,27,4,57327,27,4,59499,18,25.0,-1.3832336,36.7647372,-1.3208162,36.8451209,676,2172,950,1817
48,12932,2102,3,Business,18,1,44982,18,1,44995,18,1,45493,18,1,45800,18,1,47485,15,26.7,-1.3323107,36.8692616,-1.2613768,36.8019418,650,1685,13,805
49,10939,1976,3,Business,7,2,39953,7,2,40055,7,2,40314,7,2,40554,7,2,42171,12,23.25888921888938,-1.257028,36.7810435,-1.3073569,36.8202163,647,1617,102,499
50,1131,2761,3,Personal,21,5,39277,21,5,39349,21,5,40249,21,5,40356,21,5,41997,11,23.0,-1.3038645,36.8684596,-1.2950041,36.8143583,675,1641,72,1007
51,15298,3686,3,Business,9,3,36682,9,3,36687,9,3,36692,9,3,37040,9,3,39069,19,17.6,-1.255956,36.789867,-1.334474,36.88389,771,2029,5,353
52,27809,3326,3,Business,13,4,58565,13,4,58583,13,4,61803,13,4,62081,13,4,62085,3,22.7,-1.2551895,36.7822034,-1.256522,36.7864132,536,4,18,3498
53,25221,3222,3,Business,27,3,34858,27,3,34920,27,3,35440,27,3,35757,27,3,36812,8,23.25888921888938,-1.2551895,36.7822034,-1.2964348,36.8182757,953,1055,62,837
54,22790,1271,3,Business,17,2,47226,17,2,47256,17,2,48282,17,2,48349,17,2,50184,28,19.2,-1.3244885,36.897792,-1.3107918,36.761794,650,1835,30,1093
55,310,893,3,Business,14,5,46163,14,5,52489,14,5,54648,14,5,54775,14,5,56868,8,23.9,-1.2663194,36.809901,-1.2985153,36.7876043,441,2093,6326,2286
56,14114,909,3,Business,5,5,47135,5,5,47166,5,5,47533,5,5,48232,5,5,50130,10,24.7,-1.225322,36.80855,-1.2653185,36.8358841,108,1898,31,1066
57,7973,3730,2,Personal,15,1,44541,15,1,44562,15,1,46190,15,1,46673,15,1,47814,8,23.25888921888938,-1.3929709,36.7504644,-1.3440693,36.7518442,328,1141,21,2111
58,17495,2982,3,Business,8,5,37071,8,5,37098,8,5,37516,8,5,38586,8,5,41413,18,28.2,-1.300921,36.828195,-1.177202,36.8351183,519,2827,27,1488
59,7925,113,1,Business,10,5,39215,10,5,39219,10,5,39625,10,5,39792,10,5,41012,8,19.1,-1.2844653,36.8206676,-1.2963097,36.7688221,229,1220,4,573
60,24544,1051,3,Business,19,1,35143,19,1,38099,19,1,38309,19,1,39996,19,1,42343,8,24.6,-1.2891922,36.825189,-1.2963097,36.7688221,462,2347,2956,1897
61,8642,20,3,Business,1,3,39493,1,3,39563,1,3,39937,1,3,40456,1,3,41294,2,20.1,-1.2628638,36.8070399,-1.263419,36.8060348,208,838,70,893
62,24325,2069,3,Business,27,3,39966,27,3,40039,27,3,41204,27,3,41504,27,3,42523,9,26.3,-1.265715,36.823815,-1.228911,36.881876,269,1019,73,1465
63,12251,1976,3,Business,15,6,34981,15,6,34996,15,6,35741,15,6,36197,15,6,37408,14,17.7,-1.326471,36.8487849,-1.257028,36.7810435,882,1211,15,1201
64,25240,517,3,Business,4,5,36496,4,5,36523,4,5,36716,4,5,37074,4,5,38370,11,17.3,-1.3167113,36.8301563,-1.2574219,36.7927073,523,1296,27,551
65,4994,3470,3,Business,8,3,63632,8,3,63764,8,3,63768,8,3,64333,8,3,68626,11,23.25888921888938,-1.28878,36.8168312,-1.2916953,36.8855273,61,4293,132,569
66,28233,1224,1,Personal,22,5,46124,22,5,46180,22,5,46367,22,5,47056,22,5,48013,3,21.9,-1.304033,36.7848695,-1.2923533,36.7883364,474,957,56,876
67,21811,2179,3,Business,7,4,37556,7,4,37580,7,4,38573,7,4,39137,7,4,39527,2,24.5,-1.2527958,36.8003131,-1.2571472,36.7950633,547,390,24,1557
68,28095,633,3,Business,16,3,52166,16,3,52229,16,3,53162,16,3,54099,16,3,54589,4,26.9,-1.3077869,36.8443207,-1.3004062,36.829741,188,490,63,1870
69,1297,893,3,Business,5,1,37272,5,1,37319,5,1,37513,5,1,37872,5,1,38866,9,18.4,-1.2594474,36.8089122,-1.2273124,36.8163603,101,994,47,553
70,27629,598,1,Business,21,1,63302,21,1,63377,21,1,64313,21,1,64528,21,1,67314,4,23.25888921888938,-1.2536797,36.7995085,-1.2653906,36.8134406,668,2786,75,1151
71,1210,435,3,Business,14,5,41273,14,5,41727,14,5,42553,14,5,43102,14,5,43949,7,22.0,-1.300921,36.828195,-1.3271684,36.8173021,76,847,454,1375
72,4354,959,2,Personal,18,4,46814,18,4,46882,18,4,48058,18,4,48708,18,4,50369,6,25.7,-1.281892,36.7834972,-1.2544802,36.8111822,565,1661,68,1826
73,17165,633,3,Business,6,3,40499,6,3,40517,6,3,41880,6,3,42090,6,3,42685,4,23.25888921888938,-1.3077869,36.8443207,-1.3004062,36.829741,448,595,18,1573
74,18585,867,3,Business,14,4,37403,14,4,37412,14,4,37425,14,4,38336,14,4,40298,15,23.7,-1.2991441,36.7528804,-1.3228003,36.8306435,39,1962,9,924
75,12918,2200,3,Business,18,2,48766,18,2,48789,18,2,49442,18,2,49866,18,2,52739,11,25.8,-1.2927792,36.9053492,-1.290894,36.822971,231,2873,23,1077
76,26182,1927,3,Business,14,1,56521,14,1,56743,14,1,57784,14,1,58255,14,1,59926,19,25.6,-1.2859912,36.8756811,-1.3404187,36.7614685,720,1671,222,1512
77,5424,1218,2,Personal,27,5,34056,27,5,35443,27,5,36780,27,5,36876,27,5,39118,19,16.2,-1.3605299,36.7579536,-1.2630828,36.8050538,194,2242,1387,1433
78,9322,970,3,Business,7,4,56043,7,4,56058,7,4,56511,7,4,56863,7,4,59590,19,31.0,-1.2571472,36.7950633,-1.3325582,36.7406697,401,2727,15,805
79,2401,478,3,Business,8,5,40598,8,5,40686,8,5,41150,8,5,41580,8,5,45605,15,28.2,-1.2551895,36.7822034,-1.3278522,36.8711134,147,4025,88,894
80,2393,393,3,Business,8,4,39507,8,4,39523,8,4,39528,8,4,40972,8,4,43890,14,26.2,-1.3177547,36.8303703,-1.306378,36.7519845,239,2918,16,1449
81,4823,2929,3,Business,11,2,42286,11,2,48696,11,2,48722,11,2,49866,11,2,49880,5,25.7,-1.269534,36.80697,-1.2551895,36.7822034,185,14,6410,1170
82,13324,824,1,Business,14,7,49796,14,7,49837,14,7,50804,14,7,50995,14,7,51674,8,28.6,-1.2248308,36.8012573,-1.207546,36.7913976,743,679,41,1158
83,27621,2956,3,Business,2,1,43867,2,1,44278,2,1,44640,2,1,44768,2,1,45569,5,19.3,-1.2584143,36.8048002,-1.2885315,36.8230419,726,801,411,490
84,23062,1796,3,Business,18,4,35136,18,4,35522,18,4,36287,18,4,37040,18,4,38401,11,23.25888921888938,-1.265715,36.823815,-1.331619,36.847976,710,1361,386,1518
85,8724,2987,3,Business,7,3,40378,7,3,40772,7,3,41473,7,3,41673,7,3,43022,8,25.2,-1.270212,36.8210877,-1.3271374,36.8495534,949,1349,394,901
86,23720,391,3,Business,23,2,46831,23,2,46850,23,2,47927,23,2,49643,23,2,49647,4,23.25888921888938,-1.2839729,36.8115146,-1.2867454,36.8259017,613,4,19,2793
87,5762,2150,3,Business,2,3,45502,2,3,45527,2,3,46278,2,3,46597,2,3,49516,23,24.0,-1.228911,36.881876,-1.344446,36.756597,75,2919,25,1070
88,21200,2358,4,Business,18,4,45298,18,4,45303,18,4,45407,18,4,46119,18,4,47266,12,25.5,-1.346286,36.768793,-1.293973,36.80169,622,1147,5,816
89,11711,1450,3,Personal,28,4,44826,28,4,44896,28,4,45674,28,4,45982,28,4,46901,3,23.25888921888938,-1.2995135,36.7933633,-1.2952784,36.7793271,124,919,70,1086
90,17131,393,3,Business,27,2,36794,27,2,38837,27,2,39299,27,2,40981,27,2,42829,14,23.6,-1.3177547,36.8303703,-1.306378,36.7519845,878,1848,2043,2144
91,27235,134,3,Business,28,4,54647,28,4,54683,28,4,55247,28,4,55507,28,4,56255,5,30.1,-1.2609745,36.7886626,-1.2743958,36.8215915,785,748,36,824
92,10820,1281,3,Business,25,2,38993,25,2,39147,25,2,39870,25,2,40766,25,2,44453,9,23.9,-1.2869041,36.8240057,-1.2706815,36.7646286,532,3687,154,1619
93,2255,419,3,Business,3,3,50052,3,3,50162,3,3,50185,3,3,52268,3,3,53092,7,26.7,-1.2886923,36.8241519,-1.2571472,36.7950633,6,824,110,2106
94,15634,3560,3,Business,24,5,54632,24,5,54730,24,5,54779,24,5,55063,24,5,60168,18,22.8,-1.3705766,36.9120742,-1.279395,36.825364,564,5105,98,333
95,13979,1578,3,Business,5,1,55254,5,1,55321,5,1,56583,5,1,56929,5,1,58416,5,25.8,-1.28878,36.8168312,-1.2597529,36.806629,795,1487,67,1608
96,14861,1187,1,Personal,17,1,38449,17,1,39189,17,1,40260,17,1,40790,17,1,42484,4,25.2,-1.3025958,36.8614441,-1.3302867,36.8542859,810,1694,740,1601
97,18800,1329,3,Business,13,1,55081,13,1,55375,13,1,56037,13,1,56237,13,1,57544,6,23.25888921888938,-1.273056,36.811298,-1.2370629,36.7981962,161,1307,294,862
98,26616,2523,3,Business,13,1,33195,13,1,33233,13,1,33508,13,1,33593,13,1,36214,20,23.25888921888938,-1.2551895,36.7822034,-1.3251247,36.8995926,190,2621,38,360
99,20962,3544,2,Personal,18,5,67958,18,5,70100,18,5,70939,18,5,72092,18,5,73288,4,19.3,-1.25537,36.7756,-1.271377,36.7884294,103,1196,2142,1992
100,11708,517,3,Business,30,4,36876,30,4,36905,30,4,37650,30,4,38844,30,4,39588,4,23.25888921888938,-1.3228003,36.8306435,-1.3004062,36.829741,349,744,29,1939
101,1567,186,3,Business,5,2,56228,5,2,56568,5,2,58152,5,2,58453,5,2,59817,6,27.7,-1.2571472,36.7950633,-1.2925919,36.8170577,85,1364,340,1885
102,23834,3621,3,Business,19,2,30926,19,2,30942,19,2,31134,19,2,31463,19,2,31791,4,21.3,-1.2836583,36.7886014,-1.2913246,36.8019522,247,328,16,521
103,26496,393,3,Business,8,5,38575,8,5,38621,8,5,38825,8,5,39117,8,5,40612,11,28.6,-1.3167113,36.8301563,-1.2638185,36.7930057,411,1495,46,496
104,9169,598,1,Business,19,2,60964,19,2,61115,19,2,61623,19,2,61898,19,2,63591,6,19.7,-1.2536042,36.8064895,-1.2668265,36.7680484,427,1693,151,783
105,1570,517,3,Business,29,3,36645,29,3,36726,29,3,37968,29,3,38344,29,3,40258,14,23.25888921888938,-1.3228003,36.8306435,-1.2991441,36.7528804,829,1914,81,1618
106,63,3621,3,Business,30,6,33337,30,6,33382,30,6,34126,30,6,34390,30,6,36443,9,23.25888921888938,-1.2836583,36.7886014,-1.3222535,36.8246176,508,2053,45,1008
107,12953,49,3,Business,27,4,53397,27,4,53762,27,4,54283,27,4,54519,27,4,56168,10,23.7,-1.2790196,36.8160867,-1.2906539,36.7523571,21,1649,365,757
108,15454,797,3,Business,18,3,28439,18,3,28453,18,3,28682,18,3,29033,18,3,31041,15,14.5,-1.2551895,36.7822034,-1.2686837,36.8891847,116,2008,14,580
109,15476,867,3,Business,18,2,41946,18,2,43991,18,2,44150,18,2,44886,18,2,46445,10,23.25888921888938,-1.2996533,36.8292629,-1.2991441,36.7528804,555,1559,2045,895
110,22769,247,3,Personal,27,4,52520,27,4,52586,27,4,53319,27,4,54195,27,4,54410,4,25.2,-1.2850644,36.8343657,-1.290026,36.8165275,531,215,66,1609
111,14296,2676,3,Business,18,1,49669,18,1,49952,18,1,51348,18,1,51576,18,1,53592,7,30.8,-1.3047473,36.830562,-1.2963097,36.7688221,448,2016,283,1624
112,23454,2587,3,Business,16,2,51906,16,2,54233,16,2,55354,16,2,55432,16,2,56484,6,23.25888921888938,-1.2765736,36.8513646,-1.28878,36.8168312,438,1052,2327,1199
113,19485,1761,3,Business,5,2,38562,5,2,39848,5,2,40401,5,2,40825,5,2,42804,17,23.8,-1.3339943,36.7263409,-1.2830989,36.8165739,952,1979,1286,977
114,11002,2030,3,Business,10,3,33963,10,3,34001,10,3,34008,10,3,34313,10,3,34689,2,21.7,-1.2963097,36.7688221,-1.2969741,36.7856612,438,376,38,312
115,25971,3548,1,Personal,20,4,40028,20,4,40271,20,4,42215,20,4,42375,20,4,44432,9,24.6,-1.3112755,36.7430611,-1.29817,36.8001417,482,2057,243,2104
116,19307,3647,3,Business,8,1,39626,8,1,39730,8,1,40398,8,1,40574,8,1,42790,16,27.7,-1.272639,36.794723,-1.2155671,36.8898931,245,2216,104,844
117,9727,2178,1,Personal,10,5,44008,10,5,44124,10,5,44557,10,5,44827,10,5,46138,6,19.1,-1.2998552,36.8187077,-1.2781391,36.8267148,249,1311,116,703
118,3145,3647,3,Business,11,4,59307,11,4,59369,11,4,61891,11,4,62437,11,4,64867,19,24.2,-1.272639,36.794723,-1.1940334,36.9187324,606,2430,62,3068
119,15827,1637,3,Business,5,1,56900,5,1,56907,5,1,57072,5,1,58347,5,1,59778,14,25.9,-1.2615888,36.7928732,-1.2283403,36.8822756,551,1431,7,1440
120,13369,3508,2,Personal,22,6,43526,22,6,43554,22,6,45013,22,6,46045,22,6,47633,8,21.2,-1.2755887,36.8742523,-1.2677646,36.8298466,408,1588,28,2491
121,11369,1573,1,Personal,4,1,70874,4,1,70893,4,1,71074,4,1,71489,4,1,71952,6,18.9,-1.273056,36.811298,-1.297657,36.7995692,116,463,19,596
122,26196,2332,1,Personal,25,3,50908,25,3,50919,25,3,52127,25,3,52305,25,3,53796,20,17.9,-1.215678,36.873872,-1.293393,36.790237,265,1491,11,1386
123,667,1151,2,Personal,4,2,37175,4,2,37228,4,2,38064,4,2,39284,4,2,40879,10,18.7,-1.311121,36.900472,-1.3233955,36.8562944,753,1595,53,2056
124,27885,2606,1,Personal,19,5,35196,19,5,35233,19,5,36006,19,5,36846,19,5,38590,8,20.0,-1.2528485,36.7953722,-1.2973949,36.816038,446,1744,37,1613
125,23420,2866,3,Business,4,1,47259,4,1,47307,4,1,47924,4,1,48341,4,1,49078,4,25.4,-1.2696183,36.8021778,-1.2551895,36.7822034,885,737,48,1034
126,6027,1469,3,Business,21,5,45718,21,5,46130,21,5,47355,21,5,48234,21,5,48250,4,22.9,-1.2571472,36.7950633,-1.2731645,36.7900343,793,16,412,2104
127,8737,346,3,Business,19,5,53000,19,5,53058,19,5,53813,19,5,54386,19,5,55405,6,23.25888921888938,-1.28878,36.8168312,-1.2527958,36.8003131,705,1019,58,1328
128,6699,1973,2,Personal,17,1,38857,17,1,38884,17,1,39338,17,1,39793,17,1,41114,7,25.2,-1.3034231,36.7650287,-1.2655477,36.8001682,328,1321,27,909
129,7095,265,3,Business,14,4,46637,14,4,48426,14,4,48779,14,4,49734,14,4,55264,48,27.8,-1.300921,36.828195,-1.0302254,37.0167793,102,5530,1789,1308
130,27892,3420,3,Business,7,5,53054,7,5,53596,7,5,54281,7,5,55256,7,5,57636,7,25.0,-1.265981,36.7936121,-1.3046007,36.8211743,726,2380,542,1660
131,4643,1500,3,Business,6,3,46155,6,3,46200,6,3,47615,6,3,48131,6,3,49552,8,22.6,-1.3004062,36.829741,-1.2638185,36.7930057,332,1421,45,1931
132,27447,2330,1,Business,28,5,60084,28,5,60136,28,5,63521,28,5,63982,28,5,66266,19,23.25888921888938,-1.254191,36.8099132,-1.185943,36.9276394,532,2284,52,3846
133,10974,1559,2,Personal,11,4,47584,11,4,47619,11,4,48498,11,4,49693,11,4,51408,14,26.7,-1.2514753,36.7870287,-1.2287936,36.826979,882,1715,35,2074
134,6460,868,3,Business,25,4,39823,25,4,39833,25,4,40088,25,4,40498,25,4,41268,7,23.25888921888938,-1.2628473,36.781805,-1.265715,36.823815,709,770,10,665
135,1855,2386,1,Personal,14,6,45146,14,6,45210,14,6,46175,14,6,46556,14,6,48216,6,17.6,-1.2965169,36.793522,-1.3186522,36.7699884,465,1660,64,1346
136,855,3725,2,Personal,6,4,61632,6,4,61652,6,4,61805,6,4,62061,6,4,63103,4,22.7,-1.2547349,36.8065138,-1.2731645,36.7900343,409,1042,20,409
137,2965,1995,3,Business,14,3,35519,14,3,35531,14,3,35880,14,3,36033,14,3,38161,22,18.6,-1.2551895,36.7822034,-1.3562374,36.9042954,793,2128,12,502
138,10339,3647,3,Business,20,1,36872,20,1,36926,20,1,38054,20,1,38142,20,1,40090,14,23.25888921888938,-1.3175925,36.8742349,-1.272639,36.794723,364,1948,54,1216
139,28104,3147,3,Business,2,2,49697,2,2,49753,2,2,52743,2,2,53122,2,2,55548,15,26.0,-1.3472066,36.7692638,-1.308106,36.86594,846,2426,56,3369
140,15326,84,3,Business,26,1,43477,26,1,44059,26,1,44651,26,1,45334,26,1,48024,9,22.9,-1.2551895,36.7822034,-1.3014461,36.7661381,607,2690,582,1275
141,27512,3510,1,Business,25,5,59838,25,5,60162,25,5,61480,25,5,62029,25,5,63447,6,21.1,-1.2472211,36.7826109,-1.2702719,36.7688649,888,1418,324,1867
142,15258,3525,3,Business,7,5,41239,7,5,41246,7,5,41464,7,5,42600,7,5,45057,21,24.9,-1.2551895,36.7822034,-1.3700383,36.9190174,828,2457,7,1354
143,14165,1205,3,Business,7,5,42079,7,5,42323,7,5,43634,7,5,44783,7,5,47178,5,25.6,-1.2810807,36.8144229,-1.299846,36.7940155,268,2395,244,2460
144,23852,2627,3,Business,28,1,44379,28,1,45206,28,1,46186,28,1,46722,28,1,48008,15,23.9,-1.2283403,36.8822756,-1.2571472,36.7950633,276,1286,827,1516
145,5478,1642,3,Business,5,1,42856,5,1,43560,5,1,44086,5,1,45987,5,1,46920,5,24.4,-1.2768982,36.8262879,-1.2728069,36.7962362,268,933,704,2427
146,383,633,3,Business,10,4,50827,10,4,50848,10,4,50872,10,4,51177,10,4,51889,5,25.4,-1.2770708,36.8231093,-1.3004062,36.829741,812,712,21,329
147,19533,3647,3,Business,5,3,40158,5,3,40246,5,3,40879,5,3,41169,5,3,44358,15,22.6,-1.272639,36.794723,-1.3194518,36.869396,547,3189,88,923
148,7197,2989,3,Business,18,4,56812,18,4,56907,18,4,56917,18,4,57106,18,4,58692,12,26.7,-1.3472066,36.7692638,-1.2793859,36.8218002,79,1586,95,199
149,7790,2521,3,Business,26,6,38014,26,6,38061,26,6,38718,26,6,38904,26,6,40636,14,26.0,-1.3167113,36.8301563,-1.306378,36.7519845,523,1732,47,843
150,2701,265,3,Business,27,2,45471,27,2,45958,27,2,46599,27,2,46860,27,2,48171,7,23.7,-1.300921,36.828195,-1.2595467,36.8113044,685,1311,487,902
151,27173,909,3,Business,14,2,53306,14,2,53306,14,2,53437,14,2,54095,14,2,56201,7,23.25888921888938,-1.2527958,36.8003131,-1.225322,36.80855,510,2106,0,789
152,2869,2285,1,Personal,8,1,35976,8,1,36291,8,1,37116,8,1,38164,8,1,39593,10,24.5,-1.3324594,36.861964,-1.2950041,36.8143583,662,1429,315,1873
153,3761,2607,2,Personal,30,6,54545,30,6,58035,30,6,58848,30,6,59439,30,6,60630,8,23.8,-1.2917966,36.7730221,-1.304119,36.819649,844,1191,3490,1404
154,25270,393,3,Business,13,2,48894,13,2,51068,13,2,51083,13,2,54392,13,2,56039,14,26.0,-1.3177547,36.8303703,-1.306378,36.7519845,555,1647,2174,3324
155,10054,1927,3,Business,16,4,58975,16,4,61344,16,4,61624,16,4,61827,16,4,64239,14,23.25888921888938,-1.3472066,36.7692638,-1.3106338,36.6809768,821,2412,2369,483
156,7561,2946,2,Personal,31,4,55703,31,4,55885,31,4,58204,31,4,58399,31,4,60052,10,22.7,-1.2749662,36.7658781,-1.289521,36.8190724,124,1653,182,2514
157,8538,1548,1,Personal,9,1,62918,9,1,63007,9,1,64001,9,1,64511,9,1,65433,4,20.3,-1.2950408,36.8098172,-1.3136452,36.7974014,312,922,89,1504
158,20150,1787,3,Business,4,2,48756,4,2,49484,4,2,51062,4,2,51217,4,2,52380,3,22.6,-1.215909,36.886056,-1.2283403,36.8822756,402,1163,728,1733
159,6734,60,3,Business,15,2,44233,15,2,44245,15,2,44307,15,2,46589,15,2,46609,10,24.4,-1.2600926,36.8088685,-1.2296618,36.8438272,517,20,12,2344
160,15912,12,3,Business,6,4,45387,6,4,46142,6,4,47554,6,4,47871,6,4,49853,9,23.9,-1.240021,36.84999,-1.2864963,36.8252086,764,1982,755,1729
161,8453,2871,1,Personal,20,5,41084,20,5,41161,20,5,42554,20,5,43252,20,5,44134,8,18.5,-1.288922,36.814826,-1.2623805,36.7805404,159,882,77,2091
162,16835,3291,3,Business,15,5,41641,15,5,41665,15,5,42820,15,5,43588,15,5,46582,18,25.8,-1.3393547,36.8910035,-1.2600926,36.8088685,856,2994,24,1923
163,10269,867,3,Business,14,4,55979,14,4,56113,14,4,58178,14,4,60514,14,4,61875,10,26.2,-1.2996533,36.8292629,-1.2991441,36.7528804,233,1361,134,4401
164,11318,718,3,Business,5,5,44908,5,5,44954,5,5,44960,5,5,45822,5,5,47314,12,23.9,-1.2551895,36.7822034,-1.320157,36.830887,871,1492,46,868
165,24446,71,3,Business,6,2,51173,6,2,58589,6,2,59322,6,2,60126,6,2,63147,8,23.25888921888938,-1.2891922,36.825189,-1.2551895,36.7822034,456,3021,7416,1537
166,22511,3517,3,Business,19,5,28693,19,5,28697,19,5,29888,19,5,33098,19,5,34415,15,20.4,-1.300921,36.828195,-1.3882008,36.7699445,208,1317,4,4401
167,24913,2509,3,Business,24,1,46580,24,1,46587,24,1,46782,24,1,49451,24,1,51739,20,23.25888921888938,-1.2571472,36.7950633,-1.3700383,36.9190174,290,2288,7,2864
168,27461,635,3,Business,10,1,38466,10,1,38820,10,1,40491,10,1,41953,10,1,41961,5,18.7,-1.2867454,36.8259017,-1.2602337,36.7990548,766,8,354,3133
169,6738,516,3,Business,10,5,57764,10,5,57863,10,5,57892,10,5,60346,10,5,62737,13,23.25888921888938,-1.2571472,36.7950633,-1.2224188,36.8868824,291,2391,99,2483
170,1632,496,3,Business,20,3,44380,20,3,44490,20,3,44897,20,3,45595,20,3,48233,10,20.3,-1.2551895,36.7822034,-1.3201096,36.8180968,101,2638,110,1105
171,3572,3621,3,Business,23,2,32415,23,2,32454,23,2,33177,23,2,33427,23,2,34361,4,15.3,-1.2836583,36.7886014,-1.2833106,36.8240238,571,934,39,973
172,12234,3404,3,Business,22,6,58607,22,6,61060,22,6,61770,22,6,62003,22,6,63298,11,23.8,-1.279395,36.825364,-1.3206958,36.8769553,576,1295,2453,943
173,16858,3517,3,Business,7,4,49038,7,4,49127,7,4,49497,7,4,49703,7,4,51090,16,27.5,-1.300921,36.828195,-1.3882008,36.7699445,136,1387,89,576
174,20386,3599,3,Business,4,2,45257,4,2,45893,4,2,51087,4,2,52701,4,2,57410,15,22.4,-1.3302996,36.8707935,-1.2610066,36.7851622,459,4709,636,6808
175,19094,393,3,Business,24,5,38680,24,5,38734,24,5,40364,24,5,41331,24,5,44086,11,21.3,-1.3228003,36.8306435,-1.2638185,36.7930057,564,2755,54,2597
176,4448,3599,3,Business,14,4,48217,14,4,50189,14,4,51997,14,4,54547,14,4,57297,13,28.2,-1.3302996,36.8707935,-1.2913552,36.7875945,152,2750,1972,4358
177,16444,635,3,Business,27,3,53988,27,3,54114,27,3,54249,27,3,55393,27,3,56769,8,29.6,-1.3081376,36.8329772,-1.2602337,36.7990548,787,1376,126,1279
178,3042,757,1,Personal,20,4,44826,20,4,44848,20,4,45187,20,4,46434,20,4,48711,14,24.2,-1.2248308,36.8012573,-1.2952784,36.7793271,215,2277,22,1586
179,20468,852,2,Personal,11,3,62611,11,3,62839,11,3,63076,11,3,63679,11,3,64600,8,19.9,-1.298066,36.7767095,-1.263593,36.7882903,431,921,228,840
180,24788,81,3,Business,25,1,55150,25,1,55354,25,1,56111,25,1,56442,25,1,57140,4,23.25888921888938,-1.2641496,36.7914139,-1.2555811,36.802267,101,698,204,1088
181,20431,496,3,Business,30,4,46446,30,4,46462,30,4,46948,30,4,48480,30,4,51608,21,23.25888921888938,-1.2571472,36.7950633,-1.191363,36.9219712,424,3128,16,2018
182,6581,432,3,Business,20,1,66367,20,1,68233,20,1,69296,20,1,69524,20,1,72648,3,23.25888921888938,-1.3012008,36.764868,-1.2763494,36.7671783,868,3124,1866,1291
183,25970,265,3,Business,5,2,50121,5,2,50278,5,2,51295,5,2,51773,5,2,53431,11,27.6,-1.2433673,36.7849565,-1.300921,36.828195,148,1658,157,1495
184,17247,265,3,Business,13,2,59014,13,2,60562,13,2,61023,13,2,61146,13,2,61828,4,23.7,-1.300921,36.828195,-1.2974472,36.8156997,685,682,1548,584
185,9028,620,2,Personal,4,4,49678,4,4,51737,4,4,52469,4,4,53833,4,4,59224,11,24.6,-1.2293754,36.8624324,-1.281553,36.8185334,86,5391,2059,2096
186,2441,1705,3,Business,9,4,53222,9,4,53264,9,4,54352,9,4,54439,9,4,55996,15,25.9,-1.2551895,36.7822034,-1.2239216,36.8792146,379,1557,42,1175
187,595,1304,3,Business,17,5,48769,17,5,49404,17,5,50300,17,5,50614,17,5,51844,6,23.25888921888938,-1.2551895,36.7822034,-1.2855666,36.8194926,709,1230,635,1210
188,17816,1402,3,Business,20,1,34613,20,1,34642,20,1,34749,20,1,35062,20,1,35517,1,18.9,-1.279395,36.825364,-1.2813012,36.8323962,456,455,29,420
189,4298,2123,1,Personal,15,1,33746,15,1,33811,15,1,35933,15,1,36133,15,1,37952,3,23.25888921888938,-1.2833335,36.8260084,-1.2969035,36.8083806,338,1819,65,2322
190,11024,2330,3,Business,9,4,50124,9,4,50248,9,4,50841,9,4,51081,9,4,52167,5,23.25888921888938,-1.3015197,36.7658456,-1.2921463,36.8029626,348,1086,124,833
191,12738,2008,3,Business,31,5,35082,31,5,35138,31,5,35601,31,5,36242,31,5,37665,9,23.25888921888938,-1.2508229,36.7895263,-1.2944584,36.7614555,937,1423,56,1104
192,14693,788,3,Business,5,2,43756,5,2,43776,5,2,44344,5,2,44513,5,2,46890,15,23.8,-1.2232123,36.8932547,-1.225322,36.80855,691,2377,20,737
193,8012,3565,3,Business,10,7,45105,10,7,45235,10,7,46607,10,7,46866,10,7,49948,29,23.25888921888938,-1.2844665,36.7866113,-1.1428716,36.962347,267,3082,130,1631
194,12436,2227,3,Personal,19,3,37737,19,3,37788,19,3,38179,19,3,38618,19,3,40208,8,22.4,-1.2541275,36.8263055,-1.297101,36.798243,630,1590,51,830
195,9774,360,3,Personal,31,4,33529,31,4,33542,31,4,34302,31,4,35707,31,4,40455,29,17.3,-1.2959053,36.7898158,-1.142527,36.91799,79,4748,13,2165
196,834,788,3,Business,16,3,32430,16,3,32497,16,3,33750,16,3,34599,16,3,37360,11,19.8,-1.225322,36.80855,-1.291768,36.8297208,101,2761,67,2102
197,6654,1205,3,Business,26,2,44938,26,2,44967,26,2,45133,26,2,45501,26,2,46380,3,27.5,-1.2495931,36.8065087,-1.2714767,36.8138291,484,879,29,534
198,21691,3517,3,Business,19,1,40657,19,1,40774,19,1,42542,19,1,43162,19,1,45227,15,24.9,-1.300921,36.828195,-1.3882008,36.7699445,280,2065,117,2388
199,23114,788,3,Business,12,1,43277,12,1,43358,12,1,44085,12,1,44608,12,1,46799,15,23.6,-1.3052491,36.8223899,-1.225322,36.80855,778,2191,81,1250
200,27149,2412,3,Business,21,2,43040,21,2,43061,21,2,43142,21,2,43719,21,2,44704,12,22.7,-1.2584143,36.8048002,-1.2283403,36.8822756,383,985,21,658
201,827,3326,3,Business,16,2,58143,16,2,58335,16,2,59194,16,2,60256,16,2,63598,8,23.25888921888938,-1.2571472,36.7950633,-1.3025667,36.7803495,422,3342,192,1921
202,92,1724,3,Business,25,1,40900,25,1,40906,25,1,40926,25,1,41685,25,1,44632,23,25.7,-1.2551895,36.7822034,-1.3724413,36.9284922,430,2947,6,779
203,1503,3755,1,Personal,18,4,35031,18,4,35051,18,4,35201,18,4,35390,18,4,36370,6,20.6,-1.2956756,36.7719383,-1.2617028,36.7983849,680,980,20,339
204,6795,1724,3,Business,2,1,36326,2,1,36362,2,1,36844,2,1,37463,2,1,38239,8,16.8,-1.2958383,36.8073162,-1.2551895,36.7822034,103,776,36,1101
205,9197,1245,3,Business,21,2,34709,21,2,34730,21,2,34747,21,2,36883,21,2,38395,17,23.25888921888938,-1.300921,36.828195,-1.3198615,36.7110323,120,1512,21,2153
206,7102,2423,3,Business,24,2,53416,24,2,53424,24,2,53483,24,2,53932,24,2,55199,6,18.4,-1.2551895,36.7822034,-1.2884308,36.821751,415,1267,8,508
207,25304,2987,3,Business,25,2,44296,25,2,45060,25,2,45274,25,2,45399,25,2,46797,10,23.6,-1.270212,36.8210877,-1.3014461,36.7661381,574,1398,764,339
208,13188,2523,3,Business,25,1,50634,25,1,50660,25,1,51850,25,1,52345,25,1,54393,17,23.25888921888938,-1.2551895,36.7822034,-1.3339943,36.7263409,648,2048,26,1685
209,13700,1852,1,Personal,8,1,29265,8,1,29291,8,1,30485,8,1,30790,8,1,32184,8,20.0,-1.2657709,36.7305746,-1.2922857,36.7813274,74,1394,26,1499
210,24749,3194,3,Business,3,3,45325,3,3,45376,3,3,45628,3,3,45876,3,3,46558,5,27.4,-1.2551895,36.7822034,-1.270721,36.786231,250,682,51,500
211,22336,1961,3,Business,20,1,32382,20,1,33501,20,1,33845,20,1,34245,20,1,35295,9,19.1,-1.303596,36.778378,-1.3188359,36.7038526,628,1050,1119,744
212,19647,1304,3,Business,15,4,57825,15,4,57882,15,4,58901,15,4,58973,15,4,60524,3,27.5,-1.2551895,36.7822034,-1.2562366,36.8038565,866,1551,57,1091
213,23342,3689,3,Business,31,1,48510,31,1,48772,31,1,50400,31,1,51430,31,1,53951,16,24.1,-1.3472066,36.7692638,-1.2527958,36.8003131,428,2521,262,2658
214,15594,646,2,Personal,3,2,37087,3,2,37248,3,2,39260,3,2,40245,3,2,41306,7,18.5,-1.284705,36.79287,-1.2661264,36.8030359,752,1061,161,2997
215,19988,3621,3,Business,29,6,43906,29,6,43961,29,6,45246,29,6,45460,29,6,48100,15,24.2,-1.2836583,36.7886014,-1.2778747,36.8831829,854,2640,55,1499
216,12098,1340,3,Business,10,4,47296,10,4,47408,10,4,48709,10,4,49116,10,4,50144,9,21.9,-1.2819626,36.7540971,-1.2707179,36.7979713,749,1028,112,1708
217,8325,2763,3,Business,4,1,53719,4,1,53911,4,1,54540,4,1,54865,4,1,56948,5,23.25888921888938,-1.2551895,36.7822034,-1.2711982,36.8240199,205,2083,192,954
218,7719,3175,3,Business,17,3,35537,17,3,35573,17,3,36306,17,3,36436,17,3,40469,16,21.1,-1.2681004,36.7952081,-1.207546,36.7913976,932,4033,36,863
219,8655,3462,1,Personal,25,2,49945,25,2,49974,25,2,52364,25,2,52441,25,2,53637,6,27.2,-1.255683,36.813771,-1.2817758,36.7980252,434,1196,29,2467
220,12573,570,3,Business,13,2,32507,13,2,33722,13,2,34484,13,2,34997,13,2,35927,6,19.7,-1.2551895,36.7822034,-1.2765492,36.7669809,778,930,1215,1275
221,18011,2627,3,Business,11,2,54715,11,2,54915,11,2,55927,11,2,56295,11,2,57153,9,22.5,-1.3014461,36.7661381,-1.2571472,36.7950633,279,858,200,1380
222,23551,2718,3,Business,11,2,58188,11,2,58283,11,2,58983,11,2,59210,11,2,59951,2,22.1,-1.2741118,36.8020094,-1.2657456,36.8087424,112,741,95,927
223,13385,1927,3,Business,22,6,44592,22,6,45686,22,6,46317,22,6,46511,22,6,50215,26,23.1,-1.3472066,36.7692638,-1.207546,36.7913976,200,3704,1094,825
224,13492,265,3,Business,9,3,52382,9,3,52415,9,3,52616,9,3,53494,9,3,54663,8,25.3,-1.29276,36.783799,-1.300921,36.828195,862,1169,33,1079
225,8408,2066,3,Business,11,2,51156,11,2,51166,11,2,51306,11,2,51484,11,2,52103,5,25.4,-1.316961,36.820337,-1.2885504,36.8066908,676,619,10,318
226,268,1342,3,Business,25,2,49995,25,2,51270,25,2,52538,25,2,52723,25,2,53652,9,27.0,-1.290894,36.822971,-1.3025826,36.7670807,88,929,1275,1453
227,1178,393,3,Business,9,2,44383,9,2,44394,9,2,44714,9,2,44784,9,2,46628,5,27.0,-1.3004062,36.829741,-1.3167113,36.8301563,151,1844,11,390
228,8604,1744,2,Personal,4,5,45843,4,5,52943,4,5,53954,4,5,54131,4,5,55443,6,24.1,-1.2516322,36.8250834,-1.2857902,36.8316231,753,1312,7100,1188
229,9123,3701,3,Business,2,2,52373,2,2,52404,2,2,54390,2,2,54468,2,2,56314,17,29.2,-1.2612574,36.7879622,-1.3253037,36.8942439,576,1846,31,2064
230,26948,346,3,Business,12,3,44619,12,3,44969,12,3,45764,12,3,48017,12,3,49220,5,19.4,-1.2584143,36.8048002,-1.28878,36.8168312,106,1203,350,3048
231,1233,2330,3,Business,26,2,51041,26,2,51054,26,2,51323,26,2,51513,26,2,52977,8,29.8,-1.3015197,36.7658456,-1.2649605,36.7981777,831,1464,13,459
232,8285,1469,3,Business,15,1,35347,15,1,35454,15,1,35918,15,1,36159,15,1,36972,7,23.25888921888938,-1.2551895,36.7822034,-1.2896399,36.8124498,453,813,107,705
233,8160,606,1,Personal,10,1,39998,10,1,40732,10,1,41388,10,1,41549,10,1,42286,8,23.25888921888938,-1.2143387,36.7914548,-1.2152204,36.8563184,453,737,734,817
234,3873,3689,3,Business,5,2,49687,5,2,49708,5,2,49715,5,2,49780,5,2,50825,6,22.6,-1.2601709,36.8002238,-1.2904016,36.8226303,379,1045,21,72
235,28262,391,3,Business,23,2,52991,23,2,53061,23,2,54287,23,2,54568,23,2,56446,20,18.8,-1.2857574,36.8295667,-1.1923911,36.9447333,449,1878,70,1507
236,11515,1412,3,Personal,25,3,44288,25,3,44314,25,3,45068,25,3,45408,25,3,47545,10,23.25888921888938,-1.238874,36.807889,-1.2591485,36.7891335,208,2137,26,1094
237,5562,1280,3,Business,12,2,52907,12,2,52964,12,2,53834,12,2,53917,12,2,57225,8,23.25888921888938,-1.2551895,36.7822034,-1.2897215,36.7945959,131,3308,57,953
238,11581,3698,3,Business,7,5,46892,7,5,46952,7,5,47875,7,5,49500,7,5,50809,11,23.25888921888938,-1.2669247,36.9086497,-1.3244885,36.897792,75,1309,60,2548
239,4783,2294,3,Business,16,2,45689,16,2,45753,16,2,47755,16,2,47977,16,2,49789,11,23.25888921888938,-1.2977969,36.8104085,-1.2788572,36.8794368,831,1812,64,2224
240,24085,1071,1,Personal,6,1,38463,6,1,38476,6,1,39012,6,1,39629,6,1,41053,11,20.3,-1.3301743,36.8487987,-1.2689015,36.7986106,105,1424,13,1153
241,18899,246,3,Business,7,5,52836,7,5,53063,7,5,53804,7,5,54006,7,5,54245,15,25.0,-1.2297202,36.8819507,-1.2584143,36.8048002,704,239,227,943
242,10888,420,3,Business,26,2,69142,26,2,70034,26,2,70621,26,2,71502,26,2,72029,6,22.5,-1.2517448,36.7924971,-1.2643683,36.7777614,361,527,892,1468
243,25303,1329,3,Business,30,3,34831,30,3,35027,30,3,35936,30,3,36105,30,3,36875,2,19.6,-1.273056,36.811298,-1.2600932,36.8041689,206,770,196,1078
244,22168,62,3,Business,27,1,41219,27,1,45181,27,1,45932,27,1,47080,27,1,51754,11,20.9,-1.2967108,36.7871135,-1.324859,36.859367,812,4674,3962,1899
245,15232,1363,3,Business,26,2,38778,26,2,38866,26,2,39281,26,2,39549,26,2,40782,7,26.3,-1.3004062,36.829741,-1.2953162,36.7828041,837,1233,88,683
246,13479,346,3,Business,14,2,57457,14,2,57790,14,2,60336,14,2,62362,14,2,62473,10,23.25888921888938,-1.2274192,36.8008308,-1.28878,36.8168312,193,111,333,4572
247,20462,186,3,Business,7,4,39476,7,4,39517,7,4,40216,7,4,41050,7,4,43357,20,27.5,-1.2571472,36.7950633,-1.3700383,36.9190174,831,2307,41,1533
248,6148,1162,3,Business,17,5,33652,17,5,33936,17,5,34525,17,5,34761,17,5,36560,8,23.25888921888938,-1.312261,36.794658,-1.2776982,36.83126,344,1799,284,825
249,1353,393,3,Business,18,2,34502,18,2,39248,18,2,39254,18,2,40822,18,2,41841,11,23.25888921888938,-1.3167113,36.8301563,-1.2574219,36.7927073,515,1019,4746,1574
250,46,1932,3,Business,9,1,47166,9,1,47205,9,1,47880,9,1,47999,9,1,48929,7,20.5,-1.2985987,36.7809119,-1.2736498,36.8061911,312,930,39,794
251,2908,2530,1,Personal,14,7,55310,14,7,55343,14,7,55865,14,7,56170,14,7,56696,6,28.6,-1.2049707,36.7858957,-1.238874,36.807889,453,526,33,827
252,25281,1940,1,Personal,21,4,38583,21,4,38981,21,4,39466,21,4,40783,21,4,42259,10,21.8,-1.276312,36.882742,-1.3157973,36.815148,549,1476,398,1802
253,6173,136,3,Business,27,4,56952,27,4,56964,27,4,59508,27,4,60275,27,4,62976,27,22.8,-1.3165104,36.7077726,-1.2313147,36.8016863,789,2701,12,3311
254,20016,3521,3,Business,6,4,59492,6,4,59568,6,4,59691,6,4,60096,6,4,60842,3,21.6,-1.2594474,36.8089122,-1.2560874,36.7931031,536,746,76,528
255,9691,1207,3,Business,23,6,43490,23,6,43525,23,6,43671,23,6,44026,23,6,45732,13,23.25888921888938,-1.2629666,36.8068369,-1.2156006,36.8916865,119,1706,35,501
256,19506,2746,1,Personal,1,2,38509,1,2,38629,1,2,39949,1,2,40402,1,2,40893,4,21.7,-1.2784495,36.7981729,-1.2789477,36.8122359,396,491,120,1773
257,25163,598,1,Business,25,5,62301,25,5,62353,25,5,63276,25,5,63484,25,5,66482,20,21.1,-1.2536797,36.7995085,-1.2516072,36.6665983,103,2998,52,1131
258,504,677,3,Business,16,2,52246,16,2,52264,16,2,55538,16,2,55871,16,2,58701,3,23.25888921888938,-1.3025826,36.7670807,-1.2763494,36.7671783,167,2830,18,3607
259,25644,560,1,Personal,1,1,36655,1,1,36717,1,1,37383,1,1,37850,1,1,40119,8,18.6,-1.2611578,36.8145307,-1.2242368,36.8148681,409,2269,62,1133
260,22173,2008,3,Business,19,3,31758,19,3,31787,19,3,32334,19,3,32717,19,3,34813,10,19.6,-1.2508229,36.7895263,-1.301809,36.75643,854,2096,29,930
261,19812,1271,3,Business,24,1,43136,24,1,43152,24,1,46023,24,1,47981,24,1,49120,9,22.9,-1.3244885,36.897792,-1.2698307,36.8801649,26,1139,16,4829
262,25828,649,3,Business,26,2,37603,26,2,37673,26,2,38340,26,2,42189,26,2,43484,9,23.25888921888938,-1.3034396,36.8329998,-1.2551895,36.7822034,791,1295,70,4516
263,8781,1471,3,Business,13,3,40491,13,3,40514,13,3,40680,13,3,41254,13,3,41267,3,24.7,-1.2551895,36.7822034,-1.2705336,36.7943509,720,13,23,740
264,22771,2766,1,Personal,9,3,39179,9,3,39504,9,3,43024,9,3,44010,9,3,46254,8,21.2,-1.3214137,36.8569475,-1.2851847,36.8314086,698,2244,325,4506
265,10564,1927,3,Business,6,4,44014,6,4,44125,6,4,45337,6,4,46255,6,4,48447,12,19.8,-1.279395,36.825364,-1.3472066,36.7692638,36,2192,111,2130
266,5610,1469,3,Business,15,4,56336,15,4,56444,15,4,56592,15,4,57035,15,4,59826,18,27.7,-1.2571472,36.7950633,-1.3339943,36.7263409,647,2791,108,591
267,15861,3391,1,Personal,19,7,37718,19,7,37910,19,7,38295,19,7,39653,19,7,40169,3,18.1,-1.316948,36.824399,-1.3009926,36.8208532,329,516,192,1743
268,17268,3099,1,Personal,28,5,39914,28,5,40179,28,5,41074,28,5,41579,28,5,42479,5,25.1,-1.3205669,36.8362168,-1.2932015,36.8284918,532,900,265,1400
269,9121,970,3,Business,1,5,38830,1,5,39104,1,5,40209,1,5,40600,1,5,44010,19,26.7,-1.2551895,36.7822034,-1.3459625,36.9073925,831,3410,274,1496
270,25893,2330,3,Business,17,4,36768,17,4,36797,17,4,37065,17,4,38806,17,4,39948,10,25.4,-1.2649605,36.7981777,-1.3015197,36.7658456,647,1142,29,2009
271,9565,111,3,Business,16,2,44149,16,2,44206,16,2,44505,16,2,44586,16,2,46658,13,23.25888921888938,-1.2551895,36.7822034,-1.3233955,36.8562944,570,2072,57,380
272,543,496,3,Business,5,5,59687,5,5,59708,5,5,59799,5,5,61048,5,5,62424,12,24.7,-1.2646084,36.8028645,-1.2044082,36.7775137,882,1376,21,1340
273,18477,718,3,Business,27,5,58275,27,5,58299,27,5,59093,27,5,59352,27,5,61514,9,23.8,-1.2551895,36.7822034,-1.3001735,36.8042049,519,2162,24,1053
274,10923,1280,3,Business,26,5,58681,26,5,58709,26,5,58744,26,5,59169,26,5,60031,4,23.25888921888938,-1.2551895,36.7822034,-1.2768326,36.8073804,531,862,28,460
275,26474,2066,3,Business,25,3,56619,25,3,56701,25,3,57482,25,3,57616,25,3,59035,16,17.6,-1.316961,36.820337,-1.3319686,36.9115553,409,1419,82,915
276,18347,635,3,Business,18,4,51832,18,4,51848,18,4,52087,18,4,53258,18,4,54003,1,23.25888921888938,-1.2567464,36.7915273,-1.2602337,36.7990548,641,745,16,1410
277,16196,1134,2,Personal,31,2,34468,31,2,34483,31,2,34596,31,2,34869,31,2,36400,13,16.9,-1.2560455,36.7800867,-1.2318301,36.7327062,735,1531,15,386
278,26723,2412,3,Business,31,2,64409,31,2,64418,31,2,64423,31,2,64750,31,2,65470,5,19.8,-1.2156006,36.8916865,-1.2297202,36.8819507,531,720,9,332
279,14911,3091,3,Business,25,1,32747,25,1,32954,25,1,33750,25,1,35795,25,1,39200,5,23.25888921888938,-1.290894,36.822971,-1.262073,36.7986087,127,3405,207,2841
280,5952,2978,3,Business,21,4,54331,21,4,54493,21,4,55212,21,4,55300,21,4,56479,7,26.4,-1.2551895,36.7822034,-1.2812264,36.8204146,330,1179,162,807
281,9853,2763,3,Business,28,4,52013,28,4,52026,28,4,52465,28,4,53585,28,4,54435,15,30.0,-1.2551895,36.7822034,-1.3255855,36.8647627,137,850,13,1559
282,5768,256,3,Personal,4,5,44738,4,5,44794,4,5,46078,4,5,46559,4,5,47983,6,22.6,-1.286837,36.823308,-1.2941024,36.79578,425,1424,56,1765
283,19071,393,3,Business,18,2,50674,18,2,51964,18,2,52055,18,2,52771,18,2,54429,11,25.4,-1.3167113,36.8301563,-1.2574219,36.7927073,518,1658,1290,807
284,9757,1244,3,Business,8,2,34523,8,2,34593,8,2,34656,8,2,35474,8,2,38013,9,19.1,-1.2600926,36.8088685,-1.303596,36.778378,107,2539,70,881
285,102,1589,3,Business,14,5,37035,14,5,37075,14,5,37476,14,5,38113,14,5,38992,4,22.1,-1.225322,36.7987613,-1.2391616,36.8101823,781,879,40,1038
286,2070,2707,3,Business,13,4,45104,13,4,45277,13,4,46235,13,4,47074,13,4,48833,9,22.0,-1.2654831,36.8293629,-1.2963097,36.7688221,382,1759,173,1797
287,6722,2509,3,Business,3,2,32332,3,2,32348,3,2,32643,3,2,32982,3,2,35387,20,15.4,-1.2579304,36.8019667,-1.3700383,36.9190174,116,2405,16,634
288,23674,733,3,Business,18,2,56232,18,2,56252,18,2,56645,18,2,56829,18,2,58734,18,25.7,-1.2584143,36.8048002,-1.3251247,36.8995926,456,1905,20,577
289,18202,706,3,Business,21,1,28131,21,1,28353,21,1,29007,21,1,29323,21,1,31372,4,16.8,-1.3004062,36.829741,-1.3077869,36.8443207,805,2049,222,970
290,15044,3517,3,Business,23,5,32268,23,5,32278,23,5,32285,23,5,37234,23,5,37577,15,20.4,-1.300921,36.828195,-1.3882008,36.7699445,137,343,10,4956
291,28149,265,3,Business,10,5,40058,10,5,40165,10,5,40741,10,5,41657,10,5,42710,8,23.25888921888938,-1.2731645,36.7900343,-1.300921,36.828195,298,1053,107,1492
292,9665,2847,3,Personal,5,5,61926,5,5,62571,5,5,63450,5,5,65027,5,5,66728,6,24.6,-1.2564799,36.8112138,-1.2822773,36.7953121,755,1701,645,2456
293,223,540,3,Business,2,5,43252,2,5,43900,2,5,45243,2,5,45500,2,5,46709,9,23.5,-1.3036803,36.8181344,-1.2551895,36.7822034,199,1209,648,1600
294,4383,3711,3,Business,29,4,61546,29,4,61959,29,4,62287,29,4,62951,29,4,64366,9,20.8,-1.290894,36.822971,-1.3014461,36.7661381,320,1415,413,992
295,15102,1469,3,Business,8,1,55230,8,1,55354,8,1,56659,8,1,57178,8,1,58590,12,24.7,-1.2571472,36.7950633,-1.2402455,36.8791753,882,1412,124,1824
296,5422,3514,2,Personal,14,7,47222,14,7,47236,14,7,47921,14,7,48580,14,7,51512,16,25.1,-1.3197995,36.8476721,-1.2664227,36.7453671,532,2932,14,1344
297,9017,1500,3,Business,3,3,55722,3,3,55995,3,3,56722,3,3,57751,3,3,58641,8,28.2,-1.3004062,36.829741,-1.2638185,36.7930057,576,890,273,1756
298,19830,972,3,Business,21,3,55545,21,3,56224,21,3,56733,21,3,56928,21,3,58883,5,23.2,-1.2862033,36.8152966,-1.2908072,36.7860517,178,1955,679,704
299,5550,3291,3,Business,28,4,33722,28,4,33754,28,4,34279,28,4,35978,28,4,36888,4,22.6,-1.272828,36.816608,-1.2600926,36.8088685,857,910,32,2224
300,6834,1402,3,Business,15,6,41190,15,6,42044,15,6,43106,15,6,43385,15,6,44338,2,22.1,-1.279395,36.825364,-1.281754,36.8324229,879,953,854,1341
301,22371,3557,3,Business,4,2,57980,4,2,58655,4,2,60751,4,2,62292,4,2,62294,9,22.3,-1.2876782,36.7605992,-1.2506993,36.8089666,652,2,675,3637
302,20968,3321,3,Personal,30,4,59415,30,4,59650,30,4,60367,30,4,64205,30,4,65218,5,23.25888921888938,-1.2861765,36.8209086,-1.2723552,36.7881306,796,1013,235,4555
303,3951,2701,3,Business,21,2,54368,21,2,54397,21,2,54427,21,2,56410,21,2,57926,15,24.9,-1.3472066,36.7692638,-1.2765736,36.8513646,815,1516,29,2013
304,22600,3404,3,Business,25,5,46362,25,5,46375,25,5,46456,25,5,47439,25,5,47451,1,26.6,-1.28878,36.8168312,-1.279395,36.825364,845,12,13,1064
305,4706,633,3,Business,1,5,53934,1,5,53942,1,5,53971,1,5,54863,1,5,55350,4,28.5,-1.3228003,36.8306435,-1.3004062,36.829741,523,487,8,921
306,28261,3689,3,Business,28,3,40429,28,3,40453,28,3,40456,28,3,42461,28,3,43871,13,23.25888921888938,-1.2363092,36.8823617,-1.2527958,36.8003131,450,1410,24,2008
307,6361,2378,3,Personal,16,2,48081,16,2,48137,16,2,48590,16,2,49121,16,2,51712,18,27.6,-1.3336562,36.9144339,-1.2950041,36.8143583,409,2591,56,984
308,24165,393,3,Business,20,3,38450,20,3,38474,20,3,38571,20,3,40396,20,3,40398,7,26.5,-1.3167113,36.8301563,-1.3083266,36.8494756,953,2,24,1922
309,7155,2330,3,Business,3,1,63421,3,1,67090,3,1,67149,3,1,67694,3,1,68974,8,17.8,-1.2687407,36.7373043,-1.3015197,36.7658456,310,1280,3669,604
310,9173,1075,3,Business,8,5,55836,8,5,56351,8,5,57101,8,5,57359,8,5,59192,2,30.5,-1.2527958,36.8003131,-1.2679657,36.8081617,849,1833,515,1008
311,15283,2763,3,Business,14,3,39123,14,3,39159,14,3,39656,14,3,40348,14,3,42162,16,24.7,-1.326825,36.864345,-1.2551895,36.7822034,550,1814,36,1189
312,22541,2956,3,Business,11,4,59346,11,4,59367,11,4,59801,11,4,60090,11,4,60571,2,26.7,-1.2584143,36.8048002,-1.2671296,36.8125772,547,481,21,723
313,9273,3621,3,Business,13,7,48886,13,7,48918,13,7,50241,13,7,50477,13,7,53869,19,24.7,-1.2836583,36.7886014,-1.2000932,36.7754458,246,3392,32,1559
314,7906,1054,3,Personal,17,3,55033,17,3,55900,17,3,56464,17,3,57428,17,3,58632,11,28.2,-1.2640244,36.8047682,-1.2222487,36.8081423,726,1204,867,1528
315,2958,2523,3,Business,13,1,33270,13,1,33313,13,1,33641,13,1,33881,13,1,36264,10,23.25888921888938,-1.2551895,36.7822034,-1.297131,36.7604242,50,2383,43,568
316,20305,1500,3,Business,18,2,41617,18,2,41817,18,2,42389,18,2,43903,18,2,45104,8,23.25888921888938,-1.3004062,36.829741,-1.2574219,36.7927073,518,1201,200,2086
317,12561,265,3,Business,3,5,34533,3,5,34594,3,5,37309,3,5,38586,3,5,40073,13,23.25888921888938,-1.235348,36.760016,-1.300921,36.828195,564,1487,61,3992
318,552,3355,3,Business,15,2,35116,15,2,35151,15,2,36656,15,2,37974,15,2,39050,10,24.5,-1.3472066,36.7692638,-1.3052491,36.8223899,246,1076,35,2823
319,26253,2310,1,Business,31,2,59435,31,2,59503,31,2,60229,31,2,60624,31,2,61776,8,20.0,-1.2765736,36.8513646,-1.2859912,36.8756811,263,1152,68,1121
320,18115,3262,3,Personal,9,4,40923,9,4,40966,9,4,41579,9,4,42473,9,4,46816,32,23.25888921888938,-1.2640106,36.8346608,-1.0921599,37.005025,627,4343,43,1507
321,18909,3688,3,Business,9,5,44806,9,5,44869,9,5,46546,9,5,48234,9,5,51216,10,25.7,-1.2551895,36.7822034,-1.3072605,36.8474457,518,2982,63,3365
322,13346,978,1,Personal,30,3,41618,30,3,43412,30,3,45207,30,3,45732,30,3,47756,5,22.3,-1.3084067,36.8345014,-1.2865677,36.8253346,808,2024,1794,2320
323,23522,2451,1,Personal,2,2,41077,2,2,41405,2,2,41887,2,2,42251,2,2,43089,4,20.9,-1.285714,36.830624,-1.2713865,36.8058221,761,838,328,846
324,22700,20,3,Business,27,3,47138,27,3,47190,27,3,47629,27,3,47982,27,3,49187,5,26.0,-1.2629666,36.8068369,-1.276495,36.8205966,785,1205,52,792
325,25825,424,1,Personal,3,1,32730,3,1,32776,3,1,34762,3,1,35006,3,1,35903,8,15.1,-1.322999,36.7832633,-1.2985749,36.8088,88,897,46,2230
326,11324,1293,1,Personal,1,3,47969,1,3,47978,1,3,48375,1,3,48738,1,3,51024,18,24.1,-1.3152336,36.7116401,-1.2543164,36.831861,726,2286,9,760
327,10651,1271,3,Business,3,5,58484,3,5,59413,3,5,61009,3,5,61756,3,5,66911,28,22.5,-1.3244885,36.897792,-1.1984414,36.9009205,415,5155,929,2343
328,1631,635,3,Business,24,4,41172,24,4,41284,24,4,42699,24,4,44564,24,4,46318,4,21.0,-1.2599563,36.7993439,-1.283362,36.8260149,844,1754,112,3280
329,1413,2718,3,Business,18,4,51405,18,4,51548,18,4,53588,18,4,54142,18,4,55325,4,26.6,-1.2904753,36.8144721,-1.2668815,36.8017244,247,1183,143,2594
330,922,3289,3,Personal,24,4,39436,24,4,39483,24,4,40233,24,4,40460,24,4,41100,3,24.7,-1.3002727,36.7668028,-1.2974406,36.7765953,559,640,47,977
331,21037,3115,3,Business,14,3,41611,14,3,42730,14,3,43492,14,3,44314,14,3,45762,8,24.4,-1.2916155,36.8407913,-1.2963097,36.7688221,622,1448,1119,1584
332,24837,2069,3,Business,4,6,41451,4,6,41782,4,6,43477,4,6,44409,4,6,45184,6,23.25888921888938,-1.2296618,36.8438272,-1.228911,36.881876,775,775,331,2627
333,487,2587,3,Business,26,5,37322,26,5,38156,26,5,38913,26,5,39417,26,5,40748,7,23.25888921888938,-1.28878,36.8168312,-1.2551895,36.7822034,171,1331,834,1261
334,9622,2134,3,Personal,10,2,67796,10,2,67867,10,2,68827,10,2,69266,10,2,70607,11,20.8,-1.2503693,36.69705101,-1.2951355,36.768931,474,1341,71,1399
335,6439,187,3,Business,31,2,41562,31,2,41582,31,2,42512,31,2,42960,31,2,45282,17,18.4,-1.3165542,36.700067,-1.2597034,36.8003065,350,2322,20,1378
336,2643,2066,3,Business,21,6,55797,21,6,55838,21,6,55845,21,6,56379,21,6,57793,8,18.4,-1.316961,36.820337,-1.2661406,36.8085212,929,1414,41,541
337,6724,2008,3,Business,27,3,35754,27,3,35784,27,3,36450,27,3,36579,27,3,39976,4,23.25888921888938,-1.2508229,36.7895263,-1.26278,36.82641,452,3397,30,795
338,471,517,3,Business,31,5,40741,31,5,40776,31,5,40925,31,5,41106,31,5,42826,14,21.6,-1.3228003,36.8306435,-1.2991441,36.7528804,211,1720,35,330
339,10970,1927,3,Business,27,3,54129,27,3,56542,27,3,57389,27,3,57639,27,3,60524,22,29.6,-1.3472066,36.7692638,-1.3632162,36.9108253,519,2885,2413,1097
340,15952,1766,2,Personal,7,5,33119,7,5,33149,7,5,33585,7,5,34404,7,5,34897,2,18.4,-1.2580991,36.7941519,-1.2663135,36.7973895,882,493,30,1255
341,5523,3047,3,Personal,2,2,49812,2,2,50564,2,2,51339,2,2,51500,2,2,52668,7,26.3,-1.2850644,36.8343657,-1.3230166,36.8391623,328,1168,752,936
342,28191,1244,3,Business,30,4,36484,30,4,36497,30,4,37908,30,4,38710,30,4,40181,8,20.3,-1.307143,36.825009,-1.303596,36.778378,447,1471,13,2213
343,16684,3103,1,Personal,12,4,29099,12,4,29164,12,4,30250,12,4,31220,12,4,32415,11,16.0,-1.2939186,36.8069693,-1.2379585,36.875789,159,1195,65,2056
344,25937,3491,3,Business,10,3,42274,10,3,42284,10,3,42792,10,3,43017,10,3,44276,13,22.1,-1.2248308,36.8012573,-1.2297202,36.8819507,453,1259,10,733
345,24822,3110,3,Business,11,1,38253,11,1,38271,11,1,40713,11,1,40921,11,1,42419,15,26.8,-1.2598589,36.7470168,-1.2420055,36.8144424,393,1498,18,2650
346,24499,3533,3,Business,5,2,43245,5,2,43273,5,2,44433,5,2,44663,5,2,45374,5,25.4,-1.2615888,36.7928732,-1.2790232,36.7923526,958,711,28,1390
347,26851,3560,3,Business,14,3,51189,14,3,51513,14,3,54474,14,3,56147,14,3,56796,5,25.8,-1.2527958,36.8003131,-1.279395,36.825364,878,649,324,4634
348,12543,1725,1,Business,9,4,57998,9,4,58074,9,4,59534,9,4,59804,9,4,62632,8,23.0,-1.2914795,36.8248973,-1.26578,36.781,519,2828,76,1730
349,21535,3201,3,Business,10,1,48856,10,1,49071,10,1,49212,10,1,49608,10,1,54363,5,18.5,-1.279395,36.825364,-1.2584143,36.8048002,690,4755,215,537
350,28022,3115,3,Business,8,3,46408,8,3,46741,8,3,47350,8,3,47630,8,3,51388,7,23.25888921888938,-1.2963097,36.7688221,-1.2897978,36.8267388,448,3758,333,889
351,18801,2869,3,Business,22,3,47691,22,3,48219,22,3,49227,22,3,50557,22,3,52279,13,24.5,-1.2907474,36.8453439,-1.3025826,36.7670807,161,1722,528,2338
352,11756,3772,1,Personal,3,3,50312,3,3,50364,3,3,50904,3,3,51321,3,3,52118,5,26.8,-1.3054537,36.8284768,-1.3125593,36.8430941,848,797,52,957
353,13892,1578,3,Business,28,1,42547,28,1,42554,28,1,42698,28,1,43870,28,1,45855,18,23.7,-1.3472066,36.7692638,-1.2859912,36.8756811,272,1985,7,1316
354,6984,811,3,Personal,18,1,46582,18,1,46857,18,1,48610,18,1,48896,18,1,50126,7,30.8,-1.298529,36.816482,-1.2963097,36.7688221,903,1230,275,2039
355,19457,2183,3,Business,8,2,38428,8,2,38434,8,2,38987,8,2,39271,8,2,39278,2,23.5,-1.2551895,36.7822034,-1.2650042,36.7903927,49,7,6,837
356,16158,186,3,Business,14,4,59069,14,4,59987,14,4,61270,14,4,61767,14,4,62823,4,26.3,-1.2571472,36.7950633,-1.2825816,36.8092346,548,1056,918,1780
357,8805,238,3,Business,16,3,54108,16,3,54118,16,3,57393,16,3,58104,16,3,58683,3,27.2,-1.3077869,36.8443207,-1.308366,36.823613,56,579,10,3986
358,8009,136,3,Business,25,5,45288,25,5,45293,25,5,45485,25,5,46427,25,5,49647,14,26.5,-1.3254522,36.7216584,-1.274716,36.789582,831,3220,5,1134
359,6012,142,3,Business,22,3,56288,22,3,56416,22,3,59286,22,3,59415,22,3,60919,8,24.3,-1.2963097,36.7688221,-1.2570328,36.7869744,269,1504,128,2999
360,18456,478,3,Business,13,4,54098,13,4,54889,13,4,55124,13,4,55326,13,4,56785,9,23.0,-1.2551895,36.7822034,-1.2991116,36.7960658,50,1459,791,437
361,27959,2330,3,Business,29,3,53951,29,3,54201,29,3,55070,29,3,55964,29,3,57221,14,21.0,-1.2212612,36.8440033,-1.2645318,36.7981775,8,1257,250,1763
362,3466,3701,3,Business,6,2,31826,6,2,31833,6,2,32559,6,2,32912,6,2,33985,8,19.6,-1.2684239,36.7952462,-1.3044313,36.818504,952,1073,7,1079
363,2941,1148,3,Business,28,3,47712,28,3,47740,28,3,47802,28,3,49369,28,3,52057,15,23.25888921888938,-1.3100586,36.8500329,-1.2409761,36.7760062,519,2688,28,1629
364,2321,2523,3,Business,10,1,40636,10,1,40670,10,1,40679,10,1,41173,10,1,42024,1,18.3,-1.2551895,36.7822034,-1.2549259,36.7919494,168,851,34,503
365,23345,2750,3,Business,8,4,52285,8,4,52391,8,4,53167,8,4,53263,8,4,54219,4,27.1,-1.275442,36.7660207,-1.255956,36.772901,548,956,106,872
366,9826,540,3,Business,22,1,37842,22,1,37867,22,1,38178,22,1,38835,22,1,39736,6,24.7,-1.2551895,36.7822034,-1.2877595,36.8230991,726,901,25,968
367,6290,393,3,Business,29,1,37157,29,1,37185,29,1,37360,29,1,38058,29,1,39152,10,23.25888921888938,-1.3177547,36.8303703,-1.2574219,36.7927073,731,1094,28,873
368,17625,3487,3,Business,26,5,56346,26,5,56825,26,5,57390,26,5,58651,26,5,60502,11,23.25888921888938,-1.225322,36.80855,-1.279395,36.825364,281,1851,479,1826
369,9694,302,3,Business,10,7,45005,10,7,45079,10,7,45724,10,7,46183,10,7,47121,10,23.25888921888938,-1.2649605,36.7981777,-1.3007726,36.7743644,303,938,74,1104
370,16122,1746,3,Business,2,4,52140,2,4,52169,2,4,52906,2,4,53517,2,4,54325,3,26.4,-1.2962832,36.7849683,-1.296797,36.7764525,548,808,29,1348
371,11678,3222,3,Business,16,2,54281,16,2,54410,16,2,54954,16,2,55326,16,2,57369,8,27.5,-1.2551895,36.7822034,-1.2868736,36.7805882,648,2043,129,916
372,11823,832,1,Personal,16,1,51702,16,1,51719,16,1,52785,16,1,54891,16,1,55823,10,22.5,-1.2994194,36.7647917,-1.3070122,36.8287218,312,932,17,3172
373,26548,2523,3,Business,3,5,52741,3,5,52776,3,5,53430,3,5,53787,3,5,55278,11,25.0,-1.2551895,36.7822034,-1.3173869,36.8112044,857,1491,35,1011
374,6239,3283,3,Business,17,3,51169,17,3,51177,17,3,51444,17,3,52077,17,3,53146,14,23.25888921888938,-1.228911,36.881876,-1.2628473,36.781805,276,1069,8,900
375,3315,962,3,Personal,17,5,55677,17,5,56099,17,5,57734,17,5,57857,17,5,60145,9,20.4,-1.345199,36.7664115,-1.2943818,36.7858765,312,2288,422,1758
376,27460,214,3,Personal,13,1,52992,13,1,53012,13,1,53928,13,1,54227,13,1,56899,3,19.3,-1.2616213,36.8221128,-1.262229,36.802598,407,2672,20,1215
377,15389,2330,3,Business,4,2,60934,4,2,61458,4,2,63836,4,2,64009,4,2,66409,14,22.7,-1.2464559,36.8169857,-1.2687407,36.7373043,309,2400,524,2551
378,6356,2066,3,Business,29,1,61396,29,1,61426,29,1,61966,29,1,62536,29,1,63338,3,23.2,-1.316961,36.820337,-1.3124792,36.829166,208,802,30,1110
379,20224,1623,1,Personal,17,2,55579,17,2,56502,17,2,58613,17,2,58938,17,2,60764,11,24.3,-1.3327654,36.8853117,-1.3159617,36.8117934,465,1826,923,2436
380,26358,517,3,Business,31,5,37253,31,5,39902,31,5,39906,31,5,43679,31,5,43684,8,21.8,-1.3228003,36.8306435,-1.2770708,36.8231093,10,5,2649,3777
381,10101,1402,3,Business,10,3,36451,10,3,36513,10,3,39156,10,3,39932,10,3,42929,1,27.8,-1.290894,36.822971,-1.2813012,36.8323962,819,2997,62,3419
382,17711,3295,3,Business,15,5,57840,15,5,57881,15,5,58068,15,5,58708,15,5,59427,3,27.8,-1.2571472,36.7950633,-1.2679514,36.8095213,107,719,41,827
383,12988,2216,3,Business,29,5,43135,29,5,43647,29,5,44821,29,5,46604,29,5,47117,1,19.7,-1.2551895,36.7822034,-1.2606254,36.783056,101,513,512,2957
384,9681,3283,3,Business,25,1,39906,25,1,39992,25,1,40176,25,1,41311,25,1,41819,5,27.1,-1.2600926,36.8088685,-1.2628473,36.781805,383,508,86,1319
385,9165,3247,3,Business,17,3,36616,17,3,36819,17,3,37250,17,3,37496,17,3,39027,10,21.1,-1.2571472,36.7950633,-1.31861,36.8113967,207,1531,203,677
386,10209,2069,3,Business,10,5,38924,10,5,38937,10,5,39330,10,5,39668,10,5,41022,16,23.25888921888938,-1.2628473,36.781805,-1.228911,36.881876,536,1354,13,731
387,9845,3686,3,Business,11,1,52140,11,1,52178,11,1,52584,11,1,52975,11,1,52977,5,27.8,-1.2551895,36.7822034,-1.2596666,36.7627206,647,2,38,797
388,21260,2956,3,Business,15,5,29929,15,5,29959,15,5,30266,15,5,30388,15,5,31021,7,19.1,-1.2584143,36.8048002,-1.2801883,36.8234728,682,633,30,429
389,26680,419,3,Business,25,1,44082,25,1,44149,25,1,44213,25,1,44993,25,1,46158,5,25.7,-1.2571472,36.7950633,-1.2897368,36.8226783,576,1165,67,844
390,24760,3688,3,Business,4,2,42345,4,2,42377,4,2,42763,4,2,42857,4,2,43731,8,20.7,-1.2551895,36.7822034,-1.2904119,36.7898312,7,874,32,480
391,23864,53,3,Business,30,4,50734,30,4,50751,30,4,50772,30,4,52494,30,4,53370,5,23.25888921888938,-1.3004062,36.829741,-1.2770708,36.8231093,751,876,17,1743
392,3258,1336,3,Business,8,4,38218,8,4,38616,8,4,38920,8,4,39201,8,4,40136,3,26.5,-1.2866012,36.8195691,-1.2891922,36.825189,615,935,398,585
393,20777,2854,3,Business,25,2,37426,25,2,37450,25,2,38983,25,2,40104,25,2,41882,17,24.0,-1.2482465,36.8889062,-1.2963097,36.7688221,851,1778,24,2654
394,12849,3661,3,Business,3,1,28850,3,1,28921,3,1,29773,3,1,29981,3,1,31930,18,18.2,-1.2132866,36.8678274,-1.3208162,36.8451209,96,1949,71,1060
395,1176,733,3,Business,31,4,41703,31,4,41734,31,4,42726,31,4,43213,31,4,46230,7,26.4,-1.2854453,36.8188363,-1.2551895,36.7822034,489,3017,31,1479
396,23092,816,3,Business,23,5,28104,23,5,32462,23,5,33779,23,5,34014,23,5,34988,2,20.3,-1.290894,36.822971,-1.2864733,36.8239937,436,974,4358,1552
397,17210,3404,3,Business,5,2,46246,5,2,47650,5,2,48111,5,2,48607,5,2,50328,11,23.4,-1.225322,36.80855,-1.279395,36.825364,365,1721,1404,957
398,8358,2677,3,Business,14,1,43363,14,1,43382,14,1,44093,14,1,44830,14,1,48844,16,23.4,-1.306378,36.7519845,-1.2555317,36.8562313,829,4014,19,1448
399,3862,1976,3,Business,16,4,45727,16,4,45791,16,4,47659,16,4,48016,16,4,51045,10,14.8,-1.2761055,36.8456176,-1.257028,36.7810435,452,3029,64,2225
400,28089,198,3,Business,11,1,41255,11,1,41275,11,1,41343,11,1,41866,11,1,43288,17,26.5,-1.3396256,36.8863135,-1.3255287,36.7850772,145,1422,20,591
401,27319,2212,3,Business,5,2,32132,5,2,32896,5,2,33092,5,2,33932,5,2,34646,4,17.9,-1.2571472,36.7950633,-1.281767,36.8220791,576,714,764,1036
402,16317,3283,3,Business,9,4,37667,9,4,38681,9,4,41785,9,4,41848,9,4,44497,11,23.25888921888938,-1.303596,36.778378,-1.2600926,36.8088685,591,2649,1014,3167
403,23537,1966,3,Business,5,5,32888,5,5,32901,5,5,34087,5,5,35132,5,5,37441,21,19.6,-1.3700383,36.9190174,-1.2917868,36.7872675,177,2309,13,2231
404,20867,1405,3,Business,24,4,52178,24,4,52344,24,4,54145,24,4,56980,24,4,57397,9,28.1,-1.3194518,36.869396,-1.3478563,36.8935824,86,417,166,4636
405,8947,635,3,Business,29,6,38097,29,6,38235,29,6,39157,29,6,39829,29,6,41340,8,24.0,-1.3016417,36.8271679,-1.2599563,36.7993439,436,1511,138,1594
406,15257,3218,3,Business,13,3,35689,13,3,35751,13,3,36305,13,3,36392,13,3,37972,10,16.2,-1.2765736,36.8513646,-1.2551895,36.7822034,444,1580,62,641
407,17624,393,3,Business,21,4,55923,21,4,55933,21,4,55937,21,4,58604,21,4,58607,11,26.2,-1.3167113,36.8301563,-1.2638185,36.7930057,10,3,10,2671
408,10063,3599,3,Business,27,1,47664,27,1,48699,27,1,51593,27,1,52484,27,1,53969,11,23.3,-1.3302996,36.8707935,-1.2744277,36.8104437,427,1485,1035,3785
409,8031,3718,3,Business,26,5,56347,26,5,57135,26,5,57924,26,5,58049,26,5,58741,5,23.25888921888938,-1.2650027,36.8126242,-1.2635089,36.7887337,326,692,788,914
410,3747,3355,3,Business,29,4,52898,29,4,53145,29,4,53422,29,4,53597,29,4,54450,10,24.8,-1.3052491,36.8223899,-1.32544,36.8958753,913,853,247,452
411,10863,928,3,Business,11,1,45420,11,1,45539,11,1,46895,11,1,47053,11,1,49183,15,17.9,-1.2551895,36.7822034,-1.3319467,36.7766998,749,2130,119,1514
412,1328,2216,3,Business,25,1,43762,25,1,43787,25,1,43914,25,1,44552,25,1,45389,8,27.2,-1.2551895,36.7822034,-1.2922992,36.7983035,267,837,25,765
413,18276,393,3,Business,31,4,36790,31,4,36797,31,4,37265,31,4,37564,31,4,39174,14,20.5,-1.3167113,36.8301563,-1.2991441,36.7528804,523,1610,7,767
414,15805,3247,3,Business,16,3,34925,16,3,34933,16,3,35991,16,3,36122,16,3,38452,22,19.6,-1.2571472,36.7950633,-1.298037,36.6934582,353,2330,8,1189
415,18278,2582,3,Business,11,1,54349,11,1,54471,11,1,55472,11,1,56648,11,1,56654,8,28.7,-1.2854406,36.789409,-1.2551895,36.7822034,314,6,122,2177
416,4096,1307,3,Business,3,5,29804,3,5,29836,3,5,31364,3,5,31453,3,5,31686,3,17.6,-1.2844665,36.7866113,-1.2759422,36.7677551,726,233,32,1617
417,23229,3560,3,Business,20,3,55913,20,3,55996,20,3,56398,20,3,56707,20,3,56811,2,28.2,-1.279395,36.825364,-1.2950632,36.8196747,206,104,83,711
418,11822,3450,3,Business,11,1,39874,11,1,40799,11,1,41208,11,1,41493,11,1,43817,17,26.4,-1.2551895,36.7822034,-1.2859912,36.8756811,268,2324,925,694
419,16492,1787,3,Business,13,4,43084,13,4,43158,13,4,43710,13,4,43865,13,4,45079,5,22.3,-1.2283403,36.8822756,-1.2467896,36.8698733,60,1214,74,707
420,26943,2523,3,Business,6,1,35699,6,1,35821,6,1,36125,6,1,36869,6,1,37629,4,23.25888921888938,-1.2551895,36.7822034,-1.2696908,36.81519,881,760,122,1048
421,23909,2190,3,Business,16,2,52976,16,2,53076,16,2,54161,16,2,54314,16,2,55701,8,27.3,-1.301953,36.788458,-1.2624343,36.8170861,649,1387,100,1238
422,14407,627,3,Business,26,4,43532,26,4,43766,26,4,46335,26,4,46527,26,4,47358,7,19.1,-1.2844516,36.8245932,-1.2551895,36.7822034,764,831,234,2761
423,12280,2258,3,Business,9,5,51862,9,5,51944,9,5,52777,9,5,53274,9,5,57330,29,26.2,-1.2571472,36.7950633,-1.1517585,36.9560679,620,4056,82,1330
424,9313,3391,1,Personal,3,1,43089,3,1,43105,3,1,43567,3,1,43694,3,1,45087,6,20.6,-1.3009926,36.8208532,-1.3229541,36.8312466,249,1393,16,589
425,26420,2509,3,Business,6,4,55430,6,4,55525,6,4,55706,6,4,56139,6,4,56710,4,23.25888921888938,-1.2571472,36.7950633,-1.2825816,36.8092346,932,571,95,614
426,11720,187,3,Business,10,6,56763,10,6,56981,10,6,58027,10,6,58311,10,6,59872,8,24.8,-1.3014461,36.7661381,-1.3169591,36.7000029,949,1561,218,1330
427,10388,972,3,Business,13,5,35837,13,5,35967,13,5,37945,13,5,38309,13,5,39452,6,23.25888921888938,-1.2862033,36.8152966,-1.3025667,36.7803495,752,1143,130,2342
428,13747,2190,3,Business,16,4,52696,16,4,52711,16,4,53348,16,4,54117,16,4,55040,5,18.9,-1.301953,36.788458,-1.2931446,36.7613971,754,923,15,1406
429,28144,1246,3,Business,10,4,43929,10,4,43995,10,4,44009,10,4,48865,10,4,50057,16,25.2,-1.2943371,36.8267,-1.3700383,36.9190174,813,1192,66,4870
430,13783,2330,1,Business,6,6,59411,6,6,59974,6,6,60827,6,6,61938,6,6,62611,12,25.3,-1.2920005,36.9040022,-1.2284323,36.8757058,397,673,563,1964
431,17373,3007,3,Personal,15,1,54605,15,1,54697,15,1,54716,15,1,56480,15,1,57231,5,23.25888921888938,-1.277551,36.8273641,-1.2935303,36.7988142,338,751,92,1783
432,840,1927,3,Business,21,2,48248,21,2,48686,21,2,49631,21,2,49967,21,2,52752,10,25.2,-1.323615,36.700475,-1.3472066,36.7692638,211,2785,438,1281
433,1730,1304,3,Business,4,2,50113,4,2,55030,4,2,57569,4,2,57706,4,2,61055,15,24.0,-1.3226302,36.8719901,-1.2612111,36.7831516,817,3349,4917,2676
434,4534,1205,3,Business,11,2,53511,11,2,53716,11,2,55380,11,2,55721,11,2,57152,7,22.5,-1.257309,36.8060084,-1.2958383,36.8073162,268,1431,205,2005
435,16252,2184,1,Personal,13,1,60128,13,1,60156,13,1,60645,13,1,61073,13,1,62189,7,19.4,-1.2764786,36.8194788,-1.2832015,36.7862218,754,1116,28,917
436,12309,1439,3,Business,3,1,46084,3,1,46198,3,1,47032,3,1,47971,3,1,49612,6,21.3,-1.2962487,36.7772971,-1.274927,36.8028302,669,1641,114,1773
437,12090,1078,3,Business,18,4,29022,18,4,29034,18,4,30932,18,4,31265,18,4,32707,15,23.25888921888938,-1.2902349,36.7850769,-1.2417321,36.8886277,576,1442,12,2231
438,20798,3686,3,Business,23,3,42314,23,3,42423,23,3,42763,23,3,43691,23,3,47937,5,23.25888921888938,-1.263717,36.823985,-1.2551895,36.7822034,727,4246,109,1268
439,18956,136,3,Business,17,4,60156,17,4,60687,17,4,61361,17,4,61544,17,4,64655,16,26.0,-1.3254522,36.7216584,-1.2531983,36.8069669,831,3111,531,857
440,27400,1471,3,Business,29,2,62120,29,2,62865,29,2,63109,29,2,63434,29,2,64085,2,22.1,-1.2553615,36.7895376,-1.2632534,36.7993427,898,651,745,569
441,18630,1231,3,Business,23,4,33333,23,4,33408,23,4,34136,23,4,34212,23,4,35657,8,15.8,-1.2821422,36.8161565,-1.3014461,36.7661381,79,1445,75,804
442,13670,1500,3,Business,23,3,43913,23,3,44846,23,3,45634,23,3,46552,23,3,48089,11,23.25888921888938,-1.3077869,36.8443207,-1.2574219,36.7927073,518,1537,933,1706
443,2700,635,3,Business,27,3,44466,27,3,45413,27,3,46035,27,3,46743,27,3,48319,16,25.8,-1.2602337,36.7990548,-1.2100345,36.8493221,222,1576,947,1330
444,14002,510,3,Business,11,1,35493,11,1,35504,11,1,35508,11,1,35716,11,1,39957,12,14.5,-1.2860183,36.8975338,-1.325808,36.861664,589,4241,11,212
445,1686,3491,3,Business,1,3,56770,1,3,56784,1,3,57044,1,3,57140,1,3,57152,3,23.25888921888938,-1.2232123,36.8932547,-1.2283403,36.8822756,521,12,14,356
446,23914,136,3,Business,12,1,56396,12,1,59489,12,1,59972,12,1,60070,12,1,61248,8,23.8,-1.3014461,36.7661381,-1.3326173,36.7146233,470,1178,3093,581
447,11715,635,3,Business,24,3,54378,24,3,57559,24,3,58271,24,3,61417,24,3,61485,7,18.2,-1.3016417,36.8271679,-1.2599563,36.7993439,775,68,3181,3858
448,11334,393,3,Business,20,3,57005,20,3,57166,20,3,57174,20,3,58027,20,3,58036,4,28.5,-1.3167113,36.8301563,-1.3004062,36.829741,39,9,161,861
449,27517,53,3,Business,3,3,51954,3,3,51985,3,3,52729,3,3,53887,3,3,54810,5,28.4,-1.3004062,36.829741,-1.2770708,36.8231093,507,923,31,1902
450,26136,1471,3,Business,28,5,47455,28,5,47576,28,5,48630,28,5,49092,28,5,51491,12,25.7,-1.2551895,36.7822034,-1.2129211,36.7963408,96,2399,121,1516
451,7020,1865,1,Personal,5,5,37261,5,5,37281,5,5,38080,5,5,40794,5,5,41039,25,23.8,-1.2166078,36.882501,-1.2709857,36.7437485,704,245,20,3513
452,21371,3283,3,Business,22,4,44104,22,4,44234,22,4,44820,22,4,46028,22,4,47515,7,22.8,-1.2783849,36.8163445,-1.2628473,36.781805,31,1487,130,1794
453,9454,2483,1,Business,5,4,56057,5,4,56083,5,4,56787,5,4,56989,5,4,58991,14,22.3,-1.255956,36.789867,-1.3060302,36.7665044,45,2002,26,906
454,5950,2532,3,Business,13,2,58777,13,2,59298,13,2,61542,13,2,63433,13,2,67014,8,23.7,-1.2551895,36.7822034,-1.2824911,36.8218042,469,3581,521,4135
455,3602,2801,3,Business,10,3,56440,10,3,56473,10,3,56921,10,3,59639,10,3,60826,9,27.1,-1.307726,36.839117,-1.2595422,36.7871178,297,1187,33,3166
456,13971,3194,3,Business,28,4,64178,28,4,64228,28,4,65529,28,4,65925,28,4,67913,13,28.2,-1.3012008,36.764868,-1.2597436,36.8282526,925,1988,50,1697
457,24694,867,3,Business,3,1,49529,3,1,49546,3,1,49657,3,1,50861,3,1,52345,10,23.3,-1.3004062,36.829741,-1.2991441,36.7528804,591,1484,17,1315
458,2863,1351,1,Personal,17,3,37203,17,3,37207,17,3,39657,17,3,40008,17,3,42595,22,25.3,-1.323682,36.708787,-1.2854453,36.8188363,680,2587,4,2801
459,4227,187,3,Business,31,1,46047,31,1,46100,31,1,46647,31,1,48578,31,1,50867,30,21.1,-1.3705766,36.9120742,-1.3165542,36.700067,670,2289,53,2478
460,8073,246,3,Business,14,4,59312,14,4,59372,14,4,60226,14,4,60337,14,4,60997,2,21.1,-1.2584143,36.8048002,-1.263499,36.8014548,898,660,60,965
461,7076,173,3,Business,21,5,76073,21,5,76096,21,5,76233,21,5,77314,21,5,78195,6,18.0,-1.2993231,36.7753372,-1.2637515,36.7885663,187,881,23,1218
462,26463,540,3,Business,3,5,34670,3,5,34853,3,5,35247,3,5,35508,3,5,37001,4,23.25888921888938,-1.2551895,36.7822034,-1.2753109,36.8130185,599,1493,183,655
463,3132,3599,3,Business,3,1,41214,3,1,41782,3,1,42300,3,1,42903,3,1,45077,21,21.4,-1.3302996,36.8707935,-1.215326,36.8919938,130,2174,568,1121
464,11697,1230,1,Personal,12,3,59997,12,3,60450,12,3,61183,12,3,61389,12,3,62341,5,24.2,-1.2535139,36.8299659,-1.2855799,36.8227554,263,952,453,939
465,1836,2100,3,Business,31,4,37399,31,4,37433,31,4,39518,31,4,39645,31,4,41624,8,26.6,-1.2765736,36.8513646,-1.2413316,36.8785525,660,1979,34,2212
466,7740,2700,3,Business,19,5,33681,19,5,33797,19,5,34869,19,5,35175,19,5,36264,9,20.1,-1.2845835,36.8079121,-1.3080793,36.7505396,726,1089,116,1378
467,165,1010,3,Personal,9,4,40504,9,4,40608,9,4,40923,9,4,41600,9,4,42198,3,24.0,-1.254191,36.8099132,-1.2463211,36.789487,415,598,104,992
468,7809,1209,3,Business,3,1,60306,3,1,60373,3,1,60787,3,1,60873,3,1,61357,4,17.5,-1.3077869,36.8443207,-1.3004062,36.829741,2,484,67,500
469,10622,3291,3,Business,31,1,50105,31,1,50135,31,1,50492,31,1,51184,31,1,51820,5,23.7,-1.2783849,36.8163445,-1.2600926,36.8088685,320,636,30,1049
470,20801,1369,2,Personal,13,5,56737,13,5,56794,13,5,57377,13,5,58317,13,5,59468,7,19.1,-1.2915307,36.7905865,-1.3011737,36.743672,312,1151,57,1523
471,6362,661,3,Business,3,6,43299,3,6,43328,3,6,43519,3,6,43848,3,6,44706,3,23.7,-1.2963097,36.7688221,-1.2976559,36.7914147,202,858,29,520
472,7533,679,1,Personal,24,2,57494,24,2,57639,24,2,57670,24,2,58522,24,2,60044,8,18.6,-1.3083777,36.8590077,-1.278612,36.8195876,546,1522,145,883
473,11365,2829,3,Business,9,3,47617,9,3,47668,9,3,48218,9,3,48300,9,3,50682,15,25.3,-1.2571472,36.7950633,-1.2190317,36.8825092,512,2382,51,632
474,2528,3326,3,Business,12,5,58774,12,5,58787,12,5,58857,12,5,59127,12,5,60206,9,23.25888921888938,-1.2551895,36.7822034,-1.3090727,36.8315262,576,1079,13,340
475,19381,1280,3,Business,10,5,61605,10,5,61701,10,5,61740,10,5,63564,10,5,63566,3,23.25888921888938,-1.2551895,36.7822034,-1.265338,36.8088155,411,2,96,1863
476,15090,664,1,Personal,7,2,48082,7,2,48188,7,2,48883,7,2,49187,7,2,49735,4,24.8,-1.2517392,36.8249608,-1.28093,36.8120044,427,548,106,999
477,2376,1927,3,Business,23,5,54924,23,5,55765,23,5,57163,23,5,57774,23,5,62182,15,26.6,-1.2561334,36.7990458,-1.3463042,36.768164,410,4408,841,2009
478,28239,2548,2,Business,1,6,56515,1,6,56560,1,6,57290,1,6,58497,1,6,59494,8,19.3,-1.2868973,36.8232984,-1.2957616,36.7669835,465,997,45,1937
479,1179,393,3,Business,9,3,38940,9,3,38957,9,3,39129,9,3,39300,9,3,41018,14,25.1,-1.3167113,36.8301563,-1.306378,36.7519845,523,1718,17,343
480,16900,166,2,Personal,30,3,60594,30,3,60783,30,3,62226,30,3,63352,30,3,66301,17,23.25888921888938,-1.2819025,36.878684,-1.3026657,36.7748881,742,2949,189,2569
481,5070,1209,3,Business,4,6,33132,4,6,33253,4,6,35215,4,6,35283,4,6,36899,12,23.25888921888938,-1.2991441,36.7528804,-1.3004062,36.829741,132,1616,121,2030
482,16742,633,3,Business,24,4,46577,24,4,46706,24,4,46817,24,4,48501,24,4,49451,4,24.5,-1.3228003,36.8306435,-1.3004062,36.829741,496,950,129,1795
483,3696,1487,1,Personal,1,1,44177,1,1,49896,1,1,50092,1,1,50427,1,1,50843,3,25.8,-1.2658335,36.8042867,-1.2866012,36.8195691,857,416,5719,531
484,24415,3491,3,Business,6,4,60235,6,4,60279,6,4,61545,6,4,61753,6,4,63791,13,22.3,-1.2248308,36.8012573,-1.2297202,36.8819507,882,2038,44,1474
485,26525,58,3,Business,7,1,40144,7,1,40236,7,1,41155,7,1,42858,7,1,43973,6,21.3,-1.295162,36.8115914,-1.2765736,36.8513646,100,1115,92,2622
486,20396,2996,2,Personal,22,2,41324,22,2,41432,22,2,41597,22,2,41976,22,2,42757,7,19.2,-1.2294985,36.8775495,-1.1878027,36.9033431,266,781,108,544
487,8461,760,3,Business,29,5,58501,29,5,58572,29,5,59009,29,5,59309,29,5,60343,7,29.2,-1.2886303,36.8026947,-1.2513025,36.8094419,404,1034,71,737
488,6468,3599,3,Business,28,3,47546,28,3,55388,28,3,55603,28,3,56322,28,3,57953,12,23.25888921888938,-1.3302996,36.8707935,-1.296642,36.799207,661,1631,7842,934
489,9361,2521,3,Business,30,6,38479,30,6,38491,30,6,38506,30,6,40319,30,6,44603,14,26.5,-1.3167113,36.8301563,-1.306378,36.7519845,25,4284,12,1828
490,8725,111,3,Business,29,5,50678,29,5,50748,29,5,52458,29,5,52878,29,5,54175,15,21.3,-1.2551895,36.7822034,-1.2343236,36.8861,520,1297,70,2130
491,6241,3557,3,Business,5,2,34808,5,2,35814,5,2,36421,5,2,36541,5,2,37568,6,18.1,-1.2546732,36.8086796,-1.288167,36.8181484,276,1027,1006,727
492,6996,2956,3,Business,12,2,48679,12,2,48714,12,2,48767,12,2,49655,12,2,50042,1,23.25888921888938,-1.2584143,36.8048002,-1.2664491,36.8102685,547,387,35,941
493,1011,1827,3,Business,23,4,43679,23,4,43873,23,4,44087,23,4,45763,23,4,46764,14,18.7,-1.265715,36.823815,-1.293515,36.897607,179,1001,194,1890
494,12211,1244,3,Business,1,5,32615,1,5,35138,1,5,36238,1,5,40626,1,5,43551,8,28.5,-1.272828,36.816608,-1.303596,36.778378,61,2925,2523,5488
495,5689,3291,3,Business,21,4,49851,21,4,49871,21,4,50071,21,4,50284,21,4,50949,5,26.2,-1.2628473,36.781805,-1.2600926,36.8088685,854,665,20,413
496,10726,3657,2,Personal,4,5,45399,4,5,45536,4,5,46222,4,5,46611,4,5,48498,9,22.7,-1.22606,36.80039,-1.2683619,36.8065993,729,1887,137,1075
497,15405,516,3,Business,2,4,53350,2,4,53619,2,4,54263,2,4,54752,2,4,58548,6,23.25888921888938,-1.2551895,36.7822034,-1.2540684,36.8239518,178,3796,269,1133
498,18731,315,2,Personal,6,6,36952,6,6,37145,6,6,37796,6,6,37969,6,6,39513,10,24.3,-1.3172339,36.8201918,-1.278068,36.8739571,74,1544,193,824
499,748,540,3,Business,19,3,51893,19,3,52926,19,3,53480,19,3,54390,19,3,58805,6,24.3,-1.2649605,36.7981777,-1.2940713,36.7890758,554,4415,1033,1464
500,8224,3517,3,Business,4,1,30420,4,1,31410,4,1,33429,4,1,34154,4,1,36319,16,22.0,-1.3882008,36.7699445,-1.300921,36.828195,559,2165,990,2744
501,8315,2347,3,Personal,13,3,51500,13,3,51524,13,3,52130,13,3,53606,13,3,53613,3,29.0,-1.2944292,36.7793569,-1.292278,36.797718,678,7,24,2082
502,13875,3283,3,Business,24,5,49472,24,5,49569,24,5,50115,24,5,50755,24,5,52094,7,22.8,-1.303596,36.778378,-1.2628473,36.781805,709,1339,97,1186
503,27759,1336,3,Business,24,4,53029,24,4,53045,24,4,53101,24,4,55330,24,4,55906,2,28.4,-1.28878,36.8168312,-1.2885029,36.825605,156,576,16,2285
504,2000,1410,3,Business,22,3,46389,22,3,46421,22,3,47791,22,3,47888,22,3,51425,21,23.0,-1.2847613,36.967084,-1.300921,36.828195,175,3537,32,1467
505,11232,3247,3,Business,8,5,44765,8,5,44786,8,5,44869,8,5,45671,8,5,47843,23,24.3,-1.2571472,36.7950633,-1.3433071,36.9043077,584,2172,21,885
506,16222,3426,3,Business,12,1,32691,12,1,32761,12,1,33262,12,1,33457,12,1,36541,8,19.5,-1.3025826,36.7670807,-1.2615888,36.7928732,559,3084,70,696
507,20366,2627,3,Business,5,2,42517,5,2,42576,5,2,44128,5,2,44243,5,2,45764,8,23.5,-1.225322,36.80855,-1.2571472,36.7950633,804,1521,59,1667
508,6587,3630,2,Personal,1,5,59608,1,5,59654,1,5,61994,1,5,62518,1,5,64444,19,22.6,-1.2793961,36.8838998,-1.214328,36.7911903,100,1926,46,2864
509,2352,3547,3,Business,20,3,44211,20,3,44227,20,3,47666,20,3,48263,20,3,50385,18,27.0,-1.3189252,36.8617269,-1.2856319,36.7672998,48,2122,16,4036
510,9387,176,1,Personal,6,1,47240,6,1,55075,6,1,57231,6,1,58248,6,1,60263,4,24.6,-1.2854453,36.8188363,-1.2666695,36.8328283,519,2015,7835,3173
511,5483,2444,1,Personal,20,5,38714,20,5,39999,20,5,40637,20,5,41428,20,5,43239,10,18.4,-1.2633255,36.7105693,-1.264788,36.7883897,313,1811,1285,1429
512,9045,1245,3,Business,9,4,55859,9,4,56279,9,4,56373,9,4,58277,9,4,59623,17,23.25888921888938,-1.300921,36.828195,-1.3198615,36.7110323,297,1346,420,1998
513,3758,3194,3,Business,4,2,60632,4,2,60675,4,2,60826,4,2,61167,4,2,61504,3,22.6,-1.2551895,36.7822034,-1.2597367,36.7848482,337,337,43,492
514,23201,2039,2,Personal,27,3,38421,27,3,38498,27,3,39486,27,3,39614,27,3,40257,4,23.25888921888938,-1.2951179,36.7684083,-1.2755226,36.7811904,749,643,77,1116
515,21700,3283,3,Business,29,5,58521,29,5,58572,29,5,59631,29,5,60499,29,5,62191,13,27.9,-1.331619,36.847976,-1.2628473,36.781805,61,1692,51,1927
516,21759,2150,3,Business,3,1,51163,3,1,51302,3,1,52245,3,1,52815,3,1,55808,15,23.1,-1.2663631,36.8163329,-1.344446,36.756597,27,2993,139,1513
517,15519,198,3,Business,21,3,54987,21,3,55009,21,3,55970,21,3,56128,21,3,57912,12,23.1,-1.3396256,36.8863135,-1.3799485,36.9349923,343,1784,22,1119
518,14701,391,3,Business,2,6,54305,2,6,55263,2,6,56078,2,6,56170,2,6,59685,19,30.8,-1.2867454,36.8259017,-1.3981712,36.7673241,291,3515,958,907
519,5013,2069,3,Business,8,3,40959,8,3,40968,8,3,41474,8,3,42043,8,3,42867,11,22.2,-1.2783849,36.8163445,-1.228911,36.881876,857,824,9,1075
520,23940,3201,3,Business,10,1,51469,10,1,51583,10,1,52484,10,1,53112,10,1,54849,9,18.2,-1.3014461,36.7661381,-1.2584143,36.8048002,155,1737,114,1529
521,28148,1304,3,Business,24,4,39039,24,4,39230,24,4,41983,24,4,42183,24,4,43442,8,21.2,-1.2553615,36.7895376,-1.2965824,36.8153022,752,1259,191,2953
522,1021,393,3,Business,11,2,46134,11,2,49241,11,2,49243,11,2,50231,11,2,52258,14,22.4,-1.3228003,36.8306435,-1.306378,36.7519845,619,2027,3107,990
523,6563,2674,3,Personal,27,6,65386,27,6,65535,27,6,67590,27,6,70396,27,6,72734,8,23.25888921888938,-1.2968742,36.7937803,-1.2797013,36.7299371,161,2338,149,4861
524,19727,2024,2,Personal,19,5,42182,19,5,42215,19,5,42846,19,5,44326,19,5,46670,19,25.0,-1.324282,36.86625,-1.2298785,36.7819851,178,2344,33,2111
525,15583,2435,2,Personal,11,2,48647,11,2,48845,11,2,49451,11,2,49914,11,2,52006,14,25.4,-1.3272343,36.7110502,-1.2646847,36.7906823,147,2092,198,1069
526,26314,2828,3,Business,1,5,35233,1,5,42611,1,5,43109,1,5,43603,1,5,48124,14,28.7,-1.2710687,36.8142839,-1.2137605,36.8788137,52,4521,7378,992
527,13587,375,3,Business,30,2,51246,30,2,51595,30,2,52077,30,2,53006,30,2,54251,9,23.25888921888938,-1.2551895,36.7822034,-1.2975098,36.8397842,613,1245,349,1411
528,13318,747,3,Personal,26,3,40561,26,3,40825,26,3,42317,26,3,42457,26,3,43382,5,24.2,-1.291768,36.8297208,-1.3009173,36.7959207,343,925,264,1632
529,12037,3291,3,Business,8,2,61040,8,2,61274,8,2,62631,8,2,63047,8,2,64930,10,23.5,-1.2600926,36.8088685,-1.22978,36.836215,862,1883,234,1773
530,23142,143,1,Personal,24,2,42574,24,2,42603,24,2,43033,24,2,43249,24,2,45409,16,17.5,-1.2745912,36.8189059,-1.3170028,36.702097,951,2160,29,646
531,16941,1502,3,Business,14,4,49861,14,4,56160,14,4,57172,14,4,57416,14,4,59203,12,28.0,-1.2765736,36.8513646,-1.2232123,36.8932547,377,1787,6299,1256
532,11583,1809,3,Business,17,4,36112,17,4,36129,17,4,37727,17,4,37854,17,4,41472,17,23.25888921888938,-1.3472066,36.7692638,-1.2571472,36.7950633,197,3618,17,1725
533,24594,3599,3,Business,28,3,47393,28,3,48400,28,3,49101,28,3,50386,28,3,51794,8,23.25888921888938,-1.3302996,36.8707935,-1.2998789,36.8168963,521,1408,1007,1986
534,5302,3647,3,Business,12,5,34447,12,5,34501,12,5,34665,12,5,34941,12,5,36256,8,21.6,-1.272639,36.794723,-1.2981102,36.8293513,205,1315,54,440
535,17809,1271,3,Business,2,1,46240,2,1,46922,2,1,48298,2,1,49163,2,1,51113,19,20.2,-1.3244885,36.897792,-1.254191,36.8099132,103,1950,682,2241
536,19743,2924,3,Personal,2,3,71989,2,3,72462,2,3,75709,2,3,76140,2,3,77308,10,20.1,-1.2664227,36.7453671,-1.2661657,36.8015748,288,1168,473,3678
537,7356,2207,3,Business,14,4,39533,14,4,39658,14,4,41266,14,4,41736,14,4,43138,5,23.7,-1.2885944,36.8175619,-1.2696908,36.81519,660,1402,125,2078
538,14847,3642,2,Personal,5,2,58445,5,2,58560,5,2,58871,5,2,60242,5,2,61084,4,21.6,-1.2922364,36.7895538,-1.2933048,36.8211515,620,842,115,1682
539,12780,1148,3,Business,27,3,51911,27,3,51946,27,3,52742,27,3,53684,27,3,55827,5,29.1,-1.3100586,36.8500329,-1.3241185,36.8578212,154,2143,35,1738
540,5796,496,3,Business,18,3,58328,18,3,58337,18,3,58440,18,3,58588,18,3,59553,8,20.5,-1.2551895,36.7822034,-1.287428,36.7800821,951,965,9,251
541,19408,590,3,Business,7,4,65244,7,4,65739,7,4,66622,7,4,66919,7,4,71260,11,25.4,-1.2815072,36.82096,-1.2296129,36.7641955,436,4341,495,1180
542,13545,3,1,Personal,29,5,51364,29,5,51699,29,5,53187,29,5,55016,29,5,58444,8,21.0,-1.2949771,36.8649898,-1.3123977,36.902807,648,3428,335,3317
543,12861,2200,3,Business,6,2,45300,6,2,47941,6,2,48903,6,2,49499,6,2,50665,7,27.3,-1.290894,36.822971,-1.2551895,36.7822034,733,1166,2641,1558
544,19619,3283,3,Business,5,6,57043,5,6,57083,5,6,57503,5,6,57974,5,6,58444,6,22.2,-1.272828,36.816608,-1.2628473,36.781805,178,470,40,891
545,377,633,3,Business,1,5,45622,1,5,46054,1,5,47171,1,5,47272,1,5,47958,5,28.4,-1.2770708,36.8231093,-1.3004062,36.829741,48,686,432,1218
546,7707,1281,3,Business,23,1,43585,23,1,43612,23,1,44002,23,1,47861,23,1,49815,10,18.4,-1.269534,36.80697,-1.275442,36.7660207,616,1954,27,4249
547,16087,3621,3,Business,7,5,41648,7,5,43046,7,5,44055,7,5,44312,7,5,46310,8,23.25888921888938,-1.2836583,36.7886014,-1.3331687,36.7848599,643,1998,1398,1266
548,16105,507,3,Personal,8,3,33211,8,3,33235,8,3,33685,8,3,33840,8,3,34928,5,23.25888921888938,-1.301093,36.7790314,-1.28467,36.794438,161,1088,24,605
549,10294,3091,3,Business,21,5,52085,21,5,53120,21,5,53236,21,5,53538,21,5,54180,3,24.7,-1.3012008,36.764868,-1.3002865,36.7491504,770,642,1035,418
550,15276,2412,3,Business,15,1,53139,15,1,53150,15,1,53337,15,1,54223,15,1,55750,12,23.25888921888938,-1.2534301,36.8000983,-1.2283403,36.8822756,247,1527,11,1073
551,22176,186,3,Business,29,1,58245,29,1,58277,29,1,58383,29,1,59155,29,1,61106,17,24.5,-1.2902869,36.8085396,-1.3700383,36.9190174,703,1951,32,878
552,8909,2982,3,Business,5,5,37473,5,5,37495,5,5,37886,5,5,39132,5,5,42400,21,24.3,-1.300921,36.828195,-1.2239243,36.710118,519,3268,22,1637
553,4854,2946,2,Personal,18,3,45556,18,3,45565,18,3,46340,18,3,46553,18,3,47604,8,19.8,-1.2749662,36.7658781,-1.2983462,36.8139996,634,1051,9,988
554,23170,3404,3,Business,1,5,62914,1,5,64532,1,5,65826,1,5,66345,1,5,67799,6,26.3,-1.279395,36.825364,-1.282937,36.7816984,540,1454,1618,1813
555,16934,136,3,Business,18,1,52970,18,1,54806,18,1,55684,18,1,57087,18,1,59152,16,17.3,-1.3326173,36.7146233,-1.2649605,36.7981777,543,2065,1836,2281
556,13759,1500,3,Business,26,2,29210,26,2,29246,26,2,29663,26,2,31650,26,2,32548,8,22.0,-1.3004062,36.829741,-1.2638185,36.7930057,842,898,36,2404
557,4061,2982,3,Business,5,2,57378,5,2,57400,5,2,57462,5,2,58961,5,2,61453,18,27.7,-1.300921,36.828195,-1.177202,36.8351183,583,2492,22,1561
558,12407,2335,3,Business,6,3,49316,6,3,49348,6,3,51018,6,3,51274,6,3,54264,22,23.25888921888938,-1.2551895,36.7822034,-1.3562374,36.9042954,295,2990,32,1926
559,9995,867,3,Business,28,2,48422,28,2,48453,28,2,48555,28,2,50966,28,2,52605,10,23.6,-1.3004062,36.829741,-1.2991441,36.7528804,686,1639,31,2513
560,21131,3339,3,Business,5,5,36921,5,5,37058,5,5,37737,5,5,38427,5,5,38951,9,24.0,-1.2551895,36.7822034,-1.3014461,36.7661381,754,524,137,1369
561,22544,635,3,Business,14,5,33176,14,5,33189,14,5,33200,14,5,35636,14,5,36626,10,17.1,-1.300921,36.828195,-1.2602337,36.7990548,2,990,13,2447
562,10725,2330,3,Business,31,5,50937,31,5,51296,31,5,53860,31,5,55021,31,5,59969,19,24.6,-1.2524916,36.8656196,-1.3015197,36.7658456,42,4948,359,3725
563,19944,393,3,Business,4,6,31454,4,6,31477,4,6,31590,4,6,33621,4,6,33627,11,23.25888921888938,-1.3167113,36.8301563,-1.2638185,36.7930057,349,6,23,2144
564,21990,1271,3,Business,8,1,49208,8,1,53876,8,1,55259,8,1,56898,8,1,58313,8,25.1,-1.3244885,36.897792,-1.2917004,36.8802381,890,1415,4668,3022
565,24634,2801,3,Business,22,2,44754,22,2,45034,22,2,46250,22,2,46462,22,2,48038,9,24.2,-1.3038408,36.818713,-1.3104506,36.8687235,332,1576,280,1428
566,14309,1792,3,Business,12,5,38309,12,5,38350,12,5,39254,12,5,39564,12,5,40046,3,24.4,-1.2809121,36.7852524,-1.2734311,36.7863778,396,482,41,1214
567,8287,3222,3,Business,4,2,57698,4,2,61080,4,2,61360,4,2,61867,4,2,63709,7,22.6,-1.2551895,36.7822034,-1.2545163,36.8243717,673,1842,3382,787
568,3841,685,3,Business,10,1,41909,10,1,42026,10,1,42495,10,1,43518,10,1,44051,3,18.5,-1.2672782,36.8041436,-1.265432,36.795034,205,533,117,1492
569,3006,1880,3,Business,7,5,47311,7,5,47443,7,5,48614,7,5,49212,7,5,53968,12,24.9,-1.2571472,36.7950633,-1.31553,36.863732,88,4756,132,1769
570,11248,393,3,Business,17,4,51237,17,4,51256,17,4,51280,17,4,53440,17,4,55227,14,23.8,-1.3177547,36.8303703,-1.306378,36.7519845,702,1787,19,2184
571,16534,2523,3,Business,25,1,38889,25,1,38915,25,1,39207,25,1,39543,25,1,40665,7,23.25888921888938,-1.2551895,36.7822034,-1.2995738,36.8199719,908,1122,26,628
572,8915,3194,3,Business,21,4,38507,21,4,38545,21,4,39067,21,4,39402,21,4,41963,16,27.8,-1.2551895,36.7822034,-1.3356493,36.8927662,784,2561,38,857
573,929,1500,3,Business,25,1,52337,25,1,52625,25,1,53632,25,1,53724,25,1,55091,8,29.9,-1.3004062,36.829741,-1.2638185,36.7930057,956,1367,288,1099
574,3152,1606,1,Personal,15,1,36936,15,1,36977,15,1,37229,15,1,37298,15,1,38427,9,23.25888921888938,-1.2666153,36.8015124,-1.3240024,36.8119022,208,1129,41,321
575,13668,6,3,Personal,30,6,34807,30,6,34825,30,6,35143,30,6,35598,30,6,40120,12,23.25888921888938,-1.3216721,36.8550496,-1.2675238,36.8127148,26,4522,18,773
576,14652,467,3,Business,30,4,58298,30,4,58345,30,4,59229,30,4,59481,30,4,60009,2,23.25888921888938,-1.304735,36.7846054,-1.2977326,36.7711606,158,528,47,1136
577,25341,3291,3,Business,8,6,54086,8,6,55729,8,6,56370,8,6,57334,8,6,58583,9,23.6,-1.307143,36.825009,-1.2600926,36.8088685,658,1249,1643,1605
578,10815,3498,2,Personal,22,2,40702,22,2,40714,22,2,41477,22,2,42118,22,2,43617,7,19.6,-1.2735236,36.7992196,-1.2915969,36.8237639,116,1499,12,1404
579,3683,1898,3,Personal,4,4,49458,4,4,49656,4,4,50474,4,4,50538,4,4,52000,8,25.0,-1.3261286,36.8469625,-1.29759,36.815769,402,1462,198,882
580,9762,1568,3,Business,15,2,39517,15,2,39534,15,2,39545,15,2,40508,15,2,41611,9,22.9,-1.2962603,36.7766164,-1.2579304,36.8019667,623,1103,17,974
581,2852,419,3,Business,3,2,61422,3,2,61804,3,2,61895,3,2,62559,3,2,64223,9,18.8,-1.3001813,36.811122,-1.2579304,36.8019667,192,1664,382,755
582,24275,1246,3,Business,9,5,54752,9,5,54901,9,5,55200,9,5,55742,9,5,56055,1,26.3,-1.2571472,36.7950633,-1.2642903,36.8002137,875,313,149,841
583,23946,3213,1,Personal,16,4,46389,16,4,46703,16,4,48862,16,4,49258,16,4,52620,14,19.1,-1.3519945,36.7471367,-1.3007534,36.7964576,327,3362,314,2555
584,26868,1927,3,Business,18,1,46411,18,1,46452,18,1,48107,18,1,48396,18,1,52152,20,27.9,-1.2860183,36.8975338,-1.3472066,36.7692638,341,3756,41,1944
585,6039,540,3,Business,20,4,36357,20,4,36520,20,4,36929,20,4,37179,20,4,39093,8,18.7,-1.2551895,36.7822034,-1.2964348,36.8182757,404,1914,163,659
586,3902,2869,3,Business,26,2,32784,26,2,32828,26,2,34351,26,2,34617,26,2,38853,9,21.6,-1.3014461,36.7661381,-1.2551895,36.7822034,306,4236,44,1789
587,28240,2523,3,Business,1,5,44403,1,5,44438,1,5,44892,1,5,45354,1,5,46191,8,26.7,-1.2551895,36.7822034,-1.2854174,36.7951152,4,837,35,916
588,20041,1075,3,Business,19,3,44399,19,3,48943,19,3,49692,19,3,50287,19,3,51524,13,24.5,-1.207546,36.7913976,-1.2527958,36.8003131,315,1237,4544,1344
589,16592,928,3,Business,30,2,55370,30,2,62907,30,2,62951,30,2,63206,30,2,65290,7,23.25888921888938,-1.2551895,36.7822034,-1.2936429,36.8277508,910,2084,7537,299
590,7658,1410,3,Business,26,3,55671,26,3,55726,26,3,56367,26,3,61868,26,3,64951,12,19.5,-1.300921,36.828195,-1.2308211,36.8679041,932,3083,55,6142
591,17172,3201,3,Business,2,4,54253,2,4,54312,2,4,54536,2,4,54714,2,4,55303,4,23.25888921888938,-1.2584143,36.8048002,-1.2551895,36.7822034,881,589,59,402
592,9488,1805,2,Personal,28,2,49529,28,2,49612,28,2,50120,28,2,50382,28,2,52391,15,19.3,-1.2979147,36.7857814,-1.3206958,36.8769553,350,2009,83,770
593,16169,3201,3,Business,9,3,61345,9,3,61372,9,3,61622,9,3,62284,9,3,62287,1,24.5,-1.2605938,36.8073235,-1.2584143,36.8048002,685,3,27,912
594,10108,230,1,Personal,6,3,55851,6,3,55988,6,3,56952,6,3,57592,6,3,60956,9,21.6,-1.2952784,36.7793271,-1.307774,36.8407541,148,3364,137,1604
595,2579,393,3,Business,17,5,36878,17,5,36891,17,5,36898,17,5,39388,17,5,39438,11,23.25888921888938,-1.3167113,36.8301563,-1.2638185,36.7930057,39,50,13,2497
596,25630,2410,1,Personal,15,1,52962,15,1,53198,15,1,53804,15,1,54294,15,1,55202,6,23.25888921888938,-1.2664428,36.809453,-1.2962832,36.7849683,383,908,236,1096
597,3419,3264,3,Business,22,2,44086,22,2,44097,22,2,44213,22,2,44395,22,2,45366,8,23.9,-1.2551895,36.7822034,-1.3027475,36.8178196,231,971,11,298
598,2974,3752,3,Business,12,3,52562,12,3,52708,12,3,52745,12,3,55072,12,3,55074,2,20.9,-1.256594,36.8002785,-1.2753109,36.8130185,531,2,146,2364
599,17886,2768,3,Business,11,6,29979,11,6,29991,11,6,31418,11,6,34937,11,6,34939,26,23.25888921888938,-1.2857764,36.8236622,-1.1344906,36.9123061,68,2,12,4946
600,18167,393,3,Business,19,6,41605,19,6,41617,19,6,41800,19,6,42276,19,6,42762,4,25.1,-1.3167113,36.8301563,-1.3004062,36.829741,523,486,12,659
601,13593,2634,3,Business,27,1,44934,27,1,44934,27,1,45180,27,1,45422,27,1,47630,21,20.9,-1.2963097,36.7688221,-1.3160977,36.9131642,425,2208,0,488
602,7333,517,3,Business,13,2,31368,13,2,35904,13,2,37685,13,2,38028,13,2,39165,6,22.3,-1.3177547,36.8303703,-1.3077869,36.8443207,95,1137,4536,2124
603,6026,1414,1,Personal,15,6,44975,15,6,45087,15,6,45994,15,6,46538,15,6,47122,6,23.25888921888938,-1.3159197,36.8516724,-1.2987976,36.829477,179,584,112,1451
604,16416,2958,3,Personal,9,3,44417,9,3,44490,9,3,45041,9,3,45736,9,3,46612,3,25.2,-1.2913246,36.8019522,-1.3123652,36.7964266,559,876,73,1246
605,258,3331,3,Business,4,2,38501,4,2,40903,4,2,41591,4,2,41829,4,2,43774,9,19.3,-1.2551895,36.7822034,-1.2956171,36.7888097,817,1945,2402,926
606,22043,53,3,Business,14,2,57177,14,2,57573,14,2,58210,14,2,58278,14,2,59819,8,23.25888921888938,-1.2770708,36.8231093,-1.276954,36.765926,843,1541,396,705
607,24884,393,3,Business,11,5,52831,11,5,52937,11,5,52940,11,5,56847,11,5,56849,4,26.5,-1.3167113,36.8301563,-1.3004062,36.829741,39,2,106,3910
608,2067,2587,3,Business,15,5,55988,15,5,56184,15,5,56829,15,5,57317,15,5,61852,5,28.1,-1.2584143,36.8048002,-1.28878,36.8168312,634,4535,196,1133
609,3839,20,3,Business,7,2,44509,7,2,44618,7,2,45339,7,2,45880,7,2,46721,6,23.0,-1.2628638,36.8070399,-1.2804456,36.8229507,857,841,109,1262
610,9102,412,3,Business,16,3,44247,16,3,44267,16,3,45221,16,3,45963,16,3,47554,3,23.0,-1.272828,36.816608,-1.266837,36.799249,611,1591,20,1696
611,7277,302,3,Business,11,1,72301,11,1,72364,11,1,74559,11,1,74676,11,1,76051,8,22.8,-1.2649605,36.7981777,-1.3162537,36.8199906,598,1375,63,2312
612,23659,3686,3,Business,8,5,58307,8,5,59482,8,5,60588,8,5,60717,8,5,63635,13,28.2,-1.2551895,36.7822034,-1.2095044,36.7832064,318,2918,1175,1235
613,17778,2216,3,Business,23,2,38477,23,2,40298,23,2,40516,23,2,41276,23,2,44481,18,18.2,-1.2551895,36.7822034,-1.2198413,36.9054958,880,3205,1821,978
614,10469,2956,3,Business,6,1,50596,6,1,50971,6,1,52152,6,1,52404,6,1,53506,8,23.25888921888938,-1.2878913,36.8089253,-1.2584143,36.8048002,132,1102,375,1433
615,18807,3222,3,Business,4,4,42781,4,4,42839,4,4,43319,4,4,43678,4,4,44158,3,25.4,-1.2551895,36.7822034,-1.2676026,36.8103629,770,480,58,839
616,21455,2216,3,Business,15,4,41225,15,4,44883,15,4,45344,15,4,47287,15,4,48470,7,24.6,-1.2551895,36.7822034,-1.2308883,36.7698236,518,1183,3658,2404
617,18112,3211,1,Personal,7,4,51205,7,4,52546,7,4,53619,7,4,57990,7,4,58979,6,20.1,-1.2783772,36.8201617,-1.288609,36.7829393,431,989,1341,5444
618,21972,60,3,Business,4,1,49821,4,1,49892,4,1,50223,4,1,52640,4,1,53961,14,28.5,-1.2628473,36.781805,-1.2296618,36.8438272,882,1321,71,2748
619,24566,156,1,Personal,11,4,38162,11,4,38198,11,4,38920,11,4,39484,11,4,40647,9,24.1,-1.2943538,36.7898148,-1.2574219,36.7927073,519,1163,36,1286
620,3863,2523,3,Business,16,1,44779,16,1,44808,16,1,45745,16,1,45843,16,1,47233,8,19.3,-1.2551895,36.7822034,-1.2860372,36.7549573,279,1390,29,1035
621,7163,2710,3,Personal,25,1,46201,25,1,46213,25,1,47158,25,1,47724,25,1,49082,11,25.5,-1.2980229,36.78865,-1.2535486,36.7933541,411,1358,12,1511
622,17120,552,3,Business,12,2,51945,12,2,52999,12,2,54899,12,2,55234,12,2,58225,15,27.2,-1.2859912,36.8756811,-1.3632162,36.9108253,231,2991,1054,2235
623,12072,269,1,Business,4,4,57716,4,4,58563,4,4,59385,4,4,59768,4,4,61443,12,23.25888921888938,-1.3332749,36.8708147,-1.3886344,36.9372718,731,1675,847,1205
624,7839,1461,2,Personal,28,2,33196,28,2,33237,28,2,33789,28,2,34148,28,2,35592,6,16.0,-1.2720769,36.8180604,-1.2635051,36.7829162,937,1444,41,911
625,23422,2453,1,Personal,9,2,46388,9,2,46419,9,2,47791,9,2,48002,9,2,51165,21,21.8,-1.2374348,36.9155704,-1.2861471,36.7903723,847,3163,31,1583
626,27017,1831,3,Business,11,1,53699,11,1,53882,11,1,54538,11,1,54954,11,1,57671,18,29.0,-1.282543,36.824618,-1.3562374,36.9042954,583,2717,183,1072
627,2548,1271,3,Business,20,4,36117,20,4,36139,20,4,42088,20,4,42153,20,4,44478,24,22.0,-1.3244885,36.897792,-1.3107918,36.761794,48,2325,22,6014
628,9493,2523,3,Business,11,1,34967,11,1,34980,11,1,35053,11,1,35472,11,1,36394,9,18.1,-1.2551895,36.7822034,-1.2978456,36.7537369,379,922,13,492
629,25353,1920,3,Business,31,3,61348,31,3,61364,31,3,61474,31,3,61669,31,3,62639,8,24.3,-1.2551895,36.7822034,-1.2854174,36.7951152,551,970,16,305
630,6873,1787,3,Business,22,5,57127,22,5,57318,22,5,57818,22,5,59799,22,5,61477,11,28.5,-1.28878,36.8168312,-1.2283403,36.8822756,267,1678,191,2481
631,1833,3517,3,Business,16,6,34372,16,6,34385,16,6,34612,16,6,37924,16,6,39886,15,25.7,-1.300921,36.828195,-1.3882008,36.7699445,858,1962,13,3539
632,1721,3239,3,Personal,14,2,33513,14,2,33534,14,2,34655,14,2,34782,14,2,37181,20,15.6,-1.2836832,36.8306719,-1.3745998,36.9314035,583,2399,21,1248
633,1487,1162,3,Business,7,2,32799,7,2,32915,7,2,34234,7,2,34751,7,2,35932,8,16.8,-1.312261,36.794658,-1.2733047,36.8109744,301,1181,116,1836
634,13762,1249,3,Business,15,4,62462,15,4,64830,15,4,66892,15,4,67495,15,4,69767,4,25.1,-1.3168075,36.8626441,-1.3189252,36.8617269,304,2272,2368,2665
635,982,1500,3,Business,10,3,34874,10,3,34903,10,3,34911,10,3,38413,10,3,38415,13,27.7,-1.2638185,36.7930057,-1.3228003,36.8306435,239,2,29,3510
636,18703,3217,3,Business,14,4,37253,14,4,38791,14,4,38812,14,4,40239,14,4,41464,12,19.2,-1.2644742,36.8083457,-1.214328,36.7911903,354,1225,1538,1448
637,21221,1899,3,Business,24,5,47534,24,5,47587,24,5,48452,24,5,49094,24,5,50479,13,23.4,-1.293515,36.897607,-1.331619,36.847976,676,1385,53,1507
638,1354,3191,3,Personal,6,1,39010,6,1,39113,6,1,39346,6,1,39543,6,1,40171,5,20.5,-1.284835,36.77601,-1.2946939,36.8043582,754,628,103,430
639,21183,2283,2,Personal,7,1,36068,7,1,36115,7,1,36159,7,1,36504,7,1,38043,11,18.6,-1.2696341,36.791664,-1.239774,36.848471,65,1539,47,389
640,21848,3517,3,Business,24,5,57606,24,5,57950,24,5,58489,24,5,60195,24,5,62969,19,20.2,-1.3207708,36.8685919,-1.3882008,36.7699445,647,2774,344,2245
641,18272,3207,1,Personal,8,3,50931,8,3,51066,8,3,52367,8,3,53279,8,3,54283,8,25.8,-1.3014461,36.7661381,-1.264945,36.784678,131,1004,135,2213
642,22436,988,3,Personal,13,1,55205,13,1,55215,13,1,55783,13,1,56499,13,1,58057,11,19.6,-1.3196809,36.8410572,-1.2844665,36.7866113,449,1558,10,1284
643,15073,3647,3,Business,6,3,41674,6,3,41710,6,3,42513,6,3,42834,6,3,44247,8,23.25888921888938,-1.272639,36.794723,-1.302559,36.819555,518,1413,36,1124
644,15990,238,3,Business,29,2,50878,29,2,50984,29,2,51943,29,2,52814,29,2,53596,5,26.9,-1.32671,36.8600138,-1.3077869,36.8443207,26,782,106,1830
645,680,2281,1,Personal,14,4,51277,14,4,52856,14,4,53809,14,4,57070,14,4,59712,9,21.2,-1.2891901,36.7620012,-1.2644742,36.8083457,64,2642,1579,4214
646,4834,2700,3,Business,27,4,58732,27,4,58778,27,4,59448,27,4,59643,27,4,61806,8,23.0,-1.261232,36.7795039,-1.2845835,36.8079121,167,2163,46,865
647,9745,622,1,Business,4,5,56327,4,5,56346,4,5,57264,4,5,57812,4,5,59660,19,24.0,-1.2190729,36.9071203,-1.2951362,36.7876989,265,1848,19,1466
648,6193,393,3,Business,19,3,29091,19,3,38883,19,3,38892,19,3,41645,19,3,41647,4,22.3,-1.3167113,36.8301563,-1.3004062,36.829741,623,2,9792,2762
649,25091,3147,3,Business,13,3,37569,13,3,37605,13,3,38829,13,3,39654,13,3,41614,3,19.9,-1.3404187,36.7614685,-1.346755,36.756349,844,1960,36,2049
650,1067,2509,3,Business,13,4,42483,13,4,45296,13,4,46240,13,4,50008,13,4,54658,15,22.5,-1.2571472,36.7950633,-1.2778747,36.8831829,194,4650,2813,4712
651,15541,250,2,Personal,20,5,45032,20,5,45136,20,5,46059,20,5,46385,20,5,47338,4,18.7,-1.2874734,36.7620715,-1.2874314,36.7764912,521,953,104,1249
652,18529,2412,3,Business,25,1,55025,25,1,55081,25,1,56416,25,1,56713,25,1,58014,11,27.9,-1.2803414,36.8265456,-1.2285835,36.8826468,341,1301,56,1632
653,9496,3752,3,Business,3,5,52578,3,5,52696,3,5,53162,3,5,53668,3,5,54310,1,23.25888921888938,-1.2696908,36.81519,-1.2753109,36.8130185,819,642,118,972
654,16092,2957,3,Personal,16,2,40165,16,2,43682,16,2,44282,16,2,44469,16,2,46467,6,23.25888921888938,-1.3014462,36.7607695,-1.2772632,36.7922251,166,1998,3517,787
655,17198,562,3,Business,17,5,30244,17,5,30306,17,5,33165,17,5,33561,17,5,36652,17,23.25888921888938,-1.3227181,36.8528097,-1.2185253,36.8174127,233,3091,62,3255
656,15559,3107,3,Business,10,5,35606,10,5,37281,10,5,38602,10,5,38933,10,5,40334,9,19.3,-1.2930128,36.8356869,-1.256958,36.8144929,88,1401,1675,1652
657,1541,3525,3,Business,8,3,47881,8,3,49008,8,3,50265,8,3,52520,8,3,55470,18,26.0,-1.2099573,36.8859752,-1.2571472,36.7950633,384,2950,1127,3512
658,8258,2587,3,Business,6,3,55921,6,3,55988,6,3,56528,6,3,56863,6,3,57857,5,23.25888921888938,-1.28878,36.8168312,-1.2922364,36.7895538,452,994,67,875
659,14590,3032,3,Business,21,5,37868,21,5,38058,21,5,38508,21,5,38774,21,5,42002,18,23.0,-1.2571472,36.7950633,-1.3251247,36.8995926,557,3228,190,716
660,25619,3647,3,Business,5,2,46308,5,2,46340,5,2,47494,5,2,47918,5,2,49429,13,23.6,-1.272639,36.794723,-1.2309704,36.8688593,26,1511,32,1578
661,27606,3091,3,Business,28,5,38749,28,5,38762,28,5,39047,28,5,39347,28,5,40642,10,23.7,-1.2527958,36.8003131,-1.3012008,36.764868,764,1295,13,585
662,6763,1164,1,Personal,31,2,50123,31,2,50266,31,2,52394,31,2,52841,31,2,54758,9,22.0,-1.2889024,36.8187402,-1.2946908,36.7549734,882,1917,143,2575
663,12066,302,3,Business,21,5,73640,21,5,74275,21,5,75346,21,5,75976,21,5,77110,3,18.0,-1.2649605,36.7981777,-1.2513861,36.8174281,489,1134,635,1701
664,19677,62,3,Business,15,1,48712,15,1,51682,15,1,52522,15,1,52763,15,1,53517,6,23.25888921888938,-1.2967108,36.7871135,-1.286925,36.821916,845,754,2970,1081
665,18979,1995,3,Business,2,4,62875,2,4,62947,2,4,63624,2,4,64731,2,4,66433,7,23.25888921888938,-1.290894,36.822971,-1.2551895,36.7822034,81,1702,72,1784
666,12032,3324,1,Business,11,1,49276,11,1,49446,11,1,50358,11,1,51866,11,1,52782,5,23.1,-1.2643994,36.812919,-1.2730069,36.811159,101,916,170,2420
667,10213,3635,1,Business,29,6,59752,29,6,59906,29,6,60892,29,6,61146,29,6,62215,6,23.8,-1.2615888,36.7928732,-1.282937,36.7816984,916,1069,154,1240
668,21551,1388,3,Personal,9,2,51941,9,2,51965,9,2,52205,9,2,55015,9,2,55720,4,30.8,-1.2611987,36.8060913,-1.2895261,36.8164407,803,705,24,3050
669,5276,867,3,Business,1,5,52642,1,5,52669,1,5,52812,1,5,53248,1,5,55005,14,31.8,-1.3228003,36.8306435,-1.2991441,36.7528804,239,1757,27,579
670,13526,3372,3,Business,14,6,39425,14,6,39435,14,6,40724,14,6,41049,14,6,43667,11,17.8,-1.2969741,36.7856612,-1.3339461,36.8219129,722,2618,10,1614
671,1848,358,3,Business,24,4,53118,24,4,53486,24,4,55690,24,4,56447,24,4,58344,6,28.3,-1.2795796,36.819062,-1.2580991,36.7941519,755,1897,368,2961
672,10078,2514,3,Business,26,5,44321,26,5,45072,26,5,46115,26,5,46841,26,5,47050,1,23.25888921888938,-1.2684667,36.8002891,-1.266294,36.8057971,101,209,751,1769
673,8257,718,3,Business,2,2,37190,2,2,37352,2,2,37584,2,2,37741,2,2,39101,8,20.7,-1.2551895,36.7822034,-1.3010059,36.8216816,85,1360,162,389
674,4270,867,3,Business,21,4,41798,21,4,41838,21,4,42071,21,4,42258,21,4,43363,9,25.0,-1.2638185,36.7930057,-1.2991441,36.7528804,523,1105,40,420
675,23042,2202,3,Business,17,4,58464,17,4,58662,17,4,60098,17,4,60483,17,4,61675,8,21.9,-1.2626906,36.7827022,-1.290894,36.822971,742,1192,198,1821
676,4162,1402,3,Business,9,2,49492,9,2,49607,9,2,50678,9,2,52066,9,2,54308,21,30.7,-1.323615,36.700475,-1.281754,36.8324229,853,2242,115,2459
677,11631,60,3,Business,6,1,43945,6,1,43961,6,1,44582,6,1,45093,6,1,47663,16,20.4,-1.331619,36.847976,-1.2296618,36.8438272,519,2570,16,1132
678,15722,2956,3,Business,7,2,44615,7,2,44800,7,2,46379,7,2,46661,7,2,48704,21,23.25888921888938,-1.3562374,36.9042954,-1.2584143,36.8048002,883,2043,185,1861
679,11862,700,3,Business,8,2,41518,8,2,41550,8,2,43091,8,2,43323,8,2,44230,8,21.2,-1.2948634,36.7651632,-1.284452,36.8300885,100,907,32,1773
680,22230,2523,3,Business,26,5,52858,26,5,52876,26,5,52889,26,5,53632,26,5,54182,8,23.25888921888938,-1.2551895,36.7822034,-1.2856664,36.7559838,291,550,18,756
681,13705,2289,3,Business,4,1,56138,4,1,56185,4,1,56204,4,1,56755,4,1,58797,6,23.25888921888938,-1.2551895,36.7822034,-1.2869955,36.8202749,291,2042,47,570
682,5516,635,3,Business,3,5,54910,3,5,55536,3,5,56116,3,5,59064,3,5,62970,8,23.25888921888938,-1.3081376,36.8329772,-1.2602337,36.7990548,591,3906,626,3528
683,27721,3647,3,Business,7,5,35459,7,5,35490,7,5,37253,7,5,37323,7,5,38734,5,23.25888921888938,-1.272639,36.794723,-1.2854174,36.7951152,172,1411,31,1833
684,15893,1081,3,Business,5,2,54681,5,2,54698,5,2,54960,5,2,55531,5,2,58510,23,27.4,-1.2283403,36.8822756,-1.3472066,36.7692638,594,2979,17,833
685,19142,635,3,Business,21,1,49004,21,1,49333,21,1,49834,21,1,51450,21,1,52373,7,27.6,-1.3081376,36.8329772,-1.2599563,36.7993439,809,923,329,2117
686,203,2982,3,Business,13,6,36450,13,6,36492,13,6,37351,13,6,37517,13,6,39098,19,19.9,-1.2691246,36.7992584,-1.177202,36.8351183,394,1581,42,1025
687,16183,2457,1,Business,26,4,49248,26,4,49318,26,4,49983,26,4,51399,26,4,54039,7,22.0,-1.2571472,36.7950633,-1.3047132,36.8089553,147,2640,70,2081
688,9728,3599,3,Business,27,6,43712,27,6,45743,27,6,48314,27,6,49332,27,6,51576,14,23.25888921888938,-1.3302996,36.8707935,-1.2603403,36.7998848,787,2244,2031,3589
689,24184,1631,2,Personal,24,2,46804,24,2,46812,24,2,47255,24,2,48498,24,2,49525,6,17.2,-1.2876575,36.8272947,-1.270186,36.8022793,144,1027,8,1686
690,11617,485,3,Personal,14,2,60311,14,2,60396,14,2,61290,14,2,61676,14,2,65549,29,23.25888921888938,-1.3463429,36.9069888,-1.1677948,36.9835042,168,3873,85,1280
691,24477,747,3,Personal,23,3,59894,23,3,60223,23,3,61395,23,3,62240,23,3,62398,2,24.3,-1.3334681,36.7116093,-1.3421304,36.718364,226,158,329,2017
692,7563,1500,3,Business,4,4,41083,4,4,41223,4,4,43111,4,4,44522,4,4,45624,8,23.25888921888938,-1.3004062,36.829741,-1.2574219,36.7927073,219,1102,140,3299
693,1819,346,3,Business,5,2,42459,5,2,42490,5,2,42501,5,2,43835,5,2,45136,11,23.5,-1.2283403,36.8822756,-1.28878,36.8168312,925,1301,31,1345
694,4,2377,3,Personal,12,2,53932,12,2,53962,12,2,55135,12,2,57171,12,2,58859,5,23.25888921888938,-1.3016067,36.8404485,-1.2855654,36.8244835,181,1688,30,3209
695,12423,1271,3,Business,23,1,40847,23,1,40877,23,1,41366,23,1,41880,23,1,43292,18,18.3,-1.2591019,36.800577,-1.3244885,36.897792,103,1412,30,1003
696,23986,71,3,Business,9,5,46134,9,5,46518,9,5,47205,9,5,47500,9,5,48422,4,25.5,-1.2765736,36.8513646,-1.2891922,36.825189,554,922,384,982
697,18379,1482,3,Business,21,5,40397,21,5,41341,21,5,41961,21,5,42116,21,5,44176,7,22.8,-1.29666,36.828668,-1.2534301,36.8000983,899,2060,944,775
698,22455,2200,3,Business,11,2,46580,11,2,47540,11,2,48548,11,2,48972,11,2,49717,2,22.2,-1.279395,36.825364,-1.290894,36.822971,511,745,960,1432
699,16118,867,3,Business,29,5,49283,29,5,49347,29,5,50131,29,5,51492,29,5,53588,10,29.1,-1.2996533,36.8292629,-1.2991441,36.7528804,709,2096,64,2145
700,8502,400,3,Business,29,4,52894,29,4,52943,29,4,53167,29,4,57718,29,4,59685,12,24.8,-1.3051399,36.8335557,-1.275442,36.7660207,519,1967,49,4775
701,5458,517,3,Business,31,1,43545,31,1,43560,31,1,43752,31,1,43847,31,1,45488,14,21.2,-1.3167113,36.8301563,-1.306378,36.7519845,523,1641,15,287
702,3438,478,3,Business,30,2,43244,30,2,43638,30,2,43833,30,2,45851,30,2,45865,4,23.25888921888938,-1.2551895,36.7822034,-1.2715686,36.8023526,535,14,394,2213
703,21552,2956,3,Business,27,1,50411,27,1,50460,27,1,51515,27,1,52097,27,1,53543,7,22.9,-1.2584143,36.8048002,-1.3008433,36.8036256,829,1446,49,1637
704,7616,540,3,Business,31,5,37868,31,5,38441,31,5,39019,31,5,39631,31,5,40391,5,16.9,-1.2571472,36.7950633,-1.2623805,36.7805404,222,760,573,1190
705,27192,1410,3,Business,24,5,58408,24,5,58581,24,5,58764,24,5,59673,24,5,62622,20,19.8,-1.300921,36.828195,-1.2847613,36.967084,218,2949,173,1092
706,15592,1882,3,Business,14,3,25162,14,3,30350,14,3,31305,14,3,32001,14,3,32902,5,18.5,-1.2958783,36.7928125,-1.287781,36.817866,612,901,5188,1651
707,10668,3621,3,Business,8,1,52349,8,1,52393,8,1,52677,8,1,52834,8,1,58399,20,29.7,-1.2836583,36.7886014,-1.230842,36.914967,778,5565,44,441
708,16010,633,3,Business,15,4,52836,15,4,53384,15,4,54773,15,4,55506,15,4,56733,9,27.7,-1.2574219,36.7927073,-1.3004062,36.829741,554,1227,548,2122
709,15000,1551,1,Personal,23,3,29550,23,3,31433,23,3,33618,23,3,35656,23,3,36550,4,16.8,-1.3100636,36.8616816,-1.307726,36.839117,87,894,1883,4223
710,9983,3283,3,Business,29,1,52535,29,1,52557,29,1,52879,29,1,53451,29,1,54635,7,24.5,-1.303596,36.778378,-1.2628473,36.781805,208,1184,22,894
711,19115,2154,3,Business,2,3,41433,2,3,42175,2,3,43384,2,3,43476,2,3,45642,5,24.1,-1.2765736,36.8513646,-1.2885315,36.8230419,134,2166,742,1301
712,23637,2956,3,Business,7,4,60965,7,4,60988,7,4,61449,7,4,61580,7,4,61608,3,25.5,-1.2584143,36.8048002,-1.2551895,36.7822034,250,28,23,592
713,9466,2183,3,Business,6,2,45370,6,2,45425,6,2,46095,6,2,46527,6,2,47872,6,24.9,-1.2551895,36.7822034,-1.2825816,36.8092346,503,1345,55,1102
714,15432,3404,3,Business,22,4,58420,22,4,59979,22,4,60368,22,4,60694,22,4,62942,4,24.4,-1.279395,36.825364,-1.2790653,36.7907262,379,2248,1559,715
715,24526,2301,2,Personal,11,2,55480,11,2,55553,11,2,56285,11,2,56496,11,2,57296,5,25.5,-1.3031315,36.8175661,-1.2855707,36.788852,85,800,73,943
716,19488,2271,3,Business,25,1,41814,25,1,42207,25,1,42706,25,1,43613,25,1,44921,11,25.7,-1.331619,36.847976,-1.293515,36.897607,283,1308,393,1406
717,3742,1280,3,Business,11,1,34212,11,1,34237,11,1,36827,11,1,37100,11,1,37212,3,21.0,-1.2551895,36.7822034,-1.2638132,36.7849775,932,112,25,2863
718,16908,2956,3,Business,5,2,33747,5,2,33757,5,2,34083,5,2,34961,5,2,35927,9,20.8,-1.2571472,36.7950633,-1.273547,36.742313,937,966,10,1204
719,12928,251,1,Personal,26,6,54811,26,6,55044,26,6,55788,26,6,56038,26,6,56954,7,24.1,-1.3041617,36.7627771,-1.3099145,36.8022774,852,916,233,994
720,2,3517,3,Business,18,4,36550,18,4,36590,18,4,36748,18,4,39112,18,4,41035,16,23.25888921888938,-1.300921,36.828195,-1.3882008,36.7699445,148,1923,40,2522
721,3740,1081,3,Business,15,5,53065,15,5,53218,15,5,55540,15,5,55657,15,5,58121,12,28.2,-1.2551895,36.7822034,-1.320157,36.830887,194,2464,153,2439
722,27683,402,3,Business,1,6,51225,1,6,51336,1,6,51683,1,6,52445,1,6,52450,1,26.4,-1.2584143,36.8048002,-1.2527958,36.8003131,819,5,111,1109
723,24047,2801,3,Business,10,3,40823,10,3,40873,10,3,41692,10,3,41762,10,3,44414,20,27.6,-1.2595422,36.7871178,-1.3206433,36.9117533,290,2652,50,889
724,651,3521,3,Business,18,4,53955,18,4,54097,18,4,55145,18,4,55420,18,4,56596,7,23.25888921888938,-1.2597649,36.775631,-1.2696908,36.81519,166,1176,142,1323
725,615,186,3,Business,20,1,62224,20,1,62239,20,1,63681,20,1,63950,20,1,64516,3,23.25888921888938,-1.2571472,36.7950633,-1.2551895,36.7822034,933,566,15,1711
726,1699,3222,3,Business,18,5,52821,18,5,52869,18,5,53481,18,5,54066,18,5,55324,8,26.9,-1.2551895,36.7822034,-1.2922992,36.7983035,801,1258,48,1197
727,10913,1934,2,Personal,28,5,37447,28,5,37493,28,5,37827,28,5,38034,28,5,38904,5,25.1,-1.2871136,36.785507,-1.2726506,36.7960153,232,870,46,541
728,20972,2069,3,Business,9,3,38686,9,3,38698,9,3,38726,9,3,39169,9,3,40916,10,25.2,-1.228911,36.881876,-1.272828,36.816608,178,1747,12,471
729,5848,3621,3,Business,8,6,33078,8,6,33285,8,6,35792,8,6,35928,8,6,38036,16,16.7,-1.2836583,36.7886014,-1.2178791,36.891137,309,2108,207,2643
730,9006,1849,3,Business,19,3,44661,19,3,45013,19,3,45565,19,3,45855,19,3,45864,3,22.2,-1.290894,36.822971,-1.2896431,36.8086201,725,9,352,842
731,11016,1687,3,Business,9,4,51864,9,4,51977,9,4,53005,9,4,53377,9,4,54266,3,25.7,-1.2890333,36.8234839,-1.2675979,36.8155653,882,889,113,1400
732,27101,197,3,Business,13,3,56263,13,3,56376,13,3,56923,13,3,57457,13,3,58766,13,27.2,-1.2664491,36.8102685,-1.3282758,36.8590281,880,1309,113,1081
733,5446,1724,3,Business,31,3,32236,31,3,32254,31,3,32332,31,3,32428,31,3,35973,15,19.2,-1.2551895,36.7822034,-1.3221141,36.8636835,62,3545,18,174
734,5532,2736,2,Personal,21,4,44615,21,4,44678,21,4,47954,21,4,48372,21,4,49226,5,21.8,-1.2741006,36.8240907,-1.2655306,36.828148,906,854,63,3694
735,25922,2763,3,Business,21,2,58595,21,2,58646,21,2,58695,21,2,60058,21,2,60067,4,24.1,-1.2551895,36.7822034,-1.260792,36.796768,651,9,51,1412
736,10389,3222,3,Business,18,2,53913,18,2,54312,18,2,55284,18,2,56655,18,2,60330,13,25.8,-1.2551895,36.7822034,-1.3122286,36.7659612,685,3675,399,2343
737,906,2330,3,Business,6,1,65586,6,1,65617,6,1,65755,6,1,66287,6,1,67410,8,23.25888921888938,-1.3015197,36.7658456,-1.3263903,36.7179885,161,1123,31,670
738,2608,1350,2,Personal,2,3,35747,2,3,35755,2,3,36703,2,3,37397,2,3,38524,9,17.8,-1.3271684,36.8173021,-1.336875,36.754409,196,1127,8,1642
739,16767,2304,1,Personal,22,3,63319,22,3,63327,22,3,63637,22,3,64548,22,3,66974,21,23.0,-1.2918164,36.8773248,-1.3549418,36.7280528,890,2426,8,1221
740,291,552,3,Business,10,1,61052,10,1,62222,10,1,64096,10,1,64688,10,1,66856,23,19.0,-1.3472066,36.7692638,-1.3562374,36.9042954,55,2168,1170,2466
741,12657,3283,3,Business,31,3,46221,31,3,47149,31,3,48760,31,3,49692,31,3,51837,18,26.9,-1.293515,36.897607,-1.2628473,36.781805,715,2145,928,2543
742,25396,2777,3,Business,4,4,58722,4,4,58874,4,4,59841,4,4,60166,4,4,60831,8,26.0,-1.2551895,36.7822034,-1.2944081,36.7897046,279,665,152,1292
743,1922,3403,3,Business,2,2,57895,2,2,58092,2,2,58374,2,2,58996,2,2,60100,7,29.3,-1.2551895,36.7822034,-1.2889751,36.8154048,676,1104,197,904
744,14134,867,3,Business,6,2,48761,6,2,48778,6,2,48998,6,2,49094,6,2,51634,14,27.7,-1.3177547,36.8303703,-1.306378,36.7519845,515,2540,17,316
745,18191,2412,3,Business,10,6,58374,10,6,58381,10,6,60333,10,6,60860,10,6,63087,17,24.5,-1.2297202,36.8819507,-1.159322,36.933658,260,2227,7,2479
746,23427,788,3,Business,10,1,50358,10,1,50629,10,1,51342,10,1,52427,10,1,53943,8,18.6,-1.2571472,36.7950633,-1.225322,36.80855,755,1516,271,1798
747,5835,3560,3,Business,11,6,52081,11,6,52467,11,6,54869,11,6,55441,11,6,56227,2,23.25888921888938,-1.2813012,36.8323962,-1.279395,36.825364,668,786,386,2974
748,27647,2383,3,Business,3,3,30855,3,3,30909,3,3,31345,3,3,31543,3,3,31902,2,18.6,-1.2608993,36.799246,-1.2516391,36.8114886,125,359,54,634
749,6780,3686,3,Business,6,2,36870,6,2,36904,6,2,37314,6,2,37644,6,2,39085,10,19.6,-1.2551895,36.7822034,-1.2365703,36.8054368,770,1441,34,740
750,6717,2330,3,Business,10,3,66740,10,3,66752,10,3,67812,10,3,68300,10,3,71084,18,27.4,-1.2536275,36.7987932,-1.2854537,36.9051024,854,2784,12,1548
751,10020,3686,3,Business,7,5,34508,7,5,34789,7,5,35265,7,5,35638,7,5,37244,4,20.5,-1.2551895,36.7822034,-1.2617028,36.7983849,646,1606,281,849
752,23411,3436,1,Personal,31,5,61041,31,5,61113,31,5,61876,31,5,62249,31,5,65111,7,20.1,-1.2571472,36.7950633,-1.2918148,36.7693264,536,2862,72,1136
753,8335,1271,3,Business,25,3,54487,25,3,57972,25,3,58682,25,3,59145,25,3,60840,14,17.6,-1.3244885,36.897792,-1.293278,36.827789,629,1695,3485,1173
754,24002,1500,3,Business,26,2,58451,26,2,59054,26,2,59066,26,2,59702,26,2,61033,10,28.4,-1.2991441,36.7528804,-1.2638185,36.7930057,881,1331,603,648
755,12189,1209,3,Business,23,2,38594,23,2,38613,23,2,38639,23,2,39200,23,2,40460,12,23.25888921888938,-1.2991441,36.7528804,-1.3004062,36.829741,855,1260,19,587
756,18632,1874,3,Business,30,5,35006,30,5,35041,30,5,36788,30,5,37688,30,5,41518,9,18.8,-1.2938875,36.7774083,-1.2571472,36.7950633,956,3830,35,2647
757,4085,1336,3,Business,29,4,34702,29,4,45447,29,4,47003,29,4,47067,29,4,49788,9,21.6,-1.2891922,36.825189,-1.2551895,36.7822034,660,2721,10745,1620
758,19379,867,3,Business,1,1,41974,1,1,42018,1,1,42022,1,1,44751,1,1,45035,10,23.25888921888938,-1.3004062,36.829741,-1.2991441,36.7528804,137,284,44,2733
759,7897,2454,3,Business,9,2,39890,9,2,43630,9,2,44361,9,2,44953,9,2,46357,12,27.1,-1.3264333,36.71071,-1.2941413,36.7958937,800,1404,3740,1323
760,2102,3222,3,Business,8,5,52380,8,5,52460,8,5,53598,8,5,54142,8,5,54941,8,30.6,-1.2551895,36.7822034,-1.2856664,36.7559838,103,799,80,1682
761,1059,2346,1,Personal,13,3,48501,13,3,48846,13,3,49092,13,3,49198,13,3,50806,7,23.4,-1.3054537,36.8284768,-1.2756364,36.8535485,890,1608,345,352
762,2728,3635,1,Business,17,3,49794,17,3,49831,17,3,50019,17,3,50547,17,3,52532,23,28.6,-1.2615888,36.7928732,-1.1923911,36.9447333,648,1985,37,716
763,12017,1342,3,Business,25,4,39583,25,4,39641,25,4,39655,25,4,41205,25,4,42851,12,20.0,-1.3006353,36.8462857,-1.3025826,36.7670807,191,1646,58,1564
764,458,1402,3,Business,18,3,40889,18,3,41403,18,3,43105,18,3,43874,18,3,45711,11,19.9,-1.225322,36.80855,-1.2891922,36.825189,726,1837,514,2471
765,9964,552,3,Business,25,4,58901,25,4,63469,25,4,64292,25,4,64903,25,4,65888,9,23.25888921888938,-1.3226302,36.8719901,-1.3632162,36.9108253,532,985,4568,1434
766,25310,230,1,Personal,1,3,57546,1,3,57577,1,3,58094,1,3,58222,1,3,60072,9,23.8,-1.2952784,36.7793271,-1.307774,36.8407541,521,1850,31,645
767,11412,3422,3,Business,3,1,57027,3,1,57526,3,1,57614,3,1,58648,3,1,58813,5,23.2,-1.3069855,36.8255528,-1.3276043,36.836922,813,165,499,1122
768,2042,1329,3,Business,12,2,34805,12,2,35016,12,2,35710,12,2,35829,12,2,36949,3,18.2,-1.273056,36.811298,-1.25896,36.8016691,332,1120,211,813
769,3450,552,3,Business,26,2,57858,26,2,57873,26,2,58612,26,2,59863,26,2,62026,17,29.4,-1.290894,36.822971,-1.3632162,36.9108253,583,2163,15,1990
770,24434,1882,3,Business,22,4,28574,22,4,29218,22,4,31318,22,4,32201,22,4,34556,13,19.5,-1.2958783,36.7928125,-1.3175825,36.7004796,762,2355,644,2983
771,14755,1245,3,Business,19,3,45803,19,3,45814,19,3,46140,19,3,46547,19,3,50034,22,22.1,-1.300921,36.828195,-1.300793,36.6871435,674,3487,11,733
772,8665,3420,3,Business,23,2,43483,23,2,43520,23,2,43563,23,2,44050,23,2,44831,6,23.25888921888938,-1.3046007,36.8211743,-1.265981,36.7936121,206,781,37,530
773,3247,2578,1,Personal,5,2,38782,5,2,38828,5,2,39723,5,2,39916,5,2,41912,14,21.5,-1.332175,36.8819641,-1.289235,36.8135805,543,1996,46,1088
774,5261,203,3,Business,28,1,58460,28,1,58470,28,1,58993,28,1,61097,28,1,62583,9,25.4,-1.2580991,36.7941519,-1.2963097,36.7688221,858,1486,10,2627
775,10641,1245,3,Business,22,2,52014,22,2,52056,22,2,52652,22,2,53410,22,2,55998,14,25.7,-1.300921,36.828195,-1.355664,36.743009,551,2588,42,1354
776,2108,1148,3,Business,9,4,45891,9,4,46380,9,4,47135,9,4,48079,9,4,48782,3,23.25888921888938,-1.3104867,36.8495593,-1.311818,36.8638544,591,703,489,1699
777,22515,1637,3,Business,10,1,47593,10,1,47708,10,1,47718,10,1,48622,10,1,53274,15,23.3,-1.2615888,36.7928732,-1.2232123,36.8932547,725,4652,115,914
778,27802,3073,3,Business,7,2,35947,7,2,35968,7,2,36248,7,2,38145,7,2,38631,8,23.0,-1.298529,36.816482,-1.2551895,36.7822034,74,486,21,2177
779,15808,2099,3,Business,26,1,44869,26,1,45036,26,1,45910,26,1,46401,26,1,48173,10,23.1,-1.2326041,36.8009029,-1.2682608,36.7973156,387,1772,167,1365
780,28120,1882,3,Business,13,1,60035,13,1,60053,13,1,60094,13,1,62198,13,1,63210,7,23.25888921888938,-1.2603403,36.7998848,-1.2268871,36.8073946,547,1012,18,2145
781,16579,2579,3,Business,21,3,35270,21,3,35359,21,3,36021,21,3,36438,21,3,37412,6,16.9,-1.2592947,36.7698085,-1.287428,36.7800821,649,974,89,1079
782,26998,2582,3,Business,23,4,57362,23,4,57559,23,4,57789,23,4,61279,23,4,62275,3,23.25888921888938,-1.2603403,36.7998848,-1.2551895,36.7822034,427,996,197,3720
783,6317,498,1,Personal,7,4,61449,7,4,61491,7,4,62502,7,4,62628,7,4,63767,2,17.8,-1.2973052,36.770748,-1.3020514,36.7748298,215,1139,42,1137
784,27300,598,1,Business,18,5,40136,18,5,41210,18,5,42533,18,5,42603,18,5,45413,16,21.2,-1.3178263,36.7141818,-1.2536797,36.7995085,938,2810,1074,1393
785,1044,393,3,Business,18,5,41871,18,5,41880,18,5,42085,18,5,43382,18,5,44140,4,20.3,-1.3167113,36.8301563,-1.3004062,36.829741,188,758,9,1502
786,686,246,3,Business,11,1,58176,11,1,58284,11,1,58350,11,1,59167,11,1,61185,21,23.2,-1.3562374,36.9042954,-1.2584143,36.8048002,541,2018,108,883
787,3959,3222,3,Business,11,5,52027,11,5,52034,11,5,52188,11,5,52570,11,5,55891,34,26.6,-1.2551895,36.7822034,-1.1105305,36.6461267,822,3321,7,536
788,26282,500,1,Personal,18,4,66509,18,4,67701,18,4,69376,18,4,69806,18,4,70886,7,23.4,-1.3124203,36.7860863,-1.270186,36.8022793,612,1080,1192,2105
789,16036,1196,2,Business,7,4,53415,7,4,53680,7,4,55283,7,4,56041,7,4,57710,8,20.1,-1.293278,36.827789,-1.2551895,36.7822034,752,1669,265,2361
790,16598,173,3,Business,13,4,40667,13,4,40767,13,4,41115,13,4,41183,13,4,41658,2,21.9,-1.2993231,36.7753372,-1.2812624,36.7714609,368,475,100,416
791,12843,2162,3,Business,25,4,45930,25,4,46676,25,4,47712,25,4,48504,25,4,49366,8,20.0,-1.2615888,36.7928732,-1.2857671,36.7875614,485,862,746,1828
792,5986,394,3,Personal,18,6,41469,18,6,41560,18,6,43012,18,6,43935,18,6,46275,19,21.3,-1.3175925,36.8742349,-1.2378425,36.7579108,377,2340,91,2375
793,6208,2008,3,Business,10,3,54258,10,3,54279,10,3,55116,10,3,55886,10,3,58368,16,30.6,-1.2508229,36.7895263,-1.3287376,36.7140875,131,2482,21,1607
794,21892,2212,3,Business,20,3,41846,20,3,41859,20,3,42034,20,3,43767,20,3,44338,2,26.4,-1.2571472,36.7950633,-1.2733047,36.8109744,948,571,13,1908
795,22199,1502,3,Business,4,1,57179,4,1,57226,4,1,57425,4,1,58516,4,1,60359,11,23.25888921888938,-1.2765736,36.8513646,-1.2232123,36.8932547,206,1843,47,1290
796,5143,1280,3,Business,11,4,26639,11,4,26711,11,4,28749,11,4,28977,11,4,30923,8,18.7,-1.2551895,36.7822034,-1.297451,36.803117,761,1946,72,2266
797,4926,2330,3,Business,29,3,49885,29,3,49992,29,3,50225,29,3,51855,29,3,53944,14,20.9,-1.285908,36.8980126,-1.2671943,36.8062533,272,2089,107,1863
798,2538,3295,3,Business,16,2,44141,16,2,44240,16,2,45125,16,2,45339,16,2,46964,12,23.25888921888938,-1.2571472,36.7950633,-1.2409346,36.8743053,660,1625,99,1099
799,22223,633,3,Business,16,6,39338,16,6,39410,16,6,39823,16,6,39931,16,6,40456,4,25.9,-1.3077869,36.8443207,-1.3004062,36.829741,778,525,72,521
800,1169,393,3,Business,15,5,31241,15,5,31254,15,5,31259,15,5,31928,15,5,33452,14,20.3,-1.3167113,36.8301563,-1.306378,36.7519845,111,1524,13,674
801,7419,2982,3,Business,12,6,42292,12,6,42305,12,6,42471,12,6,44626,12,6,47801,32,23.25888921888938,-1.300921,36.828195,-1.1462239,36.74854,26,3175,13,2321
802,7808,3080,3,Business,11,1,49192,11,1,49254,11,1,49423,11,1,49902,11,1,52186,22,29.1,-1.2551895,36.7822034,-1.3342256,36.9106741,634,2284,62,648
803,5414,1146,3,Business,18,4,57797,18,4,58008,18,4,58230,18,4,59305,18,4,63598,7,23.25888921888938,-1.3167113,36.8301563,-1.3083266,36.8494756,506,4293,211,1297
804,26508,2869,3,Business,10,5,60936,10,5,61119,10,5,61559,10,5,61868,10,5,64685,3,23.25888921888938,-1.3025826,36.7670807,-1.2763494,36.7671783,211,2817,183,749
805,6882,517,3,Business,29,2,34872,29,2,34899,29,2,34907,29,2,35523,29,2,36760,12,18.1,-1.3167113,36.8301563,-1.2551895,36.7822034,188,1237,27,624
806,21134,3557,3,Business,15,1,56569,15,1,56807,15,1,57646,15,1,58282,15,1,60077,8,23.25888921888938,-1.3047132,36.8089553,-1.2546732,36.8086796,177,1795,238,1475
807,5679,635,3,Business,23,5,50159,23,5,50581,23,5,51019,23,5,52377,23,5,53465,8,26.5,-1.3016417,36.8271679,-1.2599563,36.7993439,237,1088,422,1796
808,24935,1335,3,Personal,14,4,60259,14,4,60268,14,4,61162,14,4,61339,14,4,63394,5,21.0,-1.2611987,36.8060913,-1.2536855,36.8245276,804,2055,9,1071
809,691,868,3,Business,15,1,43888,15,1,43993,15,1,46443,15,1,46901,15,1,47272,3,23.25888921888938,-1.2783849,36.8163445,-1.265715,36.823815,341,371,105,2908
810,1298,393,3,Business,10,5,59954,10,5,60073,10,5,60606,10,5,60691,10,5,62976,3,23.25888921888938,-1.3167113,36.8301563,-1.3210541,36.8169608,910,2285,119,618
811,6538,186,3,Business,20,3,58568,20,3,58665,20,3,59891,20,3,60783,20,3,60792,6,28.0,-1.2571472,36.7950633,-1.2913246,36.8019522,205,9,97,2118
812,5040,3674,3,Business,5,2,42731,5,2,42745,5,2,43058,5,2,43626,5,2,44804,5,25.7,-1.2551895,36.7822034,-1.2753902,36.808223,831,1178,14,881
813,649,2801,3,Business,1,4,58453,1,4,58527,1,4,59391,1,4,59822,1,4,64234,9,23.25888921888938,-1.2595422,36.7871178,-1.3021707,36.8168444,684,4412,74,1295
814,285,103,3,Business,27,6,31053,27,6,31075,27,6,31845,27,6,32143,27,6,34191,19,23.25888921888938,-1.2844665,36.7866113,-1.3205566,36.9141678,228,2048,22,1068
815,27725,2330,3,Business,3,1,40524,3,1,40565,3,1,40888,3,1,41140,3,1,42415,9,21.7,-1.2536275,36.7987932,-1.2687407,36.7373043,161,1275,41,575
816,3000,1059,1,Personal,4,4,39687,4,4,39700,4,4,40610,4,4,40793,4,4,42746,14,23.25888921888938,-1.3303649,36.7260187,-1.2724885,36.7856999,844,1953,13,1093
817,5637,3404,3,Business,15,5,51831,15,5,51904,15,5,53655,15,5,54391,15,5,56276,6,28.0,-1.2551895,36.7822034,-1.279395,36.825364,268,1885,73,2487
818,6591,867,3,Business,18,2,54241,18,2,54656,18,2,56040,18,2,57286,18,2,58674,10,25.6,-1.2996533,36.8292629,-1.2991441,36.7528804,62,1388,415,2630
819,8097,2956,3,Business,23,4,48261,23,4,48489,23,4,48620,23,4,49438,23,4,50709,2,24.7,-1.2527958,36.8003131,-1.2584143,36.8048002,547,1271,228,949
820,10449,2718,3,Business,1,4,56998,1,4,57121,1,4,59188,1,4,59573,1,4,59583,2,23.25888921888938,-1.2668815,36.8017244,-1.2657456,36.8087424,726,10,123,2452
821,17413,496,3,Business,9,4,53794,9,4,54047,9,4,54649,9,4,55014,9,4,56470,4,23.25888921888938,-1.2551895,36.7822034,-1.2649114,36.8134191,427,1456,253,967
822,14441,627,3,Business,26,2,42616,26,2,42688,26,2,44937,26,2,45850,26,2,49240,18,26.1,-1.2571472,36.7950633,-1.3339943,36.7263409,172,3390,72,3162
823,2666,2066,3,Business,7,2,53201,7,2,53249,7,2,53536,7,2,53706,7,2,54256,5,24.6,-1.316961,36.820337,-1.3012173,36.8093987,726,550,48,457
824,27294,1792,3,Business,7,4,37242,7,4,37444,7,4,38611,7,4,39946,7,4,42045,18,16.9,-1.3610501,36.7520889,-1.288159,36.7925275,379,2099,202,2502
825,11530,1329,3,Business,9,5,63582,9,5,63765,9,5,64489,9,5,65097,9,5,65525,2,25.1,-1.273056,36.811298,-1.2721028,36.7953485,427,428,183,1332
826,13308,1500,3,Business,16,4,34221,16,4,34281,16,4,34297,16,4,36268,16,4,36360,6,23.25888921888938,-1.2770708,36.8231093,-1.2638185,36.7930057,41,92,60,1987
827,15857,393,3,Business,13,4,57664,13,4,57674,13,4,57733,13,4,58723,13,4,58725,4,23.0,-1.3228003,36.8306435,-1.3004062,36.829741,863,2,10,1049
828,25232,1533,2,Business,8,1,37613,8,1,37658,8,1,39309,8,1,39496,8,1,41438,12,24.7,-1.2152204,36.8563184,-1.293278,36.827789,532,1942,45,1838
829,18847,1329,3,Business,22,4,38260,22,4,38286,22,4,38763,22,4,39247,22,4,40935,18,22.4,-1.273056,36.811298,-1.3242283,36.701819,74,1688,26,961
830,16128,2112,3,Business,7,4,45497,7,4,45569,7,4,46429,7,4,48950,7,4,50095,15,31.0,-1.2615888,36.7928732,-1.2156006,36.8916865,501,1145,72,3381
831,20642,2183,3,Business,10,4,48328,10,4,48360,10,4,48612,10,4,49280,10,4,51267,16,21.7,-1.255956,36.789867,-1.3463042,36.768164,742,1987,32,920
832,27946,1637,3,Business,26,5,51395,26,5,51443,26,5,51819,26,5,52269,26,5,54132,8,23.25888921888938,-1.3014461,36.7661381,-1.2615888,36.7928732,268,1863,48,826
833,27380,1346,3,Business,6,3,57816,6,3,57872,6,3,58089,6,3,58536,6,3,59138,2,23.25888921888938,-1.2917868,36.7872675,-1.2985749,36.8088,564,602,56,664
834,400,1984,2,Business,24,1,43840,24,1,43857,24,1,44004,24,1,44132,24,1,45146,9,22.5,-1.2758945,36.7648661,-1.2456412,36.7955298,449,1014,17,275
835,25759,346,3,Business,2,2,57175,2,2,57529,2,2,58212,2,2,60155,2,2,60479,9,28.4,-1.28878,36.8168312,-1.2393878,36.8690478,910,324,354,2626
836,15772,1724,3,Business,27,1,55752,27,1,56022,27,1,56234,27,1,57352,27,1,59095,8,23.1,-1.2920721,36.831188,-1.2551895,36.7822034,89,1743,270,1330
837,10491,3621,3,Business,21,4,28451,21,4,28484,21,4,30402,21,4,30783,21,4,32027,11,21.6,-1.2836583,36.7886014,-1.322999,36.7832633,829,1244,33,2299
838,22309,1205,3,Business,20,2,50870,20,2,51089,20,2,52123,20,2,53209,20,2,54198,7,24.1,-1.257309,36.8060084,-1.2958383,36.8073162,829,989,219,2120
839,15572,3080,3,Business,15,4,54426,15,4,54533,15,4,55785,15,4,55997,15,4,58074,15,27.4,-1.2551895,36.7822034,-1.1992502,36.8294932,607,2077,107,1464
840,9044,393,3,Business,26,2,30816,26,2,31071,26,2,31692,26,2,32898,26,2,34676,11,23.25888921888938,-1.3167113,36.8301563,-1.2638185,36.7930057,329,1778,255,1827
841,21976,814,3,Business,26,5,58810,26,5,59029,26,5,59434,26,5,60286,26,5,61157,4,23.25888921888938,-1.2564152,36.7792803,-1.2551895,36.7822034,326,871,219,1257
842,15239,419,3,Business,11,1,39071,11,1,39609,11,1,40301,11,1,40520,11,1,41607,9,24.1,-1.2571472,36.7950633,-1.2326041,36.8009029,576,1087,538,911
843,14961,1469,3,Business,12,5,57905,12,5,57922,12,5,58074,12,5,58989,12,5,60488,14,23.25888921888938,-1.2551895,36.7822034,-1.3263105,36.8622904,695,1499,17,1067
844,1014,2030,3,Business,29,2,47662,29,2,48761,29,2,48870,29,2,50908,29,2,51653,6,27.1,-1.2365885,36.8898127,-1.2156006,36.8916865,75,745,1099,2147
845,1542,868,3,Business,19,2,48798,19,2,48850,19,2,49443,19,2,50032,19,2,50037,3,29.9,-1.2783849,36.8163445,-1.265715,36.823815,124,5,52,1182
846,4027,393,3,Business,24,4,31367,24,4,33884,24,4,34882,24,4,37142,24,4,37145,11,19.3,-1.3167113,36.8301563,-1.2574219,36.7927073,515,3,2517,3258
847,6782,3115,3,Business,19,3,56744,19,3,56885,19,3,56998,19,3,57126,19,3,57450,3,24.2,-1.2765492,36.7669809,-1.2949439,36.7604214,723,324,141,241
848,21609,3635,1,Business,7,5,38100,7,5,39134,7,5,39984,7,5,40797,7,5,42766,14,25.3,-1.2615888,36.7928732,-1.2297202,36.8819507,802,1969,1034,1663
849,10046,2767,3,Business,23,5,58144,23,5,59437,23,5,60267,23,5,60885,23,5,62543,8,24.6,-1.257773,36.795486,-1.233018,36.8004477,445,1658,1293,1448
850,28138,2174,3,Business,28,3,41246,28,3,41251,28,3,41409,28,3,42304,28,3,46180,23,23.25888921888938,-1.2482781,36.884092,-1.3446058,36.7605178,946,3876,5,1053
851,8467,909,3,Business,28,1,49774,28,1,49801,28,1,50690,28,1,50844,28,1,51832,8,26.4,-1.269161,36.8416264,-1.225322,36.80855,627,988,27,1043
852,27118,1753,2,Business,20,4,48102,20,4,48120,20,4,48753,20,4,52998,20,4,54309,4,28.2,-1.2710687,36.8142839,-1.2551895,36.7822034,467,1311,18,4878
853,5974,163,1,Personal,20,3,33562,20,3,33626,20,3,35041,20,3,35731,20,3,38345,21,16.6,-1.2107924,36.8030709,-1.296797,36.7764525,31,2614,64,2105
854,25717,208,3,Personal,22,5,52741,22,5,53025,22,5,54699,22,5,54951,22,5,57016,11,27.5,-1.2583017,36.8023526,-1.3108386,36.7555239,25,2065,284,1926
855,6514,3560,3,Business,15,5,39793,15,5,40179,15,5,40438,15,5,40827,15,5,42913,4,25.8,-1.279395,36.825364,-1.2658424,36.8101804,698,2086,386,648
856,2827,765,3,Business,16,2,39712,16,2,41511,16,2,42984,16,2,43525,16,2,46793,27,23.25888921888938,-1.1648303,36.951368,-1.2643174,36.7794769,8,3268,1799,2014
857,16174,1551,1,Personal,21,5,43630,21,5,43657,21,5,43808,21,5,46023,21,5,46623,8,20.2,-1.3099295,36.8436807,-1.3349663,36.8580085,179,600,27,2366
858,25044,2900,3,Business,19,2,33090,19,2,33207,19,2,34397,19,2,34760,19,2,36676,16,23.25888921888938,-1.2963097,36.7688221,-1.3189252,36.8617269,545,1916,117,1553
859,10929,1075,3,Business,18,1,41762,18,1,42048,18,1,42705,18,1,46979,18,1,48455,8,26.7,-1.2765736,36.8513646,-1.2527958,36.8003131,686,1476,286,4931
860,12358,435,3,Business,15,3,55070,15,3,58267,15,3,61125,15,3,61356,15,3,63808,22,25.2,-1.326545,36.667483,-1.300921,36.828195,831,2452,3197,3089
861,11442,2154,3,Business,7,4,39822,7,4,39878,7,4,40666,7,4,41623,7,4,42413,4,27.5,-1.3083777,36.8590077,-1.2765736,36.8513646,697,790,56,1745
862,21754,3147,3,Business,11,1,30913,11,1,30928,11,1,31320,11,1,31466,11,1,34112,17,20.9,-1.3472066,36.7692638,-1.2571472,36.7950633,490,2646,15,538
863,8831,3628,1,Personal,9,6,60653,9,6,60709,9,6,61131,9,6,61472,9,6,63298,15,18.9,-1.3009097,36.7641094,-1.2312682,36.7524906,74,1826,56,763
864,2684,2801,3,Business,3,1,49098,3,1,49265,3,1,49894,3,1,50093,3,1,51327,7,23.4,-1.2674274,36.7870827,-1.281577,36.7938293,162,1234,167,828
865,72,3206,1,Personal,7,6,37645,7,6,37669,7,6,39020,7,6,39153,7,6,42543,14,19.2,-1.2962888,36.8892359,-1.3136452,36.7974014,423,3390,24,1484
866,26033,2956,3,Business,14,2,46060,14,2,46109,14,2,49251,14,2,49840,14,2,50525,6,23.25888921888938,-1.279395,36.825364,-1.2584143,36.8048002,448,685,49,3731
867,10223,239,1,Personal,17,1,57235,17,1,57250,17,1,58024,17,1,59000,17,1,61783,10,28.3,-1.32571,36.805533,-1.2677753,36.7998955,612,2783,15,1750
868,1378,1578,3,Business,10,1,37551,10,1,38460,10,1,39617,10,1,39842,10,1,40735,6,23.7,-1.2551895,36.7822034,-1.28878,36.8168312,876,893,909,1382
869,19783,3147,3,Business,14,5,48918,14,5,49742,14,5,51211,14,5,51423,14,5,52864,11,23.8,-1.3472066,36.7692638,-1.295162,36.8115914,184,1441,824,1681
870,25472,2000,3,Business,11,1,46167,11,1,46180,11,1,46202,11,1,46320,11,1,46331,3,23.9,-1.2551895,36.7822034,-1.2562797,36.8075858,108,11,13,140
871,14459,136,3,Business,18,4,41742,18,4,41748,18,4,42527,18,4,44505,18,4,46821,28,25.6,-1.3094447,36.9107706,-1.3326173,36.7146233,207,2316,6,2757
872,16610,3149,3,Business,17,1,55398,17,1,56657,17,1,58755,17,1,59572,17,1,60487,6,22.6,-1.3004062,36.829741,-1.3228003,36.8306435,581,915,1259,2915
873,10995,142,3,Business,17,3,46908,17,3,46931,17,3,48450,17,3,48698,17,3,49840,8,23.25888921888938,-1.2963097,36.7688221,-1.2570328,36.7869744,68,1142,23,1767
874,24163,136,3,Business,25,4,48482,25,4,48570,25,4,49639,25,4,49728,25,4,51960,15,20.8,-1.3326173,36.7146233,-1.2560874,36.7931031,750,2232,88,1158
875,9293,533,3,Business,4,1,48533,4,1,49803,4,1,50914,4,1,51222,4,1,53414,8,23.25888921888938,-1.2765492,36.7669809,-1.2869955,36.8202749,41,2192,1270,1419
876,14780,868,3,Business,9,2,57280,9,2,57297,9,2,57733,9,2,58641,9,2,63991,7,30.5,-1.2628473,36.781805,-1.303596,36.778378,161,5350,17,1344
877,22331,82,1,Personal,9,2,34599,9,2,35685,9,2,36219,9,2,36988,9,2,39757,13,17.5,-1.2449604,36.7965155,-1.2802794,36.8653906,882,2769,1086,1303
878,1713,868,3,Business,5,5,42148,5,5,42166,5,5,42755,5,5,43064,5,5,44007,7,24.6,-1.2628473,36.781805,-1.265715,36.823815,598,943,18,898
879,20791,3355,3,Business,8,5,47603,8,5,47611,8,5,48178,8,5,49368,8,5,50713,17,27.0,-1.2859912,36.8756811,-1.2551895,36.7822034,839,1345,8,1757
880,17779,2532,3,Business,10,5,50086,10,5,51101,10,5,52322,10,5,54057,10,5,56237,11,23.25888921888938,-1.3352545,36.8659639,-1.2854406,36.789409,567,2180,1015,2956
881,2845,1469,3,Business,11,5,53141,11,5,53196,11,5,55108,11,5,55242,11,5,59738,6,22.5,-1.2579304,36.8019667,-1.2924639,36.7795798,290,4496,55,2046
882,4290,246,3,Business,13,4,39001,13,4,51026,13,4,52206,13,4,52404,13,4,53461,4,22.6,-1.2584143,36.8048002,-1.2821422,36.8161565,928,1057,12025,1378
883,1448,567,3,Business,14,2,34285,14,2,34321,14,2,34772,14,2,35159,14,2,36386,8,23.25888921888938,-1.2766906,36.8202151,-1.2963097,36.7688221,462,1227,36,838
884,25583,2956,3,Business,22,5,55529,22,5,55676,22,5,55884,22,5,56282,22,5,56750,3,31.0,-1.2584143,36.8048002,-1.2551895,36.7822034,607,468,147,606
885,1718,1882,3,Business,14,1,46522,14,1,46650,14,1,46875,14,1,47487,14,1,48720,5,23.7,-1.2588775,36.8079744,-1.287781,36.817866,903,1233,128,837
886,3270,3404,3,Business,22,6,43132,22,6,43150,22,6,43296,22,6,43589,22,6,44504,5,21.2,-1.2591019,36.800577,-1.2793686,36.8259233,933,915,18,439
887,164,3688,3,Business,19,3,44299,19,3,44364,19,3,44870,19,3,45070,19,3,45953,4,22.1,-1.2551895,36.7822034,-1.2622869,36.8172251,50,883,65,706
888,12887,3017,3,Business,9,3,53795,9,3,53814,9,3,54079,9,3,54472,9,3,55708,2,23.1,-1.2915271,36.782702,-1.2963097,36.7688221,663,1236,19,658
889,24268,393,3,Business,2,4,51208,2,4,55568,2,4,56378,2,4,58180,2,4,58197,8,26.4,-1.3177547,36.8303703,-1.2770708,36.8231093,606,17,4360,2612
890,25639,2436,3,Business,11,1,50540,11,1,50657,11,1,51245,11,1,51881,11,1,53305,13,28.9,-1.2571472,36.7950633,-1.2343236,36.8861,25,1424,117,1224
891,18726,3686,3,Business,14,3,43888,14,3,43944,14,3,44875,14,3,45209,14,3,46036,6,24.5,-1.2551895,36.7822034,-1.269974,36.7753728,228,827,56,1265
892,11923,2523,3,Business,25,1,42110,25,1,42150,25,1,42953,25,1,43410,25,1,43747,3,27.0,-1.2551895,36.7822034,-1.273488,36.804158,607,337,40,1260
893,23495,2532,3,Business,17,5,46088,17,5,46114,17,5,46676,17,5,46924,17,5,47753,8,23.25888921888938,-1.2551895,36.7822034,-1.2824911,36.8218042,953,829,26,810
894,27375,1209,3,Business,8,3,40929,8,3,41022,8,3,41217,8,3,42353,8,3,43203,8,23.25888921888938,-1.3004062,36.829741,-1.2638185,36.7930057,411,850,93,1331
895,10667,517,3,Business,2,3,49164,2,3,49171,2,3,49452,2,3,49663,2,3,51287,14,25.8,-1.3167113,36.8301563,-1.306378,36.7519845,523,1624,7,492
896,242,1443,1,Personal,27,3,34636,27,3,34857,27,3,35972,27,3,36724,27,3,39499,6,23.25888921888938,-1.3154433,36.806386,-1.2962832,36.7849683,846,2775,221,1867
897,25653,3283,3,Business,19,2,44410,19,2,45547,19,2,46306,19,2,47023,19,2,47927,6,26.7,-1.272828,36.816608,-1.2628473,36.781805,75,904,1137,1476
898,24582,868,3,Business,20,4,39066,20,4,39072,20,4,39295,20,4,40622,20,4,42065,10,22.2,-1.228911,36.881876,-1.265715,36.823815,685,1443,6,1550
899,23969,305,1,Personal,8,1,27339,8,1,27594,8,1,28301,8,1,28526,8,1,29576,9,19.6,-1.2591019,36.800577,-1.2994194,36.7647917,875,1050,255,932
900,13103,2982,3,Business,3,3,57594,3,3,57691,3,3,58167,3,3,59225,3,3,61621,18,28.3,-1.300921,36.828195,-1.177202,36.8351183,235,2396,97,1534
901,19526,393,3,Business,20,3,55716,20,3,55727,20,3,55752,20,3,56921,20,3,58478,14,29.2,-1.3167113,36.8301563,-1.2991441,36.7528804,15,1557,11,1194
902,16433,1062,3,Business,17,5,70982,17,5,71077,17,5,72264,17,5,72622,17,5,75014,14,23.25888921888938,-1.238874,36.807889,-1.2577289,36.7410772,517,2392,95,1545
903,22575,393,3,Business,26,2,57262,26,2,57271,26,2,57282,26,2,60536,26,2,60538,14,28.6,-1.3167113,36.8301563,-1.306378,36.7519845,39,2,9,3265
904,2880,3448,1,Personal,19,5,54616,19,5,55077,19,5,56657,19,5,57014,19,5,59419,19,27.2,-1.28621,36.825633,-1.374639,36.9253261,612,2405,461,1937
905,10997,3505,2,Personal,15,3,51856,15,3,51865,15,3,52171,15,3,53043,15,3,54177,7,21.5,-1.3004846,36.7901591,-1.2682478,36.8072852,213,1134,9,1178
906,15931,684,3,Personal,15,5,63383,15,5,63457,15,5,63905,15,5,64289,15,5,65347,8,27.8,-1.265715,36.808525,-1.3086326,36.8080886,383,1058,74,832
907,13925,1935,1,Personal,24,2,43383,24,2,43435,24,2,44045,24,2,44478,24,2,45746,10,17.2,-1.2576857,36.7799199,-1.2892697,36.8154514,379,1268,52,1043
908,16111,1005,1,Personal,23,3,33417,23,3,34793,23,3,35485,23,3,36634,23,3,38250,8,16.6,-1.298437,36.781971,-1.2763916,36.8246826,116,1616,1376,1841
909,14253,3768,1,Personal,11,5,35832,11,5,35862,11,5,36751,11,5,37106,11,5,40335,27,18.0,-1.2877907,36.830065,-1.3611971,36.6538278,159,3229,30,1244
910,12920,2801,3,Business,12,3,34092,12,3,34108,12,3,34657,12,3,35373,12,3,36078,9,23.25888921888938,-1.2958024,36.7622504,-1.2674274,36.7870827,161,705,16,1265
911,13356,645,1,Personal,14,4,53936,14,4,54148,14,4,54845,14,4,55755,14,4,58121,11,21.6,-1.2655306,36.828148,-1.3275191,36.7992817,322,2366,212,1607
912,24227,738,3,Business,19,5,29581,19,5,29708,19,5,32149,19,5,32317,19,5,33673,9,20.3,-1.288148,36.7850276,-1.2673094,36.7241334,328,1356,127,2609
913,17374,113,3,Business,9,4,46943,9,4,47084,9,4,48254,9,4,49246,9,4,51130,8,25.6,-1.2781187,36.8284492,-1.3039411,36.7695316,329,1884,141,2162
914,26447,246,3,Business,12,1,46855,12,1,46883,12,1,47009,12,1,47343,12,1,47498,1,23.9,-1.2584143,36.8048002,-1.2597529,36.806629,875,155,28,460
915,13157,104,3,Personal,24,1,40516,24,1,40762,24,1,43374,24,1,43451,24,1,44219,5,22.6,-1.2823747,36.8258855,-1.2804891,36.7865102,143,768,246,2689
916,26203,2069,3,Business,20,3,45122,20,3,45132,20,3,45142,20,3,47980,20,3,47981,17,26.4,-1.331619,36.847976,-1.228911,36.881876,406,1,10,2848
917,11213,867,3,Business,22,4,31865,22,4,32954,22,4,32987,22,4,34277,22,4,35630,10,19.5,-1.2996533,36.8292629,-1.306378,36.7519845,663,1353,1089,1323
918,11888,1124,1,Business,31,5,62605,31,5,62677,31,5,65063,31,5,65403,31,5,68488,12,19.9,-1.2871085,36.8303905,-1.2812601,36.7340272,465,3085,72,2726
919,4001,3291,3,Business,9,6,48763,9,6,48798,9,6,48845,9,6,49502,9,6,49999,5,30.0,-1.2628473,36.781805,-1.2600926,36.8088685,720,497,35,704
920,8025,27,1,Personal,19,4,35202,19,4,35309,19,4,36066,19,4,36495,19,4,37741,7,14.7,-1.2569714,36.7799637,-1.2558953,36.7339105,752,1246,107,1186
921,21234,2443,1,Personal,9,4,70736,9,4,70844,9,4,72160,9,4,72531,9,4,74669,9,18.9,-1.261114,36.806388,-1.3014461,36.7661381,213,2138,108,1687
922,20889,1051,3,Business,20,4,43137,20,4,43250,20,4,43806,20,4,43997,20,4,47081,30,22.4,-1.2963097,36.7688221,-1.1538233,36.950874,548,3084,113,747
923,18139,1882,1,Business,7,2,66630,7,2,66659,7,2,67139,7,2,67485,7,2,67855,1,23.1,-1.2591019,36.800577,-1.2536042,36.8064895,116,370,29,826
924,3564,2423,3,Business,30,2,38521,30,2,38906,30,2,39624,30,2,40257,30,2,41333,7,23.25888921888938,-1.2551895,36.7822034,-1.2824744,36.804724,245,1076,385,1351
925,11553,3300,3,Business,21,2,35904,21,2,35940,21,2,37327,21,2,37647,21,2,38961,8,23.25888921888938,-1.2663631,36.8163329,-1.303596,36.778378,624,1314,36,1707
926,10205,1179,3,Business,10,1,54141,10,1,55837,10,1,58816,10,1,59837,10,1,61946,21,18.8,-1.3700383,36.9190174,-1.2917868,36.7872675,647,2109,1696,4000
927,20421,1318,1,Personal,4,4,44085,4,4,44126,4,4,44403,4,4,44813,4,4,46405,11,23.25888921888938,-1.27871,36.819573,-1.319496,36.872668,865,1592,41,687
928,24242,2330,3,Business,27,3,54934,27,3,54951,27,3,55058,27,3,55738,27,3,56477,4,28.9,-1.2915247,36.8055757,-1.2873232,36.7658572,89,739,17,787
929,18497,3352,1,Personal,27,5,30657,27,5,30681,27,5,31593,27,5,31844,27,5,32987,10,16.1,-1.2981962,36.762348,-1.3127304,36.8189817,449,1143,24,1163
930,17159,265,3,Business,2,5,48127,2,5,48446,2,5,49085,2,5,50336,2,5,51922,13,25.2,-1.2311903,36.8102105,-1.300921,36.828195,101,1586,319,1890
931,13226,1205,3,Business,5,2,35760,5,2,40960,5,2,41534,5,2,41605,5,2,41838,4,21.7,-1.2588727,36.7761615,-1.2597482,36.7915646,215,233,5200,645
932,4324,2994,1,Personal,24,5,65197,24,5,65267,24,5,66166,24,5,66522,24,5,68148,9,23.25888921888938,-1.268027,36.8037005,-1.2610895,36.7251023,131,1626,70,1255
933,8427,964,1,Personal,2,1,39639,2,1,39780,2,1,42311,2,1,42618,2,1,44711,10,19.3,-1.26559,36.8027,-1.3205507,36.8426247,951,2093,141,2838
934,18425,3426,3,Business,4,1,53296,4,1,53356,4,1,53564,4,1,54484,4,1,59539,9,28.5,-1.2584143,36.8048002,-1.3012008,36.764868,275,5055,60,1128
935,11043,3629,3,Personal,28,4,35570,28,4,35621,28,4,37278,28,4,37447,28,4,38996,6,19.5,-1.2852951,36.8133853,-1.282937,36.7816984,245,1549,51,1826
936,12517,302,3,Business,26,5,53208,26,5,53740,26,5,54218,26,5,54617,26,5,55921,8,23.25888921888938,-1.2649605,36.7981777,-1.307376,36.813404,662,1304,532,877
937,23762,190,3,Business,22,3,59210,22,3,59210,22,3,59228,22,3,59861,22,3,59864,6,24.0,-1.3275885,36.8621552,-1.3270347,36.8667362,242,3,0,651
938,18320,3420,3,Business,6,2,41040,6,2,42416,6,2,42666,6,2,43330,6,2,45222,6,25.2,-1.3046007,36.8211743,-1.265981,36.7936121,774,1892,1376,914
939,9876,3283,3,Business,28,5,42954,28,5,43027,28,5,43193,28,5,43742,28,5,46271,18,23.8,-1.2628473,36.781805,-1.2967066,36.8860737,770,2529,73,715
940,13232,53,3,Business,17,4,54442,17,4,54540,17,4,55266,17,4,57039,17,4,59004,5,27.8,-1.3004062,36.829741,-1.2770708,36.8231093,725,1965,98,2499
941,21311,2174,3,Business,2,2,57693,2,2,57748,2,2,57770,2,2,57928,2,2,59135,15,29.3,-1.214071,36.7985052,-1.2482781,36.884092,86,1207,55,180
942,4030,393,3,Business,1,1,26991,1,1,29586,1,1,29671,1,1,32776,1,1,33455,4,18.4,-1.3177547,36.8303703,-1.3004062,36.829741,87,679,2595,3190
943,2309,20,3,Business,6,4,56425,6,4,56683,6,4,57880,6,4,58290,6,4,59661,12,23.25888921888938,-1.3125593,36.8430941,-1.2629666,36.8068369,205,1371,258,1607
944,15669,393,3,Business,1,4,30254,1,4,30372,1,4,31902,1,4,32433,1,4,35593,14,23.25888921888938,-1.3177547,36.8303703,-1.306378,36.7519845,208,3160,118,2061
945,12254,2801,3,Business,21,1,41971,21,1,42008,21,1,43242,21,1,44944,21,1,46773,8,25.3,-1.3024794,36.8228284,-1.2595422,36.7871178,899,1829,37,2936
946,7398,733,3,Business,7,4,44452,7,4,44532,7,4,45089,7,4,45320,7,4,48465,21,27.7,-1.2551895,36.7822034,-1.3407764,36.9100521,660,3145,80,788
947,20175,393,3,Business,19,2,35190,19,2,35486,19,2,35963,19,2,37211,19,2,37566,8,23.25888921888938,-1.3167113,36.8301563,-1.2770708,36.8231093,26,355,296,1725
948,16295,635,3,Business,4,2,46928,4,2,47499,4,2,49911,4,2,50566,4,2,52820,17,22.4,-1.177202,36.8351183,-1.2602337,36.7990548,740,2254,571,3067
949,26435,755,1,Personal,6,1,54777,6,1,55174,6,1,56612,6,1,57471,6,1,58242,4,24.6,-1.282357,36.782501,-1.2892762,36.764129,770,771,397,2297
950,27968,3147,3,Business,5,2,38191,5,2,38204,5,2,38614,5,2,39422,5,2,42060,21,23.8,-1.2326041,36.8009029,-1.3472066,36.7692638,72,2638,13,1218
951,16393,540,3,Business,17,1,45395,17,1,45491,17,1,46004,17,1,46309,17,1,47142,3,23.7,-1.2551895,36.7822034,-1.2636814,36.8029965,353,833,96,818
952,13841,393,3,Business,7,5,36489,7,5,36521,7,5,37218,7,5,38391,7,5,38425,4,23.25888921888938,-1.3228003,36.8306435,-1.3004062,36.829741,740,34,32,1870
953,4690,2423,3,Business,30,2,38623,30,2,39230,30,2,39641,30,2,40020,30,2,42044,8,23.25888921888938,-1.2551895,36.7822034,-1.3012173,36.8093987,564,2024,607,790
954,27140,2752,2,Personal,22,3,58158,22,3,58348,22,3,59285,22,3,59614,22,3,61119,9,23.0,-1.2876324,36.8186574,-1.2323371,36.864817,148,1505,190,1266
955,17692,517,3,Business,8,2,31852,8,2,31870,8,2,32129,8,2,32525,8,2,34314,14,19.0,-1.3167113,36.8301563,-1.306378,36.7519845,523,1789,18,655
956,24338,3326,3,Business,20,1,48474,20,1,48487,20,1,48797,20,1,50077,20,1,50081,5,23.25888921888938,-1.2551895,36.7822034,-1.2738933,36.8016678,931,4,13,1590
957,7962,1399,3,Personal,26,4,50880,26,4,50964,26,4,51179,26,4,51685,26,4,51985,1,22.1,-1.2985032,36.7821448,-1.3043649,36.7816132,101,300,84,721
958,14167,393,3,Business,31,4,43664,31,4,43691,31,4,43698,31,4,44341,31,4,46242,14,26.3,-1.3167113,36.8301563,-1.306378,36.7519845,518,1901,27,650
959,4067,2465,1,Personal,2,2,35486,2,2,35575,2,2,37416,2,2,37777,2,2,38583,6,15.0,-1.3398265,36.7399824,-1.3234611,36.7270436,412,806,89,2202
960,27663,2330,3,Business,20,1,66020,20,1,66052,20,1,66483,20,1,67097,20,1,68842,10,23.25888921888938,-1.2536275,36.7987932,-1.3015197,36.7658456,155,1745,32,1045
961,9353,2021,3,Business,19,2,56385,19,2,56444,19,2,57065,19,2,57461,19,2,60372,13,29.3,-1.29475,36.83421,-1.3287857,36.9042514,181,2911,59,1017
962,25814,186,3,Business,26,2,54987,26,2,59221,26,2,60252,26,2,60514,26,2,63680,23,28.5,-1.3700383,36.9190174,-1.2571472,36.7950633,519,3166,4234,1293
963,25481,3283,3,Business,13,3,42390,13,3,45091,13,3,46071,13,3,46479,13,3,47853,13,23.25888921888938,-1.2296618,36.8438272,-1.2628473,36.781805,633,1374,2701,1388
964,21716,2030,3,Business,1,1,35770,1,1,35954,1,1,37020,1,1,37635,1,1,38409,7,18.6,-1.3321944,36.8892329,-1.3333725,36.8717613,622,774,184,1681
965,12639,704,3,Business,23,3,44426,23,3,46775,23,3,46894,23,3,47015,23,3,48698,13,21.6,-1.2860183,36.8975338,-1.3632162,36.9108253,103,1683,2349,240
966,12809,283,3,Business,28,4,51113,28,4,51224,28,4,52583,28,4,52733,28,4,54108,7,23.25888921888938,-1.2804227,36.8250375,-1.2850048,36.7923379,88,1375,111,1509
967,6635,2030,3,Business,25,1,42595,25,1,42729,25,1,42992,25,1,43289,25,1,44038,2,23.25888921888938,-1.304735,36.7846054,-1.295908,36.791433,252,749,134,560
968,17293,3752,3,Business,14,2,42267,14,2,42290,14,2,43218,14,2,43594,14,2,44667,2,23.25888921888938,-1.256594,36.8002785,-1.2753109,36.8130185,205,1073,23,1304
969,5379,2956,3,Business,2,4,48692,2,4,49275,2,4,49487,2,4,49711,2,4,50691,6,23.25888921888938,-1.2584143,36.8048002,-1.2880129,36.8308097,250,980,583,436
970,24385,2691,2,Business,3,3,48393,3,3,48515,3,3,50080,3,3,50439,3,3,51625,8,26.9,-1.2857671,36.7875614,-1.2571472,36.7950633,770,1186,122,1924
971,18992,2797,1,Personal,6,1,49818,6,1,49941,6,1,51380,6,1,52132,6,1,53395,5,24.8,-1.2864298,36.8224345,-1.2696795,36.8640088,629,1263,123,2191
972,17244,1917,3,Personal,24,4,49654,24,4,49732,24,4,51249,24,4,51722,24,4,53301,9,28.3,-1.2767423,36.8200767,-1.3265668,36.8022026,758,1579,78,1990
973,17396,635,3,Business,6,3,55697,6,3,55939,6,3,56440,6,3,56566,6,3,57442,3,21.9,-1.2599563,36.7993439,-1.257069,36.81467,446,876,242,627
974,10330,412,3,Business,24,3,40835,24,3,40853,24,3,41126,24,3,41757,24,3,42287,4,23.25888921888938,-1.2628473,36.781805,-1.266837,36.799249,709,530,18,904
975,8889,3295,3,Business,25,4,53920,25,4,54000,25,4,55174,25,4,56150,25,4,56702,2,23.25888921888938,-1.2571472,36.7950633,-1.2736646,36.8142774,290,552,80,2150
976,11846,2523,3,Business,5,3,43595,5,3,43686,5,3,44175,5,3,44302,5,3,45145,5,22.4,-1.2551895,36.7822034,-1.2731645,36.7900343,566,843,91,616
977,17042,835,3,Business,13,3,39628,13,3,39691,13,3,40478,13,3,41103,13,3,42094,7,20.1,-1.299813,36.7871392,-1.304174,36.8219564,726,991,63,1412
978,14372,2200,3,Business,22,1,56298,22,1,56947,22,1,57882,22,1,58718,22,1,59265,2,26.3,-1.279395,36.825364,-1.290894,36.822971,101,547,649,1771
979,18438,788,3,Business,8,2,30556,8,2,31569,8,2,32671,8,2,34416,8,2,35290,7,19.2,-1.2527958,36.8003131,-1.225322,36.80855,607,874,1013,2847
980,9043,3347,1,Personal,1,3,52817,1,3,52937,1,3,53970,1,3,54337,1,3,55159,5,23.9,-1.280467,36.7859296,-1.2969293,36.8027733,414,822,120,1400
981,6029,970,3,Business,16,2,51718,16,2,51731,16,2,51740,16,2,52102,16,2,52719,5,23.25888921888938,-1.2551895,36.7822034,-1.2728069,36.7962362,291,617,13,371
982,2133,2330,3,Business,7,5,55578,7,5,55733,7,5,55992,7,5,56431,7,5,57410,9,27.0,-1.3015197,36.7658456,-1.2642903,36.8002137,920,979,155,698
983,19349,779,1,Personal,28,5,56225,28,5,56305,28,5,56871,28,5,57303,28,5,58951,9,25.7,-1.2714948,36.8166789,-1.2905113,36.7591138,107,1648,80,998
984,13488,1500,3,Business,19,5,50872,19,5,54395,19,5,55117,19,5,56828,19,5,58343,8,27.2,-1.3004062,36.829741,-1.2574219,36.7927073,751,1515,3523,2433
985,2278,113,1,Business,22,3,41198,22,3,41325,22,3,41795,22,3,42312,22,3,43317,8,23.0,-1.2963097,36.7688221,-1.2844653,36.8206676,865,1005,127,987
986,22946,970,3,Business,12,2,36799,12,2,37079,12,2,37628,12,2,37865,12,2,39219,9,17.9,-1.2551895,36.7822034,-1.2953162,36.7828041,535,1354,280,786
987,7620,3283,3,Business,18,5,34427,18,5,34437,18,5,34782,18,5,35739,18,5,36455,5,20.1,-1.2600926,36.8088685,-1.2628473,36.781805,205,716,10,1302
988,2975,2980,1,Personal,11,3,36040,11,3,36295,11,3,36738,11,3,37022,11,3,38686,7,15.1,-1.2669099,36.7977433,-1.2969741,36.7856612,427,1664,255,727
989,159,2154,3,Business,23,4,54858,23,4,54902,23,4,55779,23,4,55861,23,4,59848,17,24.6,-1.2765736,36.8513646,-1.3705766,36.9120742,845,3987,44,959
990,5786,3647,3,Business,21,5,58721,21,5,58741,21,5,59321,21,5,59436,21,5,63411,22,24.6,-1.272639,36.794723,-1.3673224,36.9161975,958,3975,20,695
991,19929,3517,3,Business,26,5,30234,26,5,30254,26,5,31025,26,5,34465,26,5,36390,16,23.25888921888938,-1.300921,36.828195,-1.3882008,36.7699445,211,1925,20,4211
992,6484,635,3,Business,14,5,37440,14,5,37465,14,5,37496,14,5,41382,14,5,42020,10,21.9,-1.3081376,36.8329772,-1.2602337,36.7990548,864,638,25,3917
993,25235,972,3,Business,7,6,35711,7,6,35747,7,6,36114,7,6,36307,7,6,38169,14,13.9,-1.2862033,36.8152966,-1.3298923,36.7590619,88,1862,36,560
994,16236,1329,3,Business,31,3,48841,31,3,48847,31,3,49757,31,3,54633,31,3,57417,20,27.1,-1.332624,36.913187,-1.269534,36.80697,647,2784,6,5786
995,11274,1500,3,Business,18,5,32823,18,5,34026,18,5,34885,18,5,37095,18,5,38160,8,20.1,-1.3004062,36.829741,-1.2574219,36.7927073,254,1065,1203,3069
996,22082,2008,3,Business,29,1,46938,29,1,46963,29,1,47253,29,1,49960,29,1,54195,12,24.4,-1.3084775,36.8611883,-1.2508229,36.7895263,123,4235,25,2997
997,25672,2801,3,Business,9,2,54879,9,2,54917,9,2,56418,9,2,58146,9,2,61413,21,22.4,-1.3104506,36.8687235,-1.3298293,36.7128909,890,3267,38,3229
998,1748,3331,3,Business,9,3,36598,9,3,36672,9,3,36891,9,3,37024,9,3,37622,4,20.4,-1.2551895,36.7822034,-1.2668454,36.7940642,439,598,74,352
999,27438,20,3,Business,13,4,53569,13,4,53655,13,4,54877,13,4,55099,13,4,58331,17,23.0,-1.281336,36.824692,-1.3261837,36.698124,622,3232,86,1444
1000,12991,3331,3,Business,27,3,40767,27,3,40794,27,3,40807,27,3,41020,27,3,43608,9,26.1,-1.2551895,36.7822034,-1.2922364,36.7895538,801,2588,27,226
1001,24328,1263,2,Personal,7,7,61809,7,7,62488,7,7,63221,7,7,63975,7,7,65545,10,23.3,-1.3185736,36.8258933,-1.2697859,36.7946203,612,1570,679,1487
1002,22196,1245,3,Business,31,5,57575,31,5,57854,31,5,58329,31,5,62122,31,5,65014,18,23.6,-1.300921,36.828195,-1.3157163,36.706653,936,2892,279,4268
1003,6640,1642,3,Business,12,2,55855,12,2,56427,12,2,57212,12,2,57408,12,2,58852,9,26.9,-1.2726506,36.7960153,-1.3054333,36.8373808,576,1444,572,981
1004,5189,1402,3,Business,8,3,32689,8,3,32715,8,3,33223,8,3,33344,8,3,34064,5,17.4,-1.2669451,36.8033576,-1.2891922,36.825189,754,720,26,629
1005,15668,2987,3,Business,5,1,46794,5,1,46975,5,1,48849,5,1,49026,5,1,49893,3,26.1,-1.270212,36.8210877,-1.2649605,36.7981777,410,867,181,2051
1006,22128,1966,3,Business,14,2,47312,14,2,48795,14,2,49283,14,2,50300,14,2,52351,21,23.25888921888938,-1.3700383,36.9190174,-1.2917868,36.7872675,877,2051,1483,1505
1007,26819,1066,3,Personal,15,3,54580,15,3,54617,15,3,55449,15,3,55928,15,3,58282,20,21.5,-1.2191053,36.8995881,-1.2885713,36.7649818,384,2354,37,1311
1008,817,2335,3,Business,19,1,42689,19,1,42705,19,1,43724,19,1,44748,19,1,47609,22,24.5,-1.2551895,36.7822034,-1.3562374,36.9042954,254,2861,16,2043
1009,4111,393,3,Business,11,4,39797,11,4,39831,11,4,39834,11,4,41721,11,4,43578,14,25.6,-1.3167113,36.8301563,-1.2991441,36.7528804,293,1857,34,1890
1010,8268,3300,3,Business,31,5,32285,31,5,32299,31,5,34378,31,5,35498,31,5,37313,17,23.25888921888938,-1.228911,36.881876,-1.303596,36.778378,351,1815,14,3199
1011,27208,136,3,Business,9,5,36517,9,5,36601,9,5,36811,9,5,37498,9,5,38779,10,20.0,-1.2536042,36.8064895,-1.2248308,36.8012573,903,1281,84,897
1012,15860,3500,3,Business,14,5,52861,14,5,52928,14,5,53538,14,5,54762,14,5,56055,8,23.0,-1.2973949,36.816038,-1.2621828,36.7949276,167,1293,67,1834
1013,26909,3291,3,Business,17,3,58898,17,3,58915,17,3,59078,17,3,59468,17,3,60198,5,23.25888921888938,-1.2628473,36.781805,-1.2600926,36.8088685,161,730,17,553
1014,24520,2700,1,Business,2,6,34447,2,6,43104,2,6,44533,2,6,45753,2,6,48598,22,23.8,-1.3895183,36.8164183,-1.3052672,36.7538539,654,2845,8657,2649
1015,24754,1244,3,Business,26,2,34507,26,2,34525,26,2,35080,26,2,35681,26,2,37003,7,22.0,-1.2628473,36.781805,-1.303596,36.778378,427,1322,18,1156
1016,25089,1827,3,Business,19,2,56971,19,2,59148,19,2,60399,19,2,62282,19,2,63115,11,19.6,-1.307143,36.825009,-1.293515,36.897607,549,833,2177,3134
1017,12709,1471,3,Business,28,2,52911,28,2,52921,28,2,53411,28,2,54172,28,2,55699,12,23.5,-1.2551895,36.7822034,-1.2987332,36.8463349,411,1527,10,1251
1018,26726,53,3,Business,30,2,43123,30,2,43220,30,2,43229,30,2,44132,30,2,48381,5,22.4,-1.3004062,36.829741,-1.2770708,36.8231093,684,4249,97,912
1019,23212,721,2,Personal,25,1,41663,25,1,41681,25,1,42301,25,1,42498,25,1,44063,15,23.25888921888938,-1.2952109,36.7757064,-1.2324936,36.8224146,116,1565,18,817
1020,10424,2677,3,Business,2,3,34477,2,3,34495,2,3,35422,2,3,35791,2,3,37216,14,19.9,-1.3228003,36.8306435,-1.2991441,36.7528804,263,1425,18,1296
1021,1214,3426,3,Business,16,5,48673,16,5,49444,16,5,49894,16,5,50416,16,5,51105,2,23.25888921888938,-1.3014461,36.7661381,-1.306939,36.7727566,952,689,771,972
1022,6011,3727,3,Business,27,2,41210,27,2,41223,27,2,41485,27,2,41668,27,2,43368,8,24.0,-1.2963097,36.7688221,-1.2600616,36.7870182,649,1700,13,445
1023,2674,136,3,Business,27,4,44957,27,4,44997,27,4,45404,27,4,46268,27,4,47693,11,23.1,-1.2965045,36.7913036,-1.3165104,36.7077726,45,1425,40,1271
1024,7634,1154,3,Business,10,1,33756,10,1,33959,10,1,35805,10,1,35888,10,1,37005,5,16.6,-1.2917868,36.7872675,-1.2825615,36.8227197,429,1117,203,1929
1025,1932,2102,3,Business,7,4,33885,7,4,33897,7,4,33912,7,4,34393,7,4,36089,15,23.25888921888938,-1.3323107,36.8692616,-1.2613768,36.8019418,430,1696,12,496
1026,26732,1422,3,Business,3,4,55899,3,4,56851,3,4,58507,3,4,59204,3,4,60509,5,26.0,-1.308985,36.835623,-1.2856826,36.8255265,436,1305,952,2353
1027,583,2706,3,Personal,4,1,49675,4,1,49795,4,1,50481,4,1,50548,4,1,51591,6,22.5,-1.2603014,36.8069828,-1.2858511,36.7946184,116,1043,120,753
1028,5837,658,2,Personal,30,1,36450,30,1,36495,30,1,38112,30,1,38256,30,1,46139,27,22.5,-1.2827946,36.7689449,-1.1560774,36.7067359,857,7883,45,1761
1029,27813,552,3,Business,10,5,60099,10,5,60644,10,5,61958,10,5,62285,10,5,65447,18,23.25888921888938,-1.28878,36.8168312,-1.3562374,36.9042954,416,3162,545,1641
1030,6809,2159,3,Business,2,1,37820,2,1,37897,2,1,38268,2,1,39673,2,1,41995,7,19.2,-1.2697141,36.7981777,-1.304735,36.7846054,467,2322,77,1776
1031,18833,868,3,Business,25,4,54596,25,4,54607,25,4,54612,25,4,55193,25,4,56633,8,23.25888921888938,-1.303596,36.778378,-1.265715,36.823815,709,1440,11,586
1032,21772,2509,3,Business,29,5,38292,29,5,38553,29,5,39720,29,5,40345,29,5,41361,5,19.8,-1.2909665,36.8150406,-1.2857671,36.7875614,726,1016,261,1792
1033,17139,3302,1,Personal,26,2,52199,26,2,52221,26,2,52814,26,2,53245,26,2,55629,18,23.25888921888938,-1.31661,36.820315,-1.2251345,36.8835216,549,2384,22,1024
1034,12686,2505,1,Personal,2,2,32053,2,2,32067,2,2,33192,2,2,33413,2,2,36784,24,15.2,-1.312469,36.815177,-1.269018,36.67827,532,3371,14,1346
1035,6277,1500,3,Business,12,2,59894,12,2,59964,12,2,60041,12,2,60868,12,2,62397,8,28.6,-1.3004062,36.829741,-1.2638185,36.7930057,8,1529,70,904
1036,3513,2200,3,Business,13,1,35653,13,1,35739,13,1,36127,13,1,36382,13,1,37280,6,15.2,-1.2649605,36.7981777,-1.290894,36.822971,263,898,86,643
1037,3303,2063,3,Business,6,2,37243,6,2,37248,6,2,37445,6,2,37878,6,2,39804,18,19.8,-1.2551895,36.7822034,-1.3289016,36.8765964,932,1926,5,630
1038,9391,1927,3,Business,15,3,48488,15,3,48538,15,3,48918,15,3,49128,15,3,50762,15,25.7,-1.2584143,36.8048002,-1.3472066,36.7692638,953,1634,50,590
1039,13440,1146,3,Business,21,4,50601,21,4,50689,21,4,51551,21,4,52796,21,4,53614,7,26.5,-1.3167113,36.8301563,-1.3083266,36.8494756,25,818,88,2107
1040,12275,3068,3,Personal,10,5,37551,10,5,37660,10,5,38454,10,5,38798,10,5,41560,22,19.1,-1.2513529,36.752172,-1.3203335,36.6831543,215,2762,109,1138
1041,22410,2753,3,Personal,14,1,41373,14,1,43196,14,1,44803,14,1,45209,14,1,45768,2,22.9,-1.279285,36.8260574,-1.2842286,36.8150609,100,559,1823,2013
1042,1471,2881,1,Personal,20,7,36190,20,7,38238,20,7,39251,20,7,39640,20,7,40372,5,20.0,-1.2851714,36.8318207,-1.3102963,36.8212746,858,732,2048,1402
1043,14618,533,3,Business,29,2,61230,29,2,61244,29,2,61252,29,2,61573,29,2,62460,4,23.25888921888938,-1.3014461,36.7661381,-1.2765492,36.7669809,523,887,14,329
1044,419,53,3,Business,18,4,46245,18,4,46312,18,4,46318,18,4,47395,18,4,47711,5,23.25888921888938,-1.3004062,36.829741,-1.2770708,36.8231093,472,316,67,1083
1045,24331,2412,3,Business,10,1,49711,10,1,56829,10,1,57085,10,1,57974,10,1,58689,11,18.7,-1.2803414,36.8265456,-1.2285835,36.8826468,812,715,7118,1145
1046,14945,706,3,Business,18,5,52132,18,5,52154,18,5,52584,18,5,53158,18,5,53481,3,26.8,-1.3080092,36.8284543,-1.3077869,36.8443207,178,323,22,1004
1047,6495,1500,3,Business,28,4,49410,28,4,49432,28,4,49439,28,4,51019,28,4,51126,8,27.5,-1.3004062,36.829741,-1.2638185,36.7930057,41,107,22,1587
1048,11874,635,3,Business,30,3,43469,30,3,43487,30,3,44164,30,3,45881,30,3,46983,6,25.2,-1.3077723,36.8336065,-1.3229345,36.8566974,540,1102,18,2394
1049,3825,2956,3,Business,9,5,55215,9,5,57671,9,5,60306,9,5,60394,9,5,61479,7,24.8,-1.225322,36.80855,-1.2584143,36.8048002,453,1085,2456,2723
1050,13715,3621,3,Business,22,6,63169,22,6,63197,22,6,63202,22,6,64284,22,6,66507,5,23.9,-1.2836583,36.7886014,-1.3046156,36.7658572,725,2223,28,1087
1051,199,1927,3,Business,27,2,64090,27,2,64129,27,2,64307,27,2,64469,27,2,66821,15,22.1,-1.2584143,36.8048002,-1.3463042,36.768164,626,2352,39,340
1052,23928,2521,3,Business,30,6,41669,30,6,41679,30,6,41684,30,6,44559,30,6,44562,14,26.4,-1.3167113,36.8301563,-1.306378,36.7519845,10,3,10,2880
1053,3985,3175,3,Business,17,2,30366,17,2,30585,17,2,30590,17,2,30873,17,2,32211,8,14.7,-1.2681004,36.7952081,-1.297701,36.806896,345,1338,219,288
1054,14670,2330,3,Business,5,2,56662,5,2,57078,5,2,58944,5,2,60026,5,2,63998,22,25.0,-1.3206433,36.9117533,-1.2642903,36.8002137,6,3972,416,2948
1055,11394,552,3,Business,9,3,54656,9,3,54764,9,3,55122,9,3,55734,9,3,57934,9,25.3,-1.3329777,36.866203,-1.335477,36.9308297,31,2200,108,970
1056,25541,510,3,Business,17,4,50038,17,4,50057,17,4,50067,17,4,50383,17,4,52725,12,23.7,-1.2860183,36.8975338,-1.325469,36.862403,900,2342,19,326
1057,11742,2216,3,Business,27,3,40031,27,3,40052,27,3,40199,27,3,40390,27,3,41275,7,26.3,-1.2551895,36.7822034,-1.2817426,36.7846148,267,885,21,338
1058,9889,2763,3,Business,28,1,48039,28,1,48075,28,1,48820,28,1,49343,28,1,50563,13,26.2,-1.2551895,36.7822034,-1.321846,36.82826,178,1220,36,1268
1059,14363,1209,3,Business,18,4,39736,18,4,39787,18,4,41440,18,4,41911,18,4,42794,5,23.25888921888938,-1.2770708,36.8231093,-1.3004062,36.829741,843,883,51,2124
1060,21365,1849,3,Business,5,5,50425,5,5,50505,5,5,50750,5,5,51245,5,5,52384,6,26.7,-1.2571472,36.7950633,-1.290894,36.822971,231,1139,80,740
1061,25895,1841,3,Business,26,5,48118,26,5,48194,26,5,48515,26,5,49175,26,5,50183,10,23.25888921888938,-1.3148396,36.8202498,-1.2571472,36.7950633,650,1008,76,981
1062,27858,2436,3,Business,15,5,54971,15,5,55070,15,5,55399,15,5,56287,15,5,56615,4,18.0,-1.2551895,36.7822034,-1.2627937,36.8156957,124,328,99,1217
1063,1491,2154,3,Business,26,6,48643,26,6,48675,26,6,50637,26,6,51629,26,6,54381,16,23.8,-1.3169591,36.7000029,-1.2885529,36.8160141,122,2752,32,2954
1064,23278,540,3,Business,23,5,43693,23,5,45732,23,5,46507,23,5,47159,23,5,47919,5,24.1,-1.2571472,36.7950633,-1.2896171,36.8241291,88,760,2039,1427
1065,5137,3661,3,Business,20,3,43649,20,3,43719,20,3,44913,20,3,45138,20,3,46423,18,27.4,-1.2132866,36.8678274,-1.3195936,36.9161697,683,1285,70,1419
1066,17510,2330,3,Business,26,2,66817,26,2,69237,26,2,69851,26,2,70434,26,2,71616,7,22.7,-1.2325706,36.8083923,-1.2649605,36.7981777,72,1182,2420,1197
1067,19978,3160,3,Business,26,1,52369,26,1,54829,26,1,56730,26,1,58509,26,1,59602,15,22.1,-1.2642197,36.7168247,-1.2844665,36.7866113,240,1093,2460,3680
1068,2977,111,3,Business,5,1,54568,5,1,54900,5,1,55595,5,1,55657,5,1,57379,9,26.2,-1.2551895,36.7822034,-1.2790138,36.8269909,11,1722,332,757
1069,25215,302,3,Business,28,6,67735,28,6,67756,28,6,68092,28,6,69101,28,6,70811,6,23.2,-1.2649605,36.7981777,-1.2909634,36.7813995,427,1710,21,1345
1070,27371,186,3,Business,13,3,36960,13,3,36992,13,3,38683,13,3,39349,13,3,39952,7,23.25888921888938,-1.2825816,36.8092346,-1.2571472,36.7950633,564,603,32,2357
1071,24345,113,3,Business,18,4,62461,18,4,62540,18,4,63013,18,4,63414,18,4,65260,7,23.7,-1.2618802,36.8068534,-1.2963097,36.7688221,330,1846,79,874
1072,8535,1721,3,Business,30,2,47634,30,2,47942,30,2,48292,30,2,48609,30,2,50339,21,23.25888921888938,-1.2551895,36.7822034,-1.332624,36.913187,438,1730,308,667
1073,20130,510,3,Business,25,4,53259,25,4,55131,25,4,56191,25,4,56259,25,4,57262,10,20.6,-1.2765736,36.8513646,-1.2860183,36.8975338,402,1003,1872,1128
1074,10234,295,3,Business,12,2,52082,12,2,54635,12,2,54817,12,2,55420,12,2,56130,6,26.9,-1.282206,36.815958,-1.2967108,36.7871135,330,710,2553,785
1075,369,633,3,Business,14,4,53103,14,4,55297,14,4,56673,14,4,57389,14,4,58273,6,27.8,-1.3083266,36.8494756,-1.3004062,36.829741,448,884,2194,2092
1076,201,246,3,Business,15,3,45410,15,3,45422,15,3,46011,15,3,46877,15,3,49404,7,18.0,-1.225322,36.80855,-1.2584143,36.8048002,334,2527,12,1455
1077,18891,1067,3,Personal,5,2,49434,5,2,49525,5,2,51021,5,2,52031,5,2,55536,18,27.3,-1.2696183,36.8021778,-1.2381178,36.6678333,580,3505,91,2506
1078,22928,2582,3,Business,11,1,38014,11,1,38058,11,1,38741,11,1,39182,11,1,40823,3,26.4,-1.2551895,36.7822034,-1.2644742,36.8083457,690,1641,44,1124
1079,2270,1245,3,Business,8,5,48924,8,5,52686,8,5,52696,8,5,54128,8,5,56119,17,30.3,-1.300921,36.828195,-1.3198615,36.7110323,120,1991,3762,1442
1080,24421,1085,3,Business,18,2,50081,18,2,50093,18,2,50498,18,2,50700,18,2,51410,2,25.4,-1.2628638,36.8070399,-1.2715686,36.8023526,658,710,12,607
1081,9048,540,3,Business,8,4,51169,8,4,51227,8,4,51502,8,4,52008,8,4,52009,3,27.5,-1.2551895,36.7822034,-1.2673725,36.8077775,191,1,58,781
1082,24264,814,3,Business,11,5,57193,11,5,57225,11,5,58154,11,5,58316,11,5,60446,12,26.6,-1.3014461,36.7661381,-1.25282,36.68764,210,2130,32,1091
1083,24157,2330,3,Business,30,3,55405,30,3,55489,30,3,56315,30,3,56805,30,3,58716,8,29.2,-1.2326041,36.8009029,-1.2341666,36.8443334,436,1911,84,1316
1084,19704,2823,3,Business,21,4,55217,21,4,55256,21,4,55565,21,4,56899,21,4,58091,8,22.4,-1.2615888,36.7928732,-1.3014461,36.7661381,116,1192,39,1643
1085,13525,3647,3,Business,22,3,45365,22,3,45409,22,3,46998,22,3,47630,22,3,47636,6,23.3,-1.2985749,36.8088,-1.272639,36.794723,138,6,44,2221
1086,10079,2423,3,Business,7,4,36674,7,4,36743,7,4,37099,7,4,38081,7,4,40414,8,27.5,-1.2551895,36.7822034,-1.2967702,36.8040381,520,2333,69,1338
1087,15601,1475,3,Business,12,5,47262,12,5,47306,12,5,47859,12,5,48769,12,5,50704,12,27.1,-1.3379799,36.8835453,-1.3233496,36.8139159,948,1935,44,1463
1088,3930,3635,1,Business,3,3,60776,3,3,60837,3,3,60859,3,3,61474,3,3,61897,3,23.7,-1.2584143,36.8048002,-1.2615888,36.7928732,536,423,61,637
1089,7230,1244,3,Business,24,1,39614,24,1,39733,24,1,43124,24,1,44627,24,1,48116,17,22.7,-1.228911,36.881876,-1.303596,36.778378,101,3489,119,4894
1090,14587,1831,3,Business,11,1,31422,11,1,31492,11,1,33960,11,1,34240,11,1,38339,15,17.9,-1.3562374,36.9042954,-1.282543,36.824618,863,4099,70,2748
1091,19923,393,3,Business,30,2,42388,30,2,43744,30,2,44524,30,2,44634,30,2,45400,5,23.25888921888938,-1.2770708,36.8231093,-1.3004062,36.829741,438,766,1356,890
1092,24640,2390,2,Personal,16,1,41321,16,1,41350,16,1,41628,16,1,41890,16,1,42556,5,19.2,-1.27401,36.819197,-1.2676164,36.8075243,726,666,29,540
1093,15968,2330,3,Business,6,4,57788,6,4,57798,6,4,58019,6,4,58575,6,4,59576,9,23.25888921888938,-1.2868601,36.7738025,-1.2671943,36.8062533,847,1001,10,777
1094,3953,635,3,Business,27,1,41088,27,1,41204,27,1,41271,27,1,41549,27,1,42437,7,20.9,-1.2602337,36.7990548,-1.3081376,36.8329772,576,888,116,345
1095,20911,3291,3,Business,21,2,40546,21,2,40564,21,2,40979,21,2,41520,21,2,42886,11,22.4,-1.303596,36.778378,-1.2600926,36.8088685,675,1366,18,956
1096,1382,2869,3,Business,8,6,42436,8,6,42479,8,6,43248,8,6,44458,8,6,49081,12,20.1,-1.2765736,36.8513646,-1.3025826,36.7670807,404,4623,43,1979
1097,26993,1473,3,Business,8,4,43592,8,4,43630,8,4,44940,8,4,45050,8,4,48505,18,26.3,-1.3700383,36.9190174,-1.298701,36.8192575,101,3455,38,1420
1098,6682,3377,2,Personal,17,3,42837,17,3,42914,17,3,43128,17,3,43602,17,3,46140,25,25.6,-1.303961,36.7804405,-1.1860322,36.9379956,406,2538,77,688
1099,7549,3452,1,Personal,24,4,52005,24,4,52128,24,4,52371,24,4,53072,24,4,53616,3,22.7,-1.2666153,36.8015124,-1.2545422,36.7902075,45,544,123,944
1100,3998,2207,3,Business,30,5,35143,30,5,35151,30,5,36677,30,5,36836,30,5,38888,16,18.8,-1.207546,36.7913976,-1.2768326,36.8073804,733,2052,8,1685
1101,668,3599,3,Business,14,2,38793,14,2,39857,14,2,42628,14,2,43505,14,2,46108,20,23.25888921888938,-1.3302996,36.8707935,-1.3166316,36.713034,519,2603,1064,3648
1102,4751,53,3,Business,9,4,38525,9,4,38550,9,4,39245,9,4,39464,9,4,41314,8,23.25888921888938,-1.2770708,36.8231093,-1.276954,36.765926,843,1850,25,914
1103,9242,426,3,Business,30,2,51543,30,2,55850,30,2,56806,30,2,58196,30,2,59565,15,27.2,-1.2696824,36.8026164,-1.3323107,36.8692616,403,1369,4307,2346
1104,4224,1482,3,Business,27,3,46451,27,3,46474,27,3,46855,27,3,47043,27,3,48982,16,26.1,-1.2649605,36.7981777,-1.177145,36.8295169,576,1939,23,569
1105,7760,1920,3,Business,21,3,50561,21,3,52038,21,3,52609,21,3,52888,21,3,53773,5,23.4,-1.3169591,36.7000029,-1.3339943,36.7263409,317,885,1477,850
1106,18372,1038,1,Business,21,4,41544,21,4,42183,21,4,43331,21,4,43761,21,4,45768,9,21.8,-1.3035984,36.8035843,-1.2563755,36.8215762,549,2007,639,1578
1107,19673,3233,1,Personal,14,4,42278,14,4,42317,14,4,43455,14,4,43841,14,4,46046,10,19.1,-1.214328,36.7911903,-1.2574645,36.805504,802,2205,39,1524
1108,6344,3647,3,Business,10,5,35490,10,5,35550,10,5,36349,10,5,36643,10,5,38640,11,23.25888921888938,-1.272639,36.794723,-1.3127877,36.8481987,770,1997,60,1093
1109,11187,2318,2,Personal,22,5,45503,22,5,45882,22,5,46266,22,5,46990,22,5,48557,14,21.5,-1.3339943,36.7263409,-1.3190714,36.8016277,95,1567,379,1108
1110,14211,1342,3,Business,26,4,49760,26,4,49800,26,4,50392,26,4,50463,26,4,52109,9,22.0,-1.3025826,36.7670807,-1.2551895,36.7822034,520,1646,40,663
1111,9307,1502,3,Business,7,5,43177,7,5,45672,7,5,46210,7,5,46645,7,5,47969,12,25.3,-1.290894,36.822971,-1.2232123,36.8932547,744,1324,2495,973
1112,10495,437,3,Business,8,4,40592,8,4,40624,8,4,41168,8,4,42016,8,4,45466,18,26.3,-1.2551895,36.7822034,-1.2902161,36.8936181,328,3450,32,1392
1113,898,2066,3,Business,24,5,54748,24,5,54757,24,5,55055,24,5,56219,24,5,57022,7,23.0,-1.316961,36.820337,-1.303105,36.7645772,857,803,9,1462
1114,4857,635,3,Business,1,4,50937,1,4,50967,1,4,51820,1,4,52381,1,4,53980,5,23.25888921888938,-1.2549476,36.8269576,-1.2599563,36.7993439,755,1599,30,1414
1115,26781,1938,1,Personal,11,3,44545,11,3,44605,11,3,47351,11,3,47754,11,3,49416,5,18.8,-1.2709579,36.8108962,-1.2905152,36.7834982,795,1662,60,3149
1116,4989,3091,3,Business,7,5,38902,7,5,38913,7,5,40316,7,5,41569,7,5,45302,25,24.9,-1.207546,36.7913976,-1.3025826,36.7670807,560,3733,11,2656
1117,15558,2828,1,Business,24,4,48666,24,4,48820,24,4,51001,24,4,51064,24,4,52479,9,22.8,-1.2615888,36.7928732,-1.307774,36.8407541,742,1415,154,2244
1118,25687,2855,3,Business,14,4,35465,14,4,35519,14,4,35922,14,4,36281,14,4,36994,4,17.9,-1.2945179,36.7685349,-1.2871136,36.785507,462,713,54,762
1119,16524,633,3,Business,5,2,60192,5,2,60256,5,2,60263,5,2,60443,5,2,62173,9,25.2,-1.2638185,36.7930057,-1.3004062,36.829741,311,1730,64,187
1120,20559,3247,3,Business,15,3,38054,15,3,38172,15,3,38712,15,3,39281,15,3,40694,10,23.25888921888938,-1.2571472,36.7950633,-1.31861,36.8113967,205,1413,118,1109
1121,4059,517,3,Business,29,4,26161,29,4,31608,29,4,31812,29,4,32230,29,4,33382,4,18.9,-1.3177547,36.8303703,-1.3004062,36.829741,523,1152,5447,622
1122,18367,1205,3,Business,21,4,36295,21,4,36345,21,4,36744,21,4,39473,21,4,41528,4,27.8,-1.2800617,36.7883831,-1.2495931,36.8065087,228,2055,50,3128
1123,11225,1280,3,Business,7,2,36829,7,2,36840,7,2,36847,7,2,37122,7,2,37419,3,23.25888921888938,-1.2551895,36.7822034,-1.2575407,36.7868197,576,297,11,282
1124,21644,3359,3,Business,15,5,39636,15,5,40295,15,5,41161,15,5,41568,15,5,43740,7,26.5,-1.2791224,36.8306878,-1.2551895,36.7822034,351,2172,659,1273
1125,27120,2200,3,Business,14,2,59689,14,2,61999,14,2,62622,14,2,63824,14,2,65202,11,23.25888921888938,-1.2285835,36.8826468,-1.290894,36.822971,567,1378,2310,1825
1126,25561,1150,1,Personal,22,6,40854,22,6,40947,22,6,42351,22,6,42789,22,6,44383,8,21.3,-1.2569523,36.8254961,-1.2934697,36.7799724,89,1594,93,1842
1127,11056,3491,3,Business,15,5,36421,15,5,36753,15,5,37936,15,5,38451,15,5,40008,12,26.5,-1.2283403,36.8822756,-1.2591019,36.800577,831,1557,332,1698
1128,20127,893,3,Business,4,1,49736,4,1,49829,4,1,50197,4,1,50319,4,1,51447,6,23.25888921888938,-1.2663194,36.809901,-1.2807336,36.7791105,535,1128,93,490
1129,6367,2423,3,Business,14,4,48610,14,4,51902,14,4,52217,14,4,52675,14,4,54700,6,28.2,-1.2551895,36.7822034,-1.285382,36.8162878,863,2025,3292,773
1130,2717,136,3,Business,25,5,52546,25,5,52597,25,5,53435,25,5,54293,25,5,55648,8,29.4,-1.3009676,36.7657189,-1.3165104,36.7077726,831,1355,51,1696
1131,26290,393,3,Business,25,1,58104,25,1,58134,25,1,58142,25,1,60126,25,1,60138,14,27.3,-1.3167113,36.8301563,-1.306378,36.7519845,39,12,30,1992
1132,22372,3450,3,Business,15,5,35541,15,5,35901,15,5,36817,15,5,37079,15,5,39410,8,20.3,-1.2551895,36.7822034,-1.2802914,36.8296544,311,2331,360,1178
1133,4387,517,3,Business,27,4,37281,27,4,37286,27,4,37475,27,4,37993,27,4,39589,14,23.2,-1.3167113,36.8301563,-1.306378,36.7519845,523,1596,5,707
1134,7337,2658,3,Business,11,4,62626,11,4,62712,11,4,65886,11,4,67301,11,4,67364,8,26.3,-1.2813012,36.8323962,-1.2963097,36.7688221,119,63,86,4589
1135,16214,1107,2,Personal,3,2,48915,3,2,48948,3,2,49498,3,2,49580,3,2,50277,3,20.4,-1.2728058,36.8049903,-1.260964,36.820424,770,697,33,632
1136,14834,1527,3,Business,13,4,45608,13,4,45645,13,4,45750,13,4,46559,13,4,46949,5,22.1,-1.3004062,36.829741,-1.3228003,36.8306435,2,390,37,914
1137,4664,594,1,Personal,28,1,46576,28,1,46705,28,1,48814,28,1,49264,28,1,50310,6,24.5,-1.3024794,36.8228284,-1.297611,36.775445,865,1046,129,2559
1138,10295,391,3,Business,23,4,56006,23,4,56280,23,4,57825,23,4,62252,23,4,63009,4,23.25888921888938,-1.300921,36.828195,-1.2897368,36.8226783,223,757,274,5972
1139,15009,2008,3,Business,5,5,29584,5,5,30369,5,5,31678,5,5,34677,5,5,35605,6,17.6,-1.2858606,36.8249342,-1.2508229,36.7895263,329,928,785,4308
1140,475,2008,3,Business,14,3,41802,14,3,41840,14,3,43385,14,3,43626,14,3,45758,16,24.7,-1.2508229,36.7895263,-1.33924,36.7607362,878,2132,38,1786
1141,15650,3147,3,Business,14,3,46162,14,3,46224,14,3,46333,14,3,46433,14,3,48366,10,24.8,-1.3472066,36.7692638,-1.316315,36.8268861,878,1933,62,209
1142,25839,3599,3,Business,14,2,38560,14,2,38582,14,2,39721,14,2,40725,14,2,42562,13,23.25888921888938,-1.3302996,36.8707935,-1.2568926,36.8130636,675,1837,22,2143
1143,12029,136,3,Business,25,1,53360,25,1,53386,25,1,54099,25,1,54581,25,1,55336,5,28.1,-1.2965045,36.7913036,-1.2963367,36.8094235,783,755,26,1195
1144,11102,2207,3,Business,4,1,31651,4,1,31693,4,1,31771,4,1,32730,4,1,33388,6,21.9,-1.2891116,36.810438,-1.2696908,36.81519,955,658,42,1037
1145,15313,3283,3,Business,21,1,45931,21,1,45974,21,1,46138,21,1,46424,21,1,47103,4,25.5,-1.266837,36.799249,-1.2628473,36.781805,247,679,43,450
1146,8518,1584,3,Business,30,2,33677,30,2,33716,30,2,34038,30,2,34534,30,2,35553,6,23.25888921888938,-1.2824911,36.8218042,-1.2969741,36.7856612,698,1019,39,818
1147,23562,3573,3,Personal,24,1,53768,24,1,53787,24,1,54331,24,1,54801,24,1,55500,2,23.25888921888938,-1.26836,36.809632,-1.263194,36.797624,882,699,19,1014
1148,22630,3365,2,Personal,2,4,55631,2,4,55652,2,4,55683,2,4,56470,2,4,58258,5,26.3,-1.2860198,36.8176562,-1.2812997,36.7986672,89,1788,21,818
1149,7602,2540,1,Personal,12,4,38564,12,4,39292,12,4,39690,12,4,40241,12,4,42181,16,18.9,-1.2021922,36.8904146,-1.285611,36.9047023,806,1940,728,949
1150,12551,1179,3,Business,29,2,53083,29,2,53110,29,2,54062,29,2,54746,29,2,56966,23,24.0,-1.3700383,36.9190174,-1.299813,36.7871392,890,2220,27,1636
1151,3587,3621,3,Business,7,5,45840,7,5,46246,7,5,47226,7,5,47845,7,5,50218,20,23.25888921888938,-1.2836583,36.7886014,-1.1774212,36.8305524,269,2373,406,1599
1152,11784,1526,3,Personal,12,2,57274,12,2,57301,12,2,59199,12,2,60868,12,2,63452,30,26.6,-1.1471704,36.9636043,-1.2886166,36.7836803,882,2584,27,3567
1153,25244,136,3,Business,25,2,38850,25,2,38856,25,2,39528,25,2,39881,25,2,42912,29,23.9,-1.3326173,36.7146233,-1.3094447,36.9107706,465,3031,6,1025
1154,6126,2174,3,Business,22,3,44177,22,3,44177,22,3,44430,22,3,48086,22,3,48089,16,23.3,-1.2482781,36.884092,-1.2016077,36.930397,86,3,0,3909
1155,18883,2296,1,Personal,28,5,39135,28,5,39187,28,5,39566,28,5,39875,28,5,40680,7,25.0,-1.2655306,36.828148,-1.2918246,36.801585,216,805,52,688
1156,10150,3314,1,Personal,24,5,33821,24,5,33872,24,5,36928,24,5,37431,24,5,39141,5,15.6,-1.2858511,36.7946184,-1.285709,36.8219844,234,1710,51,3559
1157,23950,1809,3,Business,29,3,41636,29,3,41645,29,3,41981,29,3,42795,29,3,43351,2,18.5,-1.2527958,36.8003131,-1.2646084,36.8028645,875,556,9,1150
1158,14322,393,3,Business,4,2,59235,4,2,59235,4,2,59332,4,2,60502,4,2,60504,4,22.3,-1.3228003,36.8306435,-1.3004062,36.829741,239,2,0,1267
1159,21953,687,3,Business,27,2,36476,27,2,36847,27,2,37746,27,2,37808,27,2,40502,20,18.5,-1.2339734,36.6747329,-1.3109027,36.7689452,240,2694,371,961
1160,22232,2956,3,Business,13,1,36740,13,1,36775,13,1,37783,13,1,38413,13,1,39834,14,23.25888921888938,-1.207546,36.7913976,-1.2584143,36.8048002,564,1421,35,1638
1161,15080,1882,3,Business,28,4,71182,28,4,71317,28,4,72442,28,4,74401,28,4,75233,6,22.8,-1.2956882,36.7861845,-1.2591019,36.800577,269,832,135,3084
1162,20003,770,1,Personal,11,3,44273,11,3,44368,11,3,45276,11,3,45444,11,3,47517,9,19.1,-1.2846475,36.8275903,-1.3258649,36.8000584,808,2073,95,1076
1163,18470,2823,3,Business,7,1,64122,7,1,64427,7,1,65605,7,1,66544,7,1,68921,20,20.2,-1.2141875,36.791039,-1.3018758,36.7590863,56,2377,305,2117
1164,5684,868,3,Business,12,1,57243,12,1,62316,12,1,63345,12,1,64101,12,1,64868,9,23.7,-1.2296618,36.8438272,-1.265715,36.823815,453,767,5073,1785
1165,16191,20,3,Business,2,2,51933,2,2,51942,2,2,53122,2,2,53335,2,2,55674,20,26.1,-1.3342256,36.9106741,-1.2628638,36.8070399,62,2339,9,1393
1166,27458,1744,2,Personal,19,5,51361,19,5,51378,19,5,51404,19,5,52326,19,5,54585,16,27.6,-1.3178263,36.7141818,-1.2726573,36.8267008,456,2259,17,948
1167,6326,722,3,Business,18,4,49592,18,4,49606,18,4,50662,18,4,51680,18,4,54131,19,23.25888921888938,-1.32943,36.894243,-1.2647975,36.8215183,126,2451,14,2074
1168,14058,212,3,Personal,31,2,40689,31,2,40711,31,2,41022,31,2,41367,31,2,42316,6,18.4,-1.2666153,36.8015124,-1.2607569,36.7747575,519,949,22,656
1169,3765,3291,3,Business,29,1,48935,29,1,49271,29,1,50153,29,1,50553,29,1,51297,4,24.4,-1.265715,36.823815,-1.2600926,36.8088685,842,744,336,1282
1170,11826,2351,3,Personal,9,6,57227,9,6,57242,9,6,57671,9,6,57868,9,6,59119,11,27.3,-1.3066143,36.8161046,-1.2830519,36.8808254,691,1251,15,626
1171,23809,635,3,Business,30,4,47681,30,4,47947,30,4,48796,30,4,50675,30,4,51805,4,23.25888921888938,-1.300921,36.828195,-1.284497,36.8286605,567,1130,266,2728
1172,13156,3291,3,Business,5,2,36888,5,2,36980,5,2,38013,5,2,39042,5,2,39681,4,25.4,-1.272828,36.816608,-1.2600926,36.8088685,52,639,92,2062
1173,10681,1584,3,Business,8,5,58539,8,5,58607,8,5,59389,8,5,61293,8,5,61295,8,25.3,-1.2969741,36.7856612,-1.2715686,36.8023526,953,2,68,2686
1174,9249,647,3,Business,6,4,32061,6,4,32212,6,4,32903,6,4,34197,6,4,35011,10,16.2,-1.3004062,36.829741,-1.2555317,36.8562313,70,814,151,1985
1175,21079,868,3,Business,24,3,37366,24,3,37380,24,3,37759,24,3,38801,24,3,38806,5,23.25888921888938,-1.2600926,36.8088685,-1.265715,36.823815,547,5,14,1421
1176,18431,2330,3,Business,1,5,36829,1,5,36866,1,5,37499,1,5,37600,1,5,38828,9,23.25888921888938,-1.3015197,36.7658456,-1.2649605,36.7981777,368,1228,37,734
1177,1706,1397,3,Business,26,2,54888,26,2,54924,26,2,55239,26,2,55568,26,2,57376,18,29.5,-1.2648363,36.8023754,-1.317461,36.707031,875,1808,36,644
1178,21872,1787,3,Business,29,3,55584,29,3,55682,29,3,56793,29,3,57748,29,3,58870,10,19.2,-1.2872996,36.8310969,-1.2297202,36.8819507,384,1122,98,2066
1179,18993,868,3,Business,22,3,61209,22,3,61659,22,3,63232,22,3,63630,22,3,64649,6,23.8,-1.307143,36.825009,-1.265715,36.823815,953,1019,450,1971
1180,8985,2457,3,Business,7,3,41455,7,3,41494,7,3,41911,7,3,42251,7,3,45720,3,25.3,-1.2551895,36.7822034,-1.2544973,36.8061844,646,3469,39,757
1181,24099,1961,3,Business,20,1,37786,20,1,37828,20,1,37927,20,1,38378,20,1,39298,6,23.25888921888938,-1.344446,36.756597,-1.3188359,36.7038526,942,920,42,550
1182,26377,2523,3,Business,9,1,43398,9,1,43419,9,1,43609,9,1,44270,9,1,46591,18,20.3,-1.2551895,36.7822034,-1.2198413,36.9054958,520,2321,21,851
1183,16519,1850,3,Business,5,2,57728,5,2,57849,5,2,58237,5,2,58339,5,2,59822,7,27.3,-1.2551895,36.7822034,-1.2824744,36.804724,359,1483,121,490
1184,17053,59,3,Business,14,4,38864,14,4,39018,14,4,39679,14,4,40083,14,4,40681,1,19.0,-1.290894,36.822971,-1.2885529,36.8160141,444,598,154,1065
1185,6778,1075,3,Business,22,6,50375,22,6,50405,22,6,51060,22,6,52421,22,6,53927,15,26.0,-1.2156006,36.8916865,-1.2527958,36.8003131,685,1506,30,2016
1186,17049,3194,3,Business,27,3,37190,27,3,37237,27,3,37940,27,3,38139,27,3,38742,7,25.9,-1.2811695,36.8200313,-1.2551895,36.7822034,365,603,47,902
1187,23714,1271,3,Business,4,4,33742,4,4,33784,4,4,34386,4,4,34750,4,4,39226,24,21.9,-1.3244885,36.897792,-1.3108386,36.7555239,404,4476,42,966
1188,16617,2974,3,Business,19,2,46786,19,2,46829,19,2,47145,19,2,47286,19,2,49903,19,27.3,-1.2944424,36.7797938,-1.2038217,36.8794507,129,2617,43,457
1189,8766,2436,3,Business,17,3,50114,17,3,50180,17,3,50566,17,3,50981,17,3,52681,12,28.4,-1.2571472,36.7950633,-1.2397503,36.8797681,612,1700,66,801
1190,3490,20,3,Business,27,1,45612,27,1,45630,27,1,47227,27,1,49308,27,1,50373,5,23.25888921888938,-1.2880771,36.8269099,-1.2628638,36.8070399,213,1065,18,3678
1191,5445,1069,1,Personal,25,5,54859,25,5,55945,25,5,57483,25,5,57824,25,5,60401,6,23.4,-1.2806774,36.8370763,-1.3020624,36.7904837,852,2577,1086,1879
1192,24056,419,3,Business,13,3,36503,13,3,36525,13,3,36843,13,3,37950,13,3,40013,14,20.2,-1.2579304,36.8019667,-1.3053865,36.8917332,116,2063,22,1425
1193,27258,186,3,Business,22,5,45476,22,5,45573,22,5,46247,22,5,47057,22,5,50234,4,28.4,-1.2571472,36.7950633,-1.2825816,36.8092346,521,3177,97,1484
1194,11311,3283,3,Business,2,6,53160,2,6,53293,2,6,54015,2,6,54766,2,6,55508,5,29.0,-1.2600926,36.8088685,-1.2628473,36.781805,691,742,133,1473
1195,20298,393,3,Business,6,2,39454,6,2,39461,6,2,39537,6,2,39925,6,2,41699,10,24.8,-1.3177547,36.8303703,-1.2574219,36.7927073,10,1774,7,464
1196,21176,1500,3,Business,16,2,36581,16,2,36625,16,2,36780,16,2,36939,16,2,38088,8,23.25888921888938,-1.2638185,36.7930057,-1.3017117,36.8149763,855,1149,44,314
1197,4449,3517,3,Business,6,1,32646,6,1,32686,6,1,32908,6,1,38413,6,1,40332,16,23.25888921888938,-1.300921,36.828195,-1.3882008,36.7699445,591,1919,40,5727
1198,6154,2980,1,Personal,12,4,43867,12,4,44007,12,4,45087,12,4,45357,12,4,46212,7,19.1,-1.2669099,36.7977433,-1.2969741,36.7856612,951,855,140,1350
1199,15970,2783,2,Personal,16,1,58564,16,1,58812,16,1,59451,16,1,61151,16,1,63112,8,23.25888921888938,-1.2859331,36.7865464,-1.2659914,36.8283655,215,1961,248,2339
1200,1946,1544,3,Business,3,4,48940,3,4,50176,3,4,51618,3,4,51963,3,4,53072,4,25.0,-1.278656,36.8256949,-1.30479,36.8129524,268,1109,1236,1787
1201,11920,2030,3,Business,9,3,38538,9,3,38570,9,3,39167,9,3,39297,9,3,40653,3,25.2,-1.2963097,36.7688221,-1.295908,36.791433,548,1356,32,727
1202,27232,2383,3,Business,29,3,44200,29,3,44276,29,3,45348,29,3,45604,29,3,46082,3,23.25888921888938,-1.2608993,36.799246,-1.2633494,36.7959696,344,478,76,1328
1203,21783,432,3,Business,13,1,52394,13,1,52451,13,1,53611,13,1,53774,13,1,55826,9,23.25888921888938,-1.290894,36.822971,-1.3012008,36.764868,849,2052,57,1323
1204,15810,2718,3,Business,9,3,37706,9,3,37733,9,3,38103,9,3,38527,9,3,40510,17,21.0,-1.2601,36.796528,-1.3360449,36.8844837,541,1983,27,794
1205,13976,2200,3,Business,20,2,40363,20,2,41048,20,2,41540,20,2,42102,20,2,43971,8,20.0,-1.3014461,36.7661381,-1.290894,36.822971,933,1869,685,1054
1206,15649,2523,3,Business,5,4,45848,5,4,45962,5,4,46789,5,4,47083,5,4,48132,8,23.25888921888938,-1.2551895,36.7822034,-1.303711,36.8154933,636,1049,114,1121
1207,22517,53,3,Business,10,5,38522,10,5,38576,10,5,39451,10,5,40584,10,5,40585,3,23.25888921888938,-1.2770708,36.8231093,-1.2802781,36.8311292,910,1,54,2008
1208,5457,722,3,Business,10,4,44207,10,4,44219,10,4,44594,10,4,45687,10,4,47306,15,24.9,-1.32943,36.894243,-1.3041129,36.8104939,418,1619,12,1468
1209,2641,3470,3,Business,30,5,33544,30,5,33672,30,5,34306,30,5,35749,30,5,36545,3,19.0,-1.28878,36.8168312,-1.3012902,36.80964,101,796,128,2077
1210,19443,1075,3,Business,9,6,33621,9,6,34119,9,6,35114,9,6,35518,9,6,36688,5,20.8,-1.2793686,36.8259233,-1.2527958,36.8003131,576,1170,498,1399
1211,1534,1073,3,Business,4,5,50314,4,5,50331,4,5,50684,4,5,51019,4,5,53480,9,23.25888921888938,-1.2563576,36.7881585,-1.3017433,36.8149586,382,2461,17,688
1212,14508,3781,3,Business,1,4,49222,1,4,49239,1,4,49284,1,4,51233,1,4,52431,10,23.25888921888938,-1.2128018,36.8326371,-1.26071,36.8206332,101,1198,17,1994
1213,18192,970,3,Business,11,1,40948,11,1,40966,11,1,42473,11,1,43889,11,1,47423,23,23.8,-1.3459625,36.9073925,-1.2551895,36.7822034,519,3534,18,2923
1214,20907,3017,3,Business,14,6,66556,14,6,66782,14,6,67130,14,6,67286,14,6,68111,4,18.8,-1.299313,36.7831488,-1.3004311,36.7524273,735,825,226,504
1215,23774,2982,3,Business,22,6,33414,22,6,33446,22,6,35247,22,6,35808,22,6,38220,18,20.2,-1.300921,36.828195,-1.177202,36.8351183,725,2412,32,2362
1216,10860,552,3,Business,12,3,59941,12,3,61774,12,3,62585,12,3,62851,12,3,63977,7,24.0,-1.3562374,36.9042954,-1.335477,36.9308297,927,1126,1833,1077
1217,1119,3360,2,Personal,18,3,46496,18,3,47231,18,3,48912,18,3,49926,18,3,52685,13,20.9,-1.328128,36.8719,-1.2555811,36.802267,848,2759,735,2695
1218,3776,251,1,Personal,28,1,37421,28,1,37540,28,1,40113,28,1,40576,28,1,41606,7,22.7,-1.3099145,36.8022774,-1.2945179,36.7685349,808,1030,119,3036
1219,7723,3326,3,Business,5,1,54232,5,1,55299,5,1,56523,5,1,56617,5,1,59845,9,25.8,-1.2551895,36.7822034,-1.3090727,36.8315262,878,3228,1067,1318
1220,19272,3291,3,Business,1,1,33305,1,1,33535,1,1,35299,1,1,35616,1,1,36809,11,21.3,-1.303596,36.778378,-1.2600926,36.8088685,855,1193,230,2081
1221,4621,3641,3,Business,11,2,52149,11,2,55369,11,2,55384,11,2,56663,11,2,58038,15,21.5,-1.2571472,36.7950633,-1.2257343,36.8933543,320,1375,3220,1294
1222,9871,84,3,Business,22,2,45374,22,2,45452,22,2,46143,22,2,46479,22,2,48059,11,23.8,-1.2551895,36.7822034,-1.3141837,36.8163275,758,1580,78,1027
1223,3432,649,3,Business,8,2,58040,8,2,58247,8,2,58767,8,2,59204,8,2,63106,22,25.2,-1.2551895,36.7822034,-1.3562374,36.9042954,512,3902,207,957
1224,15849,1148,3,Business,27,6,31151,27,6,32128,27,6,33372,27,6,33740,27,6,35358,14,23.25888921888938,-1.3100586,36.8500329,-1.2294985,36.8775495,715,1618,977,1612
1225,11729,478,3,Business,13,4,55402,13,4,55417,13,4,55618,13,4,56497,13,4,58154,11,22.9,-1.2551895,36.7822034,-1.3188899,36.8394916,690,1657,15,1080
1226,14040,3147,3,Business,10,4,53271,10,4,53321,10,4,54017,10,4,54216,10,4,56503,14,25.1,-1.3226302,36.8719901,-1.3472066,36.7692638,48,2287,50,895
1227,19614,1073,3,Business,6,3,42167,6,3,42232,6,3,42818,6,3,43197,6,3,44155,10,22.4,-1.2561964,36.7885001,-1.2766659,36.8432432,103,958,65,965
1228,16170,653,3,Business,2,6,55789,2,6,55957,2,6,58569,2,6,58779,2,6,62183,6,29.0,-1.279395,36.825364,-1.316315,36.8268861,686,3404,168,2822
1229,26518,2956,3,Business,8,3,59006,8,3,59232,8,3,60072,8,3,60382,8,3,64655,10,23.25888921888938,-1.2584143,36.8048002,-1.2413316,36.8785525,96,4273,226,1150
1230,25025,3186,3,Business,8,5,34503,8,5,34563,8,5,35990,8,5,36143,8,5,36940,5,22.9,-1.3060302,36.7665044,-1.2980229,36.78865,783,797,60,1580
1231,5665,3517,3,Business,22,2,52069,22,2,52092,22,2,52124,22,2,56228,22,2,58342,15,25.6,-1.300921,36.828195,-1.3882008,36.7699445,686,2114,23,4136
1232,4104,136,3,Business,2,2,38649,2,2,38784,2,2,40252,2,2,40640,2,2,44037,15,26.3,-1.2874648,36.8271985,-1.3254522,36.7216584,341,3397,135,1856
1233,14072,3557,3,Business,12,2,39000,12,2,39030,12,2,39280,12,2,40547,12,2,41299,2,24.4,-1.2652108,36.8056075,-1.2546732,36.8086796,531,752,30,1517
1234,4586,3003,1,Personal,20,4,37106,20,4,37626,20,4,38667,20,4,39420,20,4,41348,6,24.5,-1.322999,36.7832633,-1.296797,36.7764525,612,1928,520,1794
1235,14277,1329,3,Business,13,4,53561,13,4,55596,13,4,55636,13,4,57248,13,4,58729,9,23.2,-1.273056,36.811298,-1.3217618,36.8568179,75,1481,2035,1652
1236,22824,3718,3,Business,16,2,54875,16,2,54939,16,2,54976,16,2,55922,16,2,56781,5,27.5,-1.2650027,36.8126242,-1.2635744,36.781677,51,859,64,983
1237,2372,1500,3,Business,28,4,46603,28,4,46632,28,4,46795,28,4,48909,28,4,48926,8,27.3,-1.3004062,36.829741,-1.2638185,36.7930057,953,17,29,2277
1238,2573,1417,3,Business,8,3,57472,8,3,57525,8,3,58179,8,3,58462,8,3,59406,5,23.25888921888938,-1.2985749,36.8088,-1.2741728,36.7969108,607,944,53,937
1239,25657,3647,3,Business,18,5,47293,18,5,47361,18,5,48305,18,5,48716,18,5,49352,5,19.9,-1.272639,36.794723,-1.2592947,36.7698085,205,636,68,1355
1240,22597,1645,1,Personal,11,4,35401,11,4,35678,11,4,36356,11,4,36872,11,4,38390,8,18.3,-1.2727269,36.8298864,-1.3118872,36.8039137,844,1518,277,1194
1241,18307,2587,3,Business,12,1,46594,12,1,47500,12,1,48163,12,1,48300,12,1,49968,16,24.0,-1.207546,36.7913976,-1.28878,36.8168312,879,1668,906,800
1242,18700,3222,3,Business,21,2,50498,21,2,50527,21,2,50582,21,2,50848,21,2,50952,1,24.9,-1.2551895,36.7822034,-1.2549259,36.7919494,926,104,29,321
1243,13861,3440,1,Personal,5,5,49871,5,5,50032,5,5,50540,5,5,50961,5,5,51539,3,26.8,-1.2629818,36.8135865,-1.2617574,36.8025343,407,578,161,929
1244,27440,2642,3,Personal,18,5,56477,18,5,56490,18,5,58036,18,5,58417,18,5,61303,20,24.5,-1.326774,36.7878069,-1.3562374,36.9042954,432,2886,13,1927
1245,9700,3352,3,Personal,23,1,29735,23,1,29774,23,1,31667,23,1,31918,23,1,34187,10,14.4,-1.254778,36.790006,-1.3127304,36.8189817,726,2269,39,2144
1246,23645,478,3,Business,15,1,53403,15,1,53499,15,1,54492,15,1,55373,15,1,56076,3,23.25888921888938,-1.2551895,36.7822034,-1.2640571,36.7883547,177,703,96,1874
1247,10021,3149,3,Business,25,2,43491,25,2,44552,25,2,45666,25,2,47056,25,2,48767,15,24.0,-1.306378,36.7519845,-1.3177547,36.8303703,532,1711,1061,2504
1248,8738,393,3,Business,14,4,34862,14,4,34871,14,4,35352,14,4,37046,14,4,37047,14,17.9,-1.3167113,36.8301563,-1.306378,36.7519845,39,1,9,2175
1249,1281,733,3,Business,14,4,46914,14,4,47659,14,4,48401,14,4,48774,14,4,50728,20,27.8,-1.2551895,36.7822034,-1.3185307,36.9001089,205,1954,745,1115
1250,6013,2587,3,Business,7,1,44696,7,1,44821,7,1,47737,7,1,47880,7,1,49211,2,24.9,-1.2896431,36.8086201,-1.28878,36.8168312,899,1331,125,3059
1251,21041,914,3,Business,3,1,40938,3,1,40963,3,1,41581,3,1,43142,3,1,43889,6,20.4,-1.2995481,36.8190561,-1.2670213,36.7994482,857,747,25,2179
1252,27542,954,1,Personal,28,4,41099,28,4,41119,28,4,42534,28,4,42613,28,4,44372,16,23.25888921888938,-1.2763087,36.8170342,-1.3298445,36.7601244,874,1759,20,1494
1253,14958,1831,3,Business,5,2,59306,5,2,59594,5,2,60417,5,2,60796,5,2,63254,18,25.0,-1.282543,36.824618,-1.3562374,36.9042954,622,2458,288,1202
1254,2126,3647,3,Business,13,4,55196,13,4,55253,13,4,55370,13,4,55807,13,4,56813,6,23.0,-1.2921656,36.8104181,-1.272639,36.794723,564,1006,57,554
1255,14250,2383,3,Business,24,5,30919,24,5,30951,24,5,31116,24,5,31547,24,5,31901,2,18.3,-1.2608993,36.799246,-1.2516391,36.8114886,178,354,32,596
1256,654,2718,3,Business,11,1,44989,11,1,47207,11,1,47326,11,1,47861,11,1,49100,8,18.0,-1.2601,36.796528,-1.2859858,36.8224519,393,1239,2218,654
1257,25498,948,3,Business,28,2,40394,28,2,40488,28,2,43733,28,2,43935,28,2,47009,11,21.1,-1.3024388,36.859699,-1.2594474,36.8089122,25,3074,94,3447
1258,24541,71,3,Business,13,3,53112,13,3,53134,13,3,53510,13,3,56882,13,3,58320,1,23.6,-1.2864674,36.820262,-1.2821108,36.8250555,338,1438,22,3748
1259,2605,3275,1,Personal,9,4,39885,9,4,41696,9,4,43247,9,4,43671,9,4,44713,11,23.7,-1.1855066,36.8254646,-1.2143387,36.7914548,670,1042,1811,1975
1260,12013,1856,3,Business,5,2,58431,5,2,58678,5,2,59256,5,2,59828,5,2,60304,3,23.25888921888938,-1.2738936,36.8035805,-1.272798,36.8124195,763,476,247,1150
1261,27996,1934,2,Personal,21,6,35279,21,6,35332,21,6,35380,21,6,36332,21,6,38585,13,13.8,-1.2559294,36.788465,-1.2207656,36.8282605,215,2253,53,1000
1262,22852,2789,3,Business,3,1,32307,3,1,32361,3,1,33916,3,1,34275,3,1,34839,5,18.4,-1.304735,36.7846054,-1.2939186,36.8069693,942,564,54,1914
1263,8585,909,3,Business,18,4,57587,18,4,58518,18,4,61522,18,4,61720,18,4,64943,12,23.25888921888938,-1.225322,36.80855,-1.2765736,36.8513646,56,3223,931,3202
1264,16585,364,3,Personal,15,5,58788,15,5,59105,15,5,59924,15,5,60641,15,5,61284,5,27.7,-1.2665082,36.7963034,-1.2812015,36.8261246,576,643,317,1536
1265,1672,2639,3,Personal,14,5,45484,14,5,45537,14,5,46509,14,5,46773,14,5,50082,18,21.8,-1.32943,36.894243,-1.2661981,36.8154712,856,3309,53,1236
1266,5586,868,3,Business,23,4,35602,23,4,35803,23,4,36534,23,4,37361,23,4,38439,5,23.25888921888938,-1.2600926,36.8088685,-1.265715,36.823815,484,1078,201,1558
1267,18745,2841,1,Personal,25,1,45971,25,1,46148,25,1,46748,25,1,46918,25,1,48198,9,23.25888921888938,-1.2639254,36.8126952,-1.3044625,36.8543915,88,1280,177,770
1268,2224,1678,2,Personal,18,1,56421,18,1,57082,18,1,57990,18,1,58718,18,1,59385,6,17.4,-1.2939132,36.8081606,-1.2812997,36.7986672,425,667,661,1636
1269,24501,517,3,Business,3,1,31670,3,1,31799,3,1,32230,3,1,32367,3,1,34613,10,18.3,-1.3177547,36.8303703,-1.2574219,36.7927073,523,2246,129,568
1270,3934,3247,3,Business,8,1,51316,8,1,51337,8,1,51422,8,1,52116,8,1,53063,3,29.6,-1.273488,36.804158,-1.2571472,36.7950633,108,947,21,779
1271,18684,2733,3,Business,28,2,36421,28,2,36527,28,2,37650,28,2,39186,28,2,40813,8,21.1,-1.2813012,36.8323962,-1.2963097,36.7688221,19,1627,106,2659
1272,26989,1402,3,Business,31,4,43757,31,4,43845,31,4,44927,31,4,45201,31,4,45715,1,26.5,-1.2813012,36.8323962,-1.290894,36.822971,696,514,88,1356
1273,6544,722,3,Business,4,1,39110,4,1,39134,4,1,39374,4,1,40997,4,1,43558,19,25.5,-1.32943,36.894243,-1.25896,36.8016691,564,2561,24,1863
1274,20933,2789,3,Business,27,2,31333,27,2,31773,27,2,32096,27,2,32761,27,2,33720,7,18.7,-1.2862116,36.81147,-1.304735,36.7846054,726,959,440,988
1275,4956,2006,3,Business,19,1,36107,19,1,36128,19,1,36815,19,1,36912,19,1,37741,5,19.2,-1.2661264,36.8030359,-1.255956,36.772901,50,829,21,784
1276,7251,867,3,Business,29,1,35058,29,1,35069,29,1,35210,29,1,36802,29,1,36806,11,23.25888921888938,-1.2770708,36.8231093,-1.2991441,36.7528804,613,4,11,1733
1277,13732,393,3,Business,11,1,31294,11,1,31324,11,1,31337,11,1,34633,11,1,34637,14,18.2,-1.3167113,36.8301563,-1.306378,36.7519845,10,4,30,3309
1278,15062,3222,3,Business,28,4,55087,28,4,55182,28,4,57106,28,4,57326,28,4,60346,19,27.4,-1.2551895,36.7822034,-1.334474,36.88389,770,3020,95,2144
1279,15285,3652,1,Personal,28,4,54083,28,4,54541,28,4,54930,28,4,55137,28,4,56096,4,23.25888921888938,-1.3014515,36.8120092,-1.2856826,36.8255265,851,959,458,596
1280,5800,2688,2,Personal,16,3,56790,16,3,56825,16,3,57266,16,3,57692,16,3,58615,4,25.5,-1.2962603,36.7766164,-1.2897215,36.7945959,898,923,35,867
1281,20192,2330,3,Business,25,1,43624,25,1,43716,25,1,45676,25,1,45915,25,1,46929,9,26.9,-1.2291477,36.8440295,-1.2524916,36.8656196,307,1014,92,2199
1282,4811,2801,3,Business,25,1,39227,25,1,39243,25,1,39287,25,1,40503,25,1,42230,8,23.25888921888938,-1.2595422,36.7871178,-1.2925919,36.8170577,103,1727,16,1260
1283,22908,1244,3,Business,19,6,38774,19,6,38792,19,6,40218,19,6,40622,19,6,43128,16,25.0,-1.3346773,36.8842734,-1.303596,36.778378,777,2506,18,1830
1284,8081,517,3,Business,8,6,43177,8,6,43244,8,6,43663,8,6,45981,8,6,46406,13,20.0,-1.3228003,36.8306435,-1.2991441,36.7528804,624,425,67,2737
1285,9931,633,3,Business,21,4,57113,21,4,57385,21,4,58121,21,4,58613,21,4,59674,9,26.2,-1.2638185,36.7930057,-1.3004062,36.829741,206,1061,272,1228
1286,2855,496,3,Business,26,2,33543,26,2,33580,26,2,33586,26,2,34268,26,2,36665,26,23.25888921888938,-1.2551895,36.7822034,-1.3916459,36.9305892,523,2397,37,688
1287,5271,635,3,Business,25,6,48093,25,6,48195,25,6,48493,25,6,49698,25,6,51574,7,23.25888921888938,-1.2602337,36.7990548,-1.2976287,36.7744015,617,1876,102,1503
1288,23932,1687,3,Business,7,5,42252,7,5,42650,7,5,43200,7,5,43341,7,5,45400,3,25.4,-1.2626574,36.8014034,-1.2755629,36.8131522,857,2059,398,691
1289,21315,2561,3,Business,29,4,33281,29,4,33772,29,4,34622,29,4,34927,29,4,37511,7,18.5,-1.2551895,36.7822034,-1.2880771,36.8269099,726,2584,491,1155
1290,19998,540,3,Business,24,3,45404,24,3,45499,24,3,46780,24,3,48444,24,3,49765,9,19.7,-1.2978908,36.7963215,-1.2551895,36.7822034,565,1321,95,2945
1291,12753,909,3,Business,18,1,51627,18,1,51822,18,1,53087,18,1,53302,18,1,54587,8,31.0,-1.225322,36.80855,-1.2733047,36.8109744,953,1285,195,1480
1292,894,3283,3,Business,18,4,39047,18,4,39057,18,4,39195,18,4,39443,18,4,40521,7,23.25888921888938,-1.303596,36.778378,-1.2628473,36.781805,99,1078,10,386
1293,22853,1029,2,Personal,20,1,44524,20,1,44554,20,1,45327,20,1,45463,20,1,48045,10,20.0,-1.2507752,36.7556628,-1.2925792,36.79069,770,2582,30,909
1294,8216,2200,3,Business,26,5,55883,26,5,56586,26,5,57118,26,5,57591,26,5,58667,6,23.25888921888938,-1.2584143,36.8048002,-1.290894,36.822971,237,1076,703,1005
1295,4566,3434,3,Business,2,3,47416,2,3,47617,2,3,48664,2,3,49683,2,3,52665,22,23.6,-1.3261259,36.904086,-1.2963097,36.7688221,791,2982,201,2066
1296,14863,2956,3,Business,7,2,57819,7,2,57843,7,2,58203,7,2,58473,7,2,59068,4,23.25888921888938,-1.2584143,36.8048002,-1.2551895,36.7822034,177,595,24,630
1297,18822,3647,3,Business,3,4,55902,3,4,56222,3,4,57038,3,4,57183,3,4,59036,9,24.9,-1.272639,36.794723,-1.2930128,36.8356869,56,1853,320,961
1298,14579,893,3,Business,18,5,50825,18,5,50842,18,5,51423,18,5,51532,18,5,52120,3,26.9,-1.2663194,36.809901,-1.2574088,36.799712,611,588,17,690
1299,21920,3017,3,Business,10,2,62341,10,2,64134,10,2,64522,10,2,65024,10,2,66291,9,20.5,-1.299313,36.7831488,-1.3202198,36.8026069,465,1267,1793,890
1300,20817,3154,1,Business,12,3,59615,12,3,59629,12,3,60083,12,3,60928,12,3,62172,16,24.1,-1.3326173,36.7146233,-1.3233496,36.8139159,620,1244,14,1299
1301,4163,3404,3,Business,23,5,46835,23,5,46973,23,5,48121,23,5,49102,23,5,50628,9,26.4,-1.279395,36.825364,-1.2413316,36.8785525,660,1526,138,2129
1302,23701,1271,3,Business,11,2,58043,11,2,58699,11,2,59408,11,2,59806,11,2,62420,10,21.2,-1.3107918,36.761794,-1.2805757,36.8223948,267,2614,656,1107
1303,2481,618,1,Personal,10,5,52027,10,5,52079,10,5,53127,10,5,53347,10,5,55498,8,21.8,-1.2840605,36.8191699,-1.2853885,36.775643,519,2151,52,1268
1304,26303,3091,3,Business,26,1,57765,26,1,57971,26,1,58653,26,1,58811,26,1,60093,8,22.0,-1.3012008,36.764868,-1.2551895,36.7822034,698,1282,206,840
1305,6657,1402,3,Business,7,4,55769,7,4,55925,7,4,57626,7,4,58166,7,4,59527,2,30.9,-1.2813012,36.8323962,-1.2848174,36.826163,653,1361,156,2241
1306,1725,20,3,Business,7,5,46178,7,5,46332,7,5,48070,7,5,48183,7,5,49121,8,25.5,-1.2629666,36.8068369,-1.2930128,36.8356869,726,938,154,1851
1307,1564,633,3,Business,20,3,48050,20,3,48058,20,3,48061,20,3,49220,20,3,49222,9,28.6,-1.2638185,36.7930057,-1.3004062,36.829741,39,2,8,1162
1308,17558,2069,3,Business,10,1,54754,10,1,54940,10,1,55613,10,1,56709,10,1,58291,15,18.1,-1.318062,36.849326,-1.228911,36.881876,416,1582,186,1769
1309,13500,1363,3,Business,18,4,51233,18,4,51268,18,4,51408,18,4,51861,18,4,52536,5,26.8,-1.3004062,36.829741,-1.3177547,36.8303703,519,675,35,593
1310,27810,627,3,Business,6,3,45178,6,3,45218,6,3,46384,6,3,46477,6,3,46479,3,23.25888921888938,-1.2551895,36.7822034,-1.2569383,36.7880021,647,2,40,1259
1311,26615,633,3,Business,22,5,27090,22,5,27102,22,5,27332,22,5,28825,22,5,28849,4,22.2,-1.3077869,36.8443207,-1.3004062,36.829741,119,24,12,1723
1312,12328,2868,1,Personal,2,4,33449,2,4,33456,2,4,33569,2,4,34481,2,4,34939,2,13.4,-1.2943371,36.8267,-1.3044313,36.818504,414,458,7,1025
1313,18159,587,1,Personal,22,5,54461,22,5,55105,22,5,56998,22,5,57668,22,5,58160,5,23.25888921888938,-1.2582194,36.8194689,-1.2371615,36.8084033,616,492,644,2563
1314,21116,577,3,Personal,26,6,34172,26,6,34238,26,6,34527,26,6,35019,26,6,36938,12,20.5,-1.3270347,36.8667362,-1.3628439,36.9407567,418,1919,66,781
1315,5068,3147,3,Business,8,1,35182,8,1,35198,8,1,35422,8,1,35963,8,1,38072,23,19.6,-1.3467389,36.7690312,-1.3002993,36.9153417,420,2109,16,765
1316,8573,1373,2,Personal,7,6,45187,7,6,45201,7,6,46153,7,6,46347,7,6,48079,10,18.8,-1.2906604,36.8318242,-1.2884354,36.7606766,33,1732,14,1146
1317,17130,3560,3,Business,20,3,44054,20,3,44154,20,3,44654,20,3,44775,20,3,45990,7,26.5,-1.279395,36.825364,-1.2551895,36.7822034,41,1215,100,621
1318,5387,582,1,Personal,6,6,44983,6,6,44999,6,6,45501,6,6,46150,6,6,47885,9,24.2,-1.2709035,36.8168523,-1.299259,36.763364,263,1735,16,1151
1319,17289,1471,3,Business,30,2,40482,30,2,40587,30,2,42108,30,2,42295,30,2,45913,8,23.25888921888938,-1.2551895,36.7822034,-1.3037387,36.8175661,533,3618,105,1708
1320,11809,1207,3,Business,9,5,69751,9,5,69857,9,5,70212,9,5,71263,9,5,72534,8,20.7,-1.2629666,36.8068369,-1.2745321,36.765088,86,1271,106,1406
1321,9813,3300,3,Business,11,4,37285,11,4,37330,11,4,38158,11,4,38583,11,4,40288,11,25.6,-1.318062,36.849326,-1.303596,36.778378,154,1705,45,1253
1322,24855,3647,3,Business,30,2,53202,30,2,53226,30,2,53839,30,2,54076,30,2,54940,4,27.3,-1.265971,36.766806,-1.272639,36.794723,727,864,24,850
1323,10976,2330,3,Business,28,4,56530,28,4,56778,28,4,56784,28,4,59672,28,4,64006,9,25.8,-1.2649605,36.7981777,-1.3015197,36.7658456,926,4334,248,2894
1324,15300,533,3,Business,21,1,52075,21,1,52105,21,1,53031,21,1,53854,21,1,54635,4,27.7,-1.3014461,36.7661381,-1.2765492,36.7669809,79,781,30,1749
1325,7618,3689,3,Business,10,1,51641,10,1,51680,10,1,51723,10,1,52108,10,1,52414,1,23.25888921888938,-1.2649605,36.7981777,-1.2527958,36.8003131,648,306,39,428
1326,13568,3240,2,Personal,27,4,33901,27,4,33909,27,4,34186,27,4,34292,27,4,36101,12,19.0,-1.3212168,36.8276058,-1.2551895,36.7822034,62,1809,8,383
1327,28078,2700,3,Business,23,5,48072,23,5,56501,23,5,56557,23,5,57248,23,5,58273,4,26.2,-1.2845902,36.8254724,-1.2845835,36.8079121,102,1025,8429,747
1328,19262,3655,1,Personal,6,6,56159,6,6,56377,6,6,57264,6,6,58080,6,6,60489,12,27.8,-1.2332989,36.8130698,-1.2832116,36.788102,662,2409,218,1703
1329,15030,2066,3,Business,3,5,52243,3,5,52253,3,5,52748,3,5,53123,3,5,55102,10,25.0,-1.316961,36.820337,-1.2650413,36.7980137,865,1979,10,870
1330,19054,393,3,Business,20,3,31960,20,3,31970,20,3,31975,20,3,35063,20,3,35065,14,20.9,-1.3167113,36.8301563,-1.2991441,36.7528804,239,2,10,3093
1331,18732,3091,3,Business,30,2,48458,30,2,48492,30,2,48614,30,2,49767,30,2,54290,6,23.25888921888938,-1.290894,36.822971,-1.2584143,36.8048002,812,4523,34,1275
1332,12626,635,3,Business,5,3,42626,5,3,42736,5,3,45472,5,3,46580,5,3,47427,11,22.5,-1.2599563,36.7993439,-1.3229345,36.8566974,813,847,110,3844
1333,10434,2330,3,Business,31,4,52873,31,4,52902,31,4,52925,31,4,53430,31,4,53901,2,28.8,-1.2642903,36.8002137,-1.2695287,36.7981777,219,471,29,528
1334,17040,3718,3,Business,18,4,52808,18,4,52831,18,4,54818,18,4,55899,18,4,60518,14,26.9,-1.2650027,36.8126242,-1.3178524,36.7139804,755,4619,23,3068
1335,1822,733,3,Business,22,5,47981,22,5,48000,22,5,48026,22,5,48470,22,5,49991,16,23.25888921888938,-1.2551895,36.7822034,-1.2156006,36.8916865,523,1521,19,470
1336,13249,1500,3,Business,4,1,37798,4,1,39967,4,1,40746,4,1,41171,4,1,42503,8,26.7,-1.3004062,36.829741,-1.2638185,36.7930057,559,1332,2169,1204
1337,15417,1764,1,Personal,7,1,38312,7,1,38392,7,1,39234,7,1,39419,7,1,41325,8,21.3,-1.279199,36.8224926,-1.2962603,36.7766164,771,1906,80,1027
1338,18611,3475,1,Personal,10,5,41418,10,5,41967,10,5,46250,10,5,46539,10,5,48407,14,19.3,-1.2778747,36.8831829,-1.2644742,36.8083457,700,1868,549,4572
1339,22592,187,3,Business,11,1,42158,11,1,42163,11,1,42168,11,1,44337,11,1,46198,27,18.1,-1.2859912,36.8756811,-1.3169591,36.7000029,408,1861,5,2174
1340,24911,746,2,Personal,22,5,39546,22,5,39679,22,5,41957,22,5,42476,22,5,44104,9,21.9,-1.2880771,36.8269099,-1.2867726,36.7630367,844,1628,133,2797
1341,17556,321,1,Personal,4,6,40899,4,6,40924,4,6,41428,4,6,42247,4,6,44022,13,20.0,-1.3246123,36.7902267,-1.2749209,36.7857781,798,1775,25,1323
1342,10992,909,3,Business,10,5,57791,10,5,57943,10,5,60499,10,5,61688,10,5,64523,13,21.0,-1.290894,36.822971,-1.225322,36.80855,519,2835,152,3745
1343,24052,577,1,Personal,13,1,52417,13,1,52436,13,1,52949,13,1,53088,13,1,54457,12,19.6,-1.3270347,36.8667362,-1.2662728,36.8151265,650,1369,19,652
1344,22898,2517,1,Personal,27,1,68552,27,1,68592,27,1,69657,27,1,69870,27,1,71663,7,17.7,-1.2682179,36.8009289,-1.2979147,36.7857814,770,1793,40,1278
1345,22333,3686,3,Business,26,5,33762,26,5,33779,26,5,33818,26,5,34035,26,5,34056,2,23.25888921888938,-1.2551895,36.7822034,-1.255392,36.792539,876,21,17,256
1346,9158,3090,2,Personal,18,2,37414,18,2,37431,18,2,38266,18,2,38354,18,2,40076,8,22.7,-1.2602192,36.7878612,-1.2885504,36.8066908,532,1722,17,923
1347,4987,893,3,Business,23,4,46430,23,4,46442,23,4,46826,23,4,47509,23,4,49019,17,23.1,-1.2663194,36.809901,-1.3373345,36.7118861,660,1510,12,1067
1348,15947,1329,3,Business,30,6,57313,30,6,57335,30,6,58110,30,6,61184,30,6,61187,6,28.1,-1.273056,36.811298,-1.2886434,36.7709868,613,3,22,3849
1349,7807,1341,3,Business,13,3,52720,13,3,52755,13,3,53100,13,3,53690,13,3,53889,7,29.4,-1.307143,36.825009,-1.331619,36.847976,633,199,35,935
1350,6146,635,3,Business,3,3,48609,3,3,48963,3,3,50705,3,3,51515,3,3,54663,7,28.1,-1.3081376,36.8329772,-1.2648164,36.8057234,508,3148,354,2552
1351,18587,435,3,Business,27,1,52442,27,1,52485,27,1,55321,27,1,56264,27,1,59634,10,23.2,-1.3000978,36.7658352,-1.300921,36.828195,92,3370,43,3779
1352,21185,393,3,Business,30,2,31415,30,2,31703,30,2,32567,30,2,34166,30,2,34172,8,23.25888921888938,-1.3167113,36.8301563,-1.2770708,36.8231093,921,6,288,2463
1353,18448,540,3,Business,10,1,50989,10,1,51111,10,1,51631,10,1,51865,10,1,53933,8,18.8,-1.2551895,36.7822034,-1.2940713,36.7890758,205,2068,122,754
1354,2949,478,3,Business,30,2,53771,30,2,58304,30,2,58945,30,2,59120,30,2,64025,8,23.25888921888938,-1.2551895,36.7822034,-1.2857117,36.7968296,548,4905,4533,816
1355,3921,1329,3,Business,15,5,34764,15,5,34795,15,5,35098,15,5,35280,15,5,36870,12,19.0,-1.273056,36.811298,-1.2672045,36.7172069,953,1590,31,485
1356,5853,2330,3,Business,18,4,39732,18,4,39746,18,4,39789,18,4,41202,18,4,41637,12,23.25888921888938,-1.293082,36.8278578,-1.2284323,36.8757058,61,435,14,1456
1357,15820,1724,3,Business,5,1,48236,5,1,48271,5,1,49255,5,1,49794,5,1,50594,8,26.0,-1.2907854,36.7774108,-1.2551895,36.7822034,952,800,35,1523
1358,24777,2523,3,Business,23,2,34140,23,2,34153,23,2,34393,23,2,34784,23,2,36555,14,23.25888921888938,-1.2551895,36.7822034,-1.329568,36.8520825,958,1771,13,631
1359,3302,2532,3,Business,31,3,52194,31,3,52644,31,3,53116,31,3,54092,31,3,54982,6,27.1,-1.2551895,36.7822034,-1.281606,36.8150086,237,890,450,1448
1360,5699,242,3,Business,28,4,56235,28,4,56248,28,4,57174,28,4,57701,28,4,59528,17,23.25888921888938,-1.2551895,36.7822034,-1.3286928,36.8925243,808,1827,13,1453
1361,1241,1245,3,Business,2,5,43539,2,5,44109,2,5,44990,2,5,46842,2,5,50202,17,23.5,-1.300921,36.828195,-1.3156678,36.713569,859,3360,570,2733
1362,11835,111,3,Business,15,3,54097,15,3,54113,15,3,56248,15,3,56478,15,3,57091,4,26.1,-1.2551895,36.7822034,-1.2728947,36.8079426,422,613,16,2365
1363,4484,1753,2,Business,13,6,32109,13,6,32209,13,6,33273,13,6,33402,13,6,34608,10,23.25888921888938,-1.2551895,36.7822034,-1.3046156,36.7658572,178,1206,100,1193
1364,8543,2701,3,Business,14,3,36522,14,3,36564,14,3,37445,14,3,37570,14,3,41904,11,18.6,-1.2765736,36.8513646,-1.2571472,36.7950633,248,4334,42,1006
1365,17808,269,3,Business,31,2,49342,31,2,52784,31,2,53403,31,2,53821,31,2,54972,10,22.1,-1.3332749,36.8708147,-1.293278,36.827789,409,1151,3442,1037
1366,11739,1195,3,Business,6,6,42352,6,6,42378,6,6,43021,6,6,43661,6,6,45794,15,24.1,-1.2991441,36.7528804,-1.3177547,36.8303703,31,2133,26,1283
1367,21096,3688,3,Business,3,3,56733,3,3,56845,3,3,58403,3,3,58533,3,3,60697,6,28.2,-1.2736466,36.8164042,-1.2551895,36.7822034,166,2164,112,1688
1368,18489,706,3,Business,4,4,55291,4,4,55295,4,4,55303,4,4,55753,4,4,56062,2,24.9,-1.3077869,36.8443207,-1.3006971,36.8314135,848,309,4,458
1369,22242,3032,3,Business,19,3,35163,19,3,35267,19,3,37960,19,3,38783,19,3,40912,12,22.3,-1.2571472,36.7950633,-1.3246119,36.7833339,362,2129,104,3516
1370,6733,3718,3,Business,20,2,40779,20,2,40789,20,2,41092,20,2,41600,20,2,41996,3,19.9,-1.2561334,36.7990458,-1.2650027,36.8126242,932,396,10,811
1371,5332,1500,3,Business,19,1,31740,19,1,32568,19,1,35664,19,1,35726,19,1,37346,8,19.2,-1.3004062,36.829741,-1.2574219,36.7927073,532,1620,828,3158
1372,18321,1850,3,Business,3,3,36204,3,3,36276,3,3,36310,3,3,37301,3,3,38582,6,21.5,-1.3173869,36.8112044,-1.285382,36.8162878,258,1281,72,1025
1373,7692,2718,3,Business,25,5,38487,25,5,38528,25,5,38797,25,5,39727,25,5,40956,3,21.0,-1.2595467,36.8113044,-1.2601,36.796528,727,1229,41,1199
1374,8722,2330,3,Business,7,5,38859,7,5,38999,7,5,41365,7,5,42223,7,5,42231,3,23.25888921888938,-1.2890715,36.8157588,-1.2915247,36.8055757,271,8,140,3224
1375,1156,3203,3,Business,8,5,54988,8,5,57141,8,5,57992,8,5,60537,8,5,62038,17,19.8,-1.331619,36.847976,-1.228911,36.881876,116,1501,2153,3396
1376,933,1268,1,Personal,12,5,35350,12,5,35723,12,5,37416,12,5,37605,12,5,39756,9,18.6,-1.273757,36.821634,-1.293554,36.763113,532,2151,373,1882
1377,229,1907,2,Personal,26,3,50692,26,3,50746,26,3,51170,26,3,51367,26,3,52673,8,27.1,-1.2861184,36.8159704,-1.30217,36.770468,698,1306,54,621
1378,6262,2314,2,Personal,11,2,69556,11,2,69585,11,2,71000,11,2,71460,11,2,73175,11,18.4,-1.2839842,36.7921296,-1.2482518,36.7550829,379,1715,29,1875
1379,13270,3621,3,Business,10,6,28229,10,6,28255,10,6,28618,10,6,28986,10,6,29599,5,20.7,-1.2836583,36.7886014,-1.2857701,36.7591723,45,613,26,731
1380,8905,2976,3,Business,24,4,34714,24,4,34815,24,4,35600,24,4,36111,24,4,36794,6,16.8,-1.2696819,36.8028694,-1.2478668,36.8069224,116,683,101,1296
1381,26777,2363,1,Personal,3,2,60528,3,2,60630,3,2,61176,3,2,61613,3,2,63050,11,18.8,-1.2649605,36.7981777,-1.2095044,36.7832064,103,1437,102,983
1382,25177,265,3,Business,11,1,41961,11,1,42000,11,1,42678,11,1,42990,11,1,43924,12,26.4,-1.329285,36.8867853,-1.300921,36.828195,402,934,39,990
1383,19630,3283,3,Business,4,2,49815,4,2,50217,4,2,51621,4,2,53942,4,2,57114,13,22.7,-1.331619,36.847976,-1.2628473,36.781805,864,3172,402,3725
1384,26631,2030,3,Business,17,1,50972,17,1,52001,17,1,53219,17,1,53812,17,1,55397,14,24.8,-1.1490105,36.9307413,-1.2156006,36.8916865,40,1585,1029,1811
1385,23521,1148,3,Business,28,4,38366,28,4,39932,28,4,40781,28,4,40885,28,4,42852,10,28.0,-1.3100586,36.8500329,-1.2649605,36.7981777,61,1967,1566,953
1386,25482,3222,3,Business,28,2,32606,28,2,32764,28,2,33505,28,2,33569,28,2,35175,9,18.8,-1.2551895,36.7822034,-1.3074264,36.8226123,706,1606,158,805
1387,27030,2436,3,Business,18,4,44896,18,4,44943,18,4,45503,18,4,46128,18,4,47626,5,23.25888921888938,-1.2696908,36.81519,-1.2551895,36.7822034,498,1498,47,1185
1388,12052,1724,3,Business,29,2,58379,29,2,58648,29,2,59545,29,2,60056,29,2,62382,8,22.4,-1.2553615,36.7895376,-1.2879618,36.8200863,644,2326,269,1408
1389,2992,1346,3,Business,23,5,52132,23,5,52596,23,5,53659,23,5,53963,23,5,54987,6,26.2,-1.2695287,36.7981777,-1.2917868,36.7872675,322,1024,464,1367
1390,2412,393,3,Business,17,4,30014,17,4,30020,17,4,30185,17,4,30675,17,4,32653,14,23.25888921888938,-1.3167113,36.8301563,-1.2991441,36.7528804,523,1978,6,655
1391,17707,186,3,Business,30,4,30480,30,4,30754,30,4,31371,30,4,32995,30,4,36833,6,16.2,-1.2902869,36.8085396,-1.2571472,36.7950633,566,3838,274,2241
1392,3291,140,3,Personal,23,2,59048,23,2,59679,23,2,60275,23,2,60578,23,2,62362,9,23.25888921888938,-1.2944292,36.7793569,-1.2546209,36.8016025,245,1784,631,899
1393,2208,63,3,Personal,19,3,35310,19,3,35398,19,3,35404,19,3,36248,19,3,37574,13,19.6,-1.2737091,36.8131533,-1.2762879,36.9024933,403,1326,88,850
1394,27054,2330,3,Business,30,2,44230,30,2,45147,30,2,45239,30,2,45756,30,2,47454,8,23.25888921888938,-1.3015197,36.7658456,-1.2890715,36.8157588,99,1698,917,609
1395,16553,1329,3,Business,5,3,37233,5,3,39636,5,3,40783,5,3,40932,5,3,41661,4,22.3,-1.273056,36.811298,-1.2615888,36.7928732,611,729,2403,1296
1396,19709,3262,3,Personal,23,2,43353,23,2,43379,23,2,43975,23,2,44060,23,2,46743,35,23.25888921888938,-1.255611,36.815386,-1.0921599,37.005025,710,2683,26,681
1397,7774,393,3,Business,19,2,35209,19,2,35522,19,2,35983,19,2,36621,19,2,37141,4,23.25888921888938,-1.3167113,36.8301563,-1.3004062,36.829741,15,520,313,1099
1398,27822,2931,3,Business,17,5,44549,17,5,44916,17,5,46121,17,5,46270,17,5,47372,7,23.25888921888938,-1.2862984,36.8293971,-1.2452664,36.8028541,119,1102,367,1354
1399,23588,1932,3,Business,29,2,52659,29,2,52730,29,2,54160,29,2,55406,29,2,55789,2,23.9,-1.2873232,36.7658572,-1.2922857,36.7813274,919,383,71,2676
1400,11925,391,3,Business,23,2,49016,23,2,49411,23,2,49677,23,2,51016,23,2,51788,5,23.25888921888938,-1.300921,36.828195,-1.2867454,36.8259017,456,772,395,1605
1401,26522,2869,3,Business,3,3,33106,3,3,33339,3,3,33740,3,3,34261,3,3,37541,19,21.2,-1.2859912,36.8756811,-1.3025826,36.7670807,50,3280,233,922
1402,3712,1280,3,Business,14,5,39146,14,5,39156,14,5,39273,14,5,39551,14,5,39905,4,21.8,-1.2551895,36.7822034,-1.2585521,36.7945765,727,354,10,395
1403,10826,2284,3,Personal,29,2,43247,29,2,43783,29,2,45669,29,2,45921,29,2,46630,6,21.3,-1.2517392,36.8249608,-1.2823851,36.8186472,320,709,536,2138
1404,11542,1995,3,Business,17,3,60639,17,3,61799,17,3,61818,17,3,62038,17,3,63973,10,23.25888921888938,-1.2551895,36.7822034,-1.2765736,36.8513646,613,1935,1160,239
1405,23649,2216,3,Business,3,5,57458,3,5,58126,3,5,58948,3,5,59472,3,5,60638,9,23.25888921888938,-1.2551895,36.7822034,-1.225322,36.80855,177,1166,668,1346
1406,874,2052,2,Personal,27,4,58311,27,4,58328,27,4,59215,27,4,59884,27,4,61602,9,23.2,-1.312715,36.8077464,-1.2657464,36.7801144,612,1718,17,1556
1407,12737,2008,3,Business,2,4,32057,2,4,32098,2,4,34336,2,4,35896,2,4,36838,6,23.25888921888938,-1.2508229,36.7895263,-1.285244,36.832159,119,942,41,3798
1408,6924,3517,3,Business,31,5,37934,31,5,37956,31,5,38259,31,5,39649,31,5,41486,19,21.9,-1.3207708,36.8685919,-1.3882008,36.7699445,243,1837,22,1693
1409,11559,1243,1,Business,15,3,50927,15,3,50964,15,3,51684,15,3,51923,15,3,52949,7,21.8,-1.304524,36.775371,-1.3034396,36.8329998,754,1026,37,959
1410,23894,2457,3,Business,6,2,41543,6,2,45439,6,2,46537,6,2,46862,6,2,48847,7,25.2,-1.2551895,36.7822034,-1.289498,36.818878,671,1985,3896,1423
1411,11818,3565,3,Business,25,5,27459,25,5,27481,25,5,28350,25,5,29727,25,5,31653,20,17.1,-1.2844665,36.7866113,-1.355309,36.6541393,116,1926,22,2246
1412,9753,3781,3,Business,25,4,44833,25,4,47263,25,4,48922,25,4,51389,25,4,53461,10,20.8,-1.2128018,36.8326371,-1.26071,36.8206332,237,2072,2430,4126
1413,5996,2987,3,Business,16,1,44118,16,1,46194,16,1,46572,16,1,46931,16,1,47895,10,19.1,-1.270212,36.8210877,-1.2297202,36.8819507,427,964,2076,737
1414,13514,2200,3,Business,30,5,42352,30,5,42409,30,5,43929,30,5,44291,30,5,45937,12,23.6,-1.225322,36.80855,-1.290894,36.822971,928,1646,57,1882
1415,13258,94,1,Personal,28,2,39283,28,2,39302,28,2,39960,28,2,42866,28,2,43450,3,17.4,-1.2719423,36.8205148,-1.265007,36.8149619,414,584,19,3564
1416,23052,3312,3,Business,9,3,40774,9,3,40836,9,3,41530,9,3,41913,9,3,44095,13,25.3,-1.2583017,36.8023526,-1.2159575,36.8311829,205,2182,62,1077
1417,11240,2911,1,Personal,17,4,49239,17,4,49267,17,4,50062,17,4,50371,17,4,50748,3,23.7,-1.3066143,36.8161046,-1.3004062,36.829741,742,377,28,1104
1418,22527,868,3,Business,13,2,48531,13,2,48542,13,2,49180,13,2,49424,13,2,50013,5,26.1,-1.2600926,36.8088685,-1.265715,36.823815,557,589,11,882
1419,21062,2383,3,Business,18,2,54941,18,2,54998,18,2,55025,18,2,55472,18,2,55605,2,25.4,-1.2608993,36.799246,-1.2516391,36.8114886,31,133,57,474
1420,18044,393,3,Business,4,2,44969,4,2,45031,4,2,45268,4,2,45705,4,2,47303,11,20.6,-1.3228003,36.8306435,-1.2638185,36.7930057,36,1598,62,674
1421,21916,970,3,Business,12,1,54396,12,1,55191,12,1,56251,12,1,56333,12,1,57738,11,27.0,-1.2551895,36.7822034,-1.2217967,36.81099,744,1405,795,1142
1422,5681,1280,3,Business,30,2,36761,30,2,36804,30,2,37391,30,2,37597,30,2,38245,4,23.25888921888938,-1.2551895,36.7822034,-1.2715686,36.8023526,607,648,43,793
1423,12562,2956,3,Business,23,5,49077,23,5,49119,23,5,49736,23,5,50569,23,5,50805,1,26.4,-1.2571472,36.7950633,-1.2584143,36.8048002,547,236,42,1450
1424,24266,867,3,Business,9,5,53389,9,5,53432,9,5,53453,9,5,53733,9,5,55078,12,26.1,-1.306378,36.7519845,-1.2996533,36.8292629,93,1345,43,301
1425,23064,2781,3,Personal,11,6,46473,11,6,46559,11,6,49080,11,6,49146,11,6,52214,14,23.25888921888938,-1.296599,36.7629672,-1.3393293,36.6642273,523,3068,86,2587
1426,5099,3222,3,Business,9,4,43644,9,4,43662,9,4,43773,9,4,44253,9,4,45253,5,23.25888921888938,-1.2551895,36.7822034,-1.2731645,36.7900343,161,1000,18,591
1427,21427,2982,3,Business,12,5,44340,12,5,44349,12,5,45713,12,5,46859,12,5,49897,22,24.4,-1.300921,36.828195,-1.1917753,36.9211989,581,3038,9,2510
1428,22222,2701,3,Business,1,4,33479,1,4,33532,1,4,35929,1,4,37111,1,4,38879,12,23.25888921888938,-1.3027293,36.7661974,-1.2765736,36.8513646,588,1768,53,3579
1429,13953,393,3,Business,8,5,48928,8,5,48996,8,5,49005,8,5,49965,8,5,50500,4,27.0,-1.3167113,36.8301563,-1.3004062,36.829741,901,535,68,969
1430,25027,186,3,Business,24,4,32121,24,4,32154,24,4,35725,24,4,35816,24,4,38774,23,19.6,-1.3700383,36.9190174,-1.2571472,36.7950633,498,2958,33,3662
1431,9477,1502,3,Business,1,4,48356,1,4,49158,1,4,49605,1,4,50531,1,4,51459,12,23.25888921888938,-1.2874501,36.8261229,-1.2156006,36.8916865,320,928,802,1373
1432,27428,909,3,Business,12,2,61053,12,2,61085,12,2,62270,12,2,62749,12,2,64384,11,21.0,-1.2615888,36.7928732,-1.225322,36.80855,101,1635,32,1664
1433,15935,1075,3,Business,6,6,56764,6,6,56782,6,6,57877,6,6,58097,6,6,58729,1,27.9,-1.2649605,36.7981777,-1.2527958,36.8003131,318,632,18,1315
1434,24900,2804,3,Business,15,5,55932,15,5,56084,15,5,56811,15,5,57736,15,5,58101,3,28.0,-1.2551895,36.7822034,-1.2659149,36.8054322,881,365,152,1652
1435,10227,3080,3,Business,13,5,44350,13,5,44360,13,5,44811,13,5,46944,13,5,48538,17,23.25888921888938,-1.2551895,36.7822034,-1.3434,36.711224,116,1594,10,2584
1436,18843,246,3,Business,13,4,40387,13,4,40520,13,4,40722,13,4,41393,13,4,41811,3,23.3,-1.2584143,36.8048002,-1.2551895,36.7822034,100,418,133,873
1437,10214,2523,3,Business,10,3,35470,10,3,35506,10,3,36130,10,3,36202,10,3,37345,7,21.7,-1.2551895,36.7822034,-1.282937,36.7816984,828,1143,36,696
1438,11577,1827,3,Business,5,6,42934,5,6,42942,5,6,42959,5,6,44165,5,6,45034,11,22.2,-1.318062,36.849326,-1.293515,36.897607,408,869,8,1223
1439,4615,3688,3,Business,28,1,53430,28,1,53463,28,1,53848,28,1,54071,28,1,55207,6,26.4,-1.2551895,36.7822034,-1.2737591,36.8142522,381,1136,33,608
1440,12047,393,3,Business,29,1,39980,29,1,44456,29,1,44461,29,1,45150,29,1,47799,10,23.25888921888938,-1.3177547,36.8303703,-1.2574219,36.7927073,702,2649,4476,694
1441,25045,788,3,Business,27,3,50684,27,3,51061,27,3,51822,27,3,52244,27,3,53913,12,23.25888921888938,-1.2771683,36.8209872,-1.225322,36.80855,844,1669,377,1183
1442,25939,3203,3,Business,9,4,38015,9,4,38209,9,4,39646,9,4,39902,9,4,40650,6,23.8,-1.2296618,36.8438272,-1.228911,36.881876,427,748,194,1693
1443,10365,3080,3,Business,24,4,43635,24,4,43902,24,4,44935,24,4,45068,24,4,46011,6,21.3,-1.2553615,36.7895376,-1.282543,36.824618,159,943,267,1166
1444,4722,1178,3,Business,9,4,43405,9,4,43451,9,4,43922,9,4,44155,9,4,44982,6,24.0,-1.2665946,36.7888833,-1.2862269,36.7841601,107,827,46,704
1445,15082,2423,3,Business,30,2,62339,30,2,62843,30,2,64307,30,2,64704,30,2,65844,4,23.25888921888938,-1.2551895,36.7822034,-1.2643794,36.816234,177,1140,504,1861
1446,5042,2412,3,Business,17,5,54471,17,5,54481,17,5,54928,17,5,55324,17,5,55334,5,23.25888921888938,-1.2283403,36.8822756,-1.2232123,36.8932547,126,10,10,843
1447,16931,136,3,Business,3,4,44259,3,4,44365,3,4,44390,3,4,45455,3,4,46084,4,23.3,-1.3165104,36.7077726,-1.3254522,36.7216584,644,629,106,1090
1448,24979,3635,1,Business,9,2,45858,9,2,45928,9,2,46233,9,2,46700,9,2,49143,20,22.0,-1.2615888,36.7928732,-1.3292721,36.6656534,848,2443,70,772
1449,4429,893,3,Business,22,5,46216,22,5,46241,22,5,47505,22,5,47615,22,5,49742,2,23.25888921888938,-1.2663194,36.809901,-1.2617028,36.7983849,411,2127,25,1374
1450,7058,1341,3,Business,17,3,33147,17,3,33210,17,3,35673,17,3,36608,17,3,37770,13,23.25888921888938,-1.303596,36.778378,-1.331619,36.847976,855,1162,63,3398
1451,3298,1280,3,Business,28,5,62255,28,5,62268,28,5,62353,28,5,62747,28,5,63500,3,23.25888921888938,-1.2551895,36.7822034,-1.2647688,36.775086,449,753,13,479
1452,9201,393,3,Business,27,1,31771,27,1,31825,27,1,32832,27,1,35089,27,1,36387,11,18.2,-1.3228003,36.8306435,-1.2638185,36.7930057,194,1298,54,3264
1453,11491,1863,3,Business,3,3,69561,3,3,69580,3,3,70612,3,3,71256,3,3,71627,2,19.4,-1.259488,36.800101,-1.2627937,36.8156957,407,371,19,1676
1454,16479,1637,3,Business,23,2,38305,23,2,38343,23,2,38679,23,2,39064,23,2,39375,3,17.8,-1.2696183,36.8021778,-1.2615888,36.7928732,578,311,38,721
1455,12114,3647,3,Business,2,5,41301,2,5,44179,2,5,45213,2,5,45557,2,5,47110,6,23.7,-1.272639,36.794723,-1.2874632,36.8243956,477,1553,2878,1378
1456,14969,1594,3,Business,11,4,52414,11,4,54682,11,4,55565,11,4,55755,11,4,57643,16,26.9,-1.2156006,36.8916865,-1.3285517,36.9018,75,1888,2268,1073
1457,4757,1146,3,Business,3,3,52309,3,3,52319,3,3,52362,3,3,54997,3,3,55749,5,28.0,-1.3004062,36.829741,-1.3083266,36.8494756,668,752,10,2678
1458,3217,2187,3,Business,15,3,35055,15,3,35118,15,3,35490,15,3,36190,15,3,37077,3,23.25888921888938,-1.28878,36.8168312,-1.2909536,36.8407162,204,887,63,1072
1459,5035,393,3,Business,21,4,44293,21,4,44303,21,4,44337,21,4,48440,21,4,48442,14,28.0,-1.3167113,36.8301563,-1.306378,36.7519845,39,2,10,4137
1460,19348,186,3,Business,30,4,38700,30,4,38766,30,4,39474,30,4,39983,30,4,39986,7,23.25888921888938,-1.2825816,36.8092346,-1.2571472,36.7950633,764,3,66,1217
1461,9848,988,3,Personal,6,5,58197,6,5,60987,6,5,62425,6,5,62880,6,5,64222,14,23.25888921888938,-1.211356,36.9051898,-1.2796514,36.819573,906,1342,2790,1893
1462,16983,3669,3,Business,20,3,61345,20,3,62588,20,3,63874,20,3,64567,20,3,65725,8,27.4,-1.2615888,36.7928732,-1.2434437,36.7487213,269,1158,1243,1979
1463,22799,2651,3,Business,7,2,58959,7,2,59016,7,2,62142,7,2,63266,7,2,67973,16,23.25888921888938,-1.3247683,36.85803,-1.3014497,36.7582475,106,4707,57,4250
1464,18735,1346,3,Business,7,5,48821,7,5,48879,7,5,49294,7,5,49488,7,5,50788,6,23.25888921888938,-1.3047889,36.8214432,-1.2917868,36.7872675,826,1300,58,609
1465,14348,238,3,Business,6,3,40219,6,3,40252,6,3,40463,6,3,41191,6,3,42013,4,23.25888921888938,-1.3004062,36.829741,-1.3077869,36.8443207,686,822,33,939
1466,27623,2717,3,Business,27,5,39545,27,5,39669,27,5,40217,27,5,40577,27,5,42001,6,22.3,-1.2551895,36.7822034,-1.2834945,36.812937,519,1424,124,908
1467,23028,496,3,Business,8,2,48168,8,2,48201,8,2,48536,8,2,48896,8,2,50676,22,25.4,-1.2571472,36.7950633,-1.374163,36.913444,178,1780,33,695
1468,8238,2523,3,Business,2,4,44687,2,4,44912,2,4,46522,2,4,46992,2,4,47838,9,23.25888921888938,-1.2551895,36.7822034,-1.2959605,36.7873854,855,846,225,2080
1469,334,375,3,Business,29,1,51337,29,1,51360,29,1,51423,29,1,51811,29,1,53191,10,23.25888921888938,-1.2551895,36.7822034,-1.2518814,36.859661,168,1380,23,451
1470,19753,3427,3,Personal,29,2,26477,29,2,30268,29,2,31477,29,2,31978,29,2,33130,7,16.7,-1.2720269,36.8174107,-1.2755226,36.7811904,101,1152,3791,1710
1471,13390,1753,2,Business,25,2,49987,25,2,50013,25,2,50053,25,2,50646,25,2,52913,16,27.3,-1.2551895,36.7822034,-1.2156006,36.8916865,498,2267,26,633
1472,14046,3647,3,Business,30,4,45567,30,4,45604,30,4,47061,30,4,47327,30,4,47926,4,23.25888921888938,-1.272639,36.794723,-1.2762743,36.8152789,937,599,37,1723
1473,16739,2677,3,Business,22,1,54098,22,1,54444,22,1,56247,22,1,58364,22,1,61189,14,26.1,-1.3177547,36.8303703,-1.306378,36.7519845,328,2825,346,3920
1474,24936,2682,1,Personal,18,2,45299,18,2,45317,18,2,45887,18,2,46229,18,2,47809,5,22.7,-1.2753109,36.8130185,-1.2985749,36.8088,844,1580,18,912
1475,26918,3599,3,Business,8,6,32604,8,6,32604,8,6,36625,8,6,36837,8,6,39182,12,16.6,-1.3302996,36.8707935,-1.2903421,36.7885282,772,2345,0,4233
1476,14927,577,3,Personal,18,2,50412,18,2,50551,18,2,51201,18,2,51788,18,2,53334,12,25.7,-1.3270347,36.8667362,-1.2662728,36.8151265,647,1546,139,1237
1477,16144,467,3,Business,14,5,46900,14,5,46990,14,5,47984,14,5,48313,14,5,50873,16,21.9,-1.304735,36.7846054,-1.332175,36.8819641,564,2560,90,1323
1478,2327,1462,3,Personal,13,4,37845,13,4,37911,13,4,38327,13,4,38959,13,4,39738,4,22.1,-1.2665065,36.7970081,-1.2628638,36.8070399,412,779,66,1048
1479,11075,1500,3,Business,17,3,39352,17,3,39367,17,3,39393,17,3,41300,17,3,42225,8,23.25888921888938,-1.3004062,36.829741,-1.2638185,36.7930057,41,925,15,1933
1480,21107,771,1,Personal,10,5,38110,10,5,38119,10,5,38834,10,5,39147,10,5,41269,21,19.0,-1.3176268,36.8741735,-1.3146278,36.7196956,213,2122,9,1028
1481,2788,2987,3,Business,23,1,49954,23,1,51625,23,1,53486,23,1,54109,23,1,56114,2,23.25888921888938,-1.270212,36.8210877,-1.2800881,36.8147037,174,2005,1671,2484
1482,16161,2412,3,Business,5,5,45298,5,5,45321,5,5,45703,5,5,46116,5,5,47891,14,24.0,-1.2297202,36.8819507,-1.2615888,36.7928732,74,1775,23,795
1483,1058,138,3,Business,27,3,42752,27,3,42865,27,3,44004,27,3,44601,27,3,46853,8,26.0,-1.2813012,36.8323962,-1.2615888,36.7928732,156,2252,113,1736
1484,14661,2030,3,Business,15,1,41690,15,1,42317,15,1,43429,15,1,44683,15,1,45401,6,23.25888921888938,-1.3396256,36.8863135,-1.3333725,36.8717613,101,718,627,2366
1485,27906,49,3,Business,7,5,44995,7,5,48553,7,5,49400,7,5,50754,7,5,53684,4,27.0,-1.2790196,36.8160867,-1.2977387,36.8031447,725,2930,3558,2201
1486,9512,3316,3,Personal,21,2,49473,21,2,49548,21,2,51004,21,2,51188,21,2,53794,9,25.2,-1.2795216,36.7706752,-1.2856826,36.8255265,344,2606,75,1640
1487,23015,1497,3,Personal,13,3,53068,13,3,57920,13,3,58642,13,3,58806,13,3,60113,5,23.7,-1.299813,36.7871392,-1.2861765,36.8209086,752,1307,4852,886
1488,3637,3272,2,Personal,2,1,44512,2,1,44659,2,1,45227,2,1,45347,2,1,48910,5,19.0,-1.2696341,36.8042045,-1.2754476,36.8363812,46,3563,147,688
1489,17181,1976,3,Business,26,5,59082,26,5,59477,26,5,60173,26,5,60361,26,5,62633,18,23.25888921888938,-1.257028,36.7810435,-1.2156006,36.8916865,125,2272,395,884
1490,10967,1075,3,Business,30,4,56285,30,4,56323,30,4,56839,30,4,57435,30,4,57938,2,23.25888921888938,-1.2571472,36.7950633,-1.2527958,36.8003131,147,503,38,1112
1491,23760,1544,3,Business,11,2,55235,11,2,56881,11,2,56892,11,2,58430,11,2,60480,21,21.4,-1.1932197,36.8983855,-1.2924173,36.7797814,291,2050,1646,1549
1492,27379,1591,2,Personal,12,5,53148,12,5,57014,12,5,57149,12,5,57505,12,5,58970,5,27.2,-1.2655306,36.828148,-1.281337,36.818968,101,1465,3866,491
1493,16551,1724,3,Business,29,5,58638,29,5,58831,29,5,59802,29,5,59924,29,5,60773,7,27.8,-1.2551895,36.7822034,-1.2871164,36.7652395,933,849,193,1093
1494,18331,3411,1,Personal,15,3,42086,15,3,42095,15,3,42546,15,3,42813,15,3,44986,10,18.2,-1.2919323,36.7659602,-1.3052641,36.8294145,452,2173,9,718
1495,16443,3599,3,Business,4,4,43888,4,4,44899,4,4,48203,4,4,50213,4,4,53200,11,24.9,-1.3302996,36.8707935,-1.296342,36.810352,117,2987,1011,5314
1496,12372,3525,3,Business,7,5,36921,7,5,36937,7,5,39190,7,5,39565,7,5,44045,18,25.2,-1.2038217,36.8794507,-1.2571472,36.7950633,812,4480,16,2628
1497,526,2414,2,Personal,4,2,65186,4,2,65232,4,2,66055,4,2,66804,4,2,67691,4,21.3,-1.2962832,36.7849683,-1.308217,36.77413,482,887,46,1572
1498,13778,1132,2,Personal,24,1,40374,24,1,41237,24,1,42330,24,1,42421,24,1,44306,11,22.6,-1.3173869,36.8112044,-1.2793831,36.7617573,532,1885,863,1184
1499,23223,3091,3,Business,19,7,50005,19,7,50071,19,7,50971,19,7,51115,19,7,52551,9,21.1,-1.3052491,36.8223899,-1.3014461,36.7661381,400,1436,66,1044
1500,10127,3283,3,Business,7,2,36436,7,2,37369,7,2,37932,7,2,38354,7,2,39363,14,23.25888921888938,-1.228911,36.881876,-1.2628473,36.781805,8,1009,933,985
1501,14476,2732,3,Personal,19,5,30443,19,5,31765,19,5,33013,19,5,33654,19,5,34747,3,20.1,-1.2857248,36.8228262,-1.2957196,36.8046677,829,1093,1322,1889
1502,2061,20,3,Business,17,3,52149,17,3,52250,17,3,53868,17,3,53950,17,3,55861,8,28.5,-1.3090533,36.8371502,-1.2586742,36.8016438,565,1911,101,1700
1503,26800,3356,3,Business,28,4,37042,28,4,38537,28,4,39529,28,4,39682,28,4,41720,14,23.9,-1.2036664,36.8192622,-1.2867843,36.8134769,781,2038,1495,1145
1504,6614,2677,3,Business,20,1,32493,20,1,32527,20,1,33382,20,1,33761,20,1,36304,12,19.0,-1.2991441,36.7528804,-1.3004062,36.829741,942,2543,34,1234
1505,8893,2066,3,Business,23,5,45905,23,5,47106,23,5,48361,23,5,48518,23,5,50074,13,24.2,-1.3270716,36.8406371,-1.338133,36.75417,242,1556,1201,1412
1506,13017,1081,3,Business,5,2,54560,5,2,54609,5,2,55679,5,2,56378,5,2,58249,9,27.6,-1.3014461,36.7661381,-1.3472066,36.7692638,328,1871,49,1769
1507,17283,393,3,Business,21,1,46342,21,1,46838,21,1,47484,21,1,47818,21,1,49513,14,25.5,-1.3167113,36.8301563,-1.306378,36.7519845,523,1695,496,980
1508,28081,3647,3,Business,7,5,60150,7,5,61305,7,5,63534,7,5,63757,7,5,65868,9,21.5,-1.272639,36.794723,-1.235348,36.760016,435,2111,1155,2452
1509,27913,3517,3,Business,26,5,54412,26,5,55329,26,5,56902,26,5,57363,26,5,60660,18,23.25888921888938,-1.3882008,36.7699445,-1.2867454,36.8259017,532,3297,917,2034
1510,26612,3135,3,Personal,1,1,36060,1,1,36065,1,1,36436,1,1,37024,1,1,38717,8,18.6,-1.277585,36.77145,-1.3043952,36.7664138,785,1693,5,959
1511,4023,635,3,Business,9,6,36390,9,6,36438,9,6,37077,9,6,40074,9,6,41696,6,27.5,-1.3081376,36.8329772,-1.3229345,36.8566974,181,1622,48,3636
1512,9650,1792,3,Business,21,1,42508,21,1,42660,21,1,43880,21,1,44068,21,1,45321,6,25.5,-1.2809121,36.7852524,-1.2791983,36.8237495,332,1253,152,1408
1513,811,283,3,Business,24,4,43628,24,4,45712,24,4,46440,24,4,47065,24,4,47972,8,21.3,-1.2804227,36.8250375,-1.315086,36.83801,808,907,2084,1353
1514,18101,1155,3,Personal,28,4,41186,28,4,41526,28,4,42569,28,4,42959,28,4,44558,5,28.1,-1.287079,36.7811277,-1.2897747,36.8159918,223,1599,340,1433
1515,25560,3291,3,Business,9,6,57944,9,6,58009,9,6,58706,9,6,58936,9,6,60795,8,27.0,-1.303596,36.778378,-1.2600926,36.8088685,605,1859,65,927
1516,16166,71,3,Business,24,3,51969,24,3,52450,24,3,52992,24,3,54521,24,3,56041,8,18.2,-1.2891922,36.825189,-1.2584143,36.8048002,436,1520,481,2071
1517,8761,633,3,Business,6,4,43778,6,4,43862,6,4,44736,6,4,44951,6,4,45617,4,24.3,-1.3077869,36.8443207,-1.3004062,36.829741,532,666,84,1089
1518,15274,511,3,Personal,27,3,55319,27,3,55682,27,3,56275,27,3,57075,27,3,57843,2,29.1,-1.2878149,36.8146245,-1.2885417,36.8100523,320,768,363,1393
1519,18725,3275,1,Personal,16,6,46780,16,6,46820,16,6,46956,16,6,48605,16,6,50332,12,19.2,-1.22556,36.80813,-1.1855066,36.8254646,870,1727,40,1785
1520,12546,3641,3,Business,30,2,31525,30,2,31555,30,2,32154,30,2,32349,30,2,33729,10,23.25888921888938,-1.2551895,36.7822034,-1.3019689,36.774497,953,1380,30,794
1521,10703,861,3,Personal,29,6,38416,29,6,38429,29,6,38889,29,6,38977,29,6,41063,14,24.8,-1.2661264,36.8030359,-1.2088599,36.7738438,178,2086,13,548
1522,9625,2112,3,Business,18,1,36081,18,1,36297,18,1,36777,18,1,37744,18,1,39349,12,21.3,-1.28878,36.8168312,-1.2156006,36.8916865,26,1605,216,1447
1523,2637,2828,3,Business,20,6,27292,20,6,35377,20,6,36702,20,6,36872,20,6,37413,4,19.6,-1.2710687,36.8142839,-1.2546637,36.8248917,88,541,8085,1495
1524,16784,3127,3,Business,22,4,39312,22,4,39756,22,4,40904,22,4,41260,22,4,42665,8,22.7,-1.2623805,36.7805404,-1.2918246,36.801585,532,1405,444,1504
1525,10179,654,2,Personal,25,2,67858,25,2,67868,25,2,69242,25,2,70073,25,2,72931,21,24.1,-1.1967675,36.8064464,-1.2949439,36.7604214,956,2858,10,2205
1526,9037,1346,3,Business,5,2,57979,5,2,58097,5,2,58425,5,2,58774,5,2,60163,2,23.25888921888938,-1.2917868,36.7872675,-1.2985749,36.8088,801,1389,118,677
1527,20961,3147,3,Business,28,1,53483,28,1,57439,28,1,57777,28,1,58763,28,1,59996,10,26.4,-1.3169591,36.7000029,-1.3467389,36.7690312,770,1233,3956,1324
1528,19070,909,3,Business,21,1,46916,21,1,46941,21,1,48024,21,1,48559,21,1,49633,8,25.3,-1.225322,36.80855,-1.2665132,36.8009939,125,1074,25,1618
1529,6353,1754,3,Business,2,1,32783,2,1,32793,2,1,32798,2,1,33898,2,1,37383,17,16.4,-1.2860183,36.8975338,-1.2661246,36.7961775,771,3485,10,1105
1530,2205,1329,3,Business,13,2,64327,13,2,65006,13,2,66099,13,2,66570,13,2,68081,6,23.5,-1.273056,36.811298,-1.3084722,36.8224665,276,1511,679,1564
1531,4004,391,3,Business,15,5,37089,15,5,37186,15,5,38832,15,5,43581,15,5,45012,6,26.0,-1.2789469,36.7796691,-1.2784063,36.8222933,436,1431,97,6395
1532,1049,2132,3,Business,1,4,43429,1,4,43464,1,4,44152,1,4,44400,1,4,46436,9,23.25888921888938,-1.2384056,36.8718698,-1.281914,36.83449,775,2036,35,936
1533,12949,1329,3,Business,13,6,44780,13,6,44895,13,6,45544,13,6,45643,13,6,48343,11,26.1,-1.273056,36.811298,-1.3189908,36.777074,641,2700,115,748
1534,8440,3580,3,Personal,21,4,56117,21,4,56303,21,4,60325,21,4,60780,21,4,63657,20,20.0,-1.2870003,36.8312206,-1.3745959,36.9276225,654,2877,186,4477
1535,8823,1624,2,Personal,24,4,67166,24,4,67196,24,4,67742,24,4,67858,24,4,69189,7,21.2,-1.2629944,36.7998816,-1.288621,36.778846,103,1331,30,662
1536,11435,1146,3,Business,12,2,44532,12,2,44589,12,2,44608,12,2,46813,12,2,47486,5,24.5,-1.3004062,36.829741,-1.3083266,36.8494756,469,673,57,2224
1537,13946,2965,1,Personal,15,1,48801,15,1,48986,15,1,50674,15,1,50856,15,1,54205,8,23.25888921888938,-1.274444,36.8196443,-1.2629461,36.7653137,646,3349,185,1870
1538,20463,3560,3,Business,14,4,47750,14,4,47917,14,4,48061,14,4,48344,14,4,49545,5,24.8,-1.2584143,36.8048002,-1.279395,36.825364,660,1201,167,427
1539,6217,3647,3,Business,20,1,40990,20,1,41036,20,1,41632,20,1,42046,20,1,42626,4,23.25888921888938,-1.272639,36.794723,-1.2786915,36.7633571,56,580,46,1010
1540,10549,1955,3,Business,27,3,40319,27,3,40356,27,3,41737,27,3,41864,27,3,44461,15,25.9,-1.2765492,36.7669809,-1.3263105,36.8622904,348,2597,37,1508
1541,6881,2077,2,Personal,2,2,59278,2,2,59605,2,2,61038,2,2,61471,2,2,63159,9,23.7,-1.3251584,36.8199384,-1.2946581,36.7792921,532,1688,327,1866
1542,10721,265,3,Business,8,5,57120,8,5,58016,8,5,58711,8,5,59205,8,5,60028,4,30.5,-1.300921,36.828195,-1.3117439,36.8108257,164,823,896,1189
1543,1404,1075,3,Business,12,2,38126,12,2,38566,12,2,42150,12,2,42223,12,2,43856,5,28.2,-1.2527958,36.8003131,-1.2880129,36.8308097,378,1633,440,3657
1544,13375,2866,3,Business,18,2,54565,18,2,55701,18,2,56762,18,2,57183,18,2,58098,6,25.8,-1.2551895,36.7822034,-1.265715,36.823815,547,915,1136,1482
1545,7228,867,3,Business,19,5,30588,19,5,30609,19,5,31237,19,5,32300,19,5,33823,14,20.2,-1.2991441,36.7528804,-1.3177547,36.8303703,731,1523,21,1691
1546,10874,2190,3,Business,20,3,53552,20,3,53563,20,3,54521,20,3,58707,20,3,60710,19,28.6,-1.3239725,36.8827383,-1.301953,36.788458,886,2003,11,5144
1547,15898,1469,3,Business,17,3,56756,17,3,56797,17,3,57331,17,3,57616,17,3,58834,4,28.3,-1.2551895,36.7822034,-1.2617028,36.7983849,565,1218,41,819
1548,24976,2982,3,Business,4,4,39103,4,4,39110,4,4,39456,4,4,40714,4,4,43139,18,25.3,-1.300921,36.828195,-1.177202,36.8351183,419,2425,7,1604
1549,7554,1502,3,Business,20,2,43820,20,2,43854,20,2,44812,20,2,45292,20,2,47098,15,19.7,-1.225322,36.80855,-1.2232123,36.8932547,937,1806,34,1438
1550,28003,646,2,Personal,19,4,42921,19,4,42942,19,4,43761,19,4,44395,19,4,45815,27,20.3,-1.2459594,36.8232977,-1.1846355,36.9485728,103,1420,21,1453
1551,13994,2691,3,Business,8,5,44275,8,5,49234,8,5,50323,8,5,51413,8,5,52490,6,21.3,-1.269534,36.80697,-1.2857671,36.7875614,726,1077,4959,2179
1552,10302,228,3,Business,9,2,53956,9,2,54027,9,2,54883,9,2,55157,9,2,57799,5,30.5,-1.2842665,36.7967626,-1.3024794,36.8228284,787,2642,71,1130
1553,11572,1473,3,Business,21,3,55707,21,3,55721,21,3,57847,21,3,61452,21,3,62879,29,23.25888921888938,-1.2099762,36.781053,-1.3700383,36.9190174,940,1427,14,5731
1554,9949,3531,1,Personal,15,2,46070,15,2,46158,15,2,47008,15,2,47845,15,2,49174,15,22.8,-1.2980229,36.78865,-1.3311462,36.7523014,919,1329,88,1687
1555,23563,3291,3,Business,25,5,32295,25,5,32407,25,5,33239,25,5,34518,25,5,36398,12,20.9,-1.318062,36.849326,-1.2600926,36.8088685,956,1880,112,2111
1556,17790,577,3,Personal,4,2,48020,4,2,48136,4,2,49452,4,2,49795,4,2,53244,13,22.4,-1.3270347,36.8667362,-1.2740027,36.8049172,343,3449,116,1659
1557,4462,1454,3,Personal,11,1,35245,11,1,36079,11,1,37051,11,1,37904,11,1,39224,8,14.5,-1.262423,36.8016471,-1.2961952,36.7876396,147,1320,834,1825
1558,15759,2464,3,Business,7,5,47810,7,5,48783,7,5,50730,7,5,51250,7,5,52422,6,23.25888921888938,-1.279395,36.825364,-1.2640571,36.7883547,36,1172,973,2467
1559,2100,2341,1,Personal,7,4,40736,7,4,45275,7,4,47925,7,4,48402,7,4,49192,4,16.9,-1.2925919,36.8170577,-1.3041605,36.8164326,752,790,4539,3127
1560,25248,248,3,Business,29,1,58871,29,1,58909,29,1,59090,29,1,59597,29,1,60247,3,23.5,-1.304735,36.7846054,-1.3036464,36.7950577,282,650,38,688
1561,21268,1927,3,Business,16,5,57003,16,5,58917,16,5,59228,16,5,59590,16,5,62278,20,26.1,-1.3472066,36.7692638,-1.2413316,36.8785525,487,2688,1914,673
1562,12195,3221,3,Business,3,4,50946,3,4,50995,3,4,51008,3,4,54953,3,4,57441,25,25.9,-1.199323,36.92053,-1.3064585,36.8119065,387,2488,49,3958
1563,8654,397,3,Business,21,5,49319,21,5,49330,21,5,50385,21,5,50937,21,5,52821,18,24.6,-1.3103985,36.9114173,-1.3307985,36.8036471,420,1884,11,1607
1564,20047,1209,3,Business,8,1,53428,8,1,53476,8,1,54461,8,1,55374,8,1,55921,5,29.7,-1.3004062,36.829741,-1.3228003,36.8306435,126,547,48,1898
1565,23012,3674,3,Business,14,2,38596,14,2,38639,14,2,38944,14,2,39180,14,2,43596,10,21.7,-1.2551895,36.7822034,-1.314342,36.84233,882,4416,43,541
1566,16143,867,3,Business,26,2,36250,26,2,37887,26,2,38867,26,2,39365,26,2,41316,11,27.7,-1.2770708,36.8231093,-1.2991441,36.7528804,119,1951,1637,1478
1567,23983,2314,2,Personal,4,6,28240,4,6,28260,4,6,28947,4,6,29185,4,6,30109,12,15.8,-1.2911123,36.7921078,-1.2482518,36.7550829,851,924,20,925
1568,20779,91,3,Personal,5,5,44810,5,5,44855,5,5,44922,5,5,45288,5,5,46573,8,24.5,-1.2877831,36.8146624,-1.2990731,36.8488058,404,1285,45,433
1569,4831,2330,3,Business,30,4,47425,30,4,47467,30,4,47472,30,4,49836,30,4,51039,10,23.25888921888938,-1.2642903,36.8002137,-1.2212612,36.8440033,704,1203,42,2369
1570,7221,269,3,Business,29,2,56519,29,2,60304,29,2,61225,29,2,61370,29,2,62727,9,22.1,-1.3332749,36.8708147,-1.335477,36.9308297,543,1357,3785,1066
1571,19073,393,3,Business,5,5,42793,5,5,42825,5,5,43193,5,5,43347,5,5,43784,5,24.3,-1.3004062,36.829741,-1.3167113,36.8301563,506,437,32,522
1572,15251,701,3,Personal,14,5,53409,14,5,53791,14,5,55776,14,5,56730,14,5,59024,10,23.7,-1.3080793,36.7505396,-1.2868609,36.8265752,858,2294,382,2939
1573,13663,3337,1,Personal,4,3,38111,4,3,39895,4,3,40476,4,3,40636,4,3,41169,3,16.9,-1.2661264,36.8030359,-1.2781939,36.8191922,698,533,1784,741
1574,19287,2112,3,Business,27,2,38820,27,2,41010,27,2,41820,27,2,42483,27,2,44960,12,23.9,-1.279395,36.825364,-1.2156006,36.8916865,404,2477,2190,1473
1575,14100,1500,3,Business,14,5,53813,14,5,54254,14,5,56654,14,5,56752,14,5,58065,9,22.8,-1.2638185,36.7930057,-1.3004062,36.829741,422,1313,441,2498
1576,25208,3291,3,Business,11,4,46664,11,4,46761,11,4,48315,11,4,49920,11,4,51795,18,26.8,-1.3393547,36.8910035,-1.2600926,36.8088685,675,1875,97,3159
1577,24574,1332,3,Personal,3,7,50492,3,7,50550,3,7,51376,3,7,51784,3,7,53206,15,30.0,-1.254904,36.809583,-1.2462208,36.6881422,275,1422,58,1234
1578,24046,516,3,Business,11,1,49511,11,1,49702,11,1,50566,11,1,50714,11,1,52050,8,27.8,-1.2551895,36.7822034,-1.2821378,36.7740428,332,1336,191,1012
1579,7678,3586,3,Business,13,2,52218,13,2,53607,13,2,54001,13,2,54143,13,2,58089,7,26.0,-1.275442,36.7660207,-1.2820458,36.8134557,812,3946,1389,536
1580,10274,2430,1,Personal,8,1,36573,8,1,36988,8,1,38081,8,1,39888,8,1,40882,9,24.3,-1.2913147,36.8232705,-1.317151,36.865734,328,994,415,2900
1581,22876,391,3,Business,4,2,34029,4,2,36537,4,2,37747,4,2,39378,4,2,40563,5,20.5,-1.300921,36.828195,-1.2867454,36.8259017,158,1185,2508,2841
1582,15726,393,3,Business,29,1,52348,29,1,52762,29,1,52766,29,1,54926,29,1,56432,14,24.2,-1.3177547,36.8303703,-1.306378,36.7519845,128,1506,414,2164
1583,28036,1402,3,Business,5,5,56248,5,5,56305,5,5,56707,5,5,56962,5,5,58098,1,27.7,-1.290894,36.822971,-1.2813012,36.8323962,790,1136,57,657
1584,345,3558,2,Personal,4,2,33213,4,2,33309,4,2,34503,4,2,34690,4,2,35861,12,16.5,-1.2691298,36.8254266,-1.2037968,36.7802765,453,1171,96,1381
1585,17388,1642,3,Business,10,4,54270,10,4,55515,10,4,56756,10,4,57234,10,4,58225,5,21.9,-1.2823851,36.8186472,-1.2726284,36.7882255,100,991,1245,1719
1586,24905,575,1,Personal,5,4,34977,5,4,35008,5,4,35316,5,4,36840,5,4,37907,9,23.25888921888938,-1.2684962,36.8079433,-1.2998487,36.7625853,116,1067,31,1832
1587,18913,478,3,Business,5,1,48285,5,1,48315,5,1,49047,5,1,51646,5,1,51647,10,26.0,-1.2551895,36.7822034,-1.2973682,36.7859878,19,1,30,3331
1588,25085,1104,2,Business,31,2,52333,31,2,52356,31,2,52449,31,2,55319,31,2,59073,10,22.2,-1.2551895,36.7822034,-1.297694,36.749788,101,3754,23,2963
1589,10601,3491,3,Business,13,2,49781,13,2,49789,13,2,51320,13,2,51725,13,2,53450,15,26.4,-1.3043095,36.8163115,-1.2297202,36.8819507,419,1725,8,1936
1590,22819,1848,2,Personal,4,1,60599,4,1,61449,4,1,61714,4,1,62429,4,1,63056,5,20.9,-1.2805757,36.8223948,-1.2724556,36.7931938,539,627,850,980
1591,5191,136,3,Business,21,3,37680,21,3,37742,21,3,38344,21,3,38668,21,3,40259,11,22.1,-1.2962832,36.7849683,-1.3326173,36.7146233,958,1591,62,926
1592,22697,419,3,Business,8,3,63392,8,3,63430,8,3,64195,8,3,65263,8,3,66976,9,24.2,-1.3001813,36.811122,-1.2571472,36.7950633,400,1713,38,1833
1593,14702,1500,3,Business,22,5,44117,22,5,44298,22,5,44310,22,5,48049,22,5,48095,8,28.3,-1.3004062,36.829741,-1.2638185,36.7930057,239,46,181,3751
1594,23558,2174,3,Business,29,3,38532,29,3,38532,29,3,38613,29,3,42325,29,3,42807,29,23.25888921888938,-1.2482781,36.884092,-1.392756,36.7495015,86,482,0,3793
1595,23176,1568,3,Business,4,1,56813,4,1,56994,4,1,57783,4,1,59782,4,1,61914,6,26.1,-1.2897368,36.8226783,-1.3271374,36.8495534,774,2132,181,2788
1596,14402,2587,3,Business,15,5,50344,15,5,50507,15,5,52378,15,5,52757,15,5,53054,1,27.9,-1.279395,36.825364,-1.28878,36.8168312,863,297,163,2250
1597,3008,3525,3,Business,31,5,46142,31,5,47314,31,5,47749,31,5,48013,31,5,50060,15,21.8,-1.3700383,36.9190174,-1.2981102,36.8293513,582,2047,1172,699
1598,14170,3339,3,Business,31,5,46301,31,5,47569,31,5,48002,31,5,48788,31,5,51403,6,24.7,-1.2551895,36.7822034,-1.273412,36.8182057,432,2615,1268,1219
1599,12349,760,3,Business,16,4,42380,16,4,42393,16,4,42781,16,4,43000,16,4,43960,4,23.25888921888938,-1.2736695,36.8028996,-1.2983375,36.8161099,291,960,13,607
1600,3177,2982,3,Business,20,1,38232,20,1,38246,20,1,38350,20,1,41306,20,1,44361,18,23.25888921888938,-1.300921,36.828195,-1.177202,36.8351183,519,3055,14,3060
1601,12162,3283,3,Business,29,2,48342,29,2,48530,29,2,48651,29,2,52135,29,2,52813,7,27.1,-1.287265,36.821586,-1.2628473,36.781805,124,678,188,3605
1602,9331,2804,3,Business,21,1,46558,21,1,46581,21,1,46622,21,1,47056,21,1,47383,4,25.6,-1.2551895,36.7822034,-1.2669736,36.8040985,379,327,23,475
1603,9346,1065,2,Personal,13,5,54852,13,5,54954,13,5,56575,13,5,56761,13,5,58905,6,19.1,-1.2745107,36.7974503,-1.2981625,36.8130142,939,2144,102,1807
1604,9176,706,3,Business,24,3,29190,24,3,29278,24,3,32261,24,3,32723,24,3,33784,7,17.1,-1.3077869,36.8443207,-1.3177547,36.8303703,532,1061,88,3445
1605,10177,1271,3,Business,10,3,35224,10,3,35334,10,3,36592,10,3,37961,10,3,40031,8,27.9,-1.3244885,36.897792,-1.3263105,36.8622904,907,2070,110,2627
1606,7458,3621,3,Business,29,1,29725,29,1,29735,29,1,30268,29,1,30504,29,1,33218,18,23.25888921888938,-1.2836583,36.7886014,-1.3123349,36.9152001,778,2714,10,769
1607,15151,3420,3,Business,7,1,36533,7,1,36538,7,1,37095,7,1,37806,7,1,39325,6,18.3,-1.265981,36.7936121,-1.3046007,36.8211743,948,1519,5,1268
1608,26041,346,3,Business,14,4,31978,14,4,32064,14,4,35714,14,4,36107,14,4,37660,6,17.9,-1.2615888,36.7928732,-1.28878,36.8168312,280,1553,86,4043
1609,21711,265,3,Business,10,1,38707,10,1,38757,10,1,41028,10,1,42280,10,1,43160,5,23.3,-1.327371,36.840591,-1.300921,36.828195,48,880,50,3523
1610,22085,2330,3,Business,1,1,36382,1,1,36520,1,1,38567,1,1,38836,1,1,40537,9,23.25888921888938,-1.2642903,36.8002137,-1.2124582,36.802894,843,1701,138,2316
1611,12855,1484,3,Business,1,4,41126,1,4,49430,1,4,51198,1,4,53225,1,4,53896,9,23.25888921888938,-1.2551895,36.7822034,-1.2959613,36.7684114,337,671,8304,3795
1612,4366,2803,3,Business,17,1,47177,17,1,48340,17,1,51393,17,1,51461,17,1,54847,7,24.7,-1.2765736,36.8513646,-1.2963492,36.8093377,436,3386,1163,3121
1613,13565,1329,3,Business,15,5,38751,15,5,39097,15,5,39512,15,5,39808,15,5,41442,6,25.7,-1.273056,36.811298,-1.2991481,36.8043449,657,1634,346,711
1614,27228,2423,3,Business,2,2,56513,2,2,56597,2,2,57357,2,2,60031,2,2,61096,3,23.7,-1.2571472,36.7950633,-1.2753109,36.8130185,190,1065,84,3434
1615,19329,2658,3,Business,8,5,45706,8,5,45933,8,5,46200,8,5,46889,8,5,51069,18,28.6,-1.2885029,36.825605,-1.3871626,36.7705016,779,4180,227,956
1616,5935,1966,3,Business,3,5,54113,3,5,54774,3,5,55606,3,5,56519,3,5,58847,21,23.25888921888938,-1.3700383,36.9190174,-1.2917868,36.7872675,595,2328,661,1745
1617,886,3355,3,Business,8,3,62113,8,3,63778,8,3,64407,8,3,66208,8,3,68479,9,23.25888921888938,-1.2879041,36.8217926,-1.2859912,36.8756811,61,2271,1665,2430
1618,22826,1482,3,Business,30,5,33405,30,5,33457,30,5,34237,30,5,34646,30,5,37470,14,18.8,-1.2782261,36.8225009,-1.338579,36.8963038,31,2824,52,1189
1619,25735,522,3,Personal,11,1,55254,11,1,55454,11,1,55682,11,1,56410,11,1,58357,12,23.1,-1.2643343,36.7447423,-1.278612,36.8195876,268,1947,200,956
1620,8980,1523,1,Personal,12,4,55481,12,4,55707,12,4,56244,12,4,56834,12,4,57422,4,21.7,-1.26249,36.799715,-1.25537,36.7756,281,588,226,1127
1621,13819,1882,3,Business,4,4,38966,4,4,39079,4,4,39546,4,4,39876,4,4,41724,15,25.5,-1.2160907,36.8851949,-1.253784,36.79907,686,1848,113,797
1622,18398,3282,3,Personal,6,1,51621,6,1,51666,6,1,52131,6,1,52341,6,1,53060,8,24.7,-1.2639002,36.7916805,-1.290059,36.7703475,754,719,45,675
1623,21474,1575,3,Personal,12,5,40676,12,5,40716,12,5,41593,12,5,41802,12,5,42111,1,24.7,-1.2562797,36.8075858,-1.2670196,36.8077002,343,309,40,1086
1624,23517,3064,3,Business,8,4,57254,8,4,57391,8,4,58148,8,4,59235,8,4,60328,12,27.1,-1.2571472,36.7950633,-1.2427734,36.8807215,812,1093,137,1844
1625,11498,1683,3,Business,9,2,49799,9,2,49850,9,2,50630,9,2,51338,9,2,53636,6,22.5,-1.296694,36.787758,-1.2675332,36.808561,131,2298,51,1488
1626,10696,3108,3,Business,10,4,45304,10,4,45412,10,4,46291,10,4,46426,10,4,48372,14,24.8,-1.2551895,36.7822034,-1.3020905,36.8769176,343,1946,108,1014
1627,8587,84,3,Business,14,4,38215,14,4,42208,14,4,44122,14,4,44265,14,4,47019,22,19.1,-1.2551895,36.7822034,-1.3562374,36.9042954,895,2754,3993,2057
1628,10431,2691,3,Business,20,3,37745,20,3,39024,20,3,40253,20,3,40514,20,3,43329,6,26.2,-1.2551895,36.7822034,-1.2690701,36.8314977,674,2815,1279,1490
1629,10813,868,3,Business,17,5,39613,17,5,39674,17,5,40318,17,5,41384,17,5,41489,7,23.25888921888938,-1.2628473,36.781805,-1.265715,36.823815,541,105,61,1710
1630,7697,892,2,Personal,11,3,37796,11,3,37888,11,3,38340,11,3,38693,11,3,40272,8,18.9,-1.2680641,36.8078697,-1.3203841,36.8290563,808,1579,92,805
1631,9162,1749,3,Personal,7,2,36566,7,2,36666,7,2,37011,7,2,37322,7,2,38820,5,23.25888921888938,-1.2621576,36.8103473,-1.2892697,36.8154514,96,1498,100,656
1632,28143,2066,3,Business,29,3,56456,29,3,56531,29,3,57331,29,3,57519,29,3,57674,1,18.8,-1.316961,36.820337,-1.3108175,36.8221698,676,155,75,988
1633,25260,867,3,Business,1,4,50796,1,4,50808,1,4,50905,1,4,51023,1,4,52407,9,23.25888921888938,-1.2574219,36.7927073,-1.306378,36.7519845,518,1384,12,215
1634,7749,1920,3,Business,5,3,47716,5,3,51730,5,3,52330,5,3,53295,5,3,54877,9,24.8,-1.2551895,36.7822034,-1.2981352,36.8213822,596,1582,4014,1565
1635,2856,725,1,Personal,19,6,57244,19,6,57302,19,6,59284,19,6,59612,19,6,60838,6,21.6,-1.2879618,36.8200863,-1.2772632,36.7922251,916,1226,58,2310
1636,9193,2162,3,Business,2,4,36455,2,4,40627,2,4,40782,2,4,41794,2,4,43471,12,22.3,-1.2615888,36.7928732,-1.3215394,36.836621,574,1677,4172,1167
1637,23122,627,3,Business,12,3,36285,12,3,36331,12,3,36718,12,3,36912,12,3,38354,11,23.25888921888938,-1.2551895,36.7822034,-1.3039596,36.8454147,161,1442,46,581
1638,27896,868,3,Business,7,4,39995,7,4,40070,7,4,42201,7,4,42863,7,4,43602,4,27.8,-1.266837,36.799249,-1.265715,36.823815,857,739,75,2793
1639,24962,3560,3,Business,5,1,54158,5,1,54643,5,1,54979,5,1,55645,5,1,56450,1,26.1,-1.290894,36.822971,-1.279395,36.825364,935,805,485,1002
1640,14152,868,3,Business,26,5,50647,26,5,50655,26,5,50672,26,5,52349,26,5,54577,10,23.25888921888938,-1.228911,36.881876,-1.265715,36.823815,155,2228,8,1694
1641,9673,136,3,Business,12,3,35816,12,3,35996,12,3,36396,12,3,36679,12,3,39636,14,23.25888921888938,-1.3254522,36.7216584,-1.2662138,36.7997481,647,2957,180,683
1642,2023,2582,3,Business,7,4,56839,7,4,56865,7,4,57371,7,4,57744,7,4,59080,10,30.9,-1.2985642,36.7707474,-1.2551895,36.7822034,341,1336,26,879
1643,15870,2956,3,Business,6,4,55984,6,4,56035,6,4,56353,6,4,57409,6,4,58487,9,21.4,-1.3014461,36.7661381,-1.2584143,36.8048002,855,1078,51,1374
1644,18849,3283,3,Business,22,2,48009,22,2,48487,22,2,49382,22,2,50213,22,2,51370,13,25.4,-1.2296618,36.8438272,-1.2628473,36.781805,691,1157,478,1726
1645,1821,2279,3,Business,20,3,57444,20,3,57735,20,3,59715,20,3,59965,20,3,61852,5,28.0,-1.2897368,36.8226783,-1.3057362,36.81788,763,1887,291,2230
1646,9412,393,3,Business,13,1,57982,13,1,58003,13,1,58533,13,1,59394,13,1,60149,4,23.25888921888938,-1.3167113,36.8301563,-1.3004062,36.829741,211,755,21,1391
1647,2910,3291,3,Business,15,5,53388,15,5,53542,15,5,54535,15,5,55140,15,5,56577,11,17.7,-1.2296618,36.8438272,-1.2600926,36.8088685,8,1437,154,1598
1648,19050,393,3,Business,21,4,34616,21,4,34628,21,4,34725,21,4,37388,21,4,38157,14,19.2,-1.3167113,36.8301563,-1.306378,36.7519845,515,769,12,2760
1649,12614,3398,3,Business,7,2,36171,7,2,36185,7,2,36924,7,2,37268,7,2,38711,8,16.9,-1.3472066,36.7692638,-1.3169591,36.7000029,4,1443,14,1083
1650,24014,1831,3,Business,16,3,49020,16,3,49962,16,3,51212,16,3,51455,16,3,53700,21,26.9,-1.3632162,36.9108253,-1.263987,36.798891,675,2245,942,1493
1651,12121,346,3,Business,7,4,56525,7,4,56686,7,4,57456,7,4,58451,7,4,58905,8,30.9,-1.28878,36.8168312,-1.3215394,36.836621,61,454,161,1765
1652,1419,2339,3,Personal,4,3,50125,4,3,50878,4,3,52421,4,3,53181,4,3,53911,2,18.2,-1.2864298,36.8224345,-1.2854989,36.8218183,531,730,753,2303
1653,22814,136,3,Business,23,2,44702,23,2,45116,23,2,45700,23,2,45948,23,2,49552,14,23.25888921888938,-1.3254522,36.7216584,-1.2950408,36.8098172,519,3604,414,832
1654,2019,53,3,Business,2,6,35931,2,6,36203,2,6,36888,2,6,37349,2,6,38411,5,21.2,-1.3004062,36.829741,-1.2770708,36.8231093,26,1062,272,1146
1655,1071,238,3,Business,22,5,41373,22,5,41398,22,5,41813,22,5,41963,22,5,43485,15,23.25888921888938,-1.3077869,36.8443207,-1.362953,36.904214,114,1522,25,565
1656,21948,3686,3,Business,11,1,44387,11,1,44421,11,1,44655,11,1,45696,11,1,46363,4,26.7,-1.2551895,36.7822034,-1.2519787,36.7806491,885,667,34,1275
1657,8979,3147,3,Business,24,5,43105,24,5,51364,24,5,52799,24,5,53520,24,5,55640,25,23.2,-1.3922788,36.9370094,-1.3472066,36.7692638,344,2120,8259,2156
1658,4760,393,3,Business,13,3,39464,13,3,39471,13,3,39483,13,3,40697,13,3,42138,14,25.0,-1.3167113,36.8301563,-1.306378,36.7519845,901,1441,7,1226
1659,8439,475,3,Business,29,1,59185,29,1,59286,29,1,59578,29,1,59841,29,1,61708,8,23.4,-1.2551895,36.7822034,-1.2925919,36.8170577,660,1867,101,555
1660,20848,393,3,Business,6,4,38130,6,4,38147,6,4,38334,6,4,38649,6,4,39610,5,19.5,-1.3228003,36.8306435,-1.3077869,36.8443207,155,961,17,502
1661,25654,124,3,Personal,8,2,53886,8,2,54010,8,2,55067,8,2,55556,8,2,56850,7,25.1,-1.271402,36.8238135,-1.3008471,36.8099068,281,1294,124,1546
1662,6010,3091,3,Business,4,4,37772,4,4,38420,4,4,39035,4,4,39635,4,4,41992,14,25.5,-1.2283403,36.8822756,-1.290894,36.822971,7,2357,648,1215
1663,12097,2900,3,Business,18,5,48107,18,5,48126,18,5,48160,18,5,48872,18,5,50569,16,27.0,-1.3329777,36.866203,-1.2963097,36.7688221,449,1697,19,746
1664,3435,1241,2,Personal,10,5,46269,10,5,46320,10,5,46859,10,5,47131,10,5,49281,13,19.0,-1.261842,36.78486,-1.2323371,36.864817,45,2150,51,811
1665,20136,1209,3,Business,16,2,55529,16,2,55540,16,2,55547,16,2,56999,16,2,57001,20,23.25888921888938,-1.3077309,36.6856214,-1.3004062,36.829741,10,2,11,1459
1666,12513,3355,3,Business,10,4,53044,10,4,54190,10,4,55028,10,4,55534,10,4,56957,10,21.8,-1.3008999,36.8932803,-1.3052491,36.8223899,216,1423,1146,1344
1667,16935,830,3,Business,24,4,55421,24,4,59623,24,4,60512,24,4,60714,24,4,63221,8,26.0,-1.2551895,36.7822034,-1.2904016,36.8226303,332,2507,4202,1091
1668,6736,2509,3,Business,27,4,53562,27,4,53572,27,4,53805,27,4,54027,27,4,55599,20,23.8,-1.2571472,36.7950633,-1.3700383,36.9190174,685,1572,10,455
1669,12582,1724,3,Business,4,2,50819,4,2,51119,4,2,51686,4,2,51878,4,2,53010,6,24.0,-1.2551895,36.7822034,-1.2655306,36.828148,646,1132,300,759
1670,26184,862,1,Personal,20,1,59526,20,1,59758,20,1,60550,20,1,60856,20,1,62112,10,20.3,-1.2455165,36.7909394,-1.2962832,36.7849683,74,1256,232,1098
1671,8628,970,3,Business,14,2,33038,14,2,33071,14,2,33117,14,2,33735,14,2,34604,4,23.25888921888938,-1.2551895,36.7822034,-1.2690931,36.8065779,926,869,33,664
1672,43,3115,3,Business,29,2,36633,29,2,36722,29,2,37521,29,2,38886,29,2,40226,12,21.6,-1.3108967,36.8340544,-1.296797,36.7764525,543,1340,89,2164
1673,26260,2330,3,Business,7,5,34931,7,5,34959,7,5,35138,7,5,35390,7,5,35744,3,23.25888921888938,-1.2915247,36.8055757,-1.3040812,36.7924217,829,354,28,431
1674,26235,2310,3,Business,9,3,60958,9,3,61005,9,3,62042,9,3,62711,9,3,64314,6,21.6,-1.2860183,36.8975338,-1.2859912,36.8756811,543,1603,47,1706
1675,21487,897,2,Personal,25,5,32712,25,5,32731,25,5,33222,25,5,33694,25,5,35270,9,16.8,-1.2295075,36.8016971,-1.2740396,36.81059,644,1576,19,963
1676,25663,3609,2,Personal,2,2,45435,2,2,45441,2,2,45540,2,2,45690,2,2,48450,14,21.0,-1.2676026,36.8103629,-1.2850318,36.8907864,789,2760,6,249
1677,16538,1245,3,Business,5,5,38079,5,5,38125,5,5,38178,5,5,39938,5,5,41468,15,24.7,-1.300921,36.828195,-1.3523738,36.7266216,61,1530,46,1813
1678,26859,2523,3,Business,12,1,39546,12,1,39936,12,1,40306,12,1,40773,12,1,42337,8,23.8,-1.2551895,36.7822034,-1.295156,36.8094306,519,1564,390,837
1679,19311,517,3,Business,27,4,51694,27,4,51704,27,4,51859,27,4,51996,27,4,52522,4,23.6,-1.3167113,36.8301563,-1.3004062,36.829741,523,526,10,292
1680,22310,393,3,Business,9,4,39414,9,4,41018,9,4,41407,9,4,43326,9,4,43913,5,23.25888921888938,-1.3167113,36.8301563,-1.3077869,36.8443207,168,587,1604,2308
1681,5682,2987,3,Business,19,5,43104,19,5,43150,19,5,44420,19,5,44528,19,5,47625,10,25.1,-1.270212,36.8210877,-1.2297202,36.8819507,268,3097,46,1378
1682,18291,2545,2,Personal,2,6,44589,2,6,44641,2,6,46367,2,6,46867,2,6,48843,15,23.8,-1.2297202,36.8745508,-1.2797184,36.7811448,549,1976,52,2226
1683,12375,3599,3,Business,13,4,52433,13,4,53392,13,4,56160,13,4,56366,13,4,59675,28,23.3,-1.3302996,36.8707935,-1.4287625,36.9875447,772,3309,959,2974
1684,20409,2207,3,Business,20,4,32766,20,4,32822,20,4,33597,20,4,34266,20,4,34790,2,18.6,-1.2686289,36.8073469,-1.2768326,36.8073804,50,524,56,1444
1685,3824,3647,3,Business,11,2,47038,11,2,47192,11,2,47585,11,2,47991,11,2,49923,12,19.2,-1.272639,36.794723,-1.3178263,36.7141818,155,1932,154,799
1686,20563,510,3,Business,10,4,60646,10,4,60672,10,4,61736,10,4,62251,10,4,63812,13,23.4,-1.2860183,36.8975338,-1.3189252,36.8617269,418,1561,26,1579
1687,27182,393,3,Business,14,1,37698,14,1,37707,14,1,38179,14,1,39107,14,1,39544,4,23.4,-1.3167113,36.8301563,-1.3004062,36.829741,659,437,9,1400
1688,10161,393,3,Business,1,4,28857,1,4,28898,1,4,28912,1,4,33485,1,4,33517,4,23.25888921888938,-1.3177547,36.8303703,-1.3004062,36.829741,157,32,41,4587
1689,9653,2423,3,Business,22,5,43653,22,5,43673,22,5,44030,22,5,44500,22,5,45833,8,23.25888921888938,-1.2551895,36.7822034,-1.2967702,36.8040381,411,1333,20,827
1690,6162,3218,3,Business,4,1,39558,4,1,39687,4,1,40709,4,1,42432,4,1,43579,11,20.8,-1.2156006,36.8916865,-1.2765736,36.8513646,248,1147,129,2745
1691,4999,1787,3,Business,13,6,64675,13,6,64720,13,6,65533,13,6,65680,13,6,66672,12,27.7,-1.2527958,36.8003131,-1.2283403,36.8822756,484,992,45,960
1692,240,3674,3,Business,29,3,52364,29,3,54743,29,3,54877,29,3,55502,29,3,57150,8,21.2,-1.2551895,36.7822034,-1.2801883,36.8234728,68,1648,2379,759
1693,22672,1245,3,Business,15,5,41360,15,5,41373,15,5,41838,15,5,43013,15,5,45812,22,26.0,-1.300921,36.828195,-1.3312261,36.6882186,127,2799,13,1640
1694,11659,3487,3,Business,10,3,48733,10,3,48853,10,3,50749,10,3,51033,10,3,52027,5,30.8,-1.279395,36.825364,-1.2571472,36.7950633,341,994,120,2180
1695,15059,909,3,Business,27,7,47950,27,7,52769,27,7,52979,27,7,53657,27,7,54494,7,27.9,-1.207546,36.7913976,-1.225322,36.80855,105,837,4819,888
1696,7332,346,3,Business,10,1,47141,10,1,47260,10,1,47681,10,1,49144,10,1,50519,1,18.4,-1.279395,36.825364,-1.28878,36.8168312,300,1375,119,1884
1697,28193,1209,3,Business,18,5,31191,18,5,32208,18,5,33012,18,5,33313,18,5,33899,4,20.1,-1.3077869,36.8443207,-1.3004062,36.829741,580,586,1017,1105
1698,10176,3517,3,Business,21,2,38975,21,2,38986,21,2,39550,21,2,40822,21,2,42710,16,22.6,-1.300921,36.828195,-1.3882008,36.7699445,211,1888,11,1836
1699,8635,3354,3,Business,23,3,43728,23,3,46519,23,3,46648,23,3,46998,23,3,48292,13,23.25888921888938,-1.3700383,36.9190174,-1.3153122,36.8965598,932,1294,2791,479
1700,4675,635,3,Business,27,1,46138,27,1,46159,27,1,46430,27,1,48370,27,1,49622,10,20.9,-1.3081376,36.8329772,-1.2602337,36.7990548,2,1252,21,2211
1701,20138,3091,3,Business,5,5,43550,5,5,43621,5,5,44206,5,5,44766,5,5,47133,7,24.3,-1.290894,36.822971,-1.3117395,36.8592009,910,2367,71,1145
1702,18233,635,3,Business,14,2,43062,14,2,43175,14,2,43180,14,2,44637,14,2,44948,7,23.25888921888938,-1.2602337,36.7990548,-1.3081376,36.8329772,472,311,113,1462
1703,305,391,3,Business,28,1,57152,28,1,59349,28,1,60171,28,1,60480,28,1,62587,5,25.2,-1.300921,36.828195,-1.2867454,36.8259017,819,2107,2197,1131
1704,19031,2521,3,Business,5,6,41116,5,6,41121,5,6,41132,5,6,41285,5,6,43030,14,22.4,-1.3167113,36.8301563,-1.306378,36.7519845,523,1745,5,164
1705,10847,2069,3,Business,22,5,38828,22,5,40698,22,5,42734,22,5,43525,22,5,44521,6,28.5,-1.2296618,36.8438272,-1.228911,36.881876,309,996,1870,2827
1706,19049,1500,3,Business,27,3,43277,27,3,43290,27,3,43310,27,3,43928,27,3,45342,10,26.3,-1.2991441,36.7528804,-1.2638185,36.7930057,698,1414,13,638
1707,3785,869,3,Personal,7,1,59378,7,1,59631,7,1,60015,7,1,60482,7,1,61900,5,19.9,-1.2775276,36.8140021,-1.2624804,36.7974767,478,1418,253,851
1708,21159,635,3,Business,26,1,54612,26,1,54637,26,1,55985,26,1,56416,26,1,56776,3,22.3,-1.2611642,36.7949932,-1.2599563,36.7993439,107,360,25,1779
1709,13870,517,3,Business,9,5,37610,9,5,37658,9,5,38789,9,5,39262,9,5,41431,14,25.5,-1.3177547,36.8303703,-1.306378,36.7519845,608,2169,48,1604
1710,25070,2159,3,Business,14,4,31190,14,4,31453,14,4,32857,14,4,32988,14,4,34340,7,15.4,-1.304735,36.7846054,-1.28101,36.8115102,752,1352,263,1535
1711,11156,393,3,Business,21,5,36754,21,5,36782,21,5,36786,21,5,38563,21,5,40938,11,22.7,-1.3167113,36.8301563,-1.2574219,36.7927073,515,2375,28,1781
1712,21621,1473,3,Business,24,3,57442,24,3,57473,24,3,58176,24,3,58282,24,3,59750,16,23.25888921888938,-1.3700383,36.9190174,-1.3044458,36.8233667,99,1468,31,809
1713,2337,3621,3,Business,6,4,65312,6,4,65423,6,4,68308,6,4,68632,6,4,69342,4,22.6,-1.2836583,36.7886014,-1.2721028,36.7953485,103,710,111,3209
1714,13002,2169,2,Personal,23,4,53532,23,4,53566,23,4,54631,23,4,55163,23,4,56467,9,20.6,-1.311208,36.778743,-1.2669099,36.7977433,749,1304,34,1597
1715,25950,695,1,Personal,20,1,57529,20,1,57627,20,1,58507,20,1,58797,20,1,61640,16,21.2,-1.2108499,36.7819362,-1.2977768,36.8110285,384,2843,98,1170
1716,23622,2373,1,Personal,29,5,59019,29,5,59036,29,5,59639,29,5,60107,29,5,62165,15,20.6,-1.2681257,36.8079664,-1.200688,36.7891976,427,2058,17,1071
1717,22390,3647,3,Business,14,2,47890,14,2,47909,14,2,47931,14,2,48373,14,2,51016,18,23.25888921888938,-1.272639,36.794723,-1.344748,36.745184,293,2643,19,464
1718,19994,136,3,Business,20,3,43004,20,3,44070,20,3,47186,20,3,47473,20,3,49111,13,27.3,-1.3254522,36.7216584,-1.25537,36.7756,240,1638,1066,3403
1719,7289,1329,3,Business,2,3,56574,2,3,56690,2,3,58233,2,3,58469,2,3,59350,2,23.2,-1.273056,36.811298,-1.2628067,36.8140689,676,881,116,1779
1720,11309,540,3,Business,1,4,54806,1,4,54848,1,4,55036,1,4,55198,1,4,56862,4,23.25888921888938,-1.2551895,36.7822034,-1.2753109,36.8130185,402,1664,42,350
1721,16395,238,3,Business,26,2,31293,26,2,31343,26,2,32183,26,2,32614,26,2,33320,4,22.0,-1.3004062,36.829741,-1.3077869,36.8443207,709,706,50,1271
1722,14873,474,3,Business,30,1,54191,30,1,54233,30,1,55077,30,1,55168,30,1,56427,3,20.4,-1.264945,36.784678,-1.2666153,36.8015124,770,1259,42,935
1723,5599,517,3,Business,4,2,52800,4,2,55435,4,2,55438,4,2,56433,4,2,58045,14,24.0,-1.3177547,36.8303703,-1.306378,36.7519845,10,1612,2635,998
1724,17220,718,3,Business,26,1,46345,26,1,46430,26,1,47274,26,1,47545,26,1,48851,8,23.0,-1.2551895,36.7822034,-1.298094,36.803149,290,1306,85,1115
1725,27698,265,3,Business,19,2,44796,19,2,44861,19,2,45284,19,2,46137,19,2,47774,10,27.5,-1.300921,36.828195,-1.3000978,36.7658352,712,1637,65,1276
1726,13958,3091,3,Business,5,3,38576,5,3,38611,5,3,40153,5,3,41372,5,3,44270,19,22.4,-1.2859912,36.8756811,-1.3012008,36.764868,320,2898,35,2761
1727,6403,3710,3,Business,31,2,47998,31,2,48029,31,2,48690,31,2,48994,31,2,51022,10,22.3,-1.3088274,36.8397715,-1.2551895,36.7822034,414,2028,31,965
1728,9886,306,1,Personal,10,5,30638,10,5,30676,10,5,31697,10,5,31991,10,5,34440,16,13.3,-1.3159197,36.8516724,-1.2830073,36.7662294,234,2449,38,1315
1729,11805,1724,3,Business,11,2,30421,11,2,31098,11,2,31815,11,2,32018,11,2,33869,12,16.4,-1.2852139,36.751683,-1.3325582,36.7406697,576,1851,677,920
1730,3923,3718,3,Business,17,1,54308,17,1,54949,17,1,55421,17,1,55809,17,1,56414,3,24.6,-1.2650027,36.8126242,-1.272639,36.794723,125,605,641,860
1731,5571,393,3,Business,18,1,35383,18,1,35409,18,1,35970,18,1,37002,18,1,38898,11,21.4,-1.3167113,36.8301563,-1.2638185,36.7930057,177,1896,26,1593
1732,14512,1500,3,Business,21,4,55163,21,4,55196,21,4,55637,21,4,55997,21,4,57766,8,26.3,-1.3004062,36.829741,-1.2638185,36.7930057,686,1769,33,801
1733,13601,1209,3,Business,18,4,56588,18,4,56606,18,4,57113,18,4,57337,18,4,58655,9,23.25888921888938,-1.2638185,36.7930057,-1.3004062,36.829741,422,1318,18,731
1734,11258,420,3,Business,21,5,56608,21,5,57636,21,5,60319,21,5,61446,21,5,63863,22,25.2,-1.3981712,36.7673241,-1.2709895,36.7799719,312,2417,1028,3810
1735,17079,2763,3,Business,15,4,40140,15,4,40154,15,4,40639,15,4,40809,15,4,42209,4,24.4,-1.2551895,36.7822034,-1.2717851,36.8105363,167,1400,14,655
1736,10526,3753,1,Personal,28,4,41736,28,4,42010,28,4,42515,28,4,42626,28,4,43738,5,23.25888921888938,-1.2898354,36.7872703,-1.2959817,36.8168902,21,1112,274,616
1737,16973,3599,3,Business,26,5,43564,26,5,47192,26,5,49641,26,5,49728,26,5,52791,23,23.25888921888938,-1.3302996,36.8707935,-1.3237428,36.6890511,482,3063,3628,2536
1738,5307,113,1,Business,21,1,39689,21,1,39756,21,1,40174,21,1,40869,21,1,41898,8,20.1,-1.2844653,36.8206676,-1.2963097,36.7688221,406,1029,67,1113
1739,739,3689,3,Business,29,4,44749,29,4,45628,29,4,46355,29,4,46864,29,4,47394,1,21.3,-1.2649605,36.7981777,-1.2527958,36.8003131,222,530,879,1236
1740,20649,3647,3,Business,9,4,56228,9,4,56236,9,4,56684,9,4,57179,9,4,60016,16,25.7,-1.272639,36.794723,-1.339046,36.762596,400,2837,8,943
1741,3186,53,3,Business,27,3,41617,27,3,41708,27,3,42409,27,3,42610,27,3,44265,5,26.3,-1.3004062,36.829741,-1.2770708,36.8231093,436,1655,91,902
1742,6189,2884,2,Personal,24,4,35451,24,4,37736,24,4,39102,24,4,40156,24,4,42302,20,21.2,-1.2137756,36.7996657,-1.2764692,36.7580111,441,2146,2285,2420
1743,6929,1195,3,Business,27,3,41767,27,3,41820,27,3,42167,27,3,44635,27,3,45629,14,26.0,-1.3228003,36.8306435,-1.2991441,36.7528804,771,994,53,2815
1744,16638,3355,3,Business,2,1,54557,2,1,55314,2,1,55398,2,1,57874,2,1,58840,9,20.0,-1.2859912,36.8756811,-1.3052491,36.8223899,900,966,757,2560
1745,8042,3726,1,Personal,27,5,68347,27,5,68350,27,5,69205,27,5,69380,27,5,69853,2,17.8,-1.2621576,36.8103473,-1.2612278,36.8181679,229,473,3,1030
1746,11843,2200,3,Business,19,2,51559,19,2,53220,19,2,53428,19,2,54154,19,2,57632,11,29.1,-1.2927792,36.9053492,-1.290894,36.822971,484,3478,1661,934
1747,21727,3523,3,Personal,2,2,25930,2,2,25949,2,2,27324,2,2,27526,2,2,30512,18,15.2,-1.290315,36.7573772,-1.2235201,36.8020608,432,2986,19,1577
1748,5283,633,3,Business,22,5,35479,22,5,35564,22,5,36815,22,5,37118,22,5,37800,5,22.0,-1.3004062,36.829741,-1.3083266,36.8494756,378,682,85,1554
1749,19066,2710,3,Personal,5,2,54552,5,2,54564,5,2,55318,5,2,55415,5,2,57241,11,23.25888921888938,-1.2535486,36.7933541,-1.2980229,36.78865,523,1826,12,851
1750,4840,1777,3,Personal,13,1,43539,13,1,43920,13,1,45459,13,1,45589,13,1,46816,9,17.2,-1.2505691,36.7531862,-1.270066,36.8039766,882,1227,381,1669
1751,4886,2154,3,Business,11,5,54080,11,5,54340,11,5,55075,11,5,55167,11,5,56297,6,26.3,-1.2765736,36.8513646,-1.2877544,36.8154509,15,1130,260,827
1752,17962,53,3,Business,4,4,56033,4,4,56294,4,4,56857,4,4,58163,4,4,58166,6,27.5,-1.3077869,36.8443207,-1.2770708,36.8231093,740,3,261,1869
1753,3940,3711,3,Business,20,4,37963,20,4,38725,20,4,39308,20,4,39777,20,4,40777,9,22.1,-1.3014461,36.7661381,-1.2551895,36.7822034,320,1000,762,1052
1754,16027,633,3,Business,15,5,41355,15,5,41364,15,5,41380,15,5,41888,15,5,41896,5,26.0,-1.3004062,36.829741,-1.3228003,36.8306435,10,8,9,524
1755,13529,3621,3,Business,20,2,39677,20,2,39825,20,2,40319,20,2,40629,20,2,42299,11,19.8,-1.2836583,36.7886014,-1.3472066,36.7692638,322,1670,148,804
1756,19321,2903,2,Personal,18,4,45715,18,4,45739,18,4,45794,18,4,46487,18,4,47580,10,25.3,-1.3000978,36.7658352,-1.2456412,36.7955298,848,1093,24,748
1757,8553,2523,3,Business,2,3,43059,2,3,43076,2,3,43565,2,3,43755,2,3,46139,19,24.0,-1.2551895,36.7822034,-1.2658003,36.8983864,647,2384,17,679
1758,13460,2523,3,Business,24,1,60603,24,1,60611,24,1,60674,24,1,61044,24,1,62558,8,24.3,-1.2551895,36.7822034,-1.295156,36.8094306,38,1514,8,433
1759,26469,3521,3,Business,27,3,58599,27,3,58645,27,3,59529,27,3,59705,27,3,60218,2,27.5,-1.2679971,36.8088937,-1.2696908,36.81519,879,513,46,1060
1760,11039,3635,1,Business,1,1,44960,1,1,45000,1,1,45425,1,1,45824,1,1,50127,8,23.8,-1.3052491,36.8223899,-1.2615888,36.7928732,644,4303,40,824
1761,11726,2149,1,Personal,29,6,44647,29,6,45443,29,6,45859,29,6,46174,29,6,47397,6,25.2,-1.2675332,36.808561,-1.293393,36.790237,38,1223,796,731
1762,20076,802,3,Business,20,4,56558,20,4,56807,20,4,56837,20,4,59913,20,4,62201,10,22.7,-1.3226302,36.8719901,-1.2864963,36.8252086,848,2288,249,3106
1763,16240,1329,3,Business,10,4,43353,10,4,43380,10,4,44275,10,4,44481,10,4,46420,2,24.6,-1.273056,36.811298,-1.2641662,36.8136393,467,1939,27,1101
1764,9497,893,3,Business,30,2,51010,30,2,54177,30,2,55445,30,2,56326,30,2,57229,4,23.25888921888938,-1.261247,36.826993,-1.2594474,36.8089122,96,903,3167,2149
1765,5902,1894,1,Personal,30,1,55552,30,1,55701,30,1,58741,30,1,59697,30,1,62003,11,16.1,-1.2315379,36.8156795,-1.2913246,36.8019522,937,2306,149,3996
1766,25247,302,3,Business,6,4,43166,6,4,44800,6,4,45570,6,4,45661,6,4,46974,4,24.1,-1.2649605,36.7981777,-1.2720139,36.8241971,382,1313,1634,861
1767,16948,733,3,Business,2,4,40310,2,4,40361,2,4,40371,2,4,41109,2,4,47217,15,23.25888921888938,-1.2551895,36.7822034,-1.3265961,36.8718676,349,6108,51,748
1768,4187,1502,3,Business,11,2,53500,11,2,53521,11,2,53975,11,2,54300,11,2,56863,19,22.1,-1.3014461,36.7661381,-1.2232123,36.8932547,65,2563,21,779
1769,25902,633,3,Business,19,2,32948,19,2,32998,19,2,33689,19,2,34211,19,2,35142,4,21.2,-1.2770708,36.8231093,-1.3004062,36.829741,953,931,50,1213
1770,22189,2330,3,Business,20,4,41944,20,4,43315,20,4,44230,20,4,44333,20,4,45197,11,22.4,-1.2212612,36.8440033,-1.2199518,36.8032133,870,864,1371,1018
1771,22102,1075,3,Business,21,4,44095,21,4,44158,21,4,45636,21,4,45840,21,4,49473,17,25.0,-1.2527958,36.8003131,-1.3277669,36.8975169,846,3633,63,1682
1772,20910,3209,3,Personal,29,5,36063,29,5,36152,29,5,36441,29,5,37116,29,5,37693,1,21.0,-1.2932155,36.7877116,-1.2977197,36.7861445,119,577,89,964
1773,2808,238,3,Business,26,5,38135,26,5,38158,26,5,39578,26,5,39642,26,5,40404,3,23.25888921888938,-1.3077869,36.8443207,-1.308366,36.823613,613,762,23,1484
1774,19060,868,3,Business,29,5,36207,29,5,36308,29,5,37293,29,5,37781,29,5,40186,9,20.7,-1.265715,36.823815,-1.2975066,36.7689423,907,2405,101,1473
1775,18868,265,3,Business,27,4,56711,27,4,56744,27,4,57007,27,4,57551,27,4,58956,10,24.9,-1.300921,36.828195,-1.2873232,36.7658572,100,1405,33,807
1776,24279,2978,3,Business,15,5,32701,15,5,32748,15,5,32920,15,5,33262,15,5,33984,3,19.1,-1.2551895,36.7822034,-1.2664428,36.809453,576,722,47,514
1777,23296,1754,3,Business,23,2,43396,23,2,43401,23,2,43420,23,2,44575,23,2,45409,12,17.9,-1.3052491,36.8223899,-1.2860183,36.8975338,589,834,5,1174
1778,18583,420,3,Business,19,2,57872,19,2,57893,19,2,60677,19,2,60981,19,2,66089,25,28.0,-1.3175759,36.7059218,-1.208956,36.8162198,805,5108,21,3088
1779,24339,2012,3,Personal,18,4,25474,18,4,25535,18,4,26760,18,4,27011,18,4,28942,23,23.25888921888938,-1.2715686,36.8023526,-1.375192,36.9361554,880,1931,61,1476
1780,24136,110,3,Personal,1,1,44580,1,1,44790,1,1,46352,1,1,47190,1,1,48010,9,23.25888921888938,-1.3257471,36.8775667,-1.3076262,36.8325382,883,820,210,2400
1781,3550,867,3,Business,27,3,34928,27,3,34982,27,3,35319,27,3,36186,27,3,37863,10,23.25888921888938,-1.3004062,36.829741,-1.2991441,36.7528804,154,1677,54,1204
1782,25355,517,3,Business,28,4,55844,28,4,55877,28,4,55975,28,4,56111,28,4,56630,5,27.4,-1.3004062,36.829741,-1.3167113,36.8301563,206,519,33,234
1783,22664,2066,3,Business,26,4,41369,26,4,41438,26,4,42284,26,4,42482,26,4,46237,10,19.1,-1.316961,36.820337,-1.2566586,36.7929682,844,3755,69,1044
1784,8545,2801,3,Business,3,1,55013,3,1,55141,3,1,55609,3,1,55868,3,1,56790,5,23.1,-1.2674274,36.7870827,-1.2753109,36.8130185,952,922,128,727
1785,17454,53,3,Business,9,2,51801,9,2,51884,9,2,52197,9,2,53256,9,2,54290,7,30.8,-1.2638185,36.7930057,-1.2770708,36.8231093,394,1034,83,1372
1786,14185,186,3,Business,2,2,59004,2,2,59011,2,2,59833,2,2,59952,2,2,60968,4,23.5,-1.2571472,36.7950633,-1.2890399,36.8164942,254,1016,7,941
1787,1923,633,3,Business,4,4,55302,4,4,57491,4,4,58599,4,4,58946,4,4,59837,4,24.6,-1.2770708,36.8231093,-1.3004062,36.829741,532,891,2189,1455
1788,23777,867,3,Business,14,4,53406,14,4,53491,14,4,54107,14,4,56409,14,4,58506,14,28.0,-1.3228003,36.8306435,-1.2991441,36.7528804,85,2097,85,2918
1789,6138,1280,3,Business,18,1,37714,18,1,37742,18,1,38282,18,1,38566,18,1,39265,5,27.8,-1.2551895,36.7822034,-1.265981,36.7936121,147,699,28,824
1790,27002,3517,3,Business,31,3,30982,31,3,30993,31,3,31012,31,3,34216,31,3,34461,15,18.9,-1.300921,36.828195,-1.3882008,36.7699445,137,245,11,3223
1791,19885,1839,3,Personal,11,1,39055,11,1,39068,11,1,39102,11,1,39366,11,1,40335,11,26.6,-1.2963097,36.7688221,-1.3314048,36.8229367,345,969,13,298
1792,18821,635,3,Business,12,1,51476,12,1,52126,12,1,52134,12,1,52432,12,1,53796,8,26.7,-1.2599563,36.7993439,-1.2780878,36.8469436,31,1364,650,306
1793,25607,724,1,Personal,28,5,54616,28,5,54810,28,5,55962,28,5,56139,28,5,57621,8,25.6,-1.2619538,36.8087637,-1.3023756,36.7949276,21,1482,194,1329
1794,7497,2330,3,Business,12,5,52984,12,5,53087,12,5,53361,12,5,53684,12,5,54702,7,23.25888921888938,-1.2890715,36.8157588,-1.2645318,36.7981775,79,1018,103,597
1795,4862,1927,3,Business,11,1,64252,11,1,65779,11,1,67800,11,1,68443,11,1,70876,19,23.25888921888938,-1.2927792,36.9053492,-1.3472066,36.7692638,377,2433,1527,2664
1796,21747,1705,3,Business,19,4,36526,19,4,39235,19,4,39396,19,4,39748,19,4,41785,7,20.1,-1.2551895,36.7822034,-1.2882803,36.7815881,752,2037,2709,513
1797,10824,1245,3,Business,17,5,42108,17,5,42149,17,5,42309,17,5,42700,17,5,46261,18,23.25888921888938,-1.3198615,36.7110323,-1.300921,36.828195,855,3561,41,551
1798,19013,867,3,Business,2,2,26350,2,2,26642,2,2,29043,2,2,29671,2,2,31359,10,20.5,-1.2996533,36.8292629,-1.2991441,36.7528804,206,1688,292,3029
1799,19678,1004,3,Business,8,3,41978,8,3,42018,8,3,42389,8,3,43963,8,3,47594,15,23.25888921888938,-1.2586579,36.8137885,-1.3250048,36.8697188,959,3631,40,1945
1800,2222,3201,3,Business,19,5,53069,19,5,53095,19,5,53348,19,5,53865,19,5,54438,3,27.5,-1.2649605,36.7981777,-1.2551895,36.7822034,881,573,26,770
1801,21263,2503,2,Business,20,1,57655,20,1,59585,20,1,61380,20,1,62108,20,1,63891,7,20.4,-1.2824911,36.8218042,-1.2551895,36.7822034,532,1783,1930,2523
1802,16516,2423,3,Business,3,2,36382,3,2,36957,3,2,37877,3,2,37988,3,2,42294,7,18.5,-1.2551895,36.7822034,-1.2934657,36.8212737,844,4306,575,1031
1803,13842,2956,3,Business,26,2,48982,26,2,48993,26,2,49612,26,2,49971,26,2,50328,1,29.6,-1.2584143,36.8048002,-1.2594539,36.8067841,205,357,11,978
1804,11315,633,3,Business,24,3,55406,24,3,57040,24,3,57055,24,3,58549,24,3,58956,4,18.4,-1.3177547,36.8303703,-1.3004062,36.829741,515,407,1634,1509
1805,4174,3320,3,Business,10,4,28498,10,4,28545,10,4,28576,10,4,29649,10,4,32177,26,19.0,-1.2708331,36.7904193,-1.3799485,36.9349923,822,2528,47,1104
1806,22528,1245,3,Business,21,2,39926,21,2,40378,21,2,40480,21,2,40863,21,2,44241,14,22.7,-1.3198615,36.7110323,-1.2668611,36.7956387,315,3378,452,485
1807,15686,755,1,Personal,29,6,53727,29,6,53751,29,6,54783,29,6,55690,29,6,57265,12,28.0,-1.2640571,36.7883547,-1.2270685,36.7606809,178,1575,24,1939
1808,24768,3295,3,Business,6,4,43187,6,4,43214,6,4,44735,6,4,44938,6,4,47512,8,19.5,-1.2571472,36.7950633,-1.2814233,36.8251177,739,2574,27,1724
1809,15382,2454,3,Business,23,2,37129,23,2,37257,23,2,38057,23,2,38685,23,2,40081,10,17.8,-1.3270424,36.7040693,-1.2993231,36.7753372,565,1396,128,1428
1810,45,1271,3,Business,23,5,55832,23,5,57065,23,5,59753,23,5,60756,23,5,63401,20,24.5,-1.3244885,36.897792,-1.2915472,36.7746964,322,2645,1233,3691
1811,21997,1642,3,Business,19,2,51897,19,2,51913,19,2,52435,19,2,52582,19,2,53897,5,29.8,-1.2887076,36.8254658,-1.2726506,36.7960153,330,1315,16,669
1812,7901,246,3,Business,30,3,33487,30,3,33529,30,3,33535,30,3,34716,30,3,36362,7,19.9,-1.225322,36.80855,-1.2584143,36.8048002,31,1646,42,1187
1813,22052,734,1,Personal,9,2,67035,9,2,67069,9,2,67552,9,2,67917,9,2,68644,5,18.8,-1.2947442,36.7624888,-1.2654136,36.7825146,648,727,34,848
1814,3871,1363,3,Business,17,5,46375,17,5,46541,17,5,46554,17,5,47203,17,5,48230,6,23.25888921888938,-1.3004062,36.829741,-1.269534,36.80697,855,1027,166,662
1815,18312,1259,3,Business,11,5,35217,11,5,35244,11,5,36098,11,5,37742,11,5,41368,15,17.9,-1.2913193,36.8338181,-1.229351,36.7556406,543,3626,27,2498
1816,3076,1073,3,Business,1,1,53907,1,1,53919,1,1,54441,1,1,54591,1,1,56017,16,23.25888921888938,-1.2561964,36.7885001,-1.22386,36.8887256,147,1426,12,672
1817,11636,2523,3,Business,11,5,40269,11,5,40283,11,5,40998,11,5,41396,11,5,41708,4,21.2,-1.2551895,36.7822034,-1.255956,36.772901,190,312,14,1113
1818,435,20,3,Business,4,2,50475,4,2,50567,4,2,52081,4,2,53429,4,2,55012,13,22.6,-1.3278522,36.8711134,-1.2629666,36.8068369,25,1583,92,2862
1819,22145,1967,1,Personal,15,2,37644,15,2,38922,15,2,39961,15,2,40159,15,2,41653,3,23.0,-1.2740396,36.7993518,-1.2656584,36.8096257,761,1494,1278,1237
1820,11695,1402,3,Business,18,4,52699,18,4,52742,18,4,53127,18,4,53782,18,4,54998,11,23.25888921888938,-1.2285835,36.8826468,-1.2813012,36.8323962,438,1216,43,1040
1821,11993,1372,3,Business,14,4,41004,14,4,41072,14,4,41956,14,4,42375,14,4,43561,3,25.0,-1.2875013,36.8171787,-1.2885417,36.8100523,30,1186,68,1303
1822,13246,1393,1,Business,24,7,50271,24,7,50415,24,7,53068,24,7,53171,24,7,55373,13,22.9,-1.2601709,36.8002238,-1.2156006,36.8916865,45,2202,144,2756
1823,17936,3718,3,Business,18,4,33624,18,4,33980,18,4,35695,18,4,36156,18,4,37684,5,20.6,-1.2650027,36.8126242,-1.2906618,36.8131222,147,1528,356,2176
1824,3510,1067,1,Personal,4,1,59136,4,1,61163,4,1,61958,4,1,62493,4,1,63093,4,20.8,-1.2621828,36.7949276,-1.273056,36.811298,434,600,2027,1330
1825,27588,619,1,Personal,12,2,40035,12,2,40057,12,2,40344,12,2,40830,12,2,41243,2,21.2,-1.3014515,36.8120092,-1.2913826,36.8006377,676,413,22,773
1826,25195,2828,1,Business,20,1,55404,20,1,55519,20,1,56276,20,1,56524,20,1,57437,5,21.3,-1.2696183,36.8021778,-1.2772389,36.7855864,407,913,115,1005
1827,8239,2689,1,Business,12,5,39272,12,5,39280,12,5,40591,12,5,43994,12,5,47489,19,24.6,-1.3053865,36.8917332,-1.2894847,36.7556088,248,3495,8,4714
1828,15763,1280,3,Business,19,3,55679,19,3,61481,19,3,62956,19,3,63388,19,3,66138,5,22.3,-1.2551895,36.7822034,-1.2684319,36.8165853,178,2750,5802,1907
1829,23086,1642,3,Business,13,3,52772,13,3,52843,13,3,54723,13,3,55004,13,3,57261,4,27.0,-1.2728069,36.7962362,-1.2765492,36.7669809,574,2257,71,2161
1830,13415,1809,3,Business,6,3,55535,6,3,55809,6,3,57981,6,3,58455,6,3,59958,6,22.0,-1.2646084,36.8028645,-1.291768,36.8297208,742,1503,274,2646
1831,9723,1329,3,Business,28,5,35579,28,5,35649,28,5,35839,28,5,35915,28,5,36296,3,19.3,-1.273056,36.811298,-1.2567464,36.7915273,337,381,70,266
1832,21940,2184,1,Personal,23,1,60334,23,1,60343,23,1,62594,23,1,62654,23,1,64307,7,19.4,-1.2764786,36.8194788,-1.2924639,36.7795798,229,1653,9,2311
1833,27953,868,3,Business,16,3,38013,16,3,38026,16,3,38348,16,3,39411,16,3,40881,7,22.9,-1.2628473,36.781805,-1.265715,36.823815,932,1470,13,1385
1834,8318,148,3,Business,2,1,57575,2,1,57705,2,1,58095,2,1,58492,2,1,58993,2,20.2,-1.2551895,36.7822034,-1.2579304,36.8019667,770,501,130,787
1835,15995,2330,3,Business,14,4,61254,14,4,61363,14,4,62034,14,4,62679,14,4,63468,4,25.8,-1.3040812,36.7924217,-1.3015197,36.7658456,119,789,109,1316
1836,4559,302,3,Business,21,3,55487,21,3,57111,21,3,57684,21,3,57920,21,3,58999,6,23.4,-1.2649605,36.7981777,-1.2755141,36.8323179,434,1079,1624,809
1837,7410,3283,3,Business,3,3,44177,3,3,44233,3,3,44859,3,3,45508,3,3,46281,5,27.3,-1.2600926,36.8088685,-1.2628473,36.781805,817,773,56,1275
1838,13278,2258,3,Business,11,1,41254,11,1,41279,11,1,41905,11,1,43649,11,1,45217,21,18.3,-1.2579304,36.8019667,-1.3417811,36.914606,541,1568,25,2370
1839,2715,2216,3,Business,5,2,45365,5,2,45413,5,2,48699,5,2,49887,5,2,53097,25,23.25888921888938,-1.2867627,36.883446,-1.1429062,36.9300994,697,3210,48,4474
1840,1204,1471,3,Business,3,1,59834,3,1,60171,3,1,62734,3,1,63075,3,1,64050,9,17.8,-1.2551895,36.7822034,-1.2917868,36.7872675,250,975,337,2904
1841,14954,1621,2,Personal,9,2,33150,9,2,33157,9,2,33816,9,2,34093,9,2,37546,17,17.7,-1.2840461,36.7934021,-1.3327654,36.8853117,805,3453,7,936
1842,22743,3404,3,Business,15,5,53053,15,5,53076,15,5,53083,15,5,53928,15,5,54779,5,17.7,-1.2584143,36.8048002,-1.279395,36.825364,330,851,23,852
1843,5023,3355,3,Business,13,3,53902,13,3,54503,13,3,54541,13,3,54925,13,3,55923,8,23.6,-1.3052491,36.8223899,-1.2615888,36.7928732,379,998,601,422
1844,25099,661,3,Business,29,2,53297,29,2,53335,29,2,54358,29,2,56394,29,2,57509,4,23.7,-1.2950044,36.7512209,-1.2963097,36.7688221,140,1115,38,3059
1845,13315,2216,3,Business,23,3,35699,23,3,35784,23,3,36365,23,3,36532,23,3,38279,16,23.25888921888938,-1.2551895,36.7822034,-1.3194518,36.869396,576,1747,85,748
1846,11041,191,1,Personal,31,2,47337,31,2,47396,31,2,47575,31,2,48080,31,2,49505,9,18.7,-1.296797,36.7764525,-1.2668265,36.7680484,101,1425,59,684
1847,16939,2150,3,Business,22,5,58640,22,5,58860,22,5,59403,22,5,60456,22,5,61758,11,28.5,-1.307143,36.825009,-1.344446,36.756597,206,1302,220,1596
1848,6745,3300,3,Business,22,3,33391,22,3,33486,22,3,34004,22,3,34827,22,3,36111,11,18.9,-1.331619,36.847976,-1.303596,36.778378,709,1284,95,1341
1849,11004,627,3,Business,24,5,44432,24,5,44627,24,5,44980,24,5,45232,24,5,46163,7,21.4,-1.2551895,36.7822034,-1.2848212,36.8224159,921,931,195,605
1850,26589,376,2,Personal,2,3,70485,2,3,71432,2,3,73107,2,3,73353,2,3,75241,10,17.1,-1.2655306,36.828148,-1.2655103,36.7686545,103,1888,947,1921
1851,16819,1246,3,Business,11,4,34420,11,4,34430,11,4,37954,11,4,39377,11,4,41771,26,25.5,-1.3700383,36.9190174,-1.27596,36.766263,863,2394,10,4947
1852,9082,1017,3,Business,29,3,60013,29,3,60152,29,3,60655,29,3,60779,29,3,62388,3,21.3,-1.2551895,36.7822034,-1.273488,36.804158,751,1609,139,627
1853,24038,664,1,Personal,29,2,27828,29,2,30046,29,2,31729,29,2,32222,29,2,33068,5,16.6,-1.2517392,36.8249608,-1.2633513,36.7941524,379,846,2218,2176
1854,9393,3331,3,Business,14,1,51728,14,1,51779,14,1,52186,14,1,52435,14,1,54280,10,25.5,-1.255956,36.789867,-1.3201096,36.8180968,207,1845,51,656
1855,19722,3235,1,Personal,28,5,43167,28,5,43397,28,5,43811,28,5,45094,28,5,46282,6,25.3,-1.2637296,36.8102898,-1.310011,36.820824,698,1188,230,1697
1856,24287,1162,3,Business,12,2,35200,12,2,35311,12,2,37149,12,2,38081,12,2,38939,7,28.3,-1.312261,36.794658,-1.296599,36.7629672,267,858,111,2770
1857,6905,2344,3,Business,23,5,58419,23,5,58870,23,5,59498,23,5,59655,23,5,60245,3,24.7,-1.2953162,36.7828041,-1.2857247,36.7894293,750,590,451,785
1858,12198,2869,3,Business,15,5,53064,15,5,53389,15,5,54328,15,5,55508,15,5,57073,9,17.9,-1.3169591,36.7000029,-1.3014461,36.7661381,392,1565,325,2119
1859,24833,1754,3,Business,27,3,50840,27,3,51041,27,3,51046,27,3,52193,27,3,53654,12,23.25888921888938,-1.2860183,36.8975338,-1.325469,36.862403,900,1461,201,1152
1860,25794,3222,3,Business,22,1,57300,22,1,57457,22,1,57864,22,1,58035,22,1,62056,7,26.3,-1.2551895,36.7822034,-1.2647473,36.8423019,412,4021,157,578
1861,1555,3496,3,Business,15,3,36110,15,3,39542,15,3,40391,15,3,42550,15,3,43493,6,18.1,-1.3127723,36.8758056,-1.300921,36.828195,670,943,3432,3008
1862,17233,2803,3,Business,14,3,34172,14,3,34202,14,3,35584,14,3,36360,14,3,38274,17,18.3,-1.269767,36.7351068,-1.2765736,36.8513646,536,1914,30,2158
1863,722,111,3,Business,4,5,55399,4,5,56419,4,5,56679,4,5,56835,4,5,59535,18,23.25888921888938,-1.2551895,36.7822034,-1.3277669,36.8975169,829,2700,1020,416
1864,23281,3159,1,Personal,9,6,49608,9,6,52459,9,6,52907,9,6,53171,9,6,54378,9,19.3,-1.2870003,36.8312206,-1.334168,36.8116716,852,1207,2851,712
1865,4395,2701,3,Business,28,2,36629,28,2,36695,28,2,38447,28,2,39321,28,2,40965,11,17.8,-1.225322,36.80855,-1.279395,36.825364,409,1644,66,2626
1866,26791,1594,3,Business,20,3,51237,20,3,51306,20,3,52186,20,3,53144,20,3,54709,15,29.6,-1.2325706,36.8083923,-1.2156006,36.8916865,205,1565,69,1838
1867,1838,3355,3,Business,15,6,50031,15,6,51091,15,6,51108,15,6,52805,15,6,53728,7,23.2,-1.2584143,36.8048002,-1.3052491,36.8223899,669,923,1060,1714
1868,22872,1205,3,Business,26,5,42813,26,5,43819,26,5,44194,26,5,44375,26,5,44984,3,23.25888921888938,-1.257309,36.8060084,-1.2700436,36.8209976,383,609,1006,556
1869,26529,53,3,Business,5,2,48792,5,2,49595,5,2,50209,5,2,50638,5,2,51587,6,27.5,-1.2770708,36.8231093,-1.2636051,36.7850995,267,949,803,1043
1870,8984,2330,3,Business,5,2,46187,5,2,46358,5,2,46954,5,2,48021,5,2,48444,10,23.7,-1.2687407,36.7373043,-1.2642903,36.8002137,269,423,171,1663
1871,14610,2532,3,Business,7,5,40030,7,5,41870,7,5,42163,7,5,42229,7,5,43337,7,23.25888921888938,-1.2551895,36.7822034,-1.284959,36.821733,910,1108,1840,359
1872,99,516,3,Business,22,5,38615,22,5,38654,22,5,38704,22,5,38839,22,5,39776,9,23.25888921888938,-1.2551895,36.7822034,-1.2978456,36.7537369,379,937,39,185
1873,25081,625,3,Business,15,6,35769,15,6,39092,15,6,39963,15,6,40138,15,6,41787,4,21.8,-1.2600926,36.8088685,-1.265715,36.823815,332,1649,3323,1046
1874,20467,2271,3,Business,26,5,38320,26,5,38338,26,5,38987,26,5,39989,26,5,42300,20,23.25888921888938,-1.2628473,36.781805,-1.293515,36.897607,427,2311,18,1651
1875,27774,111,3,Business,13,5,45404,13,5,45507,13,5,46733,13,5,47510,13,5,48463,6,23.25888921888938,-1.27871,36.819573,-1.2551895,36.7822034,159,953,103,2003
1876,16426,1892,2,Personal,1,1,57061,1,1,57260,1,1,58069,1,1,58261,1,1,59528,9,25.7,-1.2652835,36.8360259,-1.22589,36.7822548,622,1267,199,1001
1877,10891,1033,3,Personal,15,5,39021,15,5,39071,15,5,39778,15,5,40150,15,5,41534,11,26.4,-1.2326041,36.8009029,-1.2830057,36.8175478,669,1384,50,1079
1878,4358,1959,3,Business,10,1,47240,10,1,47311,10,1,47959,10,1,48501,10,1,52423,8,18.6,-1.2551895,36.7822034,-1.2943272,36.7667198,894,3922,71,1190
1879,10761,3091,3,Business,5,5,53508,5,5,54942,5,5,55603,5,5,55807,5,5,58913,3,27.8,-1.290894,36.822971,-1.2866078,36.8088733,910,3106,1434,865
1880,17828,2106,1,Personal,17,4,48245,17,4,48347,17,4,49198,17,4,50424,17,4,51911,12,24.1,-1.2840605,36.8191699,-1.1985673,36.8363688,266,1487,102,2077
1881,2079,3186,3,Business,7,2,41044,7,2,41121,7,2,41738,7,2,42123,7,2,42767,4,23.25888921888938,-1.2980229,36.78865,-1.2950041,36.8143583,865,644,77,1002
1882,6021,2457,1,Business,18,4,59804,18,4,60010,18,4,60530,18,4,60922,18,4,61573,3,23.5,-1.2571472,36.7950633,-1.269534,36.80697,646,651,206,912
1883,18038,393,3,Business,24,3,48636,24,3,48724,24,3,49151,24,3,50810,24,3,52805,14,23.25888921888938,-1.3167113,36.8301563,-1.306378,36.7519845,206,1995,88,2086
1884,4937,265,3,Business,25,4,30624,25,4,31915,25,4,31939,25,4,35085,25,4,36235,8,16.6,-1.254904,36.809583,-1.300921,36.828195,69,1150,1291,3170
1885,10658,3264,3,Business,30,3,41654,30,3,41788,30,3,43166,30,3,43451,30,3,44666,6,22.4,-1.2553615,36.7895376,-1.2687962,36.825707,742,1215,134,1663
1886,20104,2722,2,Personal,31,5,57545,31,5,57939,31,5,59256,31,5,60301,31,5,61984,10,19.9,-1.2915307,36.7905865,-1.232004,36.7902146,882,1683,394,2362
1887,9758,2708,2,Personal,9,4,64211,9,4,64241,9,4,64645,9,4,64825,9,4,65373,3,23.2,-1.3018758,36.7590863,-1.2901638,36.7787225,247,548,30,584
1888,13626,3283,3,Business,19,2,33081,19,2,33101,19,2,34538,19,2,36269,19,2,37549,14,21.1,-1.228911,36.881876,-1.2628473,36.781805,75,1280,20,3168
1889,12048,111,3,Business,31,5,51627,31,5,51756,31,5,53298,31,5,53523,31,5,54102,4,24.6,-1.2551895,36.7822034,-1.2747247,36.8150014,490,579,129,1767
1890,17487,435,3,Business,24,5,52320,24,5,52416,24,5,53171,24,5,53683,24,5,55380,8,23.0,-1.2580991,36.7941519,-1.300921,36.828195,155,1697,96,1267
1891,9809,1255,1,Personal,18,4,46194,18,4,46367,18,4,47280,18,4,47524,18,4,48740,9,25.6,-1.2833895,36.8212908,-1.290059,36.7703475,477,1216,173,1157
1892,15037,3560,3,Business,7,1,47737,7,1,47889,7,1,49145,7,1,49372,7,1,50460,1,26.8,-1.290894,36.822971,-1.279395,36.825364,210,1088,152,1483
1893,1744,3621,3,Business,13,1,34579,13,1,34622,13,1,35254,13,1,35418,13,1,36971,13,23.25888921888938,-1.2836583,36.7886014,-1.2355996,36.8160733,155,1553,43,796
1894,24848,909,3,Business,10,2,39096,10,2,39468,10,2,40516,10,2,40682,10,2,41833,7,20.1,-1.225322,36.80855,-1.2597034,36.8003065,726,1151,372,1214
1895,3869,1849,3,Business,28,3,31565,28,3,32477,28,3,33680,28,3,34761,28,3,36894,7,20.6,-1.290894,36.822971,-1.2551895,36.7822034,89,2133,912,2284
1896,20049,3718,3,Business,5,5,52794,5,5,53130,5,5,53789,5,5,54907,5,5,55617,12,26.7,-1.2650027,36.8126242,-1.2103372,36.835961,86,710,336,1777
1897,14175,20,3,Business,9,4,35389,9,4,35436,9,4,35589,9,4,36032,9,4,37119,8,23.25888921888938,-1.2629666,36.8068369,-1.2295205,36.8120426,227,1087,47,596
1898,22661,2445,2,Personal,11,2,33359,11,2,33497,11,2,35059,11,2,35890,11,2,36218,5,18.5,-1.2564677,36.7730828,-1.2664227,36.7453671,179,328,138,2393
1899,5058,3149,3,Business,21,2,40921,21,2,40947,21,2,42002,21,2,43565,21,2,44152,6,22.4,-1.3004062,36.829741,-1.3167113,36.8301563,409,587,26,2618
1900,3022,2366,1,Personal,26,6,43769,26,6,43820,26,6,43971,26,6,44707,26,6,46147,7,22.4,-1.2750893,36.7912189,-1.2629394,36.8275593,379,1440,51,887
1901,9682,2271,3,Business,17,3,54567,17,3,54665,17,3,56302,17,3,57997,17,3,59461,9,28.4,-1.3343129,36.8854175,-1.293515,36.897607,844,1464,98,3332
1902,24190,2069,3,Business,26,5,46147,26,5,46158,26,5,46169,26,5,47059,26,5,48571,9,23.25888921888938,-1.265715,36.823815,-1.228911,36.881876,155,1512,11,901
1903,15113,20,3,Business,20,5,30334,20,5,30359,20,5,30896,20,5,31284,20,5,32713,14,14.5,-1.2628638,36.8070399,-1.3346931,36.8661911,116,1429,25,925
1904,13607,3201,3,Business,16,2,37278,16,2,37381,16,2,37899,16,2,38089,16,2,39002,9,23.25888921888938,-1.2584143,36.8048002,-1.291254,36.765724,72,913,103,708
1905,20162,2346,1,Personal,26,6,61896,26,6,61952,26,6,63924,26,6,64208,26,6,65014,6,22.2,-1.3054537,36.8284768,-1.3121275,36.8519202,304,806,56,2256
1906,2632,2467,1,Personal,13,4,33547,13,4,33618,13,4,34512,13,4,34621,13,4,35573,6,18.4,-1.2880152,36.7716734,-1.3111884,36.8064496,749,952,71,1003
1907,23,1578,3,Business,11,2,59662,11,2,64626,11,2,65217,11,2,65597,11,2,69263,10,21.1,-1.225322,36.80855,-1.28878,36.8168312,609,3666,4964,971
1908,9369,393,3,Business,7,1,35181,7,1,35244,7,1,36344,7,1,38483,7,1,40834,10,21.3,-1.3177547,36.8303703,-1.2569006,36.7925141,358,2351,63,3239
1909,14242,1500,3,Business,25,1,43283,25,1,43386,25,1,43793,25,1,44235,25,1,44742,6,26.9,-1.2770708,36.8231093,-1.2638185,36.7930057,156,507,103,849
1910,24608,3669,3,Business,10,5,62211,10,5,62614,10,5,62677,10,5,67210,10,5,70710,25,23.25888921888938,-1.2615888,36.7928732,-1.3899636,36.7482377,864,3500,403,4596
1911,24278,2330,3,Business,5,4,53961,5,4,54078,5,4,54491,5,4,54744,5,4,55339,2,22.3,-1.2614329,36.8094365,-1.2682179,36.8009289,100,595,117,666
1912,27360,2789,3,Business,9,4,31407,9,4,31650,9,4,32951,9,4,33529,9,4,34569,8,23.25888921888938,-1.2569503,36.7834728,-1.304735,36.7846054,99,1040,243,1879
1913,16542,633,3,Business,13,3,43096,13,3,43182,13,3,44213,13,3,44311,13,3,45128,4,23.25888921888938,-1.2770708,36.8231093,-1.3004062,36.829741,763,817,86,1129
1914,2371,1542,1,Personal,23,4,33894,23,4,33971,23,4,35394,23,4,37613,23,4,38865,6,15.5,-1.2783547,36.8243545,-1.304969,36.846623,754,1252,77,3642
1915,21302,3108,3,Business,17,3,32079,17,3,32090,17,3,32235,17,3,32613,17,3,33617,10,23.25888921888938,-1.2551895,36.7822034,-1.2903067,36.8375634,291,1004,11,523
1916,10473,510,3,Business,6,4,62384,6,4,62456,6,4,63806,6,4,63930,6,4,66408,17,22.0,-1.2860183,36.8975338,-1.3251825,36.7897587,890,2478,72,1474
1917,1615,2063,3,Business,15,2,36117,15,2,37731,15,2,38096,15,2,38375,15,2,42053,8,22.9,-1.2626906,36.7827022,-1.2904016,36.8226303,786,3678,1614,644
1918,22039,3560,3,Business,14,3,41236,14,3,41300,14,3,41819,14,3,42728,14,3,44917,5,24.4,-1.2584143,36.8048002,-1.279395,36.825364,935,2189,64,1428
1919,3169,1502,3,Business,12,1,49184,12,1,50286,12,1,50924,12,1,51236,12,1,56187,11,26.8,-1.2765736,36.8513646,-1.2232123,36.8932547,490,4951,1102,950
1920,24674,3655,1,Personal,7,4,56566,7,4,57068,7,4,58189,7,4,58375,7,4,60352,8,19.9,-1.2941792,36.7633637,-1.2943371,36.8267,212,1977,502,1307
1921,17072,859,2,Personal,29,5,51626,29,5,51647,29,5,51773,29,5,52557,29,5,53783,5,21.1,-1.2857671,36.7875614,-1.3159617,36.8117934,898,1226,21,910
1922,14112,2718,3,Business,23,1,58173,23,1,58224,23,1,58633,23,1,58864,23,1,59407,2,23.25888921888938,-1.2601,36.796528,-1.2635089,36.7887337,519,543,51,640
1923,28062,1920,3,Business,23,5,43710,23,5,43782,23,5,44080,23,5,44352,23,5,46788,28,24.1,-1.2551895,36.7822034,-1.1838303,36.9543295,913,2436,72,570
1924,17153,1724,3,Business,3,5,35236,3,5,35266,3,5,35953,3,5,36436,3,5,37156,5,23.25888921888938,-1.2638132,36.7849775,-1.2571472,36.7950633,778,720,30,1170
1925,4456,136,3,Business,10,4,56779,10,4,57013,10,4,57813,10,4,58643,10,4,59456,8,25.0,-1.3009676,36.7657189,-1.3254522,36.7216584,906,813,234,1630
1926,9120,1611,3,Personal,3,1,38688,3,1,38718,3,1,38961,3,1,39372,3,1,39758,2,20.6,-1.2618016,36.7942025,-1.2663135,36.7973895,875,386,30,654
1927,15548,3688,3,Business,30,3,37630,30,3,37637,30,3,37815,30,3,38243,30,3,38248,3,24.8,-1.2551895,36.7822034,-1.2560455,36.7800867,191,5,7,606
1928,5082,3317,1,Personal,27,7,58239,27,7,58617,27,7,59995,27,7,60312,27,7,61800,10,22.0,-1.2517392,36.8249608,-1.2737137,36.7716706,281,1488,378,1695
1929,6967,1754,3,Business,11,5,33809,11,5,33815,11,5,33821,11,5,34045,11,5,36126,10,18.1,-1.2860183,36.8975338,-1.325469,36.862403,900,2081,6,230
1930,5893,2237,3,Business,15,6,37704,15,6,37816,15,6,38603,15,6,39557,15,6,40001,4,23.25888921888938,-1.266571,36.801406,-1.2772389,36.7855864,882,444,112,1741
1931,1860,393,3,Business,13,4,57644,13,4,57656,13,4,57687,13,4,59866,13,4,60398,4,22.3,-1.3228003,36.8306435,-1.3004062,36.829741,10,532,12,2210
1932,15907,1297,2,Personal,20,6,35688,20,6,35704,20,6,36094,20,6,36471,20,6,37779,13,19.8,-1.3446058,36.7605178,-1.2872974,36.8102954,22,1308,16,767
1933,27888,1268,1,Personal,17,5,61223,17,5,61391,17,5,62292,17,5,63326,17,5,64924,9,18.9,-1.2751745,36.7657676,-1.2983805,36.8198439,213,1598,168,1935
1934,25300,1271,3,Business,26,2,53659,26,2,53679,26,2,53683,26,2,54453,26,2,55952,8,30.9,-1.3244885,36.897792,-1.3263105,36.8622904,258,1499,20,774
1935,2117,2363,1,Personal,9,6,62363,9,6,62402,9,6,62492,9,6,63168,9,6,64298,12,19.1,-1.2649605,36.7981777,-1.20079,36.77198,116,1130,39,766
1936,24082,265,3,Business,3,3,42132,3,3,42385,3,3,42412,3,3,42705,3,3,43692,4,27.5,-1.300921,36.828195,-1.3205164,36.8098882,661,987,253,320
1937,7399,2657,3,Personal,28,2,34139,28,2,34201,28,2,34262,28,2,35494,28,2,38786,13,18.7,-1.2752846,36.8027022,-1.2422865,36.7278485,99,3292,62,1293
1938,670,867,3,Business,21,2,39413,21,2,39881,21,2,40622,21,2,40749,21,2,41932,9,22.3,-1.2638185,36.7930057,-1.2991441,36.7528804,709,1183,468,868
1939,12155,3737,1,Personal,20,1,45799,20,1,45883,20,1,48070,20,1,48504,20,1,50114,11,20.4,-1.2248308,36.8012573,-1.2797664,36.826967,754,1610,84,2621
1940,22200,517,3,Business,28,5,29651,28,5,29666,28,5,29872,28,5,30092,28,5,31688,14,19.3,-1.3167113,36.8301563,-1.306378,36.7519845,523,1596,15,426
1941,4526,136,3,Business,22,5,57155,22,5,57319,22,5,57477,22,5,59324,22,5,59718,3,30.8,-1.2551895,36.7822034,-1.2654716,36.7983635,607,394,164,2005
1942,25931,914,3,Business,17,1,37097,17,1,37104,17,1,37500,17,1,37865,17,1,38487,3,18.0,-1.2670213,36.7994482,-1.2630521,36.8068019,858,622,7,761
1943,15909,3355,3,Business,6,5,44472,6,5,44490,6,5,44806,6,5,45324,6,5,46530,8,20.2,-1.3052491,36.8223899,-1.2551895,36.7822034,726,1206,18,834
1944,2346,2330,3,Business,2,6,44673,2,6,44685,2,6,45141,2,6,45213,2,6,45698,2,27.7,-1.2873232,36.7658572,-1.3015197,36.7658456,368,485,12,528
1945,25246,2066,3,Business,19,2,45745,19,2,45801,19,2,46707,19,2,47017,19,2,48054,11,26.6,-1.3210189,36.8410551,-1.3202327,36.7868314,914,1037,56,1216
1946,7623,1724,3,Business,3,2,43224,3,2,43493,3,2,45694,3,2,46345,3,2,47685,10,18.4,-1.2551895,36.7822034,-1.3066143,36.8161046,312,1340,269,2852
1947,4202,3521,3,Business,30,2,51054,30,2,55662,30,2,56776,30,2,57513,30,2,58855,9,27.4,-1.2248308,36.8012573,-1.2768326,36.8073804,726,1342,4608,1851
1948,3643,1642,3,Business,26,1,54150,26,1,56544,26,1,57010,26,1,57792,26,1,58815,6,22.3,-1.2726506,36.7960153,-1.2889024,36.8187402,88,1023,2394,1248
1949,16458,2412,3,Business,10,1,30170,10,1,30630,10,1,31664,10,1,32233,10,1,33841,11,16.6,-1.2283403,36.8822756,-1.28878,36.8168312,845,1608,460,1603
1950,7777,1162,3,Business,29,2,53954,29,2,53973,29,2,54336,29,2,54453,29,2,56146,14,26.9,-1.280909,36.739555,-1.2733047,36.8109744,205,1693,19,480
1951,23151,265,3,Business,4,4,48321,4,4,48439,4,4,49400,4,4,50072,4,4,53420,7,24.8,-1.300921,36.828195,-1.260039,36.8159152,19,3348,118,1633
1952,16746,633,3,Business,22,2,43741,22,2,45638,22,2,45678,22,2,46640,22,2,48148,9,24.2,-1.2574219,36.7927073,-1.3004062,36.829741,445,1508,1897,1002
1953,1733,1687,3,Business,24,5,43407,24,5,43493,24,5,43838,24,5,44310,24,5,47179,6,21.3,-1.2626574,36.8014034,-1.2252229,36.8035587,660,2869,86,817
1954,1352,2629,2,Personal,14,5,45382,14,5,45452,14,5,45883,14,5,45945,14,5,46405,5,24.6,-1.2925317,36.8021114,-1.2753109,36.8130185,726,460,70,493
1955,8555,1324,2,Personal,1,3,46009,1,3,46051,1,3,46885,1,3,47776,1,3,50554,8,19.8,-1.2611578,36.8145307,-1.3061562,36.8184362,131,2778,42,1725
1956,19897,2171,2,Personal,25,6,52021,25,6,52050,25,6,52327,25,6,52731,25,6,53894,6,23.25888921888938,-1.2709579,36.8108962,-1.3009926,36.8208532,427,1163,29,681
1957,26408,1363,3,Business,4,1,57936,4,1,58052,4,1,58564,4,1,58778,4,1,59967,4,28.5,-1.3004062,36.829741,-1.2902869,36.8085396,668,1189,116,726
1958,8198,393,3,Business,1,1,29861,1,1,29871,1,1,30779,1,1,30932,1,1,32777,14,18.6,-1.3177547,36.8303703,-1.306378,36.7519845,731,1845,10,1061
1959,27039,2216,3,Business,8,1,44951,8,1,44970,8,1,45746,8,1,46439,8,1,47269,2,24.3,-1.2551895,36.7822034,-1.2635051,36.7829162,566,830,19,1469
1960,6899,733,3,Business,6,1,63007,6,1,63031,6,1,63034,6,1,63280,6,1,63660,3,23.25888921888938,-1.2551895,36.7822034,-1.2649605,36.7981777,576,380,24,249
1961,20093,3108,3,Business,12,2,39019,12,2,39039,12,2,39744,12,2,40305,12,2,42033,17,24.4,-1.2551895,36.7822034,-1.3393558,36.8982418,932,1728,20,1266
1962,18217,2330,1,Business,15,1,60118,15,1,60207,15,1,60722,15,1,61150,15,1,62925,9,23.25888921888938,-1.2671943,36.8062533,-1.30176,36.765658,45,1775,89,943
1963,6055,295,3,Business,31,1,40708,31,1,41984,31,1,41992,31,1,42328,31,1,43013,6,20.9,-1.286925,36.821916,-1.2967108,36.7871135,942,685,1276,344
1964,2720,1402,3,Business,16,4,52871,16,4,52932,16,4,54612,16,4,54868,16,4,55554,1,23.25888921888938,-1.290894,36.822971,-1.2813012,36.8323962,617,686,61,1936
1965,13857,246,3,Business,9,6,54050,9,6,54066,9,6,54615,9,6,55072,9,6,56259,7,19.4,-1.225322,36.80855,-1.2584143,36.8048002,116,1187,16,1006
1966,24000,478,3,Business,30,2,29530,30,2,29555,30,2,30384,30,2,30824,30,2,32788,10,23.25888921888938,-1.2551895,36.7822034,-1.2973682,36.7859878,247,1964,25,1269
1967,24817,868,3,Business,28,2,44996,28,2,45098,28,2,45528,28,2,46089,28,2,46875,9,21.2,-1.2296618,36.8438272,-1.265715,36.823815,7,786,102,991
1968,26731,393,3,Business,8,4,46911,8,4,46949,8,4,47471,8,4,48388,8,4,50428,14,26.1,-1.3177547,36.8303703,-1.306378,36.7519845,581,2040,38,1439
1969,26735,2461,3,Business,9,2,50961,9,2,51107,9,2,52261,9,2,52407,9,2,53281,9,22.5,-1.2373977,36.7598693,-1.2790653,36.7907262,754,874,146,1300
1970,9989,1425,3,Business,22,5,49775,22,5,49812,22,5,51032,22,5,51126,22,5,53561,15,31.2,-1.338283,36.8871775,-1.29387,36.7907813,883,2435,37,1314
1971,25731,3450,3,Business,3,4,52882,3,4,52927,3,4,57873,3,4,58063,3,4,59575,6,25.0,-1.2825816,36.8092346,-1.255956,36.789867,916,1512,45,5136
1972,22768,3525,3,Business,22,5,58409,22,5,58680,22,5,58711,22,5,64473,22,5,64476,20,28.7,-1.2649605,36.7981777,-1.3700383,36.9190174,613,3,271,5793
1973,10386,2120,1,Personal,9,3,66521,9,3,66574,9,3,67176,9,3,67621,9,3,69069,8,21.7,-1.262207,36.790153,-1.22589,36.7822548,103,1448,53,1047
1974,7295,1207,3,Business,17,3,41662,17,3,41712,17,3,42031,17,3,42935,17,3,44422,13,23.25888921888938,-1.2628638,36.8070399,-1.2156006,36.8916865,484,1487,50,1223
1975,21122,3599,3,Business,8,6,36407,8,6,36407,8,6,40442,8,6,40551,8,6,42469,7,20.2,-1.3302996,36.8707935,-1.3205832,36.8401395,459,1918,0,4144
1976,11654,627,3,Business,22,5,37855,22,5,38156,22,5,38424,22,5,38676,22,5,40202,7,28.5,-1.2551895,36.7822034,-1.2821653,36.8199793,709,1526,301,520
1977,17093,1081,3,Business,13,3,39700,13,3,39726,13,3,39727,13,3,40360,13,3,43734,23,24.9,-1.2551895,36.7822034,-1.3450192,36.9211859,579,3374,26,634
1978,1857,435,3,Business,22,3,31400,22,3,31638,22,3,31642,22,3,33155,22,3,33784,6,18.6,-1.300921,36.828195,-1.281577,36.7938293,61,629,238,1517
1979,9743,2956,3,Business,16,4,37341,16,4,37355,16,4,37727,16,4,39408,16,4,39414,2,23.25888921888938,-1.2615888,36.7928732,-1.2584143,36.8048002,161,6,14,2053
1980,15153,2200,3,Business,20,2,60027,20,2,60855,20,2,61332,20,2,62202,20,2,62207,2,23.6,-1.279395,36.825364,-1.290894,36.822971,926,5,828,1347
1981,18198,3355,3,Business,16,3,56569,16,3,56601,16,3,56966,16,3,57616,16,3,58523,7,26.9,-1.2584143,36.8048002,-1.3052491,36.8223899,926,907,32,1015
1982,26879,1666,3,Personal,13,1,34193,13,1,34275,13,1,34761,13,1,35114,13,1,35769,5,15.1,-1.2941024,36.79578,-1.288269,36.8182753,79,655,82,839
1983,10419,2869,3,Business,4,2,44298,4,2,44577,4,2,45843,4,2,46449,4,2,48067,9,20.3,-1.279395,36.825364,-1.3025826,36.7670807,709,1618,279,1872
1984,6321,435,3,Business,12,3,50787,12,3,50913,12,3,51427,12,3,52837,12,3,55101,16,21.0,-1.300921,36.828195,-1.2094552,36.8073286,211,2264,126,1924
1985,2293,2946,2,Personal,23,3,55461,23,3,55936,23,3,58288,23,3,58442,23,3,59427,7,22.3,-1.2785534,36.8230501,-1.2749662,36.7658781,116,985,475,2506
1986,21056,635,3,Business,30,5,52906,30,5,52923,30,5,53159,30,5,54704,30,5,55459,8,24.4,-1.3016417,36.8271679,-1.2599563,36.7993439,551,755,17,1781
1987,19511,2523,3,Business,9,5,51890,9,5,52386,9,5,52929,9,5,53685,9,5,57352,8,26.3,-1.2551895,36.7822034,-1.2989934,36.8136694,726,3667,496,1299
1988,5395,1291,3,Personal,3,3,35412,3,3,35433,3,3,36307,3,3,36951,3,3,38180,8,18.6,-1.2664491,36.8102685,-1.2963097,36.7688221,219,1229,21,1518
1989,12021,3547,3,Business,10,1,41317,10,1,41347,10,1,41513,10,1,43277,10,1,44475,9,18.3,-1.3285517,36.9018,-1.3194518,36.869396,856,1198,30,1930
1990,11089,3718,3,Business,31,3,43544,31,3,43614,31,3,43639,31,3,44406,31,3,45901,10,24.9,-1.2650027,36.8126242,-1.3205669,36.8362168,208,1495,70,792
1991,15500,2391,3,Personal,14,4,76069,14,4,76107,14,4,76708,14,4,77018,14,4,77278,2,23.25888921888938,-1.277783,36.7816464,-1.2900727,36.7890059,334,260,38,911
1992,20939,2212,3,Business,9,4,44907,9,4,45103,9,4,45640,9,4,46020,9,4,46894,5,23.25888921888938,-1.2571472,36.7950633,-1.2425149,36.7890137,937,874,196,917
1993,21203,1500,3,Business,28,4,30442,28,4,30525,28,4,31348,28,4,33910,28,4,34437,8,19.4,-1.3004062,36.829741,-1.2638185,36.7930057,206,527,83,3385
1994,26103,1964,3,Personal,11,3,47930,11,3,48068,11,3,48437,11,3,48600,11,3,49948,10,19.1,-1.3332749,36.8708147,-1.2877501,36.8146599,45,1348,138,532
1995,2134,1500,3,Business,4,5,32679,4,5,32785,4,5,34814,4,5,35188,4,5,37885,11,19.3,-1.3077869,36.8443207,-1.2569006,36.7925141,543,2697,106,2403
1996,12602,1342,3,Business,4,1,40638,4,1,41488,4,1,41923,4,1,42527,4,1,43381,5,21.0,-1.2962832,36.7849683,-1.3014461,36.7661381,322,854,850,1039
1997,1960,1246,3,Business,31,2,33849,31,2,33855,31,2,34453,31,2,35798,31,2,38118,19,16.9,-1.2689785,36.8082713,-1.3700383,36.9190174,520,2320,6,1943
1998,4570,1402,3,Business,30,2,53677,30,2,54316,30,2,55084,30,2,56699,30,2,56706,1,23.25888921888938,-1.290894,36.822971,-1.2813012,36.8323962,953,7,639,2383
1999,21809,163,1,Personal,3,1,49191,3,1,49219,3,1,49744,3,1,50134,3,1,51581,12,23.0,-1.2901786,36.824294,-1.2320609,36.752092,882,1447,28,915
2000,16898,3689,3,Business,25,3,54324,25,3,54547,25,3,54825,25,3,55834,25,3,57359,6,17.6,-1.2911905,36.8226543,-1.2527958,36.8003131,208,1525,223,1287
2001,732,186,3,Business,7,5,39399,7,5,39457,7,5,40485,7,5,40786,7,5,43202,23,23.25888921888938,-1.3700383,36.9190174,-1.2571472,36.7950633,475,2416,58,1329
2002,27386,67,3,Personal,18,1,40681,18,1,40738,18,1,42248,18,1,42478,18,1,45352,11,27.1,-1.2583017,36.8023526,-1.3108386,36.7555239,448,2874,57,1740
2003,16878,1217,3,Personal,27,3,45912,27,3,45925,27,3,46055,27,3,46588,27,3,49052,14,26.0,-1.2175583,36.884343,-1.2799676,36.8221967,829,2464,13,663
2004,11457,3214,3,Business,2,5,37041,2,5,38878,2,5,40707,2,5,40904,2,5,42601,8,23.7,-1.289795,36.7957132,-1.2604408,36.8206328,612,1697,1837,2026
2005,15457,302,3,Business,18,4,73204,18,4,73284,18,4,74198,18,4,74316,18,4,75663,5,20.0,-1.2649605,36.7981777,-1.2844072,36.8247296,299,1347,80,1032
2006,26455,393,3,Business,15,1,51192,15,1,51242,15,1,51431,15,1,52378,15,1,52542,8,23.25888921888938,-1.3167113,36.8301563,-1.2770708,36.8231093,403,164,50,1136
2007,9415,136,3,Business,10,5,35617,10,5,35679,10,5,36000,10,5,36179,10,5,37253,10,23.25888921888938,-1.3254522,36.7216584,-1.2835448,36.7708792,72,1074,62,500
2008,20594,2978,3,Business,27,1,41416,27,1,41422,27,1,42036,27,1,42498,27,1,44954,24,23.9,-1.3076278,36.9158578,-1.2551895,36.7822034,874,2456,6,1076
2009,10029,842,2,Personal,11,1,35320,11,1,36266,11,1,38261,11,1,38631,11,1,44214,5,18.0,-1.296817,36.7884565,-1.2934657,36.8212737,844,5583,946,2365
2010,1250,3621,3,Business,13,6,53883,13,6,53919,13,6,55302,13,6,56216,13,6,57787,18,27.6,-1.2836583,36.7886014,-1.3123349,36.9152001,119,1571,36,2297
2011,27462,302,3,Business,12,2,48424,12,2,48524,12,2,49125,12,2,49465,12,2,50530,6,26.8,-1.2652979,36.8000399,-1.2974472,36.8156997,576,1065,100,941
2012,24606,3283,3,Business,31,4,48171,31,4,48203,31,4,48570,31,4,49185,31,4,49857,6,28.6,-1.272828,36.816608,-1.2628473,36.781805,576,672,32,982
2013,20645,1524,1,Personal,8,6,34508,8,6,34539,8,6,35192,8,6,35665,8,6,40944,19,18.3,-1.2943272,36.7667198,-1.2859194,36.900615,312,5279,31,1126
2014,27985,322,3,Business,9,2,43252,9,2,43275,9,2,44237,9,2,45774,9,2,47523,13,21.8,-1.2452664,36.8028541,-1.2300082,36.8867427,882,1749,23,2499
2015,17311,3291,3,Business,2,4,53046,2,4,53099,2,4,54049,2,4,54133,2,4,54572,2,26.0,-1.2673935,36.8030328,-1.2600926,36.8088685,882,439,53,1034
2016,16774,1584,3,Business,13,3,49879,13,3,50253,13,3,52201,13,3,52356,13,3,53553,7,29.1,-1.2771155,36.82668,-1.2969741,36.7856612,763,1197,374,2103
2017,8801,1482,3,Business,29,3,30204,29,3,30204,29,3,31733,29,3,31845,29,3,32927,7,17.8,-1.2649605,36.7981777,-1.3066126,36.8231944,576,1082,0,1641
2018,5839,1209,3,Business,5,5,56184,5,5,56278,5,5,57632,5,5,57725,5,5,58768,5,27.8,-1.3004062,36.829741,-1.2770708,36.8231093,783,1043,94,1447
2019,21806,246,3,Business,28,5,44074,28,5,45563,28,5,46125,28,5,46464,28,5,48674,4,25.1,-1.2584143,36.8048002,-1.2848174,36.826163,754,2210,1489,901
2020,26583,1882,3,Business,6,3,68719,6,3,68811,6,3,69571,6,3,69778,6,3,70803,7,23.25888921888938,-1.2603403,36.7998848,-1.2268871,36.8073946,119,1025,92,967
2021,18294,3470,3,Business,27,3,46843,27,3,47063,27,3,47742,27,3,48657,27,3,50458,4,25.8,-1.28878,36.8168312,-1.2636814,36.8029965,329,1801,220,1594
2022,8295,393,3,Business,8,2,48183,8,2,48193,8,2,49001,8,2,49701,8,2,50293,4,25.2,-1.3167113,36.8301563,-1.3004062,36.829741,62,592,10,1508
2023,16689,3080,3,Business,20,1,42687,20,1,42695,20,1,43046,20,1,43876,20,1,45495,12,20.3,-1.2551895,36.7822034,-1.3322618,36.8045412,213,1619,8,1181
2024,7492,393,3,Business,15,6,32667,15,6,32682,15,6,32687,15,6,33164,15,6,34315,11,16.9,-1.3228003,36.8306435,-1.2638185,36.7930057,619,1151,15,482
2025,1767,540,3,Business,8,2,42346,8,2,42368,8,2,42453,8,2,42907,8,2,43548,4,23.6,-1.2551895,36.7822034,-1.269534,36.80697,19,641,22,539
2026,24999,836,1,Personal,22,2,42962,22,2,43077,22,2,45138,22,2,45425,22,2,46693,7,19.2,-1.2463211,36.789487,-1.286937,36.8246742,844,1268,115,2348
2027,12732,186,3,Business,9,2,41847,9,2,41885,9,2,42101,9,2,43608,9,2,45758,20,27.2,-1.2571472,36.7950633,-1.3700383,36.9190174,770,2150,38,1723
2028,3653,75,2,Personal,28,5,41854,28,5,41887,28,5,42460,28,5,42840,28,5,43670,7,25.2,-1.2939132,36.8081606,-1.3014462,36.7607695,412,830,33,953
2029,25649,2330,3,Business,3,5,57090,3,5,57212,3,5,58734,3,5,59517,3,5,60387,3,23.25888921888938,-1.3040812,36.7924217,-1.294597,36.7742999,197,870,122,2305
2030,15850,825,1,Personal,23,7,60477,23,7,60551,23,7,62266,23,7,62594,23,7,64325,7,24.1,-1.2874711,36.7646208,-1.2590031,36.8078168,565,1731,74,2043
2031,27034,3669,3,Business,8,2,53718,8,2,55364,8,2,55896,8,2,56014,8,2,57749,13,25.3,-1.2615888,36.7928732,-1.3339166,36.8692482,86,1735,1646,650
2032,3679,3439,3,Business,23,4,33740,23,4,33790,23,4,34246,23,4,34480,23,4,37630,25,23.25888921888938,-1.2393157,36.7668877,-1.1481468,36.6515879,198,3150,50,690
2033,20460,1927,3,Business,11,6,46784,11,6,51530,11,6,52457,11,6,52686,11,6,53929,8,23.25888921888938,-1.3472066,36.7692638,-1.3165542,36.700067,572,1243,4746,1156
2034,13685,928,3,Business,30,2,48602,30,2,48932,30,2,48937,30,2,51915,30,2,53321,7,23.25888921888938,-1.2551895,36.7822034,-1.2857241,36.8203481,61,1406,330,2983
2035,26036,1329,3,Business,13,4,47308,13,4,47379,13,4,47781,13,4,47856,13,4,51838,9,22.2,-1.273056,36.811298,-1.2521132,36.7559772,279,3982,71,477
2036,11095,2112,3,Business,24,3,44708,24,3,44723,24,3,45991,24,3,46093,24,3,47438,16,19.8,-1.2551895,36.7822034,-1.2156006,36.8916865,587,1345,15,1370
2037,3956,393,3,Business,17,1,29172,17,1,36298,17,1,37326,17,1,38127,17,1,38656,4,23.9,-1.3167113,36.8301563,-1.3004062,36.829741,254,529,7126,1829
2038,6478,3270,1,Personal,10,1,39799,10,1,40769,10,1,43929,10,1,44273,10,1,48865,15,23.25888921888938,-1.2350906,36.7053329,-1.2738387,36.8179279,580,4592,970,3504
2039,25425,1578,3,Business,5,1,41038,5,1,41136,5,1,41764,5,1,43197,5,1,43429,1,24.4,-1.279395,36.825364,-1.28878,36.8168312,519,232,98,2061
2040,18027,2627,3,Business,20,3,43473,20,3,43517,20,3,44573,20,3,45343,20,3,45345,2,27.1,-1.2571472,36.7950633,-1.2591019,36.800577,647,2,44,1826
2041,26965,1500,3,Business,15,5,55578,15,5,55830,15,5,57048,15,5,57148,15,5,58342,9,17.8,-1.2638185,36.7930057,-1.3004062,36.829741,863,1194,252,1318
2042,4150,1927,3,Business,8,6,40950,8,6,40968,8,6,41631,8,6,43646,8,6,46962,15,18.5,-1.3025826,36.7670807,-1.3463042,36.768164,355,3316,18,2678
2043,4985,1329,3,Business,28,3,37419,28,3,37520,28,3,37863,28,3,37974,28,3,38913,5,23.25888921888938,-1.273056,36.811298,-1.2849763,36.7841767,663,939,101,454
2044,19264,1148,3,Business,10,5,35630,10,5,35875,10,5,38324,10,5,39235,10,5,39877,3,19.2,-1.3100586,36.8500329,-1.311818,36.8638544,519,642,245,3360
2045,16601,868,3,Business,27,6,38845,27,6,38878,27,6,39746,27,6,40217,27,6,41520,8,23.25888921888938,-1.303596,36.778378,-1.265715,36.823815,641,1303,33,1339
2046,20024,2454,3,Business,22,2,47035,22,2,47126,22,2,47708,22,2,47864,22,2,48288,2,23.9,-1.2993231,36.7753372,-1.293716,36.772628,847,424,91,738
2047,12073,3238,3,Business,29,3,48095,29,3,48161,29,3,49029,29,3,49441,29,3,54574,28,21.2,-1.2454537,36.7782792,-1.3976138,36.782966,815,5133,66,1280
2048,10278,420,3,Business,21,4,59419,21,4,59439,21,4,59527,21,4,60169,21,4,61643,9,23.25888921888938,-1.2517448,36.7924971,-1.2915307,36.7905865,81,1474,20,730
2049,7436,2747,1,Personal,2,1,54365,2,1,55102,2,1,55963,2,1,56271,2,1,57453,7,19.8,-1.2738397,36.8186697,-1.2980229,36.78865,726,1182,737,1169
2050,12291,2096,1,Personal,5,6,32375,5,6,32392,5,6,32884,5,6,33327,5,6,36674,24,19.1,-1.2821108,36.8250555,-1.3587746,36.6517452,338,3347,17,935
2051,28184,2982,3,Business,7,4,43903,7,4,43927,7,4,44289,7,4,45658,7,4,47695,18,24.2,-1.300921,36.828195,-1.177202,36.8351183,114,2037,24,1731
2052,24538,2627,3,Business,17,3,52711,17,3,52736,17,3,53141,17,3,53238,17,3,53240,2,23.25888921888938,-1.2571472,36.7950633,-1.2591019,36.800577,40,2,25,502
2053,25,3647,3,Business,22,1,46392,22,1,46490,22,1,47103,22,1,47715,22,1,48821,5,24.7,-1.272639,36.794723,-1.2941557,36.7792012,328,1106,98,1225
2054,7529,2330,3,Business,14,5,48056,14,5,48512,14,5,49343,14,5,49468,14,5,50102,4,23.6,-1.3040812,36.7924217,-1.2868601,36.7738025,847,634,456,956
2055,5106,1557,3,Business,5,1,50748,5,1,53787,5,1,54266,5,1,55359,5,1,56035,1,25.9,-1.288269,36.8182753,-1.2815072,36.82096,281,676,3039,1572
2056,17913,3686,3,Business,21,5,43140,21,5,43352,21,5,44377,21,5,44832,21,5,46780,12,22.8,-1.2551895,36.7822034,-1.3104734,36.7363698,436,1948,212,1480
2057,9339,3214,3,Business,7,5,47249,7,5,47338,7,5,48094,7,5,48346,7,5,50771,21,25.0,-1.289795,36.7957132,-1.3450476,36.9176745,263,2425,89,1008
2058,451,1469,3,Business,29,1,62856,29,1,62886,29,1,62900,29,1,63481,29,1,63914,4,23.25888921888938,-1.2566689,36.7796952,-1.2551895,36.7822034,843,433,30,595
2059,24001,570,3,Business,4,1,45978,4,1,45999,4,1,46359,4,1,46562,4,1,47623,3,25.7,-1.2649605,36.7981777,-1.2551895,36.7822034,227,1061,21,563
2060,798,2150,3,Business,10,5,57211,10,5,57630,10,5,58860,10,5,59741,10,5,61687,9,23.25888921888938,-1.303596,36.778378,-1.344446,36.756597,292,1946,419,2111
2061,5826,2458,3,Business,7,2,47415,7,2,47481,7,2,48106,7,2,48265,7,2,49318,6,23.0,-1.2857671,36.7875614,-1.2911796,36.8215068,636,1053,66,784
2062,25876,685,3,Business,13,4,33600,13,4,33665,13,4,34252,13,4,34529,13,4,35769,8,18.4,-1.265432,36.795034,-1.2960687,36.8167909,291,1240,65,864
2063,26930,2102,3,Business,27,2,34681,27,2,34741,27,2,36098,27,2,36556,27,2,39102,15,18.5,-1.3323107,36.8692616,-1.2613768,36.8019418,114,2546,60,1815
2064,18104,1316,1,Business,12,3,44401,12,3,44430,12,3,44479,12,3,45474,12,3,46426,7,23.4,-1.2551895,36.7822034,-1.2793503,36.8039715,45,952,29,1044
2065,3385,391,3,Business,31,1,50724,31,1,51844,31,1,52166,31,1,52345,31,1,53587,6,24.1,-1.2599563,36.7993439,-1.2867454,36.8259017,511,1242,1120,501
2066,13181,31,3,Business,4,2,58057,4,2,58096,4,2,59287,4,2,62143,4,2,62153,3,21.2,-1.317151,36.865734,-1.3189252,36.8617269,890,10,39,4047
2067,9714,2804,3,Business,8,4,48962,8,4,48995,8,4,49010,8,4,49791,8,4,50480,2,27.3,-1.2642903,36.8002137,-1.2571472,36.7950633,268,689,33,796
2068,13120,2982,3,Business,27,4,46447,27,4,46453,27,4,47419,27,4,47595,27,4,51232,18,23.2,-1.300921,36.828195,-1.177202,36.8351183,569,3637,6,1142
2069,19993,190,3,Business,11,2,52916,11,2,54173,11,2,54589,11,2,54786,11,2,55309,4,22.4,-1.31553,36.863732,-1.3270347,36.8667362,900,523,1257,613
2070,246,867,3,Business,19,1,56411,19,1,56985,19,1,58359,19,1,58813,19,1,60619,14,25.1,-1.3177547,36.8303703,-1.306378,36.7519845,828,1806,574,1828
2071,1225,2587,3,Business,13,3,40916,13,3,41008,13,3,41907,13,3,42131,13,3,45571,5,24.9,-1.2584143,36.8048002,-1.28878,36.8168312,362,3440,92,1123
2072,20155,722,3,Business,30,2,39043,30,2,39171,30,2,39597,30,2,39897,30,2,42069,16,23.25888921888938,-1.25896,36.8016691,-1.3222489,36.7867025,289,2172,128,726
2073,19701,3326,3,Business,19,2,36073,19,2,36277,19,2,36837,19,2,37074,19,2,38374,9,20.9,-1.2551895,36.7822034,-1.3080696,36.8237191,531,1300,204,797
2074,25437,1402,3,Business,15,1,40996,15,1,43754,15,1,45254,15,1,48048,15,1,48073,13,23.25888921888938,-1.339046,36.762596,-1.2813012,36.8323962,613,25,2758,4294
2075,4466,467,3,Business,9,4,49994,9,4,50114,9,4,50844,9,4,51139,9,4,55317,11,23.25888921888938,-1.304735,36.7846054,-1.3507172,36.7413694,343,4178,120,1025
2076,7724,1500,3,Business,6,3,39451,6,3,39474,6,3,39723,6,3,41646,6,3,43283,8,23.25888921888938,-1.3004062,36.829741,-1.2638185,36.7930057,304,1637,23,2172
2077,28026,3291,3,Business,28,5,48671,28,5,48706,28,5,49168,28,5,49233,28,5,51460,4,25.4,-1.265715,36.823815,-1.2600926,36.8088685,26,2227,35,527
2078,10318,2659,3,Business,25,2,46789,25,2,46831,25,2,47908,25,2,48410,25,2,49258,6,23.6,-1.2917868,36.7872675,-1.2935617,36.835057,722,848,42,1579
2079,14619,2454,3,Business,6,4,59566,6,4,59672,6,4,60548,6,4,60866,6,4,61258,2,22.7,-1.2948525,36.7724424,-1.2993231,36.7753372,674,392,106,1194
2080,5764,2066,3,Business,15,3,43169,15,3,43202,15,3,43392,15,3,44022,15,3,45100,9,18.0,-1.316961,36.820337,-1.2979513,36.7504699,213,1078,33,820
2081,13823,2956,3,Business,27,3,68899,27,3,68921,27,3,69103,27,3,69420,27,3,70070,2,27.3,-1.2527958,36.8003131,-1.2584143,36.8048002,172,650,22,499
2082,542,1329,3,Business,6,4,57300,6,4,58647,6,4,59552,6,4,59872,6,4,60668,4,21.7,-1.273056,36.811298,-1.2477846,36.8023807,75,796,1347,1225
2083,16293,2801,3,Business,8,5,45860,8,5,45902,8,5,46514,8,5,46879,8,5,49141,11,23.25888921888938,-1.2595422,36.7871178,-1.307726,36.839117,942,2262,42,977
2084,13301,3017,3,Business,9,7,57848,9,7,59500,9,7,61900,9,7,62035,9,7,63639,6,24.5,-1.2993231,36.7753372,-1.3179303,36.8108344,328,1604,1652,2535
2085,17499,3426,3,Business,28,7,53415,28,7,57472,28,7,58899,28,7,59197,28,7,61365,16,23.25888921888938,-1.225322,36.80855,-1.3014461,36.7661381,588,2168,4057,1725
2086,3886,1469,3,Business,15,1,58290,15,1,58299,15,1,58311,15,1,58585,15,1,60227,14,23.25888921888938,-1.2551895,36.7822034,-1.3263105,36.8622904,96,1642,9,286
2087,22571,136,3,Business,13,1,55475,13,1,55488,13,1,55748,13,1,56077,13,1,58450,24,23.25888921888938,-1.2313147,36.8016863,-1.3165104,36.7077726,72,2373,13,589
2088,21299,1957,2,Personal,2,4,39100,2,4,39115,2,4,39281,2,4,40379,2,4,40822,2,22.7,-1.3043821,36.7840586,-1.2976248,36.7809463,105,443,15,1264
2089,10366,633,3,Business,27,2,36812,27,2,36842,27,2,37030,27,2,37487,27,2,38606,9,18.6,-1.2574219,36.7927073,-1.3004062,36.829741,878,1119,30,645
2090,19766,685,3,Business,12,3,39724,12,3,40115,12,3,41354,12,3,42519,12,3,45874,12,19.2,-1.265432,36.795034,-1.3233955,36.8562944,131,3355,391,2404
2091,7081,816,3,Business,15,5,51006,15,5,51061,15,5,52286,15,5,52627,15,5,54258,14,27.9,-1.2283403,36.8822756,-1.290894,36.822971,8,1631,55,1566
2092,224,3521,3,Business,2,1,30295,2,1,30713,2,1,31113,2,1,31814,2,1,32348,2,16.7,-1.2684667,36.8002891,-1.2696908,36.81519,103,534,418,1101
2093,15920,731,3,Business,11,1,44425,11,1,44474,11,1,45111,11,1,45277,11,1,46726,11,24.0,-1.2574088,36.799712,-1.3166778,36.8492927,279,1449,49,803
2094,5315,20,3,Business,4,2,59605,4,2,60079,4,2,61192,4,2,61796,4,2,63039,5,21.0,-1.278353,36.824045,-1.2629666,36.8068369,857,1243,474,1717
2095,7240,393,3,Business,29,1,46259,29,1,46283,29,1,46425,29,1,47410,29,1,48264,4,23.25888921888938,-1.3167113,36.8301563,-1.3004062,36.829741,211,854,24,1127
2096,4191,633,3,Business,25,5,57122,25,5,57126,25,5,57129,25,5,57216,25,5,58154,5,29.1,-1.2770708,36.8231093,-1.3004062,36.829741,39,938,4,90
2097,21498,2271,3,Business,4,3,39216,4,3,39224,4,3,39229,4,3,40785,4,3,42091,14,17.0,-1.272828,36.816608,-1.293515,36.897607,900,1306,8,1561
2098,19770,867,3,Business,14,2,46755,14,2,46780,14,2,46786,14,2,49598,14,2,50762,12,23.25888921888938,-1.2991441,36.7528804,-1.3004062,36.829741,855,1164,25,2818
2099,24828,2587,3,Business,17,7,47769,17,7,52121,17,7,53008,17,7,53173,17,7,54442,11,29.1,-1.2283403,36.8822756,-1.28878,36.8168312,8,1269,4352,1052
2100,12974,909,3,Business,14,4,49969,14,4,49988,14,4,50363,14,4,50502,14,4,51947,7,27.6,-1.207546,36.7913976,-1.225322,36.80855,295,1445,19,514
2101,10014,60,3,Business,14,5,62277,14,5,62281,14,5,62302,14,5,63139,14,5,63141,9,21.3,-1.2296618,36.8438272,-1.2663631,36.8163329,564,2,4,858
2102,12684,3547,3,Business,29,1,41287,29,1,41307,29,1,41682,29,1,42325,29,1,44671,17,23.25888921888938,-1.2761408,36.7710839,-1.3189252,36.8617269,269,2346,20,1018
2103,2151,1500,3,Business,2,2,36288,2,2,36370,2,2,36493,2,2,37548,2,2,38653,8,20.3,-1.3004062,36.829741,-1.2638185,36.7930057,177,1105,82,1178
2104,21023,877,2,Personal,19,5,41678,19,5,41811,19,5,43789,19,5,44125,19,5,45883,12,24.8,-1.249986,36.7863906,-1.2949652,36.7687874,565,1758,133,2314
2105,9031,3089,2,Personal,4,1,39861,4,1,39905,4,1,40476,4,1,40757,4,1,41828,10,20.8,-1.3102256,36.8432368,-1.2751858,36.8205365,408,1071,44,852
2106,16872,2660,2,Personal,13,4,65894,13,4,65961,13,4,67530,13,4,67631,13,4,68839,8,24.6,-1.2596351,36.8063205,-1.3175119,36.8058513,328,1208,67,1670
2107,9563,1329,3,Business,11,2,64832,11,2,64894,11,2,65418,11,2,65551,11,2,65788,1,21.0,-1.273056,36.811298,-1.2753109,36.8130185,685,237,62,657
2108,26759,3752,3,Business,3,5,52365,3,5,53627,3,5,54534,3,5,54914,3,5,55794,10,23.25888921888938,-1.2290379,36.7825944,-1.2753109,36.8130185,607,880,1262,1287
2109,5956,3260,1,Personal,15,3,55223,15,3,55281,15,3,55501,15,3,55657,15,3,56382,7,21.4,-1.2560455,36.7800867,-1.2939882,36.7591199,217,725,58,376
2110,10609,1715,3,Business,29,5,56625,29,5,56771,29,5,58329,29,5,58445,29,5,59483,4,21.1,-1.2608993,36.799246,-1.2764851,36.8007126,407,1038,146,1674
2111,6297,2763,3,Business,13,3,55472,13,3,55509,13,3,55844,13,3,56057,13,3,56760,6,29.4,-1.2551895,36.7822034,-1.2843046,36.7746132,177,703,37,548
2112,19646,1500,3,Business,13,3,45795,13,3,45805,13,3,46011,13,3,47236,13,3,48540,8,23.25888921888938,-1.3004062,36.829741,-1.2638185,36.7930057,763,1304,10,1431
2113,18573,2701,3,Business,31,4,34145,31,4,34196,31,4,35298,31,4,35445,31,4,36370,1,17.4,-1.279395,36.825364,-1.2821422,36.8161565,159,925,51,1249
2114,24576,517,3,Business,4,2,36311,4,2,36483,4,2,36964,4,2,37083,4,2,39371,14,15.8,-1.3177547,36.8303703,-1.306378,36.7519845,523,2288,172,600
2115,11931,1209,3,Business,2,6,34295,2,6,38838,2,6,40191,2,6,40773,2,6,41723,4,23.25888921888938,-1.3077869,36.8443207,-1.3004062,36.829741,523,950,4543,1935
2116,24928,900,2,Personal,3,3,38525,3,3,38531,3,3,38967,3,3,39301,3,3,41806,35,24.2,-1.3508036,36.7093385,-1.3513864,36.9033371,43,2505,6,770
2117,21297,3658,3,Personal,10,2,33328,10,2,33763,10,2,35145,10,2,35550,10,2,38195,5,16.2,-1.2886923,36.8241519,-1.262423,36.8016471,726,2645,435,1787
2118,10231,3091,1,Business,3,4,35372,3,4,35476,3,4,37199,3,4,37772,3,4,39383,12,17.2,-1.2843582,36.8229884,-1.2817919,36.7351687,742,1611,104,2296
2119,4555,3674,3,Business,29,5,39667,29,5,39762,29,5,39911,29,5,40555,29,5,42194,10,26.6,-1.2551895,36.7822034,-1.307376,36.813404,926,1639,95,793
2120,26042,2387,1,Personal,16,2,34195,16,2,34208,16,2,34990,16,2,35164,16,2,35706,5,23.25888921888938,-1.2535486,36.7933541,-1.2633494,36.7959696,726,542,13,956
2121,6711,2582,3,Business,4,1,47919,4,1,47941,4,1,48773,4,1,49061,4,1,51275,19,23.25888921888938,-1.2551895,36.7822034,-1.3283746,36.8893241,281,2214,22,1120
2122,10983,1684,1,Personal,16,2,43920,16,2,43927,16,2,45261,16,2,45576,16,2,47234,14,23.6,-1.2087365,36.7851052,-1.2731645,36.7900343,103,1658,7,1649
2123,27014,2150,3,Business,4,6,38271,4,6,40079,4,6,40603,4,6,42142,4,6,42952,12,23.25888921888938,-1.331619,36.847976,-1.344446,36.756597,459,810,1808,2063
2124,1641,1333,2,Personal,10,7,46793,10,7,46851,10,7,48209,10,7,48649,10,7,50458,21,17.8,-1.2151769,36.8846524,-1.2927531,36.7651386,906,1809,58,1798
2125,11150,1719,3,Business,22,5,46191,22,5,46323,22,5,46341,22,5,46735,22,5,49630,16,28.7,-1.296797,36.7764525,-1.23966,36.75258,709,2895,132,412
2126,7371,2523,3,Business,21,5,53888,21,5,54641,21,5,56398,21,5,56863,21,5,58285,8,24.7,-1.2551895,36.7822034,-1.3038408,36.818713,383,1422,753,2222
2127,996,3621,3,Business,20,4,39785,20,4,39879,20,4,40912,20,4,41078,20,4,41686,5,22.1,-1.2836583,36.7886014,-1.2991481,36.8043449,379,608,94,1199
2128,18338,3487,3,Business,29,1,36360,29,1,36404,29,1,36975,29,1,37096,29,1,38269,5,23.25888921888938,-1.2765736,36.8513646,-1.279395,36.825364,819,1173,44,692
2129,20120,2344,3,Business,5,2,59571,5,2,59653,5,2,59699,5,2,60423,5,2,62744,18,21.6,-1.2553615,36.7895376,-1.338579,36.8963038,379,2321,82,770
2130,13468,2869,3,Business,5,5,37496,5,5,37512,5,5,38341,5,5,38637,5,5,39881,10,24.5,-1.2584143,36.8048002,-1.3025826,36.7670807,630,1244,16,1125
2131,19733,1381,2,Personal,10,2,46194,10,2,46365,10,2,49581,10,2,50103,10,2,51558,9,21.0,-1.2811695,36.8200313,-1.22606,36.80039,234,1455,171,3738
2132,8164,2030,3,Business,21,5,41567,21,5,41603,21,5,41874,21,5,42167,21,5,43644,3,20.2,-1.2963097,36.7688221,-1.295908,36.791433,402,1477,36,564
2133,26745,246,3,Business,20,5,35749,20,5,36668,20,5,37937,20,5,38385,20,5,39593,17,18.7,-1.2156006,36.8916865,-1.2584143,36.8048002,334,1208,919,1717
2134,22840,909,3,Business,16,4,46222,16,4,47199,16,4,47665,16,4,48262,16,4,50647,27,23.25888921888938,-1.3632162,36.9108253,-1.225322,36.80855,877,2385,977,1063
2135,25636,393,3,Business,20,3,51890,20,3,51902,20,3,51936,20,3,52900,20,3,53640,4,29.3,-1.3167113,36.8301563,-1.3004062,36.829741,15,740,12,998
2136,28248,1075,3,Business,25,5,49059,25,5,49130,25,5,49879,25,5,50058,25,5,51818,5,29.2,-1.279395,36.825364,-1.2527958,36.8003131,268,1760,71,928
2137,19266,53,3,Business,1,1,43285,1,1,43388,1,1,44916,1,1,44997,1,1,47780,6,23.25888921888938,-1.3077869,36.8443207,-1.2770708,36.8231093,910,2783,103,1609
2138,19845,2270,2,Personal,29,6,61681,29,6,61704,29,6,62458,29,6,62742,29,6,66301,26,23.8,-1.3211348,36.8201452,-1.1923911,36.9447333,83,3559,23,1038
2139,8645,3201,3,Business,28,4,36969,28,4,36988,28,4,37074,28,4,37387,28,4,37457,1,22.3,-1.2584143,36.8048002,-1.2594539,36.8067841,579,70,19,399
2140,18624,2497,3,Business,29,4,54395,29,4,56164,29,4,56480,29,4,57499,29,4,58635,2,24.6,-1.2677588,36.8169359,-1.2782978,36.8273238,320,1136,1769,1335
2141,24127,3283,3,Business,6,1,49883,6,1,50125,6,1,50134,6,1,51915,6,1,51918,5,23.25888921888938,-1.2600926,36.8088685,-1.2628473,36.781805,86,3,242,1790
2142,7161,2763,3,Business,11,4,48293,11,4,49285,11,4,50075,11,4,52596,11,4,57228,11,26.8,-1.2991616,36.8424509,-1.2551895,36.7822034,349,4632,992,3311
2143,80,3017,3,Business,10,5,69221,10,5,69239,10,5,69767,10,5,71179,10,5,72597,3,17.9,-1.299313,36.7831488,-1.2801129,36.7787822,238,1418,18,1940
2144,15336,3763,3,Business,20,5,38074,20,5,38135,20,5,38865,20,5,39097,20,5,40604,5,18.6,-1.2671001,36.7977185,-1.2866908,36.8261233,159,1507,61,962
2145,10422,1329,3,Business,14,3,32181,14,3,32442,14,3,33558,14,3,33739,14,3,36022,8,18.4,-1.273056,36.811298,-1.3223922,36.837966,88,2283,261,1297
2146,15586,1502,3,Business,22,1,46835,22,1,47058,22,1,49543,22,1,52657,22,1,53788,12,26.4,-1.28878,36.8168312,-1.2232123,36.8932547,223,1131,223,5599
2147,26038,3091,3,Business,9,4,63879,9,4,63894,9,4,63908,9,4,64489,9,4,66198,10,23.0,-1.2584143,36.8048002,-1.3014461,36.7661381,89,1709,15,595
2148,7156,2935,3,Business,20,5,39794,20,5,39825,20,5,40508,20,5,41195,20,5,42966,9,18.7,-1.2961922,36.791994,-1.2528485,36.7953722,752,1771,31,1370
2149,8205,633,3,Business,19,1,44952,19,1,48661,19,1,48851,19,1,49104,19,1,50518,4,25.2,-1.2770708,36.8231093,-1.3004062,36.829741,661,1414,3709,443
2150,8718,3064,3,Business,23,3,33320,23,3,33425,23,3,36213,23,3,37505,23,3,38686,9,16.8,-1.2545924,36.8410221,-1.2579304,36.8019667,589,1181,105,4080
2151,20927,2069,3,Business,11,1,44920,11,1,44936,11,1,46386,11,1,47139,11,1,47922,9,26.6,-1.265715,36.823815,-1.228911,36.881876,655,783,16,2203
2152,25578,302,3,Business,25,7,40769,25,7,40782,25,7,41440,25,7,43404,25,7,44504,10,22.8,-1.2976314,36.777256,-1.2649605,36.7981777,612,1100,13,2622
2153,924,3674,3,Business,14,4,57597,14,4,57758,14,4,57889,14,4,58416,14,4,59854,8,27.6,-1.2551895,36.7822034,-1.305349,36.829708,26,1438,161,658
2154,3040,3291,3,Business,5,2,39580,5,2,39619,5,2,39626,5,2,40417,5,2,41134,5,25.5,-1.2628473,36.781805,-1.2600926,36.8088685,523,717,39,798
2155,22209,931,1,Personal,19,5,51556,19,5,51620,19,5,52286,19,5,52533,19,5,53418,5,27.5,-1.2644443,36.7734547,-1.2975066,36.7689423,854,885,64,913
2156,9217,3283,3,Business,29,1,41589,29,1,41817,29,1,42596,29,1,43463,29,1,44355,7,23.25888921888938,-1.303596,36.778378,-1.2628473,36.781805,327,892,228,1646
2157,24980,1214,3,Personal,20,3,47945,20,3,48010,20,3,48934,20,3,49155,20,3,52720,16,23.2,-1.2866269,36.8246368,-1.3276514,36.7121761,95,3565,65,1145
2158,17094,1384,3,Business,6,4,37721,6,4,37761,6,4,37762,6,4,38518,6,4,40541,25,19.9,-1.2517448,36.7924971,-1.1594755,36.9509792,762,2023,40,757
2159,9072,53,3,Business,15,1,54130,15,1,54325,15,1,54344,15,1,54848,15,1,56098,5,23.25888921888938,-1.3004062,36.829741,-1.2770708,36.8231093,843,1250,195,523
2160,20263,1798,3,Business,4,4,40660,4,4,40947,4,4,41534,4,4,42106,4,4,43113,6,23.25888921888938,-1.2615888,36.7928732,-1.278612,36.8195876,857,1007,287,1159
2161,21199,3714,2,Personal,15,3,40712,15,3,40731,15,3,41614,15,3,41680,15,3,44223,17,18.1,-1.2938694,36.7629838,-1.2311903,36.8102105,334,2543,19,949
2162,1290,517,3,Business,30,3,55512,30,3,55519,30,3,55679,30,3,56169,30,3,56698,4,29.1,-1.3167113,36.8301563,-1.3004062,36.829741,523,529,7,650
2163,23444,3560,3,Business,11,1,38653,11,1,38727,11,1,39562,11,1,39668,11,1,40967,6,26.7,-1.279395,36.825364,-1.2560455,36.7800867,311,1299,74,941
2164,23744,1162,3,Business,8,4,43575,8,4,43739,8,4,44456,8,4,44882,8,4,46116,8,26.5,-1.312261,36.794658,-1.2719495,36.7728776,726,1234,164,1143
2165,23758,2457,3,Business,26,5,42816,26,5,47018,26,5,47905,26,5,50162,26,5,51516,8,23.25888921888938,-1.2551895,36.7822034,-1.3016151,36.8117354,70,1354,4202,3144
2166,23267,1582,3,Business,7,3,41032,7,3,41053,7,3,41744,7,3,42692,7,3,44735,12,25.3,-1.3178711,36.84423066,-1.2508229,36.7895263,649,2043,21,1639
2167,4011,66,2,Personal,6,1,38394,6,1,38413,6,1,39701,6,1,39805,6,1,41598,7,20.4,-1.2739008,36.8139772,-1.3121789,36.8298621,402,1793,19,1392
2168,16494,3688,3,Business,19,3,57981,19,3,58309,19,3,58437,19,3,58863,19,3,59590,4,24.2,-1.2551895,36.7822034,-1.2658335,36.8042867,574,727,328,554
2169,18588,2076,1,Personal,4,6,49615,4,6,50583,4,6,52935,4,6,53302,4,6,55381,23,23.1,-1.2687102,36.6721254,-1.2897215,36.7945959,940,2079,968,2719
2170,18779,393,3,Business,17,4,32482,17,4,32517,17,4,32534,17,4,33392,17,4,35177,14,23.25888921888938,-1.3167113,36.8301563,-1.306378,36.7519845,188,1785,35,875
2171,7121,2701,3,Business,23,3,37565,23,3,37617,23,3,37621,23,3,38518,23,3,39222,6,23.25888921888938,-1.279395,36.825364,-1.2765736,36.8513646,137,704,52,901
2172,16369,487,2,Personal,18,4,42994,18,4,43005,18,4,43605,18,4,43898,18,4,45175,12,25.3,-1.259281,36.722127,-1.2844001,36.790587,726,1277,11,893
2173,3164,3123,3,Personal,19,3,58923,19,3,59780,19,3,60924,19,3,63316,19,3,66341,15,22.3,-1.2879431,36.8270069,-1.2090481,36.7471131,576,3025,857,3536
2174,7593,2112,3,Business,6,1,53474,6,1,53483,6,1,54346,6,1,54517,6,1,56957,16,24.5,-1.2156006,36.8916865,-1.3285517,36.9018,384,2440,9,1034
2175,12403,1738,3,Personal,31,5,43653,31,5,43727,31,5,44207,31,5,44305,31,5,45747,7,17.2,-1.2963097,36.7688221,-1.2855169,36.8157719,749,1442,74,578
2176,22725,2521,3,Business,30,6,37878,30,6,37900,30,6,37937,30,6,38429,30,6,39351,11,26.4,-1.3167113,36.8301563,-1.2638185,36.7930057,111,922,22,529
2177,25707,1075,3,Business,5,5,34381,5,5,34405,5,5,34807,5,5,35812,5,5,36327,2,20.0,-1.2527958,36.8003131,-1.2610837,36.8021315,394,515,24,1407
2178,16019,1919,3,Business,21,5,41482,21,5,41598,21,5,42318,21,5,43136,21,5,45185,19,22.7,-1.2658315,36.809049,-1.332624,36.913187,30,2049,116,1538
2179,14968,540,3,Business,27,1,57524,27,1,57558,27,1,57740,27,1,62194,27,1,63586,9,23.25888921888938,-1.2945074,36.8083195,-1.2551895,36.7822034,19,1392,34,4636
2180,20934,914,3,Business,2,2,40799,2,2,40949,2,2,41385,2,2,42367,2,2,43167,7,26.3,-1.2670213,36.7994482,-1.3023305,36.8260519,119,800,150,1418
2181,26023,3404,3,Business,11,1,38878,11,1,39029,11,1,39432,11,1,39753,11,1,42602,11,26.6,-1.279395,36.825364,-1.3206958,36.8769553,564,2849,151,724
2182,24352,3420,3,Business,6,3,36084,6,3,36130,6,3,36368,6,3,36500,6,3,37173,6,23.25888921888938,-1.3046007,36.8211743,-1.265981,36.7936121,231,673,46,370
2183,2534,265,3,Business,12,5,45935,12,5,45969,12,5,46341,12,5,48456,12,5,49299,5,24.7,-1.300921,36.828195,-1.3083777,36.8590077,848,843,34,2487
2184,26413,972,3,Business,19,3,44582,19,3,48505,19,3,49027,19,3,49152,19,3,50120,10,25.8,-1.2862033,36.8152966,-1.2295205,36.8120426,726,968,3923,647
2185,10273,2858,3,Business,30,2,57586,30,2,57617,30,2,58531,30,2,58731,30,2,61268,18,27.3,-1.3164106,36.6952197,-1.2605635,36.7985638,200,2537,31,1114
2186,23836,1683,3,Business,22,4,50728,22,4,50877,22,4,51988,22,4,52904,22,4,53943,7,26.4,-1.2994194,36.7647917,-1.2765334,36.8015051,375,1039,149,2027
2187,6337,3404,3,Business,14,5,42623,14,5,51537,14,5,52231,14,5,52699,14,5,54182,5,23.6,-1.2588181,36.8106709,-1.279395,36.825364,108,1483,8914,1162
2188,7772,1843,1,Personal,17,1,33861,17,1,33890,17,1,35431,17,1,35639,17,1,37336,12,18.4,-1.2655332,36.8094648,-1.2174537,36.8801909,503,1697,29,1749
2189,10257,393,3,Business,11,4,46224,11,4,46300,11,4,47190,11,4,50223,11,4,50406,4,27.2,-1.3167113,36.8301563,-1.3004062,36.829741,787,183,76,3923
2190,19302,3283,3,Business,28,5,37460,28,5,37474,28,5,37631,28,5,38213,28,5,38631,5,23.6,-1.2600926,36.8088685,-1.2628473,36.781805,453,418,14,739
2191,25855,3561,3,Personal,11,3,42417,11,3,44947,11,3,45785,11,3,46503,11,3,50890,16,19.0,-1.3255736,36.7275277,-1.2658315,36.809049,334,4387,2530,1556
2192,16733,2200,3,Business,23,2,51957,23,2,52732,23,2,53710,23,2,53858,23,2,55328,8,18.9,-1.2551895,36.7822034,-1.290894,36.822971,208,1470,775,1126
2193,4172,302,3,Business,7,3,59811,7,3,59845,7,3,60167,7,3,60869,7,3,61550,3,25.1,-1.2649605,36.7981777,-1.2647103,36.8002593,935,681,34,1024
2194,17344,978,1,Personal,15,6,33530,15,6,33603,15,6,34133,15,6,34625,15,6,34635,5,17.4,-1.3084067,36.8345014,-1.3066679,36.8648522,179,10,73,1022
2195,11782,2008,3,Business,19,1,37818,19,1,37828,19,1,38288,19,1,41488,19,1,43302,17,24.6,-1.2508229,36.7895263,-1.2482377,36.6673782,634,1814,10,3660
2196,2743,1160,1,Personal,15,1,46039,15,1,46056,15,1,46128,15,1,46719,15,1,48535,13,23.25888921888938,-1.2297202,36.8819507,-1.1748796,36.8321847,704,1816,17,663
2197,20635,1425,3,Business,25,1,43954,25,1,43965,25,1,44254,25,1,44937,25,1,45815,12,27.3,-1.3004062,36.829741,-1.338283,36.8871775,863,878,11,972
2198,3326,868,3,Business,11,6,42559,11,6,42607,11,6,43056,11,6,43622,11,6,44433,5,23.25888921888938,-1.2600926,36.8088685,-1.265715,36.823815,775,811,48,1015
2199,6120,700,3,Business,18,1,36639,18,1,37697,18,1,41037,18,1,41593,18,1,45217,8,26.7,-1.323135,36.833139,-1.2617028,36.7983849,332,3624,1058,3896
2200,19571,393,3,Business,1,5,35847,1,5,38626,1,5,38641,1,5,39063,1,5,40964,11,26.4,-1.3167113,36.8301563,-1.2636051,36.7850995,523,1901,2779,437
2201,905,2069,3,Business,1,1,39478,1,1,39643,1,1,40228,1,1,40685,1,1,41359,6,23.25888921888938,-1.2296618,36.8438272,-1.228911,36.881876,7,674,165,1042
2202,27628,1075,3,Business,18,1,49362,18,1,49817,18,1,50560,18,1,50743,18,1,51693,5,30.8,-1.279395,36.825364,-1.2527958,36.8003131,733,950,455,926
2203,15903,1664,3,Personal,13,4,52391,13,4,54075,13,4,57152,13,4,57725,13,4,59074,5,22.4,-1.324658,36.834048,-1.286937,36.8246742,48,1349,1684,3650
2204,20581,3599,3,Business,26,5,32913,26,5,33427,26,5,34998,26,5,36121,26,5,40278,20,23.25888921888938,-1.3302996,36.8707935,-1.2163391,36.8404088,519,4157,514,2694
2205,379,1995,3,Business,25,4,55585,25,4,55658,25,4,57723,25,4,59132,25,4,59793,7,23.25888921888938,-1.279395,36.825364,-1.2551895,36.7822034,815,661,73,3474
2206,26858,3558,2,Personal,20,5,63250,20,5,63583,20,5,64255,20,5,64660,20,5,65706,6,20.0,-1.2763916,36.8246826,-1.295408,36.802892,427,1046,333,1077
2207,15523,815,2,Personal,29,3,51681,29,3,51794,29,3,53311,29,3,53824,29,3,54902,5,18.8,-1.2962832,36.7849683,-1.2657469,36.8028228,670,1078,113,2030
2208,2212,1271,3,Business,2,2,35895,2,2,35907,2,2,38034,2,2,38768,2,2,41234,24,26.0,-1.3244885,36.897792,-1.3107918,36.761794,459,2466,12,2861
2209,7947,2763,3,Business,15,3,49350,15,3,49401,15,3,49753,15,3,49886,15,3,50732,5,21.5,-1.2551895,36.7822034,-1.2659232,36.8235607,415,846,51,485
2210,17362,1369,2,Personal,10,2,42223,10,2,42257,10,2,43132,10,2,43231,10,2,44181,7,20.3,-1.3011737,36.743672,-1.299813,36.7871392,629,950,34,974
2211,19518,1363,3,Business,26,2,50989,26,2,51033,26,2,51426,26,2,51689,26,2,53563,10,31.2,-1.3004062,36.829741,-1.2991441,36.7528804,863,1874,44,656
2212,20499,2789,3,Business,21,4,45502,21,4,45533,21,4,45840,21,4,46321,21,4,47266,5,21.9,-1.304735,36.7846054,-1.300722,36.816865,312,945,31,788
2213,21216,2869,3,Business,12,3,53998,12,3,54146,12,3,54646,12,3,54801,12,3,58688,8,20.8,-1.3025826,36.7670807,-1.2886385,36.8240195,942,3887,148,655
2214,2256,186,3,Business,18,2,43462,18,2,43474,18,2,43496,18,2,43875,18,2,46700,26,23.25888921888938,-1.3700383,36.9190174,-1.2232123,36.8932547,876,2825,12,401
2215,1083,20,3,Business,30,3,35606,30,3,35612,30,3,36493,30,3,37223,30,3,39620,14,17.5,-1.2628638,36.8070399,-1.3346931,36.8661911,290,2397,6,1611
2216,12650,2330,3,Business,7,4,64424,7,4,64455,7,4,64771,7,4,64940,7,4,66483,8,29.3,-1.3015197,36.7658456,-1.2649605,36.7981777,649,1543,31,485
2217,8696,3686,3,Business,10,3,56985,10,3,57070,10,3,57384,10,3,58217,10,3,60147,12,30.7,-1.2551895,36.7822034,-1.2987332,36.8463349,177,1930,85,1147
2218,25268,1363,3,Business,31,3,37975,31,3,38008,31,3,43992,31,3,44574,31,3,45707,7,24.5,-1.2649605,36.7981777,-1.3004062,36.829741,276,1133,33,6566
2219,22887,2598,3,Personal,26,3,58509,26,3,58561,26,3,60438,26,3,61289,26,3,63091,15,22.8,-1.294489,36.8746526,-1.308217,36.77413,26,1802,52,2728
2220,12805,1209,3,Business,25,4,56603,25,4,56744,25,4,56755,25,4,58177,25,4,59369,9,23.25888921888938,-1.2638185,36.7930057,-1.3004062,36.829741,926,1192,141,1433
2221,1661,1813,2,Personal,11,1,26022,11,1,27910,11,1,28744,11,1,28916,11,1,29429,3,14.5,-1.2697141,36.7981777,-1.2560455,36.7800867,116,513,1888,1006
2222,18370,2347,3,Personal,2,1,46203,2,1,46293,2,1,47320,2,1,47654,2,1,48807,4,19.0,-1.2813973,36.8289204,-1.292278,36.797718,338,1153,90,1361
2223,20603,393,3,Business,18,1,33466,18,1,33506,18,1,34012,18,1,36708,18,1,36714,11,22.1,-1.3167113,36.8301563,-1.2638185,36.7930057,263,6,40,3202
2224,872,1792,3,Business,5,5,44495,5,5,44694,5,5,45628,5,5,45972,5,5,47006,6,23.9,-1.2809121,36.7852524,-1.2690931,36.8065779,178,1034,199,1278
2225,9890,1869,1,Personal,12,5,54425,12,5,54520,12,5,55363,12,5,55775,12,5,57889,13,27.2,-1.3304954,36.8727267,-1.3039695,36.7838267,532,2114,95,1255
2226,16289,3686,3,Business,7,3,43338,7,3,43530,7,3,43620,7,3,44045,7,3,44964,6,25.2,-1.2551895,36.7822034,-1.2843046,36.7746132,107,919,192,515
2227,1183,2801,3,Business,6,2,32131,6,2,32161,6,2,33829,6,2,34974,6,2,39229,14,19.9,-1.3271374,36.8495534,-1.2595422,36.7871178,520,4255,30,2813
2228,3470,880,1,Personal,15,3,32348,15,3,32449,15,3,33563,15,3,34100,15,3,35206,4,16.5,-1.3012173,36.8093987,-1.3066967,36.785934,208,1106,101,1651
2229,338,3718,3,Business,2,5,37193,2,5,37492,2,5,40467,2,5,41493,2,5,42268,5,23.5,-1.2906618,36.8131222,-1.2650027,36.8126242,726,775,299,4001
2230,24460,1363,3,Business,27,4,52442,27,4,52680,27,4,53488,27,4,53608,27,4,55497,10,25.0,-1.3004062,36.829741,-1.2991441,36.7528804,612,1889,238,928
2231,26328,178,2,Personal,31,4,45514,31,4,45628,31,4,47066,31,4,47881,31,4,49146,5,21.7,-1.2874648,36.8271985,-1.2966785,36.7896469,844,1265,114,2253
2232,2593,2457,3,Business,18,1,34836,18,1,35169,18,1,35580,18,1,35794,18,1,37525,8,15.2,-1.2551895,36.7822034,-1.3047132,36.8089553,409,1731,333,625
2233,15007,2436,3,Business,6,3,42502,6,3,42632,6,3,44107,6,3,46023,6,3,47492,18,20.2,-1.2553615,36.7895376,-1.2198413,36.9054958,116,1469,130,3391
2234,21222,1527,3,Business,8,3,34578,8,3,34594,8,3,34608,8,3,35745,8,3,36864,9,23.25888921888938,-1.2638185,36.7930057,-1.3004062,36.829741,258,1119,16,1151
2235,18889,3186,3,Business,25,2,37443,25,2,37490,25,2,38269,25,2,39089,25,2,39915,6,24.0,-1.271672,36.783604,-1.2980229,36.78865,754,826,47,1599
2236,25207,2676,3,Business,31,2,42253,31,2,42345,31,2,42796,31,2,42991,31,2,44741,4,18.3,-1.2963097,36.7688221,-1.2764692,36.7580111,253,1750,92,646
2237,28200,1157,3,Business,4,5,39540,4,5,39589,4,5,40943,4,5,42663,4,5,44168,8,22.7,-1.3164474,36.8575861,-1.2817945,36.8258051,285,1505,49,3074
2238,21565,2982,3,Business,17,1,46429,17,1,46599,17,1,46833,17,1,50233,17,1,52780,18,24.8,-1.300921,36.828195,-1.177202,36.8351183,69,2547,170,3634
2239,13580,2982,3,Business,3,4,41804,3,4,41838,3,4,42392,3,4,43152,3,4,45574,18,23.5,-1.300921,36.828195,-1.177202,36.8351183,31,2422,34,1314
2240,885,2423,3,Business,14,4,56152,14,4,58260,14,4,58726,14,4,58885,14,4,59937,4,28.1,-1.2551895,36.7822034,-1.2707979,36.8065786,19,1052,2108,625
2241,13285,3689,3,Business,20,4,50310,20,4,52713,20,4,54426,20,4,54591,20,4,55946,8,25.2,-1.2765736,36.8513646,-1.2527958,36.8003131,660,1355,2403,1878
2242,6144,1572,2,Personal,30,6,45552,30,6,46494,30,6,46935,30,6,47204,30,6,48714,7,22.0,-1.286282,36.8217484,-1.2960302,36.7711317,21,1510,942,710
2243,11218,496,3,Business,15,5,46810,15,5,46822,15,5,47335,15,5,48174,15,5,51430,22,25.9,-1.2571472,36.7950633,-1.374163,36.913444,913,3256,12,1352
2244,22096,3264,3,Business,7,2,42240,7,2,42284,7,2,42486,7,2,42626,7,2,44881,12,23.0,-1.2551895,36.7822034,-1.2121659,36.8112437,116,2255,44,342
2245,6611,3489,1,Personal,6,6,35020,6,6,35027,6,6,35550,6,6,35778,6,6,38085,17,19.0,-1.3039695,36.7838267,-1.364732,36.658943,847,2307,7,751
2246,23055,3203,3,Business,26,4,42345,26,4,42358,26,4,42372,26,4,44036,26,4,44522,9,18.9,-1.265715,36.823815,-1.228911,36.881876,174,486,13,1678
2247,25383,2956,3,Business,4,6,34100,4,6,34113,4,6,34618,4,6,35517,4,6,36085,7,23.25888921888938,-1.2881035,36.8142095,-1.2584143,36.8048002,341,568,13,1404
2248,23046,353,3,Personal,27,3,56756,27,3,56806,27,3,57178,27,3,57319,27,3,60105,19,29.0,-1.2649605,36.7981777,-1.3678944,36.7513257,720,2786,50,513
2249,4463,3621,3,Business,5,3,42784,5,3,42822,5,3,43200,5,3,43281,5,3,45338,16,16.8,-1.2836583,36.7886014,-1.2062428,36.8379106,176,2057,38,459
2250,25124,718,3,Business,6,3,56207,6,3,58531,6,3,60692,6,3,60856,6,3,63003,12,19.8,-1.2553615,36.7895376,-1.3083777,36.8590077,808,2147,2324,2325
2251,17478,3175,3,Business,26,5,34043,26,5,34344,26,5,35773,26,5,36272,26,5,37367,7,23.25888921888938,-1.2681004,36.7952081,-1.2735999,36.8218131,171,1095,301,1928
2252,10143,2330,3,Business,14,1,54683,14,1,54726,14,1,54931,14,1,55384,14,1,56571,7,25.9,-1.2921463,36.8029626,-1.2649605,36.7981777,237,1187,43,658
2253,24866,1445,3,Personal,25,1,44815,25,1,44895,25,1,45083,25,1,45153,25,1,46223,7,23.25888921888938,-1.2661246,36.7961775,-1.2883071,36.7550523,379,1070,80,258
2254,20724,2030,3,Business,10,1,45961,10,1,48379,10,1,48591,10,1,49073,10,1,50282,2,19.0,-1.2839651,36.7891704,-1.295908,36.791433,194,1209,2418,694
2255,26912,265,3,Business,20,3,46233,20,3,46524,20,3,46814,20,3,48014,20,3,49581,8,26.4,-1.300921,36.828195,-1.277783,36.7816464,206,1567,291,1490
2256,5767,3701,3,Business,26,3,56527,26,3,56588,26,3,57100,26,3,57191,26,3,58288,7,27.3,-1.2862436,36.7719109,-1.2684239,36.7952462,337,1097,61,603
2257,9180,1500,3,Business,14,5,33569,14,5,33591,14,5,34117,14,5,34953,14,5,36262,8,17.0,-1.3004062,36.829741,-1.2638185,36.7930057,106,1309,22,1362
2258,17630,28,3,Business,28,2,56840,28,2,56920,28,2,57987,28,2,59191,28,2,60094,6,19.4,-1.268027,36.8037005,-1.299846,36.7940155,427,903,80,2271
2259,23065,510,3,Business,27,3,62031,27,3,62061,27,3,62613,27,3,62846,27,3,63856,7,27.5,-1.2755887,36.8742523,-1.2860183,36.8975338,933,1010,30,785
2260,8302,3355,3,Business,29,5,54668,29,5,56849,29,5,57634,29,5,57696,29,5,58070,3,21.0,-1.3052491,36.8223899,-1.3207146,36.8305771,549,374,2181,847
2261,21617,3565,3,Business,11,5,43231,11,5,43294,11,5,44488,11,5,45059,11,5,46398,15,20.7,-1.2844665,36.7866113,-1.2297202,36.8745508,100,1339,63,1765
2262,15299,1079,1,Personal,6,4,47484,6,4,49174,6,4,50827,6,4,52750,6,4,53877,18,23.3,-1.2782208,36.7062622,-1.2562797,36.8075858,482,1127,1690,3576
2263,15881,142,3,Business,4,4,42921,4,4,42964,4,4,43963,4,4,44479,4,4,45562,6,23.25888921888938,-1.2857723,36.8088058,-1.2963097,36.7688221,328,1083,43,1515
2264,10669,1500,3,Business,8,5,35032,8,5,35074,8,5,35104,8,5,37218,8,5,38584,10,23.0,-1.2991441,36.7528804,-1.2638185,36.7930057,803,1366,42,2144
2265,18663,1075,3,Business,18,5,53929,18,5,54028,18,5,54126,18,5,55492,18,5,56604,7,26.9,-1.2527958,36.8003131,-1.234958,36.8104235,86,1112,99,1464
2266,7389,1721,3,Business,22,5,53922,22,5,54075,22,5,54542,22,5,54683,22,5,56415,13,27.2,-1.2551895,36.7822034,-1.3083777,36.8590077,154,1732,153,608
2267,163,3557,3,Business,8,5,45139,8,5,45276,8,5,45775,8,5,46064,8,5,46614,2,28.2,-1.2546732,36.8086796,-1.2724096,36.8135361,932,550,137,788
2268,5667,1075,3,Business,23,3,44658,23,3,44668,23,3,46328,23,3,46463,23,3,48363,15,23.25888921888938,-1.2156006,36.8916865,-1.2527958,36.8003131,631,1900,10,1795
2269,2883,816,3,Business,17,4,38071,17,4,38640,17,4,38934,17,4,39809,17,4,41552,11,25.5,-1.2326041,36.8009029,-1.290894,36.822971,237,1743,569,1169
2270,11390,265,3,Business,13,3,48158,13,3,48188,13,3,48412,13,3,48777,13,3,51422,14,29.0,-1.300921,36.828195,-1.361462,36.7462389,519,2645,30,589
2271,22456,868,3,Business,10,1,40057,10,1,43489,10,1,44003,10,1,44709,10,1,45361,4,23.6,-1.266837,36.799249,-1.265715,36.823815,646,652,3432,1220
2272,21632,2190,3,Business,29,3,57728,29,3,57933,29,3,58497,29,3,58598,29,3,60666,13,21.1,-1.301953,36.788458,-1.240218,36.766816,24,2068,205,665
2273,613,1721,3,Business,10,1,31258,10,1,31281,10,1,31851,10,1,32043,10,1,32481,3,18.5,-1.2551895,36.7822034,-1.2607765,36.8080021,566,438,23,762
2274,18572,909,3,Business,5,5,59498,5,5,59521,5,5,59577,5,5,59649,5,5,62154,8,26.3,-1.225322,36.80855,-1.2684816,36.8085622,697,2505,23,128
2275,13486,2801,3,Business,26,2,45261,26,2,45285,26,2,48783,26,2,49178,26,2,53129,14,31.0,-1.3104506,36.8687235,-1.2595422,36.7871178,94,3951,24,3893
2276,9903,3667,3,Personal,4,1,35038,4,1,35093,4,1,35406,4,1,35675,4,1,36282,4,21.8,-1.2690931,36.8065779,-1.2612574,36.7879622,205,607,55,582
2277,474,302,3,Business,30,7,47248,30,7,47274,30,7,48443,30,7,49475,30,7,51061,3,26.6,-1.254924,36.815159,-1.2649605,36.7981777,795,1586,26,2201
2278,6130,3186,3,Business,12,3,51164,12,3,51558,12,3,52801,12,3,53124,12,3,55070,5,21.2,-1.2981352,36.8213822,-1.2854406,36.789409,766,1946,394,1566
2279,7610,2989,3,Business,30,1,34201,30,1,34220,30,1,34619,30,1,37194,30,1,38009,15,16.3,-1.3332749,36.8708147,-1.3472066,36.7692638,805,815,19,2974
2280,26370,1288,1,Personal,14,4,53006,14,4,54074,14,4,55807,14,4,56440,14,4,59591,4,21.2,-1.2861765,36.8209086,-1.305399,36.8221849,268,3151,1068,2366
2281,19200,1469,3,Business,4,1,37965,4,1,38047,4,1,38754,4,1,38885,4,1,40103,9,26.5,-1.2551895,36.7822034,-1.2974988,36.7956306,263,1218,82,838
2282,26177,706,3,Business,17,4,34501,17,4,34529,17,4,34994,17,4,36262,17,4,37310,6,18.2,-1.3077869,36.8443207,-1.3177547,36.8303703,148,1048,28,1733
2283,22563,2069,3,Business,24,4,38845,24,4,38858,24,4,38902,24,4,39661,24,4,40279,9,24.5,-1.265715,36.823815,-1.228911,36.881876,86,618,13,803
2284,14511,2168,3,Personal,23,7,48875,23,7,48885,23,7,50534,23,7,51785,23,7,54577,28,26.5,-1.314437,36.712353,-1.3023387,36.9066847,312,2792,10,2900
2285,19223,269,3,Business,17,1,57173,17,1,59742,17,1,60336,17,1,60444,17,1,62148,12,25.6,-1.3332749,36.8708147,-1.2852569,36.8976121,622,1704,2569,702
2286,24888,1363,3,Business,15,5,41145,15,5,41172,15,5,41763,15,5,42064,15,5,43216,3,25.7,-1.3004062,36.829741,-1.2929499,36.8180835,76,1152,27,892
2287,7045,412,3,Business,10,5,45694,10,5,45729,10,5,46120,10,5,47381,10,5,47403,3,23.25888921888938,-1.265715,36.823815,-1.266837,36.799249,436,22,35,1652
2288,12384,1927,3,Business,6,3,46541,6,3,46583,6,3,46722,6,3,47159,6,3,49210,12,22.4,-1.2880883,36.8227336,-1.3472066,36.7692638,926,2051,42,576
2289,7851,1004,3,Business,23,4,52987,23,4,53018,23,4,54238,23,4,54576,23,4,57278,11,24.8,-1.3250048,36.8697188,-1.281597,36.826482,883,2702,31,1558
2290,13314,1642,3,Business,18,1,43496,18,1,43538,18,1,43584,18,1,44295,18,1,45221,6,26.7,-1.2728069,36.7962362,-1.2941024,36.79578,576,926,42,757
2291,13661,113,1,Business,10,5,41875,10,5,41925,10,5,43186,10,5,44398,10,5,45566,8,19.3,-1.2637057,36.80517,-1.2963097,36.7688221,882,1168,50,2473
2292,2990,3078,1,Personal,20,5,60534,20,5,60613,20,5,61253,20,5,62009,20,5,62983,4,20.2,-1.255597,36.830024,-1.2860785,36.8107713,427,974,79,1396
2293,6948,2523,3,Business,8,2,39237,8,2,39271,8,2,39365,8,2,40240,8,2,47383,10,23.5,-1.2551895,36.7822034,-1.3108783,36.8392726,268,7143,34,969
2294,20986,1484,3,Business,17,4,40799,17,4,40831,17,4,41014,17,4,41260,17,4,41828,3,25.2,-1.2551895,36.7822034,-1.25896,36.8016691,829,568,32,429
2295,8683,1427,1,Personal,18,4,34356,18,4,34437,18,4,35147,18,4,35373,18,4,36220,8,20.4,-1.3014461,36.7661381,-1.3100609,36.8205365,65,847,81,936
2296,1977,2509,3,Business,26,2,33418,26,2,33751,26,2,34561,26,2,35562,26,2,36090,4,23.25888921888938,-1.2571472,36.7950633,-1.2904753,36.8144721,953,528,333,1811
2297,12800,2869,3,Business,19,2,34067,19,2,34095,19,2,35041,19,2,35115,19,2,36048,9,20.9,-1.2551895,36.7822034,-1.3025826,36.7670807,931,933,28,1020
2298,13272,3222,3,Business,6,3,52896,6,3,52906,6,3,53020,6,3,53209,6,3,54819,8,27.6,-1.2551895,36.7822034,-1.3021707,36.8168444,416,1610,10,303
2299,7033,2102,3,Business,20,1,59817,20,1,59869,20,1,61154,20,1,61236,20,1,62892,15,23.25888921888938,-1.3323107,36.8692616,-1.2613768,36.8019418,7,1656,52,1367
2300,16777,718,3,Business,26,5,52759,26,5,53365,26,5,54744,26,5,54841,26,5,57972,9,23.25888921888938,-1.2551895,36.7822034,-1.2956171,36.7888097,247,3131,606,1476
2301,7553,704,3,Business,14,4,42203,14,4,42211,14,4,42253,14,4,42345,14,4,42954,18,18.8,-1.2860183,36.8975338,-1.2551895,36.7822034,408,609,8,134
2302,3903,2216,3,Business,20,1,43886,20,1,51797,20,1,51818,20,1,52644,20,1,56148,5,21.5,-1.2551895,36.7822034,-1.2620741,36.8158147,881,3504,7911,847
2303,6927,3521,3,Business,11,2,49858,11,2,50317,11,2,50706,11,2,51256,11,2,51725,2,25.5,-1.2701582,36.8074433,-1.2696908,36.81519,100,469,459,939
2304,21063,1004,3,Business,4,2,51715,4,2,51780,4,2,55177,4,2,55713,4,2,57907,12,22.4,-1.2662728,36.8151265,-1.3250048,36.8697188,856,2194,65,3933
2305,4239,3201,3,Business,24,3,48735,24,3,48747,24,3,50008,24,3,50804,24,3,51274,6,18.5,-1.2584143,36.8048002,-1.2623805,36.7805404,287,470,12,2057
2306,20008,1271,3,Business,23,1,57236,23,1,57272,23,1,57276,23,1,58264,23,1,59100,15,23.25888921888938,-1.3244885,36.897792,-1.2911643,36.8772933,345,836,36,992
2307,21075,81,3,Business,2,3,55466,2,3,55555,2,3,56334,2,3,56782,2,3,58173,9,25.8,-1.2641496,36.7914139,-1.2768129,36.8403079,85,1391,89,1227
2308,13457,1927,3,Business,17,3,48811,17,3,48822,17,3,48859,17,3,49891,17,3,52371,20,23.25888921888938,-1.2852569,36.8976121,-1.3472066,36.7692638,584,2480,11,1069
2309,9112,2412,3,Business,14,5,49308,14,5,49341,14,5,49788,14,5,50062,14,5,51925,5,23.2,-1.2283403,36.8822756,-1.2467896,36.8698733,739,1863,33,721
2310,1962,1421,1,Personal,6,4,44547,6,4,44572,6,4,45725,6,4,46228,6,4,48336,12,21.8,-1.3207146,36.8305771,-1.2609088,36.7948069,340,2108,25,1656
2311,9364,1557,3,Business,19,3,37087,19,3,37103,19,3,38014,19,3,38217,19,3,38898,6,23.25888921888938,-1.3147074,36.811722,-1.2942764,36.7969749,612,681,16,1114
2312,27704,1724,3,Business,20,1,35442,20,1,35452,20,1,35457,20,1,35743,20,1,36308,3,18.9,-1.2551895,36.7822034,-1.2595467,36.8113044,576,565,10,291
2313,12426,3306,1,Personal,14,2,36348,14,2,36394,14,2,38599,14,2,38871,14,2,41243,17,21.7,-1.3296591,36.7572949,-1.2697141,36.7981777,465,2372,46,2477
2314,27167,2271,3,Business,10,1,54910,10,1,54953,10,1,56026,10,1,56329,10,1,58435,17,18.2,-1.2600926,36.8088685,-1.293515,36.897607,690,2106,43,1376
2315,4927,1271,3,Business,18,1,52547,18,1,52657,18,1,53172,18,1,54140,18,1,55279,15,29.3,-1.3244885,36.897792,-1.2824911,36.8218042,863,1139,110,1483
2316,6847,2989,3,Business,29,1,49885,29,1,51178,29,1,53623,29,1,53828,29,1,56179,20,24.4,-1.3472066,36.7692638,-1.2413316,36.8785525,46,2351,1293,2650
2317,3501,3222,3,Business,11,5,35580,11,5,35694,11,5,35929,11,5,36995,11,5,39794,11,21.0,-1.2551895,36.7822034,-1.3173869,36.8112044,205,2799,114,1301
2318,24040,3149,3,Business,4,5,47176,4,5,47226,4,5,48263,4,5,48957,4,5,50760,15,23.25888921888938,-1.306378,36.7519845,-1.3228003,36.8306435,114,1803,50,1731
2319,16770,1561,3,Business,12,5,45526,12,5,45553,12,5,46194,12,5,46713,12,5,49796,16,24.7,-1.2869217,36.7732203,-1.328259,36.860975,299,3083,27,1160
2320,4434,3689,3,Business,4,3,52697,4,3,52889,4,3,54571,4,3,55554,4,3,56970,12,18.1,-1.2527958,36.8003131,-1.2647206,36.7259313,844,1416,192,2665
2321,7461,2436,3,Business,13,4,60262,13,4,60345,13,4,61009,13,4,61186,13,4,64283,7,24.4,-1.2551895,36.7822034,-1.2896399,36.8124498,727,3097,83,841
2322,13904,1048,2,Personal,6,6,53362,6,6,54036,6,6,54741,6,6,54810,6,6,55839,7,27.8,-1.2879618,36.8200863,-1.2980357,36.7848303,933,1029,674,774
2323,10757,3456,3,Personal,22,6,31375,22,6,31397,22,6,33299,22,6,33998,22,6,34151,3,17.7,-1.2640571,36.7883547,-1.262492,36.8038837,731,153,22,2601
2324,27080,1430,1,Personal,26,3,64764,26,3,65139,26,3,66557,26,3,66731,26,3,69278,8,19.4,-1.3194988,36.7966681,-1.3159197,36.8516724,328,2547,375,1592
2325,8180,3521,3,Business,26,2,47693,26,2,47751,26,2,48154,26,2,48437,26,2,48744,2,23.25888921888938,-1.2621261,36.8079755,-1.2768326,36.8073804,379,307,58,686
2326,21356,1827,3,Business,17,2,60194,17,2,60217,17,2,60610,17,2,60883,17,2,63904,12,24.0,-1.318062,36.849326,-1.293515,36.897607,951,3021,23,666
2327,14673,1051,3,Business,29,1,41235,29,1,41580,29,1,41634,29,1,43446,29,1,45136,15,23.25888921888938,-1.2804792,36.8385078,-1.3160977,36.9131642,456,1690,345,1866
2328,23401,15,1,Personal,6,3,54855,6,3,54878,6,3,55524,6,3,56066,6,3,58676,17,21.9,-1.2940553,36.8184425,-1.2022306,36.7893305,852,2610,23,1188
2329,15867,1927,3,Business,12,2,38692,12,2,38714,12,2,39524,12,2,42126,12,2,44372,23,24.5,-1.2285835,36.8826468,-1.3472066,36.7692638,199,2246,22,3412
2330,16096,2987,3,Business,2,2,47663,2,2,47711,2,2,49320,2,2,49732,2,2,51394,10,26.0,-1.270212,36.8210877,-1.3014461,36.7661381,268,1662,48,2021
2331,18689,2030,3,Business,12,1,32869,12,1,32881,12,1,33025,12,1,35620,12,1,35622,4,19.5,-1.2482781,36.884092,-1.256828,36.855895,86,2,12,2739
2332,3974,3557,3,Business,26,3,47054,26,3,47097,26,3,48224,26,3,49447,26,3,50301,6,27.2,-1.287079,36.7811277,-1.2546732,36.8086796,882,854,43,2350
2333,12322,2928,3,Personal,17,1,54292,17,1,54421,17,1,55159,17,1,56219,17,1,56863,3,24.7,-1.2728947,36.8079426,-1.2561812,36.809713,375,644,129,1798
2334,28140,2677,3,Business,8,2,53296,8,2,53443,8,2,54004,8,2,54195,8,2,56388,14,25.2,-1.3228003,36.8306435,-1.306378,36.7519845,237,2193,147,752
2335,17875,3647,3,Business,29,3,34006,29,3,34087,29,3,34661,29,3,34981,29,3,35630,5,18.0,-1.272639,36.794723,-1.2938802,36.7939387,655,649,81,894
2336,3433,3318,3,Business,10,3,60752,10,3,60814,10,3,62725,10,3,63047,10,3,63755,10,27.2,-1.338283,36.8871775,-1.3004062,36.829741,126,708,62,2233
2337,24016,391,3,Business,20,3,41949,20,3,42952,20,3,44035,20,3,45035,20,3,45094,5,27.1,-1.2867454,36.8259017,-1.3010208,36.8609183,61,59,1003,2083
2338,27267,949,1,Personal,8,6,39623,8,6,39643,8,6,40397,8,6,40543,8,6,40839,1,22.6,-1.298574,36.793572,-1.2944457,36.7923516,105,296,20,900
2339,14960,3192,2,Personal,30,1,38027,30,1,38192,30,1,39120,30,1,39768,30,1,40990,6,22.8,-1.3041617,36.7627771,-1.2913246,36.8019522,634,1222,165,1576
2340,8622,1146,3,Business,24,5,37085,24,5,37121,24,5,37162,24,5,37982,24,5,38645,5,21.6,-1.3004062,36.829741,-1.3083266,36.8494756,211,663,36,861
2341,7489,1882,3,Business,23,6,36800,23,6,37087,23,6,37876,23,6,38853,23,6,39789,7,23.25888921888938,-1.2958783,36.7928125,-1.2588775,36.8079744,427,936,287,1766
2342,15190,269,3,Business,11,1,54593,11,1,54697,11,1,55458,11,1,55882,11,1,57406,15,23.1,-1.3332749,36.8708147,-1.2551895,36.7822034,726,1524,104,1185
2343,15428,508,2,Personal,14,2,49965,14,2,50071,14,2,51035,14,2,51204,14,2,53258,10,24.2,-1.2782498,36.8251128,-1.2702844,36.8803209,857,2054,106,1133
2344,2242,1642,3,Business,27,3,50977,27,3,51005,27,3,51413,27,3,51497,27,3,52242,5,29.0,-1.2728069,36.7962362,-1.2846195,36.7958316,576,745,28,492
2345,10146,246,3,Business,8,6,49292,8,6,49316,8,6,49846,8,6,50874,8,6,51101,1,24.5,-1.260775,36.8013889,-1.2584143,36.8048002,427,227,24,1558
2346,25596,868,3,Business,13,1,38715,13,1,40852,13,1,41578,13,1,42116,13,1,42903,5,17.2,-1.2600926,36.8088685,-1.265715,36.823815,268,787,2137,1264
2347,25506,868,3,Business,13,6,51404,13,6,51425,13,6,52397,13,6,52620,13,6,53409,4,27.9,-1.2600926,36.8088685,-1.265715,36.823815,547,789,21,1195
2348,3813,3283,3,Business,8,3,51959,8,3,52013,8,3,53521,8,3,54322,8,3,55756,7,23.25888921888938,-1.303596,36.778378,-1.2628473,36.781805,787,1434,54,2309
2349,26179,1329,3,Business,6,4,55210,6,4,55420,6,4,55997,6,4,56112,6,4,57557,6,21.3,-1.273056,36.811298,-1.288212,36.778334,472,1445,210,692
2350,22054,412,3,Business,4,2,38905,4,2,39803,4,2,40173,4,2,40272,4,2,40804,4,19.5,-1.266837,36.799249,-1.272828,36.816608,878,532,898,469
2351,20056,1083,1,Personal,26,6,56191,26,6,56847,26,6,57564,26,6,57771,26,6,58543,5,24.0,-1.3154004,36.8123328,-1.2862033,36.8152966,742,772,656,924
2352,5890,2424,3,Personal,11,4,47806,11,4,53955,11,4,54007,11,4,54433,11,4,55108,4,26.9,-1.304033,36.7848695,-1.2915247,36.7929598,393,675,6149,478
2353,3474,1882,3,Business,10,5,55990,10,5,56155,10,5,58265,10,5,59320,10,5,60542,8,21.6,-1.2268871,36.8073946,-1.2591019,36.800577,263,1222,165,3165
2354,2805,1046,1,Personal,23,1,67058,23,1,67065,23,1,67817,23,1,68238,23,1,70230,7,19.1,-1.3054537,36.8284768,-1.290881,36.8559893,144,1992,7,1173
2355,16765,3138,1,Personal,2,2,49147,2,2,49192,2,2,49688,2,2,49939,2,2,50705,4,26.2,-1.2924639,36.7795798,-1.2804664,36.7701111,38,766,45,747
2356,20949,1687,3,Business,28,4,39852,28,4,40014,28,4,40945,28,4,41082,28,4,42888,3,27.9,-1.2626574,36.8014034,-1.2755629,36.8131522,548,1806,162,1068
2357,13235,3621,3,Business,10,3,33695,10,3,33727,10,3,33963,10,3,34380,10,3,35983,9,21.6,-1.2836583,36.7886014,-1.31864,36.8417533,379,1603,32,653
2358,655,2523,3,Business,19,1,43587,19,1,44776,19,1,45125,19,1,45452,19,1,46486,8,24.7,-1.2551895,36.7822034,-1.2995738,36.8199719,660,1034,1189,676
2359,16466,2360,3,Business,22,5,52373,22,5,52918,22,5,53012,22,5,54573,22,5,56282,19,23.25888921888938,-1.3384245,36.8794338,-1.2551895,36.7822034,874,1709,545,1655
2360,7087,111,3,Business,9,3,36964,9,3,36993,9,3,37057,9,3,37658,9,3,37770,2,20.0,-1.2551895,36.7822034,-1.2569503,36.7834728,322,112,29,665
2361,13964,496,3,Business,10,3,51413,10,3,51508,10,3,53173,10,3,53441,10,3,54330,6,30.5,-1.2551895,36.7822034,-1.28359,36.823092,89,889,95,1933
2362,13547,1075,3,Business,24,5,38169,24,5,38917,24,5,40484,24,5,41591,24,5,44695,20,21.4,-1.3562374,36.9042954,-1.2527958,36.8003131,379,3104,748,2674
2363,10632,718,3,Business,3,5,57859,3,5,58714,3,5,59188,3,5,59609,3,5,60240,5,23.25888921888938,-1.2551895,36.7822034,-1.2764073,36.7952112,247,631,855,895
2364,14925,1336,3,Business,22,2,45334,22,2,46086,22,2,46487,22,2,47096,22,2,50014,8,24.1,-1.2885029,36.825605,-1.3038645,36.8684596,819,2918,752,1010
2365,4739,3718,3,Business,9,5,45936,9,5,46051,9,5,47347,9,5,48008,9,5,48209,1,25.5,-1.2650027,36.8126242,-1.2675613,36.8133001,427,201,115,1957
2366,26775,867,3,Business,21,1,42103,21,1,43201,21,1,43893,21,1,44954,21,1,46394,10,25.6,-1.2996533,36.8292629,-1.2991441,36.7528804,518,1440,1098,1753
2367,7731,2389,1,Personal,17,3,31191,17,3,31232,17,3,31900,17,3,32171,17,3,32624,7,21.0,-1.2813649,36.7764385,-1.2566889,36.7930784,88,453,41,939
2368,13047,1097,1,Personal,9,3,58790,9,3,58840,9,3,59377,9,3,59713,9,3,61211,11,21.7,-1.264788,36.7883897,-1.3099145,36.8022774,103,1498,50,873
2369,13969,640,3,Business,30,4,38950,30,4,39000,30,4,39310,30,4,39679,30,4,42430,21,23.25888921888938,-1.304033,36.7848695,-1.207546,36.7913976,815,2751,50,679
2370,4430,3450,3,Business,28,3,54305,28,3,58018,28,3,58444,28,3,58886,28,3,59546,9,23.25888921888938,-1.2551895,36.7822034,-1.2692149,36.74492,550,660,3713,868
2371,15203,3291,3,Business,30,2,52685,30,2,52981,30,2,53423,30,2,53932,30,2,56470,11,23.25888921888938,-1.303596,36.778378,-1.2600926,36.8088685,315,2538,296,951
2372,28018,3686,3,Business,8,5,33854,8,5,34006,8,5,34270,8,5,34725,8,5,36912,3,20.4,-1.2551895,36.7822034,-1.2655477,36.8001682,875,2187,152,719
2373,25702,2469,3,Business,11,4,47839,11,4,54101,11,4,55277,11,4,55714,11,4,56948,15,27.1,-1.303924,36.8758792,-1.369541,36.907455,166,1234,6262,1613
2374,21573,2733,3,Business,12,5,46323,12,5,46356,12,5,47482,12,5,48297,12,5,49069,2,26.5,-1.304033,36.7848695,-1.2963097,36.7688221,324,772,33,1941
2375,20755,758,3,Business,3,4,49317,3,4,49323,3,4,49331,3,4,49548,3,4,50458,4,26.2,-1.2996681,36.8068413,-1.2917868,36.7872675,322,910,6,225
2376,20156,868,3,Business,26,5,31535,26,5,31554,26,5,31713,26,5,33113,26,5,33398,4,23.25888921888938,-1.2600926,36.8088685,-1.265715,36.823815,607,285,19,1559
2377,7073,309,3,Personal,20,5,35738,20,5,35770,20,5,36880,20,5,37230,20,5,38499,6,14.7,-1.29387,36.7907813,-1.2707583,36.8237131,844,1269,32,1460
2378,1665,2982,3,Business,23,3,43705,23,3,43747,23,3,44326,23,3,46143,23,3,48258,18,23.25888921888938,-1.300921,36.828195,-1.177202,36.8351183,336,2115,42,2396
2379,11747,868,3,Business,10,5,44474,10,5,44566,10,5,46413,10,5,48434,10,5,48612,9,23.25888921888938,-1.22978,36.836215,-1.265715,36.823815,570,178,92,3868
2380,1282,2289,3,Business,27,2,50954,27,2,51035,27,2,52845,27,2,53004,27,2,56011,19,25.4,-1.2551895,36.7822034,-1.3285517,36.9018,580,3007,81,1969
2381,2069,3560,3,Business,31,1,34551,31,1,38779,31,1,39316,31,1,39524,31,1,40927,18,20.8,-1.3705766,36.9120742,-1.279395,36.825364,404,1403,4228,745
2382,14663,1882,3,Business,10,1,45691,10,1,45789,10,1,46270,10,1,47965,10,1,52512,36,18.6,-1.287781,36.817866,-1.2200124,36.6065939,462,4547,98,2176
2383,27644,496,3,Business,30,2,61512,30,2,69828,30,2,69985,30,2,70686,30,2,71844,10,23.25888921888938,-1.2551895,36.7822034,-1.2518814,36.859661,96,1158,8316,858
2384,25092,517,3,Business,2,3,46708,2,3,46751,2,3,47239,2,3,47991,2,3,49045,11,24.0,-1.3167113,36.8301563,-1.2574219,36.7927073,284,1054,43,1240
2385,11074,1090,3,Personal,3,3,37360,3,3,37403,3,3,40591,3,3,40764,3,3,41918,6,27.3,-1.2652279,36.8020159,-1.2913246,36.8019522,223,1154,43,3361
2386,19742,3291,3,Business,16,2,36758,16,2,36954,16,2,37131,16,2,39200,16,2,39861,5,23.25888921888938,-1.2783849,36.8163445,-1.2600926,36.8088685,291,661,196,2246
2387,2946,1693,3,Business,8,3,36787,8,3,36819,8,3,37503,8,3,40207,8,3,41489,9,22.1,-1.3272265,36.8231497,-1.2574088,36.799712,938,1282,32,3388
2388,14844,1845,3,Business,30,2,32417,30,2,32427,30,2,33384,30,2,35347,30,2,37639,21,17.5,-1.3700383,36.9190174,-1.2917868,36.7872675,769,2292,10,2920
2389,12325,868,3,Business,13,4,31554,13,4,31643,13,4,34982,13,4,35774,13,4,36658,7,17.9,-1.2628473,36.781805,-1.265715,36.823815,829,884,89,4131
2390,20119,1578,3,Business,20,4,44244,20,4,44374,20,4,44876,20,4,45153,20,4,46485,3,22.1,-1.28878,36.8168312,-1.3012902,36.80964,72,1332,130,779
2391,6283,3149,3,Business,26,5,46526,26,5,46617,26,5,47173,26,5,48221,26,5,49234,7,23.25888921888938,-1.3167113,36.8301563,-1.3174474,36.8585965,7,1013,91,1604
2392,19218,60,3,Business,5,6,34600,5,6,34667,5,6,35424,5,6,36321,5,6,38624,18,18.0,-1.293515,36.897607,-1.22978,36.836215,477,2303,67,1654
2393,8054,3420,3,Business,9,5,27151,9,5,29515,9,5,30730,9,5,30850,9,5,31842,6,20.4,-1.3046007,36.8211743,-1.311706,36.802841,114,992,2364,1335
2394,25004,3727,3,Business,18,2,54492,18,2,55162,18,2,55592,18,2,56176,18,2,61032,3,25.5,-1.2963097,36.7688221,-1.29663,36.7912971,829,4856,670,1014
2395,25608,1309,2,Personal,5,4,32664,5,4,32790,5,4,33390,5,4,33721,5,4,35041,8,23.25888921888938,-1.296797,36.7764525,-1.2621576,36.8103473,449,1320,126,931
2396,14467,3647,3,Business,9,3,57080,9,3,57603,9,3,58186,9,3,58314,9,3,60721,7,23.3,-1.272639,36.794723,-1.2981102,36.8293513,782,2407,523,711
2397,17582,2261,1,Personal,25,1,43228,25,1,46079,25,1,46992,25,1,47704,25,1,48342,4,23.25888921888938,-1.2878149,36.8146245,-1.273009,36.802807,265,638,2851,1625
2398,1143,1307,3,Business,20,7,49471,20,7,49680,20,7,51783,20,7,52071,20,7,54084,5,20.3,-1.2844665,36.7866113,-1.2948802,36.766374,956,2013,209,2391
2399,13165,3557,3,Business,6,3,39508,6,3,39524,6,3,40744,6,3,41622,6,3,42853,7,22.5,-1.289882,36.8105888,-1.2546732,36.8086796,899,1231,16,2098
2400,13033,1809,3,Business,4,4,42036,4,4,42504,4,4,43509,4,4,47133,4,4,47688,8,25.5,-1.2571472,36.7950633,-1.3090727,36.8315262,436,555,468,4629
2401,27473,478,3,Business,7,1,27328,7,1,27580,7,1,28782,7,1,29532,7,1,33189,10,21.6,-1.2551895,36.7822034,-1.2973682,36.7859878,829,3657,252,1952
2402,26376,2150,3,Business,4,2,43676,4,2,43718,4,2,44840,4,2,45464,4,2,46945,14,20.7,-1.303596,36.778378,-1.344446,36.756597,438,1481,42,1746
2403,22843,3590,3,Business,8,2,34778,8,2,34941,8,2,36604,8,2,36773,8,2,41471,5,19.0,-1.266294,36.8057971,-1.300722,36.816865,379,4698,163,1832
2404,17503,635,3,Business,1,3,51947,1,3,51963,1,3,52663,1,3,54912,1,3,56523,13,23.9,-1.3016417,36.8271679,-1.2297202,36.8819507,549,1611,16,2949
2405,21652,3647,3,Business,16,4,43025,16,4,43091,16,4,43702,16,4,44019,16,4,44760,5,23.25888921888938,-1.272639,36.794723,-1.2538731,36.7850223,147,741,66,928
2406,12453,3228,1,Personal,3,3,32902,3,3,32995,3,3,34245,3,3,34619,3,3,36280,10,18.7,-1.2756751,36.8144267,-1.2630429,36.7518974,532,1661,93,1624
2407,22408,96,3,Personal,14,4,41820,14,4,41953,14,4,43723,14,4,43841,14,4,45679,13,19.0,-1.307357,36.834251,-1.2672291,36.7743861,845,1838,133,1888
2408,11560,1237,1,Personal,5,2,56606,5,2,56958,5,2,58268,5,2,59008,5,2,60483,6,22.7,-1.2898179,36.8270849,-1.2733223,36.7951005,742,1475,352,2050
2409,8135,302,3,Business,3,6,75737,3,6,76067,3,6,76644,3,6,76728,3,6,78036,8,18.3,-1.2649605,36.7981777,-1.2930664,36.78495,40,1308,330,661
2410,27275,745,3,Personal,13,5,52035,13,5,53485,13,5,53859,13,5,54097,13,5,55619,7,19.1,-1.2903643,36.8319433,-1.2962832,36.7849683,832,1522,1450,612
2411,25216,393,3,Business,31,3,43907,31,3,44979,31,3,46574,31,3,47216,31,3,49738,14,24.7,-1.3177547,36.8303703,-1.306378,36.7519845,761,2522,1072,2237
2412,21685,1687,3,Business,7,3,42317,7,3,42345,7,3,42688,7,3,44218,7,3,44507,2,24.9,-1.2626574,36.8014034,-1.262718,36.797771,744,289,28,1873
2413,21740,302,3,Business,19,5,50545,19,5,50562,19,5,50820,19,5,51692,19,5,52327,2,27.6,-1.2649605,36.7981777,-1.25896,36.8016691,578,635,17,1130
2414,9607,1500,3,Business,8,1,34900,8,1,34934,8,1,36883,8,1,37017,8,1,38847,6,22.0,-1.2770708,36.8231093,-1.2638185,36.7930057,378,1830,34,2083
2415,12634,3291,3,Business,8,6,43183,8,6,43197,8,6,43537,8,6,44352,8,6,45449,11,18.5,-1.303596,36.778378,-1.2600926,36.8088685,810,1097,14,1155
2416,9421,335,2,Personal,20,3,39890,20,3,40062,20,3,40681,20,3,41015,20,3,42143,6,20.2,-1.268595,36.810189,-1.2924173,36.7797814,858,1128,172,953
2417,3230,3780,1,Personal,18,1,37519,18,1,43222,18,1,43396,18,1,44030,18,1,44824,4,23.25888921888938,-1.2868973,36.8232984,-1.2784495,36.7981729,444,794,5703,808
2418,21549,2205,2,Personal,18,4,46768,18,4,48981,18,4,49010,18,4,50258,18,4,51511,6,26.6,-1.2697859,36.7946203,-1.2836183,36.8297208,531,1253,2213,1277
2419,3926,3525,3,Business,21,4,45607,21,4,45970,21,4,46530,21,4,46996,21,4,49257,18,25.3,-1.2038217,36.8794507,-1.2571472,36.7950633,8,2261,363,1026
2420,22606,1329,3,Business,27,1,63831,27,1,64050,27,1,64656,27,1,65127,27,1,66935,9,23.25888921888938,-1.3193233,36.840991,-1.273056,36.811298,495,1808,219,1077
2421,2497,1687,3,Business,31,4,53181,31,4,53258,31,4,54378,31,4,54460,31,4,55276,5,28.6,-1.2729802,36.793734,-1.3025299,36.7901963,205,816,77,1202
2422,15962,2778,2,Personal,3,5,33448,3,5,34053,3,5,34861,3,5,35013,3,5,35929,6,17.4,-1.3038912,36.7961524,-1.2846475,36.8275903,754,916,605,960
2423,2646,1051,1,Business,7,2,50263,7,2,50314,7,2,50335,7,2,50574,7,2,53708,15,24.9,-1.2963097,36.7688221,-1.2500309,36.6690476,939,3134,51,260
2424,8448,627,3,Business,16,2,59980,16,2,60281,16,2,60721,16,2,61036,16,2,61807,4,24.9,-1.2551895,36.7822034,-1.2728947,36.8079426,795,771,301,755
2425,8925,1075,3,Business,4,2,35131,4,2,41132,4,2,42248,4,2,42679,4,2,43866,6,20.6,-1.2904016,36.8226303,-1.2527958,36.8003131,953,1187,6001,1547
2426,12004,2801,3,Business,17,5,34670,17,5,34697,17,5,36144,17,5,36979,17,5,37807,7,23.25888921888938,-1.285355,36.795287,-1.2674274,36.7870827,607,828,27,2282
2427,16154,2828,3,Business,6,3,28714,6,3,28738,6,3,29756,6,3,30275,6,3,33773,21,23.25888921888938,-1.3263105,36.8622904,-1.3981712,36.7673241,332,3498,24,1537
2428,26649,393,3,Business,6,3,42486,6,3,42499,6,3,42504,6,3,43229,6,3,45895,14,23.25888921888938,-1.3167113,36.8301563,-1.306378,36.7519845,15,2666,13,730
2429,9050,733,3,Business,7,2,61373,7,2,61445,7,2,61569,7,2,62584,7,2,64718,8,23.25888921888938,-1.2571472,36.7950633,-1.3031971,36.7863146,383,2134,72,1139
2430,5410,3560,3,Business,7,4,53563,7,4,53783,7,4,54438,7,4,54880,7,4,56773,13,31.1,-1.2156006,36.8916865,-1.279395,36.825364,836,1893,220,1097
2431,26461,1256,1,Personal,24,2,39852,24,2,39965,24,2,41133,24,2,41375,24,2,42613,8,17.5,-1.2652108,36.8056075,-1.3025667,36.7803495,144,1238,113,1410
2432,22810,2200,3,Business,3,4,51580,3,4,51814,3,4,52731,3,4,53119,3,4,54182,5,25.8,-1.2658335,36.8042867,-1.290894,36.822971,576,1063,234,1305
2433,12503,3250,3,Business,27,3,47236,27,3,48354,27,3,50958,27,3,51198,27,3,53208,14,29.3,-1.3827933,36.7626219,-1.3034451,36.7523126,269,2010,1118,2844
2434,18778,2200,3,Business,11,2,47597,11,2,53695,11,2,53856,11,2,54649,11,2,59188,6,22.3,-1.2584143,36.8048002,-1.290894,36.822971,268,4539,6098,954
2435,9721,3635,1,Business,29,6,35877,29,6,35886,29,6,37735,29,6,38225,29,6,42458,44,25.2,-1.290894,36.822971,-1.0352624,36.9131317,661,4233,9,2339
2436,17506,3647,3,Business,21,1,43070,21,1,43138,21,1,43482,21,1,43715,21,1,44188,3,25.4,-1.272639,36.794723,-1.2717174,36.7753883,315,473,68,577
2437,24110,2237,3,Business,11,1,56409,11,1,56440,11,1,56996,11,1,57931,11,1,58860,5,28.2,-1.2772389,36.7855864,-1.2574088,36.799712,523,929,31,1491
2438,1209,3698,3,Business,6,4,49502,6,4,49524,6,4,49548,6,4,51651,6,4,53623,18,21.2,-1.2649605,36.7981777,-1.3244885,36.897792,832,1972,22,2127
2439,1077,3688,3,Business,12,2,56948,12,2,58101,12,2,59347,12,2,59502,12,2,61916,7,27.1,-1.2551895,36.7822034,-1.2802803,36.8271747,452,2414,1153,1401
2440,10857,393,3,Business,23,2,35788,23,2,35880,23,2,38585,23,2,39610,23,2,41858,14,18.0,-1.3177547,36.8303703,-1.306378,36.7519845,56,2248,92,3730
2441,26721,2310,1,Business,3,5,45184,3,5,45196,3,5,46197,3,5,46608,3,5,48367,6,21.5,-1.2927792,36.9053492,-1.2859912,36.8756811,933,1759,12,1412
2442,20550,540,3,Business,22,3,28242,22,3,29385,22,3,32079,22,3,33571,22,3,34010,5,18.9,-1.2753109,36.8130185,-1.2551895,36.7822034,96,439,1143,4186
2443,19074,3291,3,Business,29,5,42628,29,5,42688,29,5,44232,29,5,44656,29,5,45336,4,26.7,-1.272828,36.816608,-1.2600926,36.8088685,52,680,60,1968
2444,12208,3444,1,Personal,10,2,45462,10,2,45478,10,2,46779,10,2,47197,10,2,50107,9,20.5,-1.263419,36.8060348,-1.2906539,36.7523571,116,2910,16,1719
2445,5825,2066,3,Business,10,1,46796,10,1,46855,10,1,47111,10,1,47444,10,1,48770,9,23.25888921888938,-1.316961,36.820337,-1.2655306,36.828148,742,1326,59,589
2446,18406,1316,3,Business,15,5,40350,15,5,40478,15,5,41181,15,5,41419,15,5,42638,11,25.8,-1.3173869,36.8112044,-1.2551895,36.7822034,205,1219,128,941
2447,17363,393,3,Business,28,4,41061,28,4,41077,28,4,41320,28,4,42320,28,4,43656,11,23.8,-1.3167113,36.8301563,-1.2638185,36.7930057,901,1336,16,1243
2448,9992,3647,3,Business,1,1,56871,1,1,56975,1,1,58269,1,1,58679,1,1,63469,8,23.25888921888938,-1.272639,36.794723,-1.2981102,36.8293513,223,4790,104,1704
2449,22037,2382,1,Personal,7,6,49724,7,6,51417,7,6,53207,7,6,53390,7,6,54198,8,21.3,-1.3188148,36.8092478,-1.2752917,36.8266879,629,808,1693,1973
2450,7649,868,3,Business,17,3,36850,17,3,36867,17,3,36879,17,3,38096,17,3,38797,6,23.25888921888938,-1.307143,36.825009,-1.265715,36.823815,68,701,17,1229
2451,25784,1964,3,Personal,25,2,56162,25,2,56171,25,2,56668,25,2,56923,25,2,58249,14,27.3,-1.3332749,36.8708147,-1.2670196,36.8077002,543,1326,9,752
2452,17299,3283,3,Business,2,6,37790,2,6,38580,2,6,39127,2,6,39878,2,6,41167,7,23.25888921888938,-1.303596,36.778378,-1.2628473,36.781805,197,1289,790,1298
2453,6009,3291,3,Business,26,2,40464,26,2,40492,26,2,40703,26,2,40999,26,2,41878,5,26.3,-1.2628473,36.781805,-1.2600926,36.8088685,269,879,28,507
2454,8369,1473,3,Business,1,1,59462,1,1,59611,1,1,60236,1,1,62219,1,1,64043,17,27.8,-1.2848212,36.8224159,-1.3700383,36.9190174,718,1824,149,2608
2455,27944,2212,3,Business,7,4,44674,7,4,44802,7,4,44907,7,4,45826,7,4,46915,7,24.4,-1.2571472,36.7950633,-1.2991249,36.8012652,19,1089,128,1024
2456,19806,3686,3,Business,6,4,58971,6,4,59016,6,4,59499,6,4,59681,6,4,60397,4,22.4,-1.2551895,36.7822034,-1.2695287,36.7981777,575,716,45,665
2457,24699,53,3,Business,14,5,45803,14,5,45876,14,5,47252,14,5,48014,14,5,48950,5,21.8,-1.3004062,36.829741,-1.2770708,36.8231093,921,936,73,2138
2458,13110,1075,3,Business,4,1,54703,4,1,54789,4,1,55950,4,1,56381,4,1,58014,10,28.6,-1.3014461,36.7661381,-1.2527958,36.8003131,862,1633,86,1592
2459,21111,60,3,Business,19,6,38888,19,6,38907,19,6,39329,19,6,42377,19,6,43459,6,25.4,-1.228911,36.881876,-1.2296618,36.8438272,669,1082,19,3470
2460,2268,868,3,Business,9,2,37142,9,2,37152,9,2,37209,9,2,38034,9,2,39149,8,26.8,-1.303596,36.778378,-1.265715,36.823815,484,1115,10,882
2461,14753,2330,3,Business,12,5,62733,12,5,62757,12,5,63447,12,5,63612,12,5,65179,10,26.7,-1.2645318,36.7981775,-1.3015197,36.7658456,177,1567,24,855
2462,23029,909,3,Business,25,5,37754,25,5,37775,25,5,37800,25,5,38197,25,5,39240,9,26.4,-1.2551895,36.7822034,-1.225322,36.80855,829,1043,21,422
2463,11105,136,3,Business,14,2,39631,14,2,40107,14,2,43349,14,2,44055,14,2,47088,17,23.25888921888938,-1.3165104,36.7077726,-1.2654716,36.7983635,315,3033,476,3948
2464,26005,432,3,Business,11,2,54110,11,2,54258,11,2,55689,11,2,55989,11,2,57240,3,21.4,-1.3012008,36.764868,-1.2763494,36.7671783,133,1251,148,1731
2465,10958,2801,3,Business,10,1,51244,10,1,51277,10,1,52029,10,1,52775,10,1,54607,6,18.5,-1.2674274,36.7870827,-1.2896399,36.8124498,158,1832,33,1498
2466,9631,517,3,Business,3,4,43368,3,4,43395,3,4,43525,3,4,43799,3,4,45626,14,23.5,-1.3167113,36.8301563,-1.306378,36.7519845,523,1827,27,404
2467,83,3456,3,Personal,20,1,53931,20,1,53941,20,1,54250,20,1,54329,20,1,55485,7,21.3,-1.280285,36.780954,-1.2538731,36.7850223,467,1156,10,388
2468,9362,1882,3,Business,13,2,40268,13,2,43792,13,2,44963,13,2,45026,13,2,46195,10,22.4,-1.2847654,36.820105,-1.2273427,36.7994683,615,1169,3524,1234
2469,6761,391,3,Business,5,2,38905,5,2,38985,5,2,40103,5,2,42160,5,2,42168,5,21.7,-1.300921,36.828195,-1.2867454,36.8259017,297,8,80,3175
2470,1796,3283,3,Business,11,2,34961,11,2,35004,11,2,36126,11,2,36608,11,2,37965,5,16.6,-1.2600926,36.8088685,-1.2628473,36.781805,27,1357,43,1604
2471,27240,2030,3,Business,14,3,45678,14,3,45748,14,3,46495,14,3,47165,14,3,48984,5,24.6,-1.304969,36.846623,-1.29658,36.823699,11,1819,70,1417
2472,20607,2654,3,Personal,15,1,41969,15,1,42165,15,1,45470,15,1,46145,15,1,48696,11,23.25888921888938,-1.2800391,36.831202,-1.2927792,36.9053492,155,2551,196,3980
2473,19819,3426,3,Business,2,6,40073,2,6,40114,2,6,40597,2,6,41616,2,6,43240,9,27.4,-1.3165542,36.700067,-1.3012008,36.764868,831,1624,41,1502
2474,1117,220,1,Personal,6,3,42025,6,3,42785,6,3,43491,6,3,43964,6,3,46388,14,19.8,-1.255956,36.789867,-1.2918164,36.8773248,852,2424,760,1179
2475,14222,540,3,Business,18,4,57960,18,4,58028,18,4,58700,18,4,58809,18,4,59702,4,27.0,-1.2551895,36.7822034,-1.2753109,36.8130185,208,893,68,781
2476,11396,1207,1,Business,8,6,33464,8,6,33478,8,6,33933,8,6,34854,8,6,35924,13,18.4,-1.2628638,36.8070399,-1.2156006,36.8916865,882,1070,14,1376
2477,3144,2008,3,Business,1,1,27335,1,1,28160,1,1,29304,1,1,30049,1,1,31239,8,18.2,-1.2508229,36.7895263,-1.29075,36.814503,722,1190,825,1889
2478,12367,1527,3,Business,3,3,31449,3,3,31497,3,3,32787,3,3,33117,3,3,34724,9,21.5,-1.2638185,36.7930057,-1.3004062,36.829741,613,1607,48,1620
2479,17849,3291,3,Business,1,3,51198,1,3,51674,1,3,52778,1,3,53383,1,3,54535,11,23.9,-1.303596,36.778378,-1.2600926,36.8088685,273,1152,476,1709
2480,9767,2956,3,Business,9,2,61965,9,2,62006,9,2,62324,9,2,63493,9,2,65633,6,27.7,-1.290894,36.822971,-1.2584143,36.8048002,119,2140,41,1487
2481,7440,60,3,Business,19,2,48403,19,2,48436,19,2,48447,19,2,49056,19,2,50491,12,30.1,-1.307143,36.825009,-1.2296618,36.8438272,31,1435,33,620
2482,26891,640,3,Business,24,3,35549,24,3,35561,24,3,35791,24,3,36244,24,3,37026,3,16.9,-1.304033,36.7848695,-1.2945106,36.7728398,612,782,12,683
2483,13757,416,1,Business,20,1,53568,20,1,53595,20,1,54204,20,1,54662,20,1,55332,6,21.5,-1.2846195,36.7958316,-1.2824911,36.8218042,241,670,27,1067
2484,9282,2701,3,Business,16,6,42225,16,6,42623,16,6,44932,16,6,45068,16,6,45860,3,19.1,-1.279395,36.825364,-1.2651643,36.8072214,208,792,398,2445
2485,3307,1899,3,Business,14,2,45520,14,2,45555,14,2,46087,14,2,49195,14,2,51238,13,24.0,-1.2600926,36.8088685,-1.331619,36.847976,882,2043,35,3640
2486,25834,2069,3,Business,22,1,49167,22,1,49183,22,1,49948,22,1,50353,22,1,51586,16,26.4,-1.303596,36.778378,-1.228911,36.881876,86,1233,16,1170
2487,26719,2330,3,Business,16,4,65186,16,4,65212,16,4,66123,16,4,67046,16,4,68554,16,23.25888921888938,-1.2326041,36.8009029,-1.3015197,36.7658456,205,1508,26,1834
2488,25565,3565,3,Business,26,6,79010,26,6,79079,26,6,79575,26,6,79996,26,6,81358,6,18.5,-1.2879041,36.8217926,-1.2844665,36.7866113,186,1362,69,917
2489,6447,1850,3,Business,27,1,51438,27,1,51456,27,1,51836,27,1,52066,27,1,55409,22,23.2,-1.2551895,36.7822034,-1.3668652,36.730459,931,3343,18,610
2490,13140,1927,3,Business,14,5,45131,14,5,45549,14,5,46208,14,5,46748,14,5,47908,8,21.3,-1.3467389,36.7690312,-1.3165542,36.700067,147,1160,418,1199
2491,8199,909,3,Business,5,5,47674,5,5,47694,5,5,48894,5,5,49373,5,5,51759,14,27.8,-1.2156006,36.8916865,-1.225322,36.80855,709,2386,20,1679
2492,9000,1075,3,Business,9,4,41832,9,4,41935,9,4,43159,9,4,43747,9,4,45029,8,23.25888921888938,-1.2765736,36.8513646,-1.2527958,36.8003131,435,1282,103,1812
2493,9262,1075,3,Business,16,2,59244,16,2,59359,16,2,60057,16,2,60306,16,2,61717,8,23.25888921888938,-1.2527958,36.8003131,-1.2765736,36.8513646,166,1411,115,947
2494,27761,3188,1,Personal,2,4,43199,2,4,43225,2,4,43430,2,4,44204,2,4,45203,7,22.5,-1.2985153,36.7876043,-1.2729652,36.8064396,726,999,26,979
2495,3410,3635,1,Business,29,3,52023,29,3,52037,29,3,52224,29,3,52489,29,3,53064,3,19.2,-1.2584143,36.8048002,-1.2615888,36.7928732,450,575,14,452
2496,5054,552,3,Business,15,1,50831,15,1,50843,15,1,51570,15,1,52604,15,1,55485,14,23.25888921888938,-1.2860183,36.8975338,-1.335477,36.9308297,155,2881,12,1761
2497,4024,2914,2,Personal,23,6,43913,23,6,43962,23,6,45325,23,6,46031,23,6,47311,5,23.25888921888938,-1.3019593,36.7521092,-1.2637699,36.7500558,752,1280,49,2069
2498,8619,1162,2,Business,9,2,32652,9,2,32842,9,2,33694,9,2,35458,9,2,36981,8,17.5,-1.312261,36.794658,-1.2661264,36.8030359,329,1523,190,2616
2499,5548,3283,3,Business,17,4,47593,17,4,47612,17,4,48029,17,4,48481,17,4,49315,9,25.3,-1.2999309,36.8307998,-1.2628473,36.781805,842,834,19,869
2500,16396,1182,2,Personal,11,1,54677,11,1,54725,11,1,56765,11,1,56884,11,1,61296,19,23.1,-1.268662,36.8016018,-1.3489543,36.7175503,919,4412,48,2159
2501,11087,3295,3,Business,25,4,39697,25,4,39762,25,4,40895,25,4,41907,25,4,45047,12,23.25888921888938,-1.2571472,36.7950633,-1.31553,36.863732,435,3140,65,2145
2502,12106,300,1,Personal,27,4,65075,27,4,65088,27,4,65173,27,4,66191,27,4,68183,12,23.1,-1.2857764,36.8236622,-1.2237819,36.8768042,338,1992,13,1103
2503,6272,1029,2,Personal,18,1,71950,18,1,72155,18,1,72759,18,1,73225,18,1,74341,9,23.25888921888938,-1.2872058,36.7802742,-1.2586758,36.7386812,956,1116,205,1070
2504,1936,2801,3,Business,24,4,53548,24,4,53568,24,4,53956,24,4,54144,24,4,58144,15,28.2,-1.2595422,36.7871178,-1.3104506,36.8687235,579,4000,20,576
2505,5463,3291,3,Business,28,2,34185,28,2,34243,28,2,34285,28,2,36280,28,2,36287,4,18.9,-1.265715,36.823815,-1.2600926,36.8088685,99,7,58,2037
2506,25018,2987,3,Business,24,4,55986,24,4,56043,24,4,58945,24,4,60551,24,4,61415,10,21.4,-1.332175,36.8819641,-1.3280091,36.8524146,618,864,57,4508
2507,22050,263,1,Personal,3,2,31475,3,2,32117,3,2,33402,3,2,34260,3,2,36011,6,15.5,-1.2624632,36.8405321,-1.300722,36.816865,208,1751,642,2143
2508,22353,1966,3,Business,10,1,54197,10,1,55222,10,1,56139,10,1,57056,10,1,58626,21,18.4,-1.3700383,36.9190174,-1.2917868,36.7872675,675,1570,1025,1834
2509,1340,3092,3,Personal,7,1,39843,7,1,39860,7,1,40276,7,1,40386,7,1,41423,12,24.9,-1.2917868,36.7872675,-1.249526,36.7711579,216,1037,17,526
2510,8760,633,3,Business,6,4,53003,6,4,56320,6,4,56944,6,4,57276,6,4,58059,4,23.25888921888938,-1.3077869,36.8443207,-1.3004062,36.829741,95,783,3317,956
2511,4281,3283,3,Business,24,1,52488,24,1,53400,24,1,53587,24,1,54444,24,1,56501,14,24.5,-1.228911,36.881876,-1.2628473,36.781805,147,2057,912,1044
2512,31,496,3,Business,20,4,52899,20,4,52926,20,4,53177,20,4,53548,20,4,55014,10,28.1,-1.2551895,36.7822034,-1.3046156,36.7658572,482,1466,27,622
2513,4073,3380,3,Personal,13,1,47396,13,1,47469,13,1,48135,13,1,48855,13,1,49727,7,23.25888921888938,-1.2781939,36.8191922,-1.2963097,36.7688221,800,872,73,1386
2514,8478,393,3,Business,29,5,31087,29,5,31100,29,5,31116,29,5,31954,29,5,34355,14,21.0,-1.3167113,36.8301563,-1.2991441,36.7528804,349,2401,13,854
2515,4485,1722,1,Personal,25,2,45451,25,2,45567,25,2,45807,25,2,46498,25,2,47382,7,23.8,-1.268501,36.801065,-1.2948385,36.7768079,116,884,116,931
2516,3815,3547,3,Business,8,2,41226,8,2,41288,8,2,42015,8,2,42106,8,2,44549,17,23.2,-1.2856319,36.7672998,-1.3194518,36.869396,958,2443,62,818
2517,26626,1634,1,Personal,12,4,45636,12,4,45647,12,4,46146,12,4,46365,12,4,48520,16,19.1,-1.2219305,36.90221,-1.2601,36.796528,384,2155,11,718
2518,5278,3291,3,Business,20,1,37079,20,1,37121,20,1,37697,20,1,40820,20,1,41429,5,23.25888921888938,-1.2628473,36.781805,-1.2600926,36.8088685,491,609,42,3699
2519,25238,3426,3,Business,20,3,41470,20,3,41576,20,3,41882,20,3,42717,20,3,43768,9,26.4,-1.3165542,36.700067,-1.3012008,36.764868,654,1051,106,1141
2520,6398,2066,3,Business,27,5,51125,27,5,51144,27,5,51793,27,5,52058,27,5,52797,4,24.0,-1.316961,36.820337,-1.318943,36.7909742,857,739,19,914
2521,1532,3149,3,Business,21,3,57422,21,3,57522,21,3,57596,21,3,60447,21,3,61262,5,23.25888921888938,-1.3004062,36.829741,-1.3177547,36.8303703,925,815,100,2925
2522,12146,510,3,Business,25,1,40481,25,1,41248,25,1,41877,25,1,41943,25,1,43908,6,25.6,-1.2859912,36.8756811,-1.2860183,36.8975338,779,1965,767,695
2523,21885,189,3,Personal,15,3,51270,15,3,51307,15,3,51878,15,3,52363,15,3,52985,5,25.9,-1.2859015,36.824532,-1.285355,36.795287,845,622,37,1056
2524,263,510,3,Business,7,5,58982,7,5,59253,7,5,59320,7,5,59493,7,5,62123,14,23.25888921888938,-1.3562374,36.9042954,-1.2860183,36.8975338,162,2630,271,240
2525,14840,3550,1,Personal,9,2,57656,9,2,57727,9,2,59658,9,2,59777,9,2,60191,2,19.2,-1.286797,36.773786,-1.2998202,36.7643997,565,414,71,2050
2526,17473,2847,3,Personal,9,4,52398,9,4,52593,9,4,53112,9,4,53285,9,4,55957,14,25.9,-1.338579,36.8963038,-1.288269,36.8182753,213,2672,195,692
2527,4138,3091,3,Business,10,1,43456,10,1,43983,10,1,44776,10,1,45062,10,1,46597,5,18.4,-1.273488,36.804158,-1.290894,36.822971,868,1535,527,1079
2528,6187,517,3,Business,8,5,50896,8,5,50914,8,5,50961,8,5,51870,8,5,51881,5,27.3,-1.3004062,36.829741,-1.3167113,36.8301563,15,11,18,956
2529,26950,471,1,Personal,27,7,46373,27,7,46391,27,7,46818,27,7,47334,27,7,49210,25,20.3,-1.2943667,36.7815346,-1.3722577,36.9415667,103,1876,18,943
2530,1089,2869,3,Business,14,5,61148,14,5,61246,14,5,61512,14,5,62200,14,5,63879,9,21.5,-1.290894,36.822971,-1.3025826,36.7670807,36,1679,98,954
2531,17975,627,3,Business,7,5,36796,7,5,36802,7,5,36952,7,5,37347,7,5,39211,19,20.6,-1.2571472,36.7950633,-1.3339943,36.7263409,647,1864,6,545
2532,25671,2330,3,Business,24,4,46511,24,4,46569,24,4,47681,24,4,47829,24,4,48882,11,24.5,-1.2642903,36.8002137,-1.2355732,36.8786063,38,1053,58,1260
2533,4131,3755,1,Personal,17,4,42467,17,4,42471,17,4,42499,17,4,43226,17,4,44486,7,22.6,-1.2965005,36.7791835,-1.28249,36.8190983,789,1260,4,755
2534,6786,1205,3,Business,7,2,55475,7,2,55618,7,2,56353,7,2,57041,7,2,59244,5,23.25888921888938,-1.2495931,36.8065087,-1.2810807,36.8144229,155,2203,143,1423
2535,26910,622,1,Business,6,4,36552,6,4,36607,6,4,37485,6,4,37772,6,4,39159,5,17.9,-1.2951362,36.7876989,-1.2778904,36.7759241,849,1387,55,1165
2536,9825,2647,1,Personal,14,4,64473,14,4,65743,14,4,66430,14,4,66600,14,4,68198,5,21.4,-1.2838297,36.8109232,-1.2536855,36.8245276,79,1598,1270,857
2537,26686,1436,3,Personal,9,4,75810,9,4,76325,9,4,76933,9,4,77064,9,4,77578,2,23.25888921888938,-1.2963097,36.7688221,-1.2994194,36.7647917,299,514,515,739
2538,12571,1244,3,Business,25,1,42810,25,1,43011,25,1,43880,25,1,44481,25,1,47512,18,26.9,-1.293515,36.897607,-1.303596,36.778378,126,3031,201,1470
2539,18656,3283,3,Business,20,2,36480,20,2,36665,20,2,37398,20,2,38919,20,2,39287,6,20.0,-1.272828,36.816608,-1.2628473,36.781805,472,368,185,2254
2540,1888,2454,3,Business,20,3,50397,20,3,50452,20,3,50704,20,3,51668,20,3,52468,3,29.6,-1.2941792,36.7633637,-1.2993231,36.7753372,129,800,55,1216
2541,1306,1853,3,Personal,11,1,39258,11,1,39295,11,1,39639,11,1,39988,11,1,40701,6,24.0,-1.2983604,36.8074766,-1.274089,36.7997508,283,713,37,693
2542,4406,2259,1,Personal,21,5,65022,21,5,65075,21,5,66342,21,5,67707,21,5,68287,4,25.4,-1.2946581,36.7792921,-1.300037,36.805514,465,580,53,2632
2543,21696,3201,3,Business,19,3,40370,19,3,40386,19,3,40555,19,3,40830,19,3,41239,1,23.25888921888938,-1.2649605,36.7981777,-1.2597529,36.806629,882,409,16,444
2544,15809,635,3,Business,13,3,43480,13,3,44840,13,3,45269,13,3,46856,13,3,49071,7,23.25888921888938,-1.3081376,36.8329772,-1.2599563,36.7993439,332,2215,1360,2016
2545,5403,633,3,Business,20,3,58633,20,3,58665,20,3,59348,20,3,59510,20,3,59967,4,29.2,-1.3077869,36.8443207,-1.3004062,36.829741,127,457,32,845
2546,7321,913,3,Personal,16,2,65576,16,2,65607,16,2,66760,16,2,67131,16,2,67680,6,23.25888921888938,-1.3034413,36.7770106,-1.2692689,36.8055169,678,549,31,1524
2547,1061,3635,1,Business,18,4,37903,18,4,37964,18,4,39430,18,4,42594,18,4,44519,14,25.7,-1.2615888,36.7928732,-1.3158232,36.8645358,478,1925,61,4630
2548,14712,24,1,Personal,12,2,48514,12,2,49246,12,2,49798,12,2,51206,12,2,52715,12,22.8,-1.303924,36.8758792,-1.2962041,36.8108293,616,1509,732,1960
2549,25894,868,3,Business,20,2,32749,20,2,32870,20,2,33408,20,2,33876,20,2,34590,5,18.8,-1.2600926,36.8088685,-1.265715,36.823815,453,714,121,1006
2550,6501,1809,3,Business,17,4,37127,17,4,37198,17,4,38687,17,4,38983,17,4,39120,8,25.4,-1.225322,36.80855,-1.2571472,36.7950633,436,137,71,1785
2551,3283,3694,3,Personal,8,1,38785,8,1,38838,8,1,39419,8,1,39657,8,1,40145,4,24.5,-1.2776963,36.7961705,-1.2678232,36.7876405,795,488,53,819
2552,24231,1205,3,Business,27,3,50355,27,3,51665,27,3,51676,27,3,52269,27,3,53163,4,23.25888921888938,-1.2810807,36.8144229,-1.2714767,36.8138291,268,894,1310,604
2553,21970,1245,3,Business,4,1,39269,4,1,40236,4,1,42504,4,1,43453,4,1,45511,14,26.7,-1.3882008,36.7699445,-1.3198615,36.7110323,246,2058,967,3217
2554,565,1250,1,Personal,21,1,53499,21,1,53685,21,1,55052,21,1,55330,21,1,56733,9,21.4,-1.2743743,36.7657321,-1.2620741,36.8158147,320,1403,186,1645
2555,2545,3565,3,Business,11,7,34398,11,7,34407,11,7,35149,11,7,35407,11,7,37770,20,21.1,-1.2844665,36.7866113,-1.3681253,36.9155298,805,2363,9,1000
2556,25357,2900,3,Business,13,1,44420,13,1,44447,13,1,44547,13,1,44812,13,1,46936,20,17.2,-1.2963097,36.7688221,-1.2198413,36.9054958,754,2124,27,365
2557,24467,2900,1,Business,1,1,50589,1,1,50610,1,1,50689,1,1,51470,1,1,52491,9,25.8,-1.2975066,36.7689423,-1.2606477,36.7224694,519,1021,21,860
2558,9392,867,3,Business,5,6,38175,5,6,38180,5,6,38183,5,6,38414,5,6,40226,10,22.6,-1.2996533,36.8292629,-1.2991441,36.7528804,914,1812,5,234
2559,7685,1899,3,Business,11,6,33721,11,6,33741,11,6,34168,11,6,38102,11,6,39232,13,21.2,-1.2600926,36.8088685,-1.331619,36.847976,882,1130,20,4361
2560,17108,1482,3,Business,1,4,42584,1,4,42631,1,4,42819,1,4,46773,1,4,48439,16,23.25888921888938,-1.260232,36.807334,-1.338579,36.8963038,648,1666,47,4142
2561,5025,2179,3,Business,5,2,46639,5,2,46777,5,2,47873,5,2,48296,5,2,49741,8,23.6,-1.225322,36.80855,-1.2571472,36.7950633,953,1445,138,1519
2562,13913,3296,1,Personal,3,1,52473,3,1,52497,3,1,53139,3,1,53330,3,1,54524,7,23.2,-1.253332,36.80636,-1.2981625,36.8130142,857,1194,24,833
2563,5782,2996,2,Personal,22,2,44156,22,2,44166,22,2,44752,22,2,45139,22,2,47046,14,19.4,-1.2637817,36.8764568,-1.305716,36.809882,654,1907,10,973
2564,2850,1271,3,Business,11,1,40698,11,1,40719,11,1,41520,11,1,42752,11,1,47243,17,24.2,-1.3244885,36.897792,-1.2285995,36.9012372,411,4491,21,2033
2565,12271,3283,3,Business,9,1,32730,9,1,34473,9,1,34707,9,1,35957,9,1,37841,13,15.5,-1.331619,36.847976,-1.2628473,36.781805,951,1884,1743,1484
2566,14254,868,3,Business,12,6,48011,12,6,48884,12,6,50091,12,6,50300,12,6,51610,9,25.5,-1.318062,36.849326,-1.265715,36.823815,742,1310,873,1416
2567,21991,1372,3,Business,4,5,37284,4,5,37296,4,5,37807,4,5,38707,4,5,39899,11,17.3,-1.2885417,36.8100523,-1.2361443,36.8108518,343,1192,12,1411
2568,21321,640,3,Business,4,4,33032,4,4,33047,4,4,33160,4,4,33308,4,4,39809,14,21.9,-1.304033,36.7848695,-1.3246455,36.8754415,202,6501,15,261
2569,16157,2279,3,Business,15,5,50561,15,5,50796,15,5,53785,15,5,53867,15,5,54180,4,28.1,-1.2897368,36.8226783,-1.2627937,36.8156957,614,313,235,3071
2570,6050,3091,3,Business,18,5,30678,18,5,30687,18,5,30707,18,5,31197,18,5,32486,9,20.3,-1.3012008,36.764868,-1.2676026,36.8103629,105,1289,9,510
2571,25888,1442,3,Personal,16,3,40960,16,3,40975,16,3,43326,16,3,44305,16,3,45855,11,23.9,-1.3185034,36.69851292,-1.2963097,36.7688221,478,1550,15,3330
2572,25580,2872,3,Business,16,2,53740,16,2,53788,16,2,54530,16,2,54871,16,2,55694,8,23.25888921888938,-1.2601197,36.7985271,-1.2963097,36.7688221,911,823,48,1083
2573,1401,3194,3,Business,26,2,54536,26,2,54974,26,2,55657,26,2,55781,26,2,56862,6,30.9,-1.2551895,36.7822034,-1.2897368,36.8226783,85,1081,438,807
2574,20193,524,1,Personal,27,4,51557,27,4,51566,27,4,52766,27,4,53039,27,4,54483,11,25.2,-1.2575407,36.7868197,-1.312469,36.815177,72,1444,9,1473
2575,24668,2330,3,Business,13,4,39146,13,4,39197,13,4,40257,13,4,40656,13,4,41943,9,22.2,-1.2645318,36.7981775,-1.2124582,36.802894,362,1287,51,1459
2576,10994,2154,3,Business,4,4,39182,4,4,39669,4,4,40437,4,4,41566,4,4,43050,8,25.5,-1.2527958,36.8003131,-1.2765736,36.8513646,907,1484,487,1897
2577,5663,136,3,Business,5,5,31314,5,5,31695,5,5,33448,5,5,35084,5,5,36966,15,17.8,-1.3326173,36.7146233,-1.3322618,36.8045412,593,1882,381,3389
2578,12264,2200,3,Business,22,3,43000,22,3,43124,22,3,43921,22,3,44829,22,3,46481,10,23.2,-1.290894,36.822971,-1.2413316,36.8785525,213,1652,124,1705
2579,18343,346,3,Business,11,2,45545,11,2,45774,11,2,47778,11,2,48017,11,2,48525,1,19.6,-1.2795827,36.8197262,-1.28878,36.8168312,790,508,229,2243
2580,16313,517,3,Business,3,4,38287,3,4,38311,3,4,38488,3,4,38692,3,4,39513,5,23.6,-1.3167113,36.8301563,-1.3077869,36.8443207,523,821,24,381
2581,25291,1178,3,Business,30,4,45335,30,4,45372,30,4,46290,30,4,46790,30,4,48106,7,20.3,-1.301028,36.809368,-1.2866544,36.784311,882,1316,37,1418
2582,1384,3343,3,Personal,27,1,44216,27,1,44259,27,1,46742,27,1,46863,27,1,50087,24,23.9,-1.3620657,36.7431685,-1.2358386,36.767204,350,3224,43,2604
2583,3647,2174,3,Business,18,5,50887,18,5,50889,18,5,50938,18,5,52429,18,5,57264,24,24.4,-1.2482781,36.884092,-1.28372,36.7085454,33,4835,2,1540
2584,13129,1207,3,Business,14,2,67023,14,2,67130,14,2,67808,14,2,68112,14,2,69257,8,23.25888921888938,-1.2629666,36.8068369,-1.2745321,36.765088,538,1145,107,982
2585,12200,1278,2,Personal,6,3,42810,6,3,42820,6,3,43491,6,3,43612,6,3,45256,15,19.9,-1.2899733,36.7908611,-1.2297202,36.8745508,726,1644,10,792
2586,10932,437,3,Business,29,4,55717,29,4,56761,29,4,57094,29,4,57351,29,4,57891,3,24.7,-1.2551895,36.7822034,-1.268027,36.8037005,228,540,1044,590
2587,23027,2344,3,Business,1,4,49510,1,4,49605,1,4,50478,1,4,50605,1,4,51559,8,23.25888921888938,-1.2551895,36.7822034,-1.2958383,36.8073162,578,954,95,1000
2588,16461,635,3,Business,25,6,38367,25,6,38398,25,6,38457,25,6,39729,25,6,42570,8,23.25888921888938,-1.3081376,36.8329772,-1.2945798,36.7737755,686,2841,31,1331
2589,22160,3491,3,Business,2,5,46214,2,5,47036,2,5,47108,2,5,47357,2,5,49493,19,23.6,-1.2297202,36.8819507,-1.15135,36.9566534,704,2136,822,321
2590,5973,2701,3,Business,7,5,37176,7,5,37246,7,5,38839,7,5,39041,7,5,39868,5,23.25888921888938,-1.2765736,36.8513646,-1.3083777,36.8590077,448,827,70,1795
2591,9202,3283,3,Business,9,6,49360,9,6,49375,9,6,49783,9,6,50408,9,6,53232,9,19.4,-1.303596,36.778378,-1.2628473,36.781805,844,2824,15,1033
2592,1191,1484,3,Business,18,1,42984,18,1,43106,18,1,43960,18,1,44234,18,1,45639,7,23.25888921888938,-1.2551895,36.7822034,-1.2995738,36.8199719,865,1405,122,1128
2593,2326,1051,3,Business,6,4,40582,6,4,41530,6,4,43269,6,4,44081,6,4,48448,31,24.2,-1.1723908,36.9461248,-1.2963097,36.7688221,447,4367,948,2551
2594,13584,2701,3,Business,12,3,38671,12,3,38940,12,3,39826,12,3,40034,12,3,42190,9,19.4,-1.2765736,36.8513646,-1.2571472,36.7950633,827,2156,269,1094
2595,2772,3599,3,Business,24,5,39602,24,5,39737,24,5,39768,24,5,40869,24,5,45496,21,21.3,-1.3302996,36.8707935,-1.2228458,36.8852512,519,4627,135,1132
2596,23811,302,3,Business,13,4,68463,13,4,68754,13,4,69385,13,4,70182,13,4,71012,7,24.3,-1.2649605,36.7981777,-1.2971379,36.8019794,427,830,291,1428
2597,25727,633,3,Business,5,2,49254,5,2,51973,5,2,52812,5,2,54629,5,2,55901,5,27.3,-1.2770708,36.8231093,-1.3004062,36.829741,959,1272,2719,2656
2598,4797,2987,3,Business,6,1,46452,6,1,46528,6,1,46967,6,1,47299,6,1,48226,10,20.3,-1.270212,36.8210877,-1.2297202,36.8819507,174,927,76,771
2599,27521,1329,3,Business,7,5,36124,7,5,36168,7,5,36527,7,5,36810,7,5,37612,5,23.25888921888938,-1.273056,36.811298,-1.29458,36.794917,178,802,44,642
2600,2233,48,1,Personal,15,1,37529,15,1,37559,15,1,38804,15,1,39138,15,1,41176,14,23.25888921888938,-1.3163867,36.8558249,-1.246772,36.883293,751,2038,30,1579
2601,26637,570,3,Business,2,5,49871,2,5,49912,2,5,50524,2,5,50615,2,5,53841,17,25.3,-1.2551895,36.7822034,-1.2855846,36.8826113,284,3226,41,703
2602,1997,3689,2,Business,14,2,31600,14,2,31644,14,2,32211,14,2,32465,14,2,33389,3,15.4,-1.2527958,36.8003131,-1.2551895,36.7822034,159,924,44,821
2603,20485,3688,3,Business,28,1,54187,28,1,54617,28,1,55195,28,1,55838,28,1,57375,5,26.4,-1.2551895,36.7822034,-1.2736466,36.8164042,948,1537,430,1221
2604,26592,1724,3,Business,29,1,40128,29,1,40695,29,1,41238,29,1,41321,29,1,42180,7,23.25888921888938,-1.2861765,36.8209086,-1.2551895,36.7822034,336,859,567,626
2605,16237,1500,3,Business,12,2,57461,12,2,57564,12,2,58566,12,2,59381,12,2,60863,11,23.25888921888938,-1.3077869,36.8443207,-1.2638185,36.7930057,590,1482,103,1817
2606,9446,1687,3,Business,3,3,32271,3,3,32289,3,3,32682,3,3,33238,3,3,34163,6,18.3,-1.2626574,36.8014034,-1.3025299,36.7901963,337,925,18,949
2607,27652,2801,3,Business,11,1,40796,11,1,40810,11,1,41112,11,1,41309,11,1,42838,7,26.6,-1.2674274,36.7870827,-1.2809847,36.8274169,709,1529,14,499
2608,26459,393,3,Business,8,4,57609,8,4,58167,8,4,59710,8,4,60519,8,4,62104,14,25.7,-1.3177547,36.8303703,-1.306378,36.7519845,708,1585,558,2352
2609,27886,1410,3,Business,17,5,60014,17,5,60028,17,5,60459,17,5,61871,17,5,64863,20,23.25888921888938,-1.300921,36.828195,-1.2847613,36.967084,349,2992,14,1843
2610,1540,435,3,Business,7,5,44440,7,5,52398,7,5,53231,7,5,53890,7,5,55933,10,23.25888921888938,-1.300921,36.828195,-1.3472066,36.7692638,732,2043,7958,1492
2611,13383,970,3,Business,11,1,41512,11,1,41529,11,1,41544,11,1,41842,11,1,42187,3,26.4,-1.2551895,36.7822034,-1.2629594,36.8077626,793,345,17,313
2612,14827,970,3,Business,5,2,48971,5,2,48993,5,2,49109,5,2,49335,5,2,51040,16,23.25888921888938,-1.2551895,36.7822034,-1.1874676,36.7424548,341,1705,22,342
2613,15315,2112,3,Business,10,1,56413,10,1,56430,10,1,56855,10,1,58547,10,1,62249,23,18.1,-1.3472066,36.7692638,-1.2156006,36.8916865,123,3702,17,2117
2614,4152,517,3,Business,22,4,28880,22,4,29547,22,4,32725,22,4,32875,22,4,35083,14,19.7,-1.3177547,36.8303703,-1.306378,36.7519845,208,2208,667,3328
2615,9271,302,3,Business,6,6,37770,6,6,37851,6,6,38305,6,6,38927,6,6,43736,12,26.8,-1.2649605,36.7981777,-1.3024388,36.859699,161,4809,81,1076
2616,17214,1750,1,Personal,19,5,34852,19,5,35851,19,5,36589,19,5,37068,19,5,38737,11,20.4,-1.3339943,36.7263409,-1.3009721,36.7689325,208,1669,999,1217
2617,10945,248,3,Business,8,1,52822,8,1,52854,8,1,53584,8,1,54195,8,1,55635,9,25.0,-1.304735,36.7846054,-1.2674274,36.7870827,565,1440,32,1341
2618,24809,3355,3,Business,25,4,47893,25,4,48107,25,4,48536,25,4,48781,25,4,53398,16,20.7,-1.305399,36.8221849,-1.3427269,36.9194847,867,4617,214,674
2619,22228,1329,3,Business,5,3,33511,5,3,33571,5,3,34541,5,3,34902,5,3,36735,6,18.0,-1.273056,36.811298,-1.3005349,36.7873912,379,1833,60,1331
2620,24481,136,3,Business,21,2,46951,21,2,48493,21,2,48536,21,2,49528,21,2,51589,18,24.9,-1.3254522,36.7216584,-1.2629838,36.8086926,411,2061,1542,1035
2621,4766,1246,3,Business,8,4,44489,8,4,44515,8,4,44563,8,4,46634,8,4,48406,2,26.5,-1.2571472,36.7950633,-1.2618632,36.8100226,520,1772,26,2119
2622,15733,3407,3,Business,18,4,45433,18,4,46319,18,4,47217,18,4,47282,18,4,48747,4,23.25888921888938,-1.2810889,36.8247135,-1.3089235,36.8372446,747,1465,886,963
2623,13087,2523,3,Business,30,2,48726,30,2,49076,30,2,52010,30,2,52144,30,2,53537,7,23.25888921888938,-1.2551895,36.7822034,-1.2989287,36.8163082,570,1393,350,3068
2624,12041,307,2,Personal,10,2,54430,10,2,54604,10,2,55977,10,2,56577,10,2,57474,4,20.9,-1.2887458,36.786049,-1.2882462,36.8164538,844,897,174,1973
2625,25909,3647,3,Business,4,1,57954,4,1,57960,4,1,58026,4,1,58118,4,1,60212,25,28.5,-1.1846355,36.9485728,-1.272639,36.794723,131,2094,6,158
2626,19471,635,3,Business,31,5,35565,31,5,35565,31,5,35833,31,5,38347,31,5,39701,10,21.9,-1.3081376,36.8329772,-1.2602337,36.7990548,582,1354,0,2782
2627,13006,3557,3,Business,11,1,43430,11,1,43499,11,1,44588,11,1,44649,11,1,45200,4,26.6,-1.2597431,36.8023063,-1.2622145,36.8087391,682,551,69,1150
2628,24213,2213,2,Personal,4,5,55973,4,5,56254,4,5,56663,4,5,58300,4,5,60530,17,24.2,-1.32943,36.894243,-1.2966785,36.7896469,101,2230,281,2046
2629,5885,2801,3,Business,25,1,37623,25,1,37731,25,1,38426,25,1,38696,25,1,39840,7,25.6,-1.2674274,36.7870827,-1.2809847,36.8274169,660,1144,108,965
2630,13306,2413,3,Business,5,6,37337,5,6,37400,5,6,38162,5,6,38496,5,6,39756,9,22.5,-1.2882803,36.7815881,-1.3033748,36.8430714,940,1260,63,1096
2631,23655,3222,3,Business,6,2,36957,6,2,37410,6,2,37872,6,2,38223,6,2,40178,11,25.0,-1.2551895,36.7822034,-1.3233496,36.8139159,726,1955,453,813
2632,19202,1502,3,Business,6,1,46454,6,1,46591,6,1,48550,6,1,50949,6,1,51276,12,23.25888921888938,-1.2765736,36.8513646,-1.2232123,36.8932547,193,327,137,4358
2633,15714,1075,3,Business,9,2,62755,9,2,62783,9,2,64457,9,2,66765,9,2,66779,1,27.8,-1.2649605,36.7981777,-1.2527958,36.8003131,106,14,28,3982
2634,17285,1697,3,Personal,3,1,55777,3,1,55797,3,1,55914,3,1,56926,3,1,59563,12,23.0,-1.2977387,36.8031447,-1.3192808,36.7121888,179,2637,20,1129
2635,11926,111,3,Business,16,2,54344,16,2,54382,16,2,54641,16,2,54743,16,2,55985,3,23.25888921888938,-1.2551895,36.7822034,-1.2648164,36.8057234,570,1242,38,361
2636,26148,111,3,Business,15,5,46486,15,5,46800,15,5,49531,15,5,49597,15,5,54115,11,28.2,-1.2551895,36.7822034,-1.2432427,36.8642382,448,4518,314,2797
2637,13159,136,3,Business,15,5,45931,15,5,45957,15,5,45978,15,5,46345,15,5,48664,14,26.0,-1.3254522,36.7216584,-1.2963367,36.8094235,458,2319,26,388
2638,21370,393,3,Business,2,4,31043,2,4,31052,2,4,31117,2,4,32292,2,4,33130,4,23.25888921888938,-1.3167113,36.8301563,-1.3004062,36.829741,438,838,9,1240
2639,25320,1776,3,Personal,7,5,50024,7,5,50203,7,5,51018,7,5,51124,7,5,52315,7,23.25888921888938,-1.2578943,36.7989213,-1.2622285,36.8534706,245,1191,179,921
2640,25528,3360,2,Personal,27,4,60297,27,4,60320,27,4,60540,27,4,62639,27,4,64048,11,22.9,-1.3278522,36.8711134,-1.3266874,36.7986312,102,1409,23,2319
2641,21620,2216,3,Business,7,5,34979,7,5,35103,7,5,35560,7,5,35699,7,5,37576,11,20.4,-1.2551895,36.7822034,-1.3185736,36.8258933,778,1877,124,596
2642,9567,393,3,Business,6,4,35247,6,4,35264,6,4,36061,6,4,36653,6,4,38187,11,16.3,-1.3228003,36.8306435,-1.2638185,36.7930057,2,1534,17,1389
2643,2969,3470,3,Business,23,5,42912,23,5,44207,23,5,44756,23,5,44925,23,5,45968,7,23.9,-1.28878,36.8168312,-1.2551895,36.7822034,250,1043,1295,718
2644,15598,2829,3,Business,1,3,35342,1,3,35351,1,3,35987,1,3,36227,1,3,39155,20,23.25888921888938,-1.2571472,36.7950633,-1.3700383,36.9190174,520,2928,9,876
2645,17573,3222,3,Business,16,4,42222,16,4,42275,16,4,42637,16,4,42995,16,4,44726,9,23.25888921888938,-1.2551895,36.7822034,-1.2604472,36.8365287,155,1731,53,720
2646,12339,3686,3,Business,13,4,41680,13,4,46638,13,4,47137,13,4,48068,13,4,50326,6,21.8,-1.2551895,36.7822034,-1.2805757,36.8223948,124,2258,4958,1430
2647,12876,1502,3,Business,23,2,44640,23,2,44722,23,2,47485,23,2,48912,23,2,50502,15,23.25888921888938,-1.225322,36.80855,-1.2232123,36.8932547,263,1590,82,4190
2648,10244,3525,3,Business,28,2,46107,28,2,46425,28,2,48402,28,2,48695,28,2,53004,16,21.5,-1.3700383,36.9190174,-1.27915,36.89929,876,4309,318,2270
2649,3309,2804,3,Business,27,3,55090,27,3,55115,27,3,55804,27,3,56455,27,3,59797,20,23.25888921888938,-1.2579304,36.8019667,-1.333148,36.922453,618,3342,25,1340
2650,288,1784,1,Personal,28,4,47744,28,4,48197,28,4,48807,28,4,49060,28,4,49364,1,23.25888921888938,-1.294555,36.814462,-1.300722,36.816865,620,304,453,863
2651,25751,2066,3,Business,20,3,55311,20,3,55377,20,3,56313,20,3,56537,20,3,58413,13,28.3,-1.3210189,36.8410551,-1.2871375,36.8898931,856,1876,66,1160
2652,5279,2587,3,Business,30,2,43670,30,2,44578,30,2,45105,30,2,46224,30,2,47897,16,22.5,-1.207546,36.7913976,-1.28878,36.8168312,414,1673,908,1646
2653,293,265,3,Business,25,6,46543,25,6,46560,25,6,47144,25,6,48124,25,6,50545,14,23.25888921888938,-1.300921,36.828195,-1.3616286,36.7452212,414,2421,17,1564
2654,18249,737,1,Personal,28,1,61078,28,1,61843,28,1,63076,28,1,63671,28,1,65945,14,22.6,-1.2801958,36.8847721,-1.291779,36.802679,116,2274,765,1828
2655,5746,510,3,Business,30,4,38658,30,4,39388,30,4,41567,30,4,41903,30,4,43047,10,23.25888921888938,-1.2765736,36.8513646,-1.2860183,36.8975338,404,1144,730,2515
2656,11908,1835,1,Personal,31,4,42448,31,4,42633,31,4,43416,31,4,43651,31,4,44979,5,21.8,-1.2745107,36.7974503,-1.2966785,36.7896469,322,1328,185,1018
2657,7914,136,3,Business,11,2,35377,11,2,36292,11,2,37055,11,2,37234,11,2,39270,16,16.4,-1.3254522,36.7216584,-1.2536042,36.8064895,647,2036,915,942
2658,10931,3283,3,Business,17,5,31174,17,5,31305,17,5,31890,17,5,32346,17,5,32893,5,23.25888921888938,-1.266837,36.799249,-1.2628473,36.781805,694,547,131,1041
2659,24876,1500,3,Business,11,5,47814,11,5,47822,11,5,47826,11,5,48896,11,5,50243,11,26.4,-1.3228003,36.8306435,-1.2574219,36.7927073,555,1347,8,1074
2660,22188,868,3,Business,9,4,56501,9,4,56642,9,4,58370,9,4,58983,9,4,59915,7,25.6,-1.2628473,36.781805,-1.265715,36.823815,85,932,141,2341
2661,3982,1329,3,Business,24,4,45074,24,4,45563,24,4,46168,24,4,46527,24,4,49369,6,21.0,-1.273056,36.811298,-1.2930317,36.7810911,742,2842,489,964
2662,27398,2676,3,Business,18,1,41213,18,1,41252,18,1,42590,18,1,42841,18,1,44187,9,27.1,-1.2612974,36.7993448,-1.2963097,36.7688221,279,1346,39,1589
2663,24156,2258,3,Business,23,5,33244,23,5,39248,23,5,39632,23,5,39776,23,5,43027,7,24.1,-1.2551895,36.7822034,-1.2897399,36.8270975,477,3251,6004,528
2664,26524,868,3,Business,2,2,58512,2,2,58684,2,2,59169,2,2,60896,2,2,62713,6,28.3,-1.307143,36.825009,-1.265715,36.823815,519,1817,172,2212
2665,16194,635,3,Business,20,3,57984,20,3,58006,20,3,58258,20,3,59169,20,3,60476,8,29.4,-1.2599563,36.7993439,-1.3123271,36.8147383,76,1307,22,1163
2666,11681,1271,3,Business,28,3,55110,28,3,55596,28,3,56280,28,3,58319,28,3,58803,9,23.25888921888938,-1.3244885,36.897792,-1.3206958,36.8769553,532,484,486,2723
2667,16400,3599,3,Business,27,1,47247,27,1,48332,27,1,51398,27,1,52508,27,1,53987,12,22.9,-1.3302996,36.8707935,-1.2922992,36.7983035,675,1479,1085,4176
2668,12483,1329,3,Business,13,1,42053,13,1,42098,13,1,42331,13,1,42611,13,1,43271,3,23.25888921888938,-1.273056,36.811298,-1.2546732,36.8086796,96,660,45,513
2669,18238,2200,3,Business,4,4,51095,4,4,51478,4,4,52357,4,4,52944,4,4,54536,9,24.6,-1.2859912,36.8756811,-1.290894,36.822971,622,1592,383,1466
2670,16811,393,3,Business,13,3,51945,13,3,51974,13,3,52361,13,3,52935,13,3,54145,4,29.1,-1.3167113,36.8301563,-1.3004062,36.829741,145,1210,29,961
2671,8415,2150,3,Business,7,5,40171,7,5,43148,7,5,43357,7,5,44443,7,5,45180,7,23.25888921888938,-1.3188359,36.7038526,-1.344446,36.756597,628,737,2977,1295
2672,1981,1991,3,Personal,9,2,49367,9,2,49380,9,2,49715,9,2,50149,9,2,52233,15,30.4,-1.2963097,36.7688221,-1.32189,36.8589727,168,2084,13,769
2673,9944,1280,3,Business,24,2,35616,24,2,35667,24,2,36000,24,2,36346,24,2,36839,3,14.4,-1.2551895,36.7822034,-1.2653589,36.8090021,726,493,51,679
2674,3753,1500,3,Business,8,3,28888,8,3,28975,8,3,29658,8,3,31047,8,3,32676,11,23.25888921888938,-1.3077869,36.8443207,-1.2638185,36.7930057,956,1629,87,2072
2675,10657,2174,3,Business,21,2,45349,21,2,45376,21,2,45384,21,2,49028,21,2,49874,23,24.9,-1.2482781,36.884092,-1.2759525,36.7082022,86,846,27,3652
2676,1881,3291,3,Business,25,1,43811,25,1,43853,25,1,44418,25,1,45550,25,1,46169,4,27.1,-1.265715,36.823815,-1.2600926,36.8088685,377,619,42,1697
2677,3199,1473,3,Business,4,1,46312,4,1,46368,4,1,47699,4,1,48183,4,1,51371,18,26.6,-1.2825783,36.8171621,-1.3700383,36.9190174,404,3188,56,1815
2678,6476,3300,3,Business,25,6,48140,25,6,48168,25,6,48184,25,6,48842,25,6,49874,9,23.25888921888938,-1.307143,36.825009,-1.303596,36.778378,155,1032,28,674
2679,15135,1250,1,Personal,28,2,33984,28,2,34019,28,2,34348,28,2,35129,28,2,36021,7,16.0,-1.2675334,36.7658246,-1.303382,36.790658,105,892,35,1110
2680,25808,2330,3,Business,31,5,64796,31,5,64959,31,5,65327,31,5,65406,31,5,66587,8,23.5,-1.2536275,36.7987932,-1.2336843,36.8007259,139,1181,163,447
2681,26439,1471,3,Business,30,2,41193,30,2,41208,30,2,42567,30,2,42637,30,2,47208,27,23.25888921888938,-1.2551895,36.7822034,-1.3554977,36.9574664,198,4571,15,1429
2682,26767,246,3,Business,9,6,54760,9,6,54790,9,6,55342,9,6,55522,9,6,55972,2,19.0,-1.2601709,36.8002238,-1.2584143,36.8048002,37,450,30,732
2683,1030,3404,3,Business,18,2,31511,18,2,31644,18,2,32484,18,2,33229,18,2,34872,10,19.8,-1.279395,36.825364,-1.2404912,36.8847788,26,1643,133,1585
2684,2846,2157,1,Personal,14,6,55961,14,6,55974,14,6,56384,14,6,58106,14,6,59490,16,19.2,-1.291696,36.8627681,-1.214428,36.883258,629,1384,13,2132
2685,16005,3328,1,Personal,28,6,65156,28,6,65193,28,6,66202,28,6,66546,28,6,67764,10,22.9,-1.2905065,36.8569079,-1.2780823,36.7960191,343,1218,37,1353
2686,20265,868,3,Business,30,6,46387,30,6,46407,30,6,46635,30,6,46875,30,6,47937,7,26.7,-1.2628473,36.781805,-1.265715,36.823815,709,1062,20,468
2687,842,2066,3,Business,29,5,35592,29,5,35695,29,5,36452,29,5,36555,29,5,37976,6,23.25888921888938,-1.316961,36.820337,-1.2937028,36.7874493,752,1421,103,860
2688,6168,867,3,Business,26,6,33759,26,6,33934,26,6,34715,26,6,35148,26,6,36979,11,18.8,-1.2770708,36.8231093,-1.306378,36.7519845,208,1831,175,1214
2689,3616,3621,3,Business,9,2,28631,9,2,28656,9,2,29214,9,2,29725,9,2,30405,4,17.4,-1.2836583,36.7886014,-1.288167,36.8181484,355,680,25,1069
2690,5549,1642,3,Business,3,3,51236,3,3,51298,3,3,51860,3,3,52266,3,3,54551,17,28.0,-1.2726506,36.7960153,-1.2000415,36.7771159,691,2285,62,968
2691,27342,3781,3,Business,23,5,33476,23,5,33765,23,5,33989,23,5,35078,23,5,35855,7,20.1,-1.2419938,36.7683729,-1.26071,36.8206332,783,777,289,1313
2692,466,2931,3,Business,14,4,52811,14,4,53394,14,4,54070,14,4,54308,14,4,55703,9,28.0,-1.2452664,36.8028541,-1.2962832,36.7849683,210,1395,583,914
2693,22224,2271,3,Business,15,5,51415,15,5,51533,15,5,52524,15,5,52937,15,5,54550,14,27.8,-1.272828,36.816608,-1.293515,36.897607,439,1613,118,1404
2694,12515,224,3,Personal,9,4,53161,9,4,53270,9,4,53361,9,4,53913,9,4,54787,5,23.25888921888938,-1.2886923,36.8241519,-1.2991116,36.7960658,790,874,109,643
2695,1207,2174,3,Business,28,4,51093,28,4,51102,28,4,51111,28,4,52939,28,4,55735,23,30.2,-1.2482781,36.884092,-1.3446058,36.7605178,86,2796,9,1837
2696,13207,3034,3,Business,17,3,43734,17,3,46672,17,3,46726,17,3,47289,17,3,49632,5,25.6,-1.2671137,36.8102851,-1.2981625,36.8130142,578,2343,2938,617
2697,12886,3404,3,Business,8,2,48567,8,2,49993,8,2,50266,8,2,50435,8,2,51285,9,25.3,-1.279395,36.825364,-1.2413316,36.8785525,878,850,1426,442
2698,11171,1578,3,Business,9,1,42695,9,1,42707,9,1,43772,9,1,44176,9,1,44638,2,20.1,-1.279395,36.825364,-1.290894,36.822971,24,462,12,1469
2699,19470,2407,2,Personal,21,6,35292,21,6,35339,21,6,35610,21,6,35864,21,6,36512,4,13.9,-1.2678925,36.7629124,-1.2878784,36.7662334,379,648,47,525
2700,22499,3298,1,Personal,4,2,59492,4,2,60091,4,2,60783,4,2,62318,4,2,64014,6,21.0,-1.2865016,36.8186143,-1.3087478,36.8042656,268,1696,599,2227
2701,12315,3050,3,Business,3,3,60944,3,3,60998,3,3,61083,3,3,66603,3,3,68406,16,27.2,-1.2945074,36.8083195,-1.343062,36.709497,539,1803,54,5605
2702,17323,3560,3,Business,14,3,48573,14,3,48609,14,3,48823,14,3,50131,14,3,51263,1,25.5,-1.290894,36.822971,-1.279395,36.825364,88,1132,36,1522
2703,26746,2570,3,Personal,21,5,34079,21,5,34098,21,5,34707,21,5,35056,21,5,41129,18,19.6,-1.2305936,36.8754998,-1.3226302,36.8719901,89,6073,19,958
2704,19734,452,1,Personal,2,3,56227,2,3,59952,2,3,60097,2,3,61956,2,3,63861,7,18.1,-1.3251584,36.8199384,-1.2861765,36.8209086,236,1905,3725,2004
2705,18130,478,3,Business,1,5,30245,1,5,30327,1,5,31011,1,5,32177,1,5,32812,3,23.25888921888938,-1.2551895,36.7822034,-1.2686614,36.8031594,247,635,82,1850
2706,19455,2828,3,Business,4,2,45530,4,2,45563,4,2,46370,4,2,47381,4,2,48809,4,19.0,-1.272798,36.8124195,-1.2615888,36.7928732,447,1428,33,1818
2707,2740,2956,3,Business,31,3,46005,31,3,46012,31,3,46391,31,3,46993,31,3,46994,1,24.8,-1.2571472,36.7950633,-1.2584143,36.8048002,79,1,7,981
2708,27939,633,3,Business,19,6,34665,19,6,34683,19,6,35438,19,6,35949,19,6,35951,4,21.3,-1.3077869,36.8443207,-1.3004062,36.829741,523,2,18,1266
2709,10499,2789,3,Business,4,4,38035,4,4,38069,4,4,39456,4,4,42454,4,4,43586,6,25.7,-1.2902869,36.8085396,-1.304735,36.7846054,819,1132,34,4385
2710,14384,868,3,Business,14,5,53192,14,5,53753,14,5,54345,14,5,54776,14,5,55758,4,23.1,-1.259478,36.8017813,-1.2663631,36.8163329,245,982,561,1023
2711,15560,99,3,Business,10,5,33730,10,5,33760,10,5,34758,10,5,36494,10,5,39811,6,23.25888921888938,-1.3020514,36.7748298,-1.2934657,36.8212737,106,3317,30,2734
2712,15888,2982,3,Business,8,4,43727,8,4,43742,8,4,43874,8,4,45050,8,4,49871,23,26.2,-1.300921,36.828195,-1.1956524,36.9488069,519,4821,15,1308
2713,16165,1642,3,Business,7,4,40628,7,4,40989,7,4,42153,7,4,42594,7,4,43943,5,27.5,-1.2887076,36.8254658,-1.2726506,36.7960153,660,1349,361,1605
2714,1851,2900,3,Business,13,3,61947,13,3,61960,13,3,62507,13,3,66990,13,3,68056,8,26.1,-1.2963097,36.7688221,-1.26365,36.719989,71,1066,13,5030
2715,7204,733,3,Business,8,2,51022,8,2,51101,8,2,51570,8,2,52923,8,2,55485,22,25.2,-1.2878913,36.8089253,-1.403476,36.947887,703,2562,79,1822
2716,11357,909,3,Business,13,4,52867,13,4,54396,13,4,55017,13,4,55256,13,4,57123,13,22.2,-1.225322,36.80855,-1.1668055,36.8304448,762,1867,1529,860
2717,4304,2532,3,Business,31,3,40420,31,3,40478,31,3,41046,31,3,43132,31,3,45243,12,24.9,-1.2571472,36.7950633,-1.329568,36.8520825,56,2111,58,2654
2718,22338,1502,3,Business,3,4,47283,3,4,47332,3,4,48312,3,4,48494,3,4,49776,17,21.9,-1.2237773,36.8861711,-1.255956,36.789867,742,1282,49,1162
2719,4752,3450,3,Business,14,5,31218,14,5,38273,14,5,39100,14,5,39922,14,5,44039,24,21.4,-1.2551895,36.7822034,-1.4011846,36.7612329,937,4117,7055,1649
2720,12157,1482,3,Business,15,4,35335,15,4,35558,15,4,36473,15,4,39840,15,4,40514,8,24.3,-1.3214137,36.8569475,-1.338579,36.8963038,559,674,223,4282
2721,6659,1075,3,Business,1,5,32930,1,5,32965,1,5,33525,1,5,33616,1,5,34131,1,23.25888921888938,-1.2649605,36.7981777,-1.2527958,36.8003131,822,515,35,651
2722,8166,3331,3,Business,24,4,59772,24,4,59789,24,4,60457,24,4,61131,24,4,63497,28,26.1,-1.2551895,36.7822034,-1.162368,36.9107603,531,2366,17,1342
2723,13755,478,3,Business,13,2,39028,13,2,40269,13,2,42449,13,2,42749,13,2,43863,9,22.5,-1.2913246,36.8019522,-1.2571472,36.7950633,578,1114,1241,2480
2724,4145,1336,3,Business,25,4,52944,25,4,53090,25,4,54166,25,4,57526,25,4,57753,9,23.25888921888938,-1.2859912,36.8756811,-1.290894,36.822971,507,227,146,4436
2725,21899,478,3,Business,2,4,43333,2,4,43390,2,4,43806,2,4,44040,2,4,45458,9,22.6,-1.2551895,36.7822034,-1.2985032,36.7808727,452,1418,57,650
2726,18315,731,3,Business,28,5,45736,28,5,45779,28,5,46177,28,5,46787,28,5,47944,7,25.1,-1.2574088,36.799712,-1.2878081,36.8200516,844,1157,43,1008
2727,26990,3266,3,Business,20,1,31645,20,1,32020,20,1,32653,20,1,32734,20,1,34078,18,14.0,-1.3339943,36.7263409,-1.321181,36.83695,249,1344,375,714
2728,12338,3333,1,Personal,30,1,40336,30,1,40358,30,1,40931,30,1,41348,30,1,42550,9,22.6,-1.2951189,36.7699791,-1.2536042,36.8064895,350,1202,22,990
2729,6707,3686,3,Business,19,3,49344,19,3,49382,19,3,50001,19,3,50108,19,3,51295,9,24.5,-1.2551895,36.7822034,-1.2315181,36.8140543,913,1187,38,726
2730,86,1721,3,Business,30,2,47444,30,2,47605,30,2,47892,30,2,49363,30,2,50051,6,23.25888921888938,-1.2551895,36.7822034,-1.2743751,36.8205442,291,688,161,1758
2731,17720,1544,3,Business,11,6,35898,11,6,36004,11,6,37426,11,6,37571,11,6,39478,10,23.25888921888938,-1.2813012,36.8323962,-1.234228,36.881123,448,1907,106,1567
2732,23603,2804,3,Business,25,4,40968,25,4,41005,25,4,41162,25,4,41874,25,4,45863,29,20.0,-1.2551895,36.7822034,-1.1270934,36.648316,536,3989,37,869
2733,8322,2587,3,Business,3,5,53666,3,5,53993,3,5,55177,3,5,56246,3,5,56575,5,23.25888921888938,-1.2584143,36.8048002,-1.28878,36.8168312,790,329,327,2253
2734,4212,867,3,Business,15,2,33636,15,2,33719,15,2,34445,15,2,37149,15,2,39181,10,20.5,-1.2996533,36.8292629,-1.2991441,36.7528804,725,2032,83,3430
2735,2220,868,3,Business,24,1,36974,24,1,36993,24,1,37249,24,1,37936,24,1,38593,4,22.5,-1.2600926,36.8088685,-1.265715,36.823815,453,657,19,943
2736,22112,3127,3,Business,24,4,55172,24,4,55201,24,4,57104,24,4,57463,24,4,57934,3,28.1,-1.2918246,36.801585,-1.302559,36.819555,655,471,29,2262
2737,3663,3565,3,Business,14,1,41879,14,1,42985,14,1,43252,14,1,43938,14,1,45045,7,22.8,-1.2844665,36.7866113,-1.2839026,36.8215225,555,1107,1106,953
2738,9847,357,3,Business,27,2,42293,27,2,43850,27,2,46215,27,2,46641,27,2,47364,7,23.8,-1.280387,36.802981,-1.2945179,36.7685349,72,723,1557,2791
2739,20916,3647,3,Business,5,2,52001,5,2,52029,5,2,53729,5,2,54062,5,2,58948,16,27.3,-1.272639,36.794723,-1.3500286,36.7314905,279,4886,28,2033
2740,22634,1195,3,Business,27,2,42271,27,2,42297,27,2,43063,27,2,43565,27,2,45022,15,23.8,-1.2991441,36.7528804,-1.3177547,36.8303703,240,1457,26,1268
2741,13139,393,3,Business,2,2,31412,2,2,31563,2,2,32046,2,2,32369,2,2,33256,4,20.6,-1.3167113,36.8301563,-1.3004062,36.829741,397,887,151,806
2742,17912,2789,3,Business,21,5,38652,21,5,39687,21,5,40159,21,5,40294,21,5,41558,10,22.8,-1.304735,36.7846054,-1.2642903,36.8002137,594,1264,1035,607
2743,523,2596,3,Business,15,5,49438,15,5,49492,15,5,50257,15,5,50809,15,5,53652,18,28.2,-1.2963097,36.7688221,-1.3343129,36.8854175,831,2843,54,1317
2744,1320,2982,3,Business,2,3,44762,2,3,44779,2,3,45584,2,3,47158,2,3,49274,18,24.0,-1.300921,36.828195,-1.177202,36.8351183,457,2116,17,2379
2745,8,3661,3,Business,15,1,47506,15,1,47742,15,1,48622,15,1,49146,15,1,51105,17,23.25888921888938,-1.2132866,36.8678274,-1.2987332,36.8463349,8,1959,236,1404
2746,10607,1244,3,Business,19,2,56724,19,2,56946,19,2,57799,19,2,58804,19,2,60788,16,29.5,-1.228911,36.881876,-1.303596,36.778378,75,1984,222,1858
2747,9897,2111,2,Personal,30,3,31957,30,3,32126,30,3,32136,30,3,34842,30,3,36411,18,17.6,-1.1943194,36.8270384,-1.2807232,36.7677141,633,1569,169,2716
2748,366,1749,3,Personal,27,3,52741,27,3,52804,27,3,53850,27,3,53937,27,3,55188,4,29.2,-1.2785858,36.8289683,-1.2621576,36.8103473,61,1251,63,1133
2749,25613,2987,3,Business,18,2,45442,18,2,45453,18,2,45458,18,2,46612,18,2,47333,7,22.5,-1.270212,36.8210877,-1.3043821,36.7840586,886,721,11,1159
2750,16296,391,3,Business,25,4,38734,25,4,41773,25,4,42883,25,4,43659,25,4,44684,5,20.0,-1.3016417,36.8271679,-1.2867454,36.8259017,477,1025,3039,1886
2751,25730,661,3,Business,29,2,53426,29,2,54099,29,2,55020,29,2,56355,29,2,57529,4,23.6,-1.2950044,36.7512209,-1.2963097,36.7688221,312,1174,673,2256
2752,301,2304,1,Personal,14,5,50065,14,5,50095,14,5,51460,14,5,51750,14,5,53575,12,27.3,-1.2963097,36.7688221,-1.3549418,36.7280528,312,1825,30,1655
2753,21963,1809,3,Business,22,5,45438,22,5,46690,22,5,48173,22,5,49712,22,5,50984,15,30.9,-1.2285835,36.8826468,-1.2571472,36.7950633,75,1272,1252,3022
2754,27308,540,3,Business,15,1,51512,15,1,58507,15,1,59142,15,1,59254,15,1,60313,7,23.25888921888938,-1.2551895,36.7822034,-1.2814031,36.8201647,208,1059,6995,747
2755,11345,1748,2,Personal,19,4,68068,19,4,68091,19,4,68214,19,4,68705,19,4,69870,10,19.7,-1.2952109,36.7757064,-1.2527958,36.8003131,74,1165,23,614
2756,5708,2521,3,Business,25,5,54137,25,5,54157,25,5,54161,25,5,54970,25,5,55433,4,29.1,-1.3167113,36.8301563,-1.3004062,36.829741,523,463,20,813
2757,14759,3291,3,Business,26,5,32848,26,5,32892,26,5,32949,26,5,34627,26,5,35610,12,23.25888921888938,-1.331619,36.847976,-1.2600926,36.8088685,402,983,44,1735
2758,22648,2698,1,Personal,26,4,48714,26,4,48725,26,4,49705,26,4,50777,26,4,51494,3,22.2,-1.299846,36.7940155,-1.292278,36.797718,144,717,11,2052
2759,23743,1502,3,Business,23,2,42845,23,2,42923,23,2,44200,23,2,44966,23,2,46150,11,23.25888921888938,-1.2765736,36.8513646,-1.2232123,36.8932547,686,1184,78,2043
2760,16838,2456,3,Business,4,1,34404,4,1,34482,4,1,36368,4,1,37280,4,1,39119,13,22.1,-1.2679514,36.8095213,-1.3189252,36.8617269,275,1839,78,2798
2761,12555,3291,3,Business,20,1,36020,20,1,36034,20,1,36500,20,1,37449,20,1,39237,13,14.2,-1.3313643,36.8577422,-1.2600926,36.8088685,213,1788,14,1415
2762,21819,3488,2,Personal,29,6,44245,29,6,44268,29,6,45039,29,6,45467,29,6,46883,8,25.1,-1.3002897,36.7601637,-1.268478,36.8008142,465,1416,23,1199
2763,13680,2102,3,Business,30,3,50515,30,3,50536,30,3,51424,30,3,51761,30,3,53932,15,29.0,-1.3323107,36.8692616,-1.2613768,36.8019418,456,2171,21,1225
2764,1572,3599,3,Business,21,4,34124,21,4,34238,21,4,36563,21,4,37596,21,4,40341,12,21.7,-1.3302996,36.8707935,-1.2618632,36.8100226,126,2745,114,3358
2765,23921,3621,3,Business,26,5,55377,26,5,55402,26,5,55824,26,5,55939,26,5,56972,4,23.25888921888938,-1.2836583,36.7886014,-1.2825816,36.8092346,923,1033,25,537
2766,12533,1889,1,Personal,13,4,34893,13,4,34913,13,4,36003,13,4,36615,13,4,37970,10,18.6,-1.2946769,36.7501951,-1.2590031,36.8078168,336,1355,20,1702
2767,648,3283,3,Business,2,2,33254,2,2,33602,2,2,34374,2,2,35215,2,2,35995,6,20.7,-1.272828,36.816608,-1.2628473,36.781805,427,780,348,1613
2768,24194,1715,3,Business,29,2,31995,29,2,32008,29,2,32987,29,2,33500,29,2,35420,6,16.7,-1.253966,36.7987692,-1.28503,36.821897,808,1920,13,1492
2769,14773,1500,3,Business,15,5,35401,15,5,35449,15,5,35876,15,5,36543,15,5,37832,8,20.3,-1.3004062,36.829741,-1.2638185,36.7930057,25,1289,48,1094
2770,12011,391,3,Business,14,4,34433,14,4,34503,14,4,35257,14,4,35920,14,4,37165,16,19.0,-1.2784063,36.8222933,-1.2026875,36.9129107,61,1245,70,1417
2771,16942,728,2,Personal,20,1,48517,20,1,48602,20,1,49123,20,1,49592,20,1,50113,4,21.5,-1.2854453,36.8188363,-1.2884634,36.8128356,88,521,85,990
2772,6890,130,3,Personal,8,1,56266,8,1,56344,8,1,57112,8,1,57522,8,1,58697,6,29.6,-1.257569,36.842164,-1.2761337,36.8011565,343,1175,78,1178
2773,12034,2844,3,Personal,16,1,51671,16,1,52880,16,1,52980,16,1,53959,16,1,55152,6,22.5,-1.283362,36.8260149,-1.312469,36.815177,672,1193,1209,1079
2774,9014,173,3,Business,14,5,61924,14,5,61934,14,5,62441,14,5,62757,14,5,64984,11,22.9,-1.3207146,36.8305771,-1.2993231,36.7753372,712,2227,10,823
2775,112,391,3,Business,20,1,50298,20,1,50537,20,1,51312,20,1,52896,20,1,56339,5,23.25888921888938,-1.300921,36.828195,-1.2784063,36.8222933,139,3443,239,2359
2776,6081,2285,3,Personal,22,3,33456,22,3,34681,22,3,35603,22,3,36403,22,3,38567,15,18.7,-1.3365372,36.7281264,-1.2950041,36.8143583,815,2164,1225,1722
2777,26842,2718,3,Business,13,2,53507,13,2,53514,13,2,54362,13,2,54597,13,2,55305,3,26.0,-1.2668815,36.8017244,-1.2768326,36.8073804,727,708,7,1083
2778,18570,3291,3,Business,23,6,55292,23,6,55371,23,6,56756,23,6,56838,23,6,58010,5,28.5,-1.2628473,36.781805,-1.2600926,36.8088685,605,1172,79,1467
2779,4595,635,3,Business,12,2,36212,12,2,36341,12,2,36860,12,2,38711,12,2,38714,5,28.2,-1.2857764,36.8236622,-1.2602337,36.7990548,119,3,129,2370
2780,1942,2330,3,Business,11,5,46976,11,5,47043,11,5,48092,11,5,48526,11,5,50133,12,20.9,-1.2642903,36.8002137,-1.2524916,36.8656196,416,1607,67,1483
2781,12575,2457,3,Business,19,4,55346,19,4,55355,19,4,55418,19,4,55776,19,4,56495,4,20.5,-1.2551895,36.7822034,-1.269534,36.80697,726,719,9,421
2782,7595,3668,1,Personal,20,5,35877,20,5,35902,20,5,36387,20,5,36641,20,5,38481,8,14.4,-1.3031971,36.7863146,-1.255956,36.772901,142,1840,25,739
2783,12065,914,3,Business,19,2,56716,19,2,57099,19,2,57983,19,2,58351,19,2,60245,11,29.3,-1.2670213,36.7994482,-1.3083777,36.8590077,708,1894,383,1252
2784,2906,2396,1,Personal,2,2,46780,2,2,46854,2,2,48147,2,2,48948,2,2,50045,3,26.2,-1.2896399,36.8124498,-1.2849951,36.8241746,328,1097,74,2094
2785,17121,1578,3,Business,7,3,44748,7,3,45176,7,3,46512,7,3,46580,7,3,49284,5,25.3,-1.2571472,36.7950633,-1.28878,36.8168312,266,2704,428,1404
2786,13455,2066,3,Business,6,5,48827,6,5,48923,6,5,49207,6,5,49495,6,5,50279,5,22.5,-1.316961,36.820337,-1.2896399,36.8124498,535,784,96,572
2787,10148,2154,3,Business,23,2,38293,23,2,38397,23,2,39425,23,2,39555,23,2,40862,8,23.25888921888938,-1.2765736,36.8513646,-1.2585521,36.7945765,281,1307,104,1158
2788,3699,1304,3,Business,13,2,34297,13,2,34378,13,2,34828,13,2,35023,13,2,37536,18,19.8,-1.3226302,36.8719901,-1.2343236,36.8861,63,2513,81,645
2789,25040,3560,3,Business,11,1,46304,11,1,47777,11,1,48688,11,1,49841,11,1,53681,12,29.0,-1.2860183,36.8975338,-1.279395,36.825364,99,3840,1473,2064
2790,13362,3599,3,Business,21,2,44117,21,2,44252,21,2,45586,21,2,45733,21,2,48625,14,22.4,-1.3302996,36.8707935,-1.2568865,36.7945489,321,2892,135,1481
2791,19856,111,3,Business,16,3,53896,16,3,53977,16,3,54437,16,3,54668,16,3,55950,11,26.8,-1.2551895,36.7822034,-1.3100586,36.8500329,553,1282,81,691
2792,27821,3517,3,Business,11,4,53834,11,4,53934,11,4,54319,11,4,55190,11,4,58826,15,27.0,-1.300921,36.828195,-1.3882008,36.7699445,728,3636,100,1256
2793,26675,867,3,Business,7,3,36622,7,3,38020,7,3,39606,7,3,39868,7,3,42826,10,24.9,-1.2996533,36.8292629,-1.306378,36.7519845,948,2958,1398,1848
2794,11608,3091,3,Business,29,4,53842,29,4,62019,29,4,62307,29,4,62965,29,4,64356,9,20.9,-1.290894,36.822971,-1.3012008,36.764868,124,1391,8177,946
2795,12630,3002,1,Personal,16,4,35116,16,4,35172,16,4,36166,16,4,36248,16,4,37541,9,15.7,-1.2528485,36.7953722,-1.2248308,36.8012573,726,1293,56,1076
2796,19685,193,2,Personal,25,6,64178,25,6,64192,25,6,64836,25,6,65015,25,6,66816,16,23.25888921888938,-1.276245,36.8363293,-1.2672045,36.7172069,622,1801,14,823
2797,18170,203,3,Business,30,3,35849,30,3,35940,30,3,37585,30,3,38154,30,3,39450,3,25.1,-1.2851882,36.7557956,-1.2963097,36.7688221,774,1296,91,2214
2798,12867,2216,3,Business,12,2,53553,12,2,55355,12,2,56282,12,2,56448,12,2,57493,7,23.2,-1.2551895,36.7822034,-1.2945159,36.7870611,726,1045,1802,1093
2799,26013,1389,3,Business,10,5,61129,10,5,61247,10,5,61916,10,5,62575,10,5,64348,14,23.25888921888938,-1.2584143,36.8048002,-1.207546,36.7913976,96,1773,118,1328
2800,22133,2330,3,Business,5,2,45835,5,2,47681,5,2,48443,5,2,48869,5,2,50854,11,27.4,-1.2284323,36.8757058,-1.293082,36.8278578,622,1985,1846,1188
2801,6059,1205,3,Business,5,3,45593,5,3,45601,5,3,46211,5,3,47101,5,3,49637,21,22.3,-1.2810807,36.8144229,-1.3802928,36.9364493,105,2536,8,1500
2802,18761,3201,3,Business,8,5,41637,8,5,41730,8,5,42465,8,5,42645,8,5,43817,10,28.3,-1.2584143,36.8048002,-1.2413316,36.8785525,52,1172,93,915
2803,14239,3274,1,Personal,6,5,43696,6,5,43720,6,5,43745,6,5,45060,6,5,45681,4,20.2,-1.2682179,36.8009289,-1.2738348,36.7852209,813,621,24,1340
2804,9624,2903,2,Personal,17,3,45329,17,3,46846,17,3,47324,17,3,47497,17,3,49620,8,25.4,-1.2456412,36.7955298,-1.3015998,36.8166465,726,2123,1517,651
2805,4639,2407,2,Personal,10,3,61300,10,3,62101,10,3,62300,10,3,63341,10,3,64495,5,22.9,-1.3014461,36.7661381,-1.2901382,36.784678,578,1154,801,1240
2806,16969,20,3,Business,7,2,35508,7,2,35536,7,2,36268,7,2,36442,7,2,38411,7,23.25888921888938,-1.2763494,36.7671783,-1.2629666,36.8068369,502,1969,28,906
2807,23694,3517,3,Business,8,1,39126,8,1,41010,8,1,42200,8,1,42544,8,1,44018,16,28.0,-1.3882008,36.7699445,-1.300921,36.828195,506,1474,1884,1534
2808,24665,928,3,Business,17,5,48517,17,5,48705,17,5,49565,17,5,50650,17,5,51855,6,23.25888921888938,-1.2551895,36.7822034,-1.2897368,36.8226783,855,1205,188,1945
2809,329,2586,1,Personal,3,5,52013,3,5,52138,3,5,52961,3,5,53345,3,5,56949,10,25.3,-1.2809423,36.7540036,-1.3246123,36.7902267,726,3604,125,1207
2810,24739,2271,3,Business,7,5,57795,7,5,58170,7,5,58966,7,5,59224,7,5,63119,17,23.25888921888938,-1.303596,36.778378,-1.293515,36.897607,709,3895,375,1054
2811,24796,2344,3,Business,1,5,57294,1,5,63761,1,5,65484,1,5,65720,1,5,67624,13,30.2,-1.2825422,36.73247,-1.3131471,36.8176568,238,1904,6467,1959
2812,8938,1336,3,Business,3,5,39083,3,5,39116,3,5,40285,3,5,40980,3,5,41882,3,21.5,-1.2765736,36.8513646,-1.2891922,36.825189,174,902,33,1864
2813,1653,3621,3,Business,19,2,39456,19,2,39505,19,2,40269,19,2,40639,19,2,42146,5,27.7,-1.2836583,36.7886014,-1.2949722,36.7524325,216,1507,49,1134
2814,28175,839,1,Personal,22,3,36512,22,3,36527,22,3,36960,22,3,37098,22,3,38496,6,15.1,-1.2682179,36.8009289,-1.3038156,36.8122733,754,1398,15,571
2815,13001,1271,3,Business,14,4,62909,14,4,63038,14,4,64377,14,4,64570,14,4,65766,11,21.3,-1.3244885,36.897792,-1.326825,36.864345,549,1196,129,1532
2816,2203,2523,3,Business,26,4,55364,26,4,55428,26,4,55978,26,4,56801,26,4,56886,3,22.1,-1.2551895,36.7822034,-1.2570047,36.7836756,116,85,64,1373
2817,2490,2803,3,Business,13,3,49517,13,3,50992,13,3,52205,13,3,52577,13,3,54080,5,27.2,-1.279395,36.825364,-1.2765736,36.8513646,660,1503,1475,1585
2818,23920,238,3,Business,18,1,44322,18,1,44366,18,1,44939,18,1,45137,18,1,46302,8,26.9,-1.3077869,36.8443207,-1.2908798,36.8033158,708,1165,44,771
2819,179,3201,3,Business,19,1,55863,19,1,55887,19,1,56255,19,1,56458,19,1,57117,3,25.0,-1.2584143,36.8048002,-1.2551895,36.7822034,167,659,24,571
2820,27844,3291,3,Business,28,2,49821,28,2,49846,28,2,50474,28,2,50613,28,2,51234,2,23.7,-1.266837,36.799249,-1.2600926,36.8088685,829,621,25,767
2821,25329,1500,3,Business,20,3,50026,20,3,50039,20,3,50042,20,3,51156,20,3,51159,8,28.6,-1.3004062,36.829741,-1.2638185,36.7930057,10,3,13,1117
2822,8154,3157,3,Personal,7,1,36358,7,1,36402,7,1,37113,7,1,37724,7,1,39213,4,18.2,-1.300722,36.816865,-1.2794007,36.8202274,886,1489,44,1322
2823,16051,1719,3,Business,20,2,39463,20,2,39534,20,2,40395,20,2,40662,20,2,43310,15,19.7,-1.3100609,36.8205365,-1.2330694,36.745451,65,2648,71,1128
2824,15607,1521,2,Personal,27,4,63640,27,4,64252,27,4,65420,27,4,66271,27,4,67970,5,23.1,-1.2850325,36.822932,-1.3007714,36.8001722,329,1699,612,2019
2825,12816,1329,3,Business,18,4,39736,18,4,39760,18,4,40091,18,4,40176,18,4,41277,7,23.25888921888938,-1.273056,36.811298,-1.2902439,36.7683384,96,1101,24,416
2826,7981,1578,3,Business,20,4,57243,20,4,58105,20,4,59217,20,4,60000,20,4,60963,2,22.8,-1.290894,36.822971,-1.28878,36.8168312,150,963,862,1895
2827,3009,867,3,Business,21,4,46552,21,4,47613,21,4,48745,21,4,49632,21,4,51764,15,26.3,-1.2991441,36.7528804,-1.3228003,36.8306435,328,2132,1061,2019
2828,17981,914,3,Business,25,1,44385,25,1,44429,25,1,45075,25,1,45297,25,1,47273,7,27.1,-1.2670213,36.7994482,-1.2979313,36.809542,709,1976,44,868
2829,5861,2801,3,Business,10,5,30655,10,5,30781,10,5,30794,10,5,31324,10,5,32247,8,23.25888921888938,-1.289081,36.8300409,-1.2674274,36.7870827,531,923,126,543
2830,14083,2763,3,Business,22,1,53277,22,1,54395,22,1,54791,22,1,55020,22,1,56078,6,26.1,-1.2849882,36.823155,-1.2571472,36.7950633,662,1058,1118,625
2831,15844,3752,3,Business,13,1,56935,13,1,57047,13,1,57913,13,1,58009,13,1,63800,4,23.25888921888938,-1.335316,36.8845063,-1.3263105,36.8622904,56,5791,112,962
2832,26346,3599,3,Business,29,5,35986,29,5,36896,29,5,39028,29,5,40175,29,5,41909,13,26.7,-1.3302996,36.8707935,-1.26348,36.800986,61,1734,910,3279
2833,19464,391,3,Business,7,2,43295,7,2,43350,7,2,45479,7,2,45678,7,2,47088,10,23.25888921888938,-1.2867454,36.8259017,-1.2224188,36.8868824,959,1410,55,2328
2834,12147,1484,3,Business,17,4,40602,17,4,40638,17,4,41203,17,4,41519,17,4,42282,1,25.6,-1.264272,36.7978791,-1.2571472,36.7950633,428,763,36,881
2835,9798,49,3,Business,11,1,41379,11,1,41651,11,1,42006,11,1,42503,11,1,42927,3,23.9,-1.278957,36.8290484,-1.2651643,36.8072214,289,424,272,852
2836,24583,2102,3,Business,26,2,32495,26,2,32514,26,2,35777,26,2,36281,26,2,38006,15,23.25888921888938,-1.3323107,36.8692616,-1.2613768,36.8019418,430,1725,19,3767
2837,16852,635,3,Business,19,2,34289,19,2,34970,19,2,35184,19,2,35570,19,2,37651,7,15.6,-1.2599563,36.7993439,-1.3016417,36.8271679,932,2081,681,600
2838,703,2982,3,Business,1,4,36829,1,4,36841,1,4,37873,1,4,38501,1,4,42522,18,23.25888921888938,-1.300921,36.828195,-1.177202,36.8351183,593,4021,12,1660
2839,13562,873,3,Personal,3,1,44300,3,1,44371,3,1,45002,3,1,45143,3,1,46391,4,20.4,-1.2890374,36.8165815,-1.3075266,36.8292369,857,1248,71,772
2840,27126,517,3,Business,3,1,39407,3,1,40808,3,1,41771,3,1,42231,3,1,44105,10,22.3,-1.3177547,36.8303703,-1.2574219,36.7927073,523,1874,1401,1423
2841,25856,2100,3,Business,30,4,49940,30,4,50157,30,4,51347,30,4,51452,30,4,53996,23,21.0,-1.2765736,36.8513646,-1.3169591,36.7000029,400,2544,217,1295
2842,24080,2112,3,Business,3,5,41800,3,5,42291,3,5,44061,3,5,44382,3,5,48759,12,23.25888921888938,-1.290894,36.822971,-1.2156006,36.8916865,778,4377,491,2091
2843,8179,246,3,Business,29,1,32595,29,1,32606,29,1,32651,29,1,32990,29,1,34492,13,19.1,-1.2584143,36.8048002,-1.2811642,36.88075,630,1502,11,384
2844,15674,2330,3,Business,8,5,47775,8,5,48986,8,5,50860,8,5,52483,8,5,54707,8,27.3,-1.293082,36.8278578,-1.3015197,36.7658456,206,2224,1211,3497
2845,19718,248,3,Business,27,2,26468,27,2,26479,27,2,27997,27,2,28106,27,2,29569,10,18.9,-1.304735,36.7846054,-1.254191,36.8099132,612,1463,11,1627
2846,18998,478,3,Business,21,2,49738,21,2,49816,21,2,50088,21,2,50598,21,2,52515,6,25.0,-1.2571472,36.7950633,-1.2950041,36.8143583,386,1917,78,782
2847,8148,1363,3,Business,17,1,34225,17,1,34235,17,1,34240,17,1,34600,17,1,35812,10,19.2,-1.3004062,36.829741,-1.2991441,36.7528804,871,1212,10,365
2848,14409,2330,3,Business,13,3,65049,13,3,65132,13,3,65223,13,3,65897,13,3,67151,9,27.4,-1.2649605,36.7981777,-1.2124582,36.802894,52,1254,83,765
2849,25621,183,1,Personal,11,5,49434,11,5,49490,11,5,49672,11,5,50399,11,5,50955,3,22.7,-1.2783619,36.8183313,-1.293973,36.80169,865,556,56,909
2850,7753,3661,3,Business,12,1,34820,12,1,35015,12,1,35939,12,1,36101,12,1,38171,17,19.6,-1.2134646,36.8755266,-1.2987332,36.8463349,726,2070,195,1086
2851,12424,1502,3,Business,17,5,53175,17,5,53188,17,5,53400,17,5,53589,17,5,54621,6,23.25888921888938,-1.2232123,36.8932547,-1.2404912,36.8847788,7,1032,13,401
2852,17763,1724,3,Business,2,4,61703,2,4,62624,2,4,63890,2,4,65036,2,4,69762,11,23.7,-1.2610117,36.7236153,-1.2941648,36.7977315,279,4726,921,2412
2853,17295,928,3,Business,9,5,54387,9,5,55306,9,5,55430,9,5,56309,9,5,58385,4,26.2,-1.2551895,36.7822034,-1.2693662,36.8085295,668,2076,919,1003
2854,12710,47,1,Personal,17,3,48361,17,3,48445,17,3,49346,17,3,49894,17,3,52279,9,28.6,-1.2758945,36.7648661,-1.2546418,36.7994074,299,2385,84,1449
2855,23031,1073,3,Business,18,2,65545,18,2,65597,18,2,65720,18,2,65884,18,2,66488,5,23.25888921888938,-1.259697,36.800664,-1.2568188,36.79082877,379,604,52,287
2856,25810,552,3,Business,23,3,42109,23,3,42133,23,3,42139,23,3,42409,23,3,43416,15,21.8,-1.3051608,36.8288914,-1.3562374,36.9042954,408,1007,24,276
2857,22458,1146,3,Business,6,3,35714,6,3,35812,6,3,36524,6,3,37742,6,3,38526,5,16.6,-1.3004062,36.829741,-1.3083266,36.8494756,581,784,98,1930
2858,7599,867,3,Business,15,1,36723,15,1,36740,15,1,36890,15,1,38098,15,1,38195,9,23.25888921888938,-1.2638185,36.7930057,-1.2991441,36.7528804,245,97,17,1358
2859,15423,3698,3,Business,21,2,57560,21,2,57632,21,2,58841,21,2,62178,21,2,62180,22,23.9,-1.3244885,36.897792,-1.3014461,36.7661381,856,2,72,4546
2860,7940,2801,3,Business,14,2,46667,14,2,47588,14,2,49185,14,2,50844,14,2,52861,29,24.2,-1.1538233,36.950874,-1.2595422,36.7871178,522,2017,921,3256
2861,22895,2801,3,Business,30,4,52588,30,4,52622,30,4,53333,30,4,53459,30,4,54608,10,23.25888921888938,-1.2674274,36.7870827,-1.301005,36.8306195,205,1149,34,837
2862,7803,1754,3,Business,12,7,39313,12,7,39322,12,7,41526,12,7,42153,12,7,44551,29,19.6,-1.3169591,36.7000029,-1.2860183,36.8975338,478,2398,9,2831
2863,11031,3040,1,Personal,20,4,51679,20,4,51695,20,4,52410,20,4,53023,20,4,55302,9,27.9,-1.2248308,36.8012573,-1.2647535,36.8156064,770,2279,16,1328
2864,6455,635,3,Business,7,2,50050,7,2,50108,7,2,50111,7,2,52092,7,2,52169,8,23.25888921888938,-1.3081376,36.8329772,-1.2602337,36.7990548,41,77,58,1984
2865,12833,2968,1,Business,3,2,62295,3,2,62402,3,2,64128,3,2,64194,3,2,65647,2,18.7,-1.28283,36.8199739,-1.285442,36.8312707,88,1453,107,1792
2866,15924,1498,1,Business,24,4,44709,24,4,44741,24,4,45155,24,4,45913,24,4,47006,11,21.1,-1.2753109,36.8130185,-1.3332749,36.8708147,360,1093,32,1172
2867,23910,1121,2,Personal,16,6,44837,16,6,44854,16,6,45924,16,6,46785,16,6,51619,28,19.2,-1.3103229,36.8966208,-1.1656054,36.9925632,543,4834,17,1931
2868,2693,1927,3,Business,18,1,38395,18,1,38421,18,1,38938,18,1,39125,18,1,40504,10,28.2,-1.3165542,36.700067,-1.3472066,36.7692638,326,1379,26,704
2869,8540,2066,3,Business,4,1,52785,4,1,52802,4,1,53801,4,1,54069,4,1,55739,11,22.8,-1.316961,36.820337,-1.2529484,36.8651347,224,1670,17,1267
2870,16879,2803,3,Business,14,4,32953,14,4,33630,14,4,34333,14,4,34393,14,4,35923,9,17.7,-1.2765736,36.8513646,-1.2868018,36.8906063,590,1530,677,763
2871,12036,2763,3,Business,5,1,44814,5,1,44835,5,1,45407,5,1,45751,5,1,46281,4,24.3,-1.2551895,36.7822034,-1.2717851,36.8105363,822,530,21,916
2872,19904,3291,3,Business,29,2,40040,29,2,40071,29,2,40116,29,2,40639,29,2,41146,4,23.5,-1.265715,36.823815,-1.2600926,36.8088685,906,507,31,568
2873,19592,868,3,Business,14,6,34207,14,6,35312,14,6,36477,14,6,37016,14,6,37888,8,15.0,-1.303596,36.778378,-1.265715,36.823815,752,872,1105,1704
2874,15373,982,3,Business,15,5,43730,15,5,43740,15,5,43840,15,5,44992,15,5,47454,22,25.8,-1.3079421,36.8390989,-1.2517871,36.6795716,595,2462,10,1252
2875,9965,2627,3,Business,9,4,51147,9,4,51615,9,4,52202,9,4,52701,9,4,53930,7,23.25888921888938,-1.2571472,36.7950633,-1.304344,36.812274,538,1229,468,1086
2876,805,948,3,Business,11,2,54412,11,2,54597,11,2,55351,11,2,55779,11,2,56315,2,21.2,-1.2696908,36.81519,-1.2594474,36.8089122,575,536,185,1182
2877,14434,393,3,Business,27,3,44230,27,3,44263,27,3,44270,27,3,44775,27,3,46256,11,25.9,-1.3167113,36.8301563,-1.2638185,36.7930057,901,1481,33,512
2878,3759,1304,3,Business,5,3,42880,5,3,42927,5,3,43236,5,3,43705,5,3,44853,10,22.0,-1.2551895,36.7822034,-1.3126476,36.831455,116,1148,47,778
2879,1667,302,3,Business,27,4,64135,27,4,64140,27,4,64403,27,4,64840,27,4,66152,2,22.8,-1.2649605,36.7981777,-1.2544458,36.7897277,275,1312,5,700
2880,25446,2956,3,Business,14,1,45836,14,1,47033,14,1,47039,14,1,49510,14,1,52125,11,25.7,-1.2860183,36.8975338,-1.290894,36.822971,408,2615,1197,2477
2881,13332,136,3,Business,16,6,46258,16,6,46295,16,6,46743,16,6,46904,16,6,47354,3,25.9,-1.3254522,36.7216584,-1.3165104,36.7077726,831,450,37,609
2882,19135,3291,3,Business,30,3,32712,30,3,32736,30,3,33642,30,3,33831,30,3,34303,2,19.5,-1.2600926,36.8088685,-1.2686413,36.8126976,72,472,24,1095
2883,2405,2876,1,Personal,20,3,32615,20,3,32640,20,3,33225,20,3,33336,20,3,34771,6,16.6,-1.2684239,36.7952462,-1.2944292,36.7793569,808,1435,25,696
2884,24211,323,3,Business,28,4,56233,28,4,56247,28,4,56720,28,4,57961,28,4,59689,12,23.25888921888938,-1.3207146,36.8305771,-1.3632162,36.9108253,494,1728,14,1714
2885,27390,3647,3,Business,4,2,58295,4,2,58893,4,2,59109,4,2,59367,4,2,60106,5,22.5,-1.272639,36.794723,-1.2560455,36.7800867,655,739,598,474
2886,15074,1959,3,Business,25,1,49830,25,1,50412,25,1,51475,25,1,51550,25,1,52877,20,30.1,-1.2095151,36.916994,-1.2551895,36.7822034,206,1327,582,1138
2887,20591,3291,3,Business,4,6,40261,4,6,40280,4,6,40875,4,6,41232,4,6,42044,4,23.25888921888938,-1.265715,36.823815,-1.2600926,36.8088685,547,812,19,952
2888,11477,3404,3,Business,3,6,52868,3,6,52938,3,6,53376,3,6,53526,3,6,55533,14,22.3,-1.279395,36.825364,-1.3287857,36.9042514,237,2007,70,588
2889,15632,2472,3,Business,16,3,53569,16,3,54579,16,3,55077,16,3,55264,16,3,56797,8,25.7,-1.3081007,36.839635,-1.2633494,36.7959696,949,1533,1010,685
2890,12383,2438,2,Personal,5,4,34733,5,4,34771,5,4,35140,5,4,35701,5,4,36113,3,23.25888921888938,-1.2753109,36.8130185,-1.2650042,36.7903927,100,412,38,930
2891,1452,816,3,Business,29,2,58833,29,2,59012,29,2,59030,29,2,60033,29,2,60842,5,23.25888921888938,-1.2977387,36.8031447,-1.290894,36.822971,237,809,179,1021
2892,628,59,3,Business,28,4,49870,28,4,49974,28,4,50967,28,4,51561,28,4,52928,9,27.3,-1.2859912,36.8756811,-1.290894,36.822971,709,1367,104,1587
2893,19556,2763,3,Business,2,4,55337,2,4,55410,2,4,55741,2,4,55988,2,4,58122,12,23.25888921888938,-1.2551895,36.7822034,-1.3200694,36.7931306,205,2134,73,578
2894,8569,1642,3,Business,1,5,55337,1,5,55391,1,5,56814,1,5,57203,1,5,58016,8,28.7,-1.2728069,36.7962362,-1.310144,36.7741554,237,813,54,1812
2895,18636,1087,3,Business,20,4,47058,20,4,47171,20,4,48583,20,4,49510,20,4,53513,15,25.3,-1.2713865,36.8058221,-1.3277669,36.8975169,404,4003,113,2339
2896,4057,393,3,Business,20,1,30678,20,1,30760,20,1,32332,20,1,32827,20,1,34975,14,14.4,-1.3177547,36.8303703,-1.306378,36.7519845,208,2148,82,2067
2897,12512,706,3,Business,19,2,51313,19,2,51372,19,2,52603,19,2,52783,19,2,54891,14,18.5,-1.3077869,36.8443207,-1.3561917,36.9100991,949,2108,59,1411
2898,15279,1428,3,Personal,18,1,45054,18,1,47730,18,1,48892,18,1,49203,18,1,50115,8,17.2,-1.300106,36.7584546,-1.3178524,36.7139804,312,912,2676,1473
2899,4753,186,3,Business,30,5,58098,30,5,58288,30,5,60169,30,5,60896,30,5,62533,17,22.1,-1.2902869,36.8085396,-1.3700383,36.9190174,932,1637,190,2608
2900,3822,393,3,Business,10,4,34675,10,4,34726,10,4,35291,10,4,35525,10,4,36063,4,19.0,-1.3167113,36.8301563,-1.3004062,36.829741,358,538,51,799
2901,2801,1245,3,Business,25,4,43226,25,4,43240,25,4,43433,25,4,44661,25,4,47130,19,23.25888921888938,-1.300921,36.828195,-1.3198615,36.7110323,570,2469,14,1421
2902,12763,3124,1,Personal,1,1,63461,1,1,63483,1,1,64150,1,1,64296,1,1,65197,8,23.7,-1.2030691,36.8394744,-1.2157086,36.8702704,607,901,22,813
2903,15388,3404,3,Business,10,6,47071,10,6,47357,10,6,47584,10,6,48095,10,6,48337,1,23.8,-1.290894,36.822971,-1.279395,36.825364,927,242,286,738
2904,15731,1368,3,Business,8,2,45519,8,2,45599,8,2,46196,8,2,46534,8,2,47047,4,23.4,-1.2571472,36.7950633,-1.2519787,36.7806491,178,513,80,935
2905,5056,2801,3,Business,14,2,36014,14,2,36019,14,2,36483,14,2,36766,14,2,41106,10,15.4,-1.2595422,36.7871178,-1.304119,36.819649,229,4340,5,747
2906,19585,3283,3,Business,14,4,52453,14,4,52652,14,4,53376,14,4,53825,14,4,55180,14,27.6,-1.228911,36.881876,-1.2628473,36.781805,8,1355,199,1173
2907,24077,3391,1,Personal,19,5,37417,19,5,37461,19,5,38202,19,5,38481,19,5,38951,3,25.1,-1.2998789,36.8168963,-1.304214,36.8276533,698,470,44,1020
2908,14120,540,3,Business,12,4,29034,12,4,29437,12,4,30509,12,4,30934,12,4,31814,2,16.0,-1.2551895,36.7822034,-1.256783,36.789915,103,880,403,1497
2909,18219,3647,3,Business,16,2,38400,16,2,38742,16,2,40973,16,2,41277,16,2,42560,5,23.25888921888938,-1.272639,36.794723,-1.2883,36.8167842,709,1283,342,2535
2910,4577,391,3,Business,20,1,40636,20,1,40950,20,1,41666,20,1,42421,20,1,44527,5,23.25888921888938,-1.2599563,36.7993439,-1.2867454,36.8259017,829,2106,314,1471
2911,24365,3214,3,Business,21,2,56487,21,2,56531,21,2,57351,21,2,57451,21,2,59446,4,25.1,-1.289795,36.7957132,-1.2890399,36.8164942,148,1995,44,920
2912,9375,3283,3,Business,18,1,42056,18,1,42081,18,1,42163,18,1,43624,18,1,44303,5,28.1,-1.2600926,36.8088685,-1.2628473,36.781805,547,679,25,1543
2913,3541,2887,3,Business,16,4,52718,16,4,56398,16,4,56809,16,4,57427,16,4,59026,9,23.25888921888938,-1.3352545,36.8659639,-1.2813012,36.8323962,411,1599,3680,1029
2914,5277,1787,3,Business,18,4,57775,18,4,57797,18,4,57870,18,4,59099,18,4,59835,3,27.0,-1.2232123,36.8932547,-1.2283403,36.8822756,704,736,22,1302
2915,17472,1502,3,Business,20,3,39837,20,3,39858,20,3,41319,20,3,42147,20,3,44997,12,26.2,-1.2765736,36.8513646,-1.2232123,36.8932547,686,2850,21,2289
2916,16279,131,2,Personal,8,1,53184,8,1,53219,8,1,53694,8,1,54514,8,1,55385,9,24.8,-1.322087,36.8402977,-1.3234802,36.7938203,449,871,35,1295
2917,25106,3291,3,Business,17,5,43929,17,5,43988,17,5,44978,17,5,45286,17,5,46561,11,23.25888921888938,-1.2296618,36.8438272,-1.2600926,36.8088685,591,1275,59,1298
2918,17628,533,3,Business,23,5,35158,23,5,35340,23,5,36162,23,5,36600,23,5,37511,6,20.4,-1.2551895,36.7822034,-1.2765492,36.7669809,290,911,182,1260
2919,25179,1500,3,Business,12,5,37742,12,5,37843,12,5,38168,12,5,39536,12,5,40349,8,26.7,-1.3004062,36.829741,-1.2638185,36.7930057,401,813,101,1693
2920,20577,432,3,Business,20,1,67057,20,1,67374,20,1,67985,20,1,68238,20,1,69279,3,23.25888921888938,-1.3012008,36.764868,-1.2763494,36.7671783,959,1041,317,864
2921,18047,1787,3,Business,20,3,42791,20,3,42818,20,3,43468,20,3,44736,20,3,45781,10,27.3,-1.2859912,36.8756811,-1.2283403,36.8822756,168,1045,27,1918
2922,26416,2521,3,Business,25,5,45121,25,5,45136,25,5,45302,25,5,45640,25,5,47750,14,26.3,-1.3167113,36.8301563,-1.306378,36.7519845,523,2110,15,504
2923,5123,3727,3,Business,28,2,44106,28,2,44134,28,2,44188,28,2,44383,28,2,45042,3,21.2,-1.2963097,36.7688221,-1.293393,36.790237,438,659,28,249
2924,13706,2200,3,Business,31,1,55384,31,1,60284,31,1,60860,31,1,61193,31,1,62048,2,22.6,-1.279395,36.825364,-1.290894,36.822971,338,855,4900,909
2925,17004,186,3,Business,20,1,54030,20,1,54165,20,1,55002,20,1,55070,20,1,55956,6,23.25888921888938,-1.2571472,36.7950633,-1.2985749,36.8088,253,886,135,905
2926,19700,419,3,Business,5,1,52265,5,1,55817,5,1,56046,5,1,56983,5,1,58503,6,26.1,-1.2571472,36.7950633,-1.3001813,36.811122,19,1520,3552,1166
2927,8141,2344,3,Business,2,4,34535,2,4,34591,2,4,35329,2,4,35562,2,4,37081,7,13.5,-1.2551895,36.7822034,-1.298529,36.816482,519,1519,56,971
2928,18013,3149,3,Business,18,6,34973,18,6,34993,18,6,35056,18,6,35988,18,6,36506,5,23.25888921888938,-1.3004062,36.829741,-1.3167113,36.8301563,591,518,20,995
2929,2395,8,2,Personal,12,5,49185,12,5,49262,12,5,49410,12,5,49675,12,5,50209,3,27.2,-1.272798,36.8124195,-1.2644009,36.8177962,795,534,77,413
2930,3288,3147,3,Business,3,5,48952,3,5,49078,3,5,49393,3,5,50371,3,5,52731,17,23.25888921888938,-1.2551895,36.7822034,-1.3472066,36.7692638,695,2360,126,1293
2931,4546,1245,3,Business,29,6,38423,29,6,40494,29,6,41847,29,6,42204,29,6,43816,5,24.8,-1.3198615,36.7110323,-1.3130876,36.6806488,565,1612,2071,1710
2932,13312,1493,1,Personal,17,2,65144,17,2,65214,17,2,65727,17,2,65907,17,2,66347,4,23.9,-1.260526,36.7873569,-1.2639198,36.8069299,510,440,70,693
2933,3267,1927,3,Business,14,5,55455,14,5,55467,14,5,56063,14,5,56619,14,5,60946,15,27.0,-1.3463042,36.768164,-1.2591019,36.800577,328,4327,12,1152
2934,6605,2532,3,Business,10,5,57564,10,5,57795,10,5,58774,10,5,59940,10,5,62127,3,23.25888921888938,-1.2571472,36.7950633,-1.2753109,36.8130185,547,2187,231,2145
2935,27520,2956,3,Business,27,3,56805,27,3,56835,27,3,58286,27,3,58628,27,3,59226,3,29.3,-1.2584143,36.8048002,-1.2551895,36.7822034,428,598,30,1793
2936,7125,53,3,Business,2,2,53430,2,2,53775,2,2,54315,2,2,54781,2,2,55884,5,29.4,-1.3004062,36.829741,-1.2770708,36.8231093,507,1103,345,1006
2937,10560,238,3,Business,15,5,50618,15,5,50818,15,5,50918,15,5,52740,15,5,52952,4,28.1,-1.3004062,36.829741,-1.3077869,36.8443207,239,212,200,1922
2938,8225,833,1,Personal,19,3,63402,19,3,63459,19,3,64704,19,3,65879,19,3,69099,15,23.2,-1.2248308,36.8012573,-1.2273134,36.871462,895,3220,57,2420
2939,23676,1500,3,Business,15,6,43034,15,6,43083,15,6,43632,15,6,43849,15,6,44479,6,19.1,-1.2770708,36.8231093,-1.2638185,36.7930057,341,630,49,766
2940,20405,393,3,Business,14,1,30101,14,1,33260,14,1,34019,14,1,34630,14,1,36145,11,20.4,-1.3167113,36.8301563,-1.2574219,36.7927073,555,1515,3159,1370
2941,24139,3291,3,Business,14,2,45574,14,2,45691,14,2,46291,14,2,47166,14,2,48164,4,23.25888921888938,-1.272828,36.816608,-1.2600926,36.8088685,361,998,117,1475
2942,15957,1783,3,Personal,30,3,33447,30,3,34182,30,3,35432,30,3,35835,30,3,37203,7,17.3,-1.3175119,36.8058513,-1.2824911,36.8218042,844,1368,735,1653
2943,20729,2521,3,Business,26,6,42121,26,6,42208,26,6,43140,26,6,43273,26,6,45148,14,25.8,-1.3167113,36.8301563,-1.306378,36.7519845,523,1875,87,1065
2944,10071,2386,1,Personal,18,3,43050,18,3,43062,18,3,43227,18,3,44746,18,3,47029,20,20.1,-1.1855066,36.8254646,-1.2924639,36.7795798,334,2283,12,1684
2945,7403,3557,3,Business,5,2,38215,5,2,38229,5,2,38925,5,2,39001,5,2,39381,1,23.4,-1.2673786,36.8081593,-1.2546732,36.8086796,650,380,14,772
2946,2662,868,3,Business,13,4,57087,13,4,57653,13,4,57657,13,4,58354,13,4,58361,3,22.9,-1.2783849,36.8163445,-1.2663631,36.8163329,89,7,566,701
2947,26062,1642,3,Business,9,2,35982,9,2,36007,9,2,36688,9,2,37716,9,2,38397,7,20.6,-1.2966535,36.8123136,-1.2726506,36.7960153,119,681,25,1709
2948,17806,3091,3,Business,5,3,38946,5,3,39002,5,3,40155,5,3,40298,5,3,43683,9,22.3,-1.3025826,36.7670807,-1.2591019,36.800577,762,3385,56,1296
2949,6472,2828,3,Business,6,4,51085,6,4,51096,6,4,51758,6,4,53315,6,4,59666,24,23.25888921888938,-1.3623272,36.9410845,-1.2560822,36.8209918,222,6351,11,2219
2950,7283,1299,3,Business,13,1,50629,13,1,50682,13,1,51088,13,1,51459,13,1,52933,7,19.7,-1.282543,36.824618,-1.2823843,36.7734371,85,1474,53,777
2951,6243,393,3,Business,14,4,43254,14,4,43281,14,4,43288,14,4,47682,14,4,47684,14,23.5,-1.3167113,36.8301563,-1.306378,36.7519845,515,2,27,4401
2952,20654,3291,3,Business,21,1,44213,21,1,44410,21,1,44902,21,1,47055,21,1,48422,9,20.0,-1.307143,36.825009,-1.2600926,36.8088685,888,1367,197,2645
2953,5991,2069,3,Business,24,5,51500,24,5,51608,24,5,52456,24,5,52604,24,5,53384,9,23.2,-1.265715,36.823815,-1.228911,36.881876,622,780,108,996
2954,20739,246,3,Business,11,6,37897,11,6,37921,11,6,38250,11,6,38382,11,6,39201,5,21.2,-1.279395,36.825364,-1.2584143,36.8048002,674,819,24,461
2955,14928,909,3,Business,5,2,50785,5,2,50918,5,2,52822,5,2,53089,5,2,54846,9,23.25888921888938,-1.225322,36.80855,-1.2551895,36.7822034,154,1757,133,2171
2956,5384,3404,3,Business,16,6,55522,16,6,55552,16,6,56398,16,6,57731,16,6,59429,6,28.5,-1.279395,36.825364,-1.3185736,36.8258933,119,1698,30,2179
2957,9791,3599,3,Business,1,1,44571,1,1,44628,1,1,46754,1,1,48436,1,1,50722,13,24.1,-1.3302996,36.8707935,-1.2709086,36.7929516,54,2286,57,3808
2958,2369,809,1,Personal,18,1,33876,18,1,35124,18,1,36334,18,1,36888,18,1,38020,6,14.8,-1.2661264,36.8030359,-1.2980815,36.8085686,808,1132,1248,1764
2959,11683,1245,3,Business,5,2,52105,5,2,52144,5,2,53653,5,2,57061,5,2,59341,17,27.6,-1.300921,36.828195,-1.3198615,36.7110323,75,2280,39,4917
2960,17126,2987,3,Business,10,2,34893,10,2,35475,10,2,35812,10,2,36016,10,2,38106,13,16.4,-1.270212,36.8210877,-1.2927792,36.9053492,131,2090,582,541
2961,7488,393,3,Business,20,2,37823,20,2,41250,20,2,42156,20,2,42885,20,2,44986,10,20.0,-1.3177547,36.8303703,-1.2574219,36.7927073,281,2101,3427,1635
2962,4992,1245,3,Business,4,2,49228,4,2,49295,4,2,50192,4,2,50651,4,2,53783,17,22.4,-1.2602337,36.7990548,-1.3198615,36.7110323,155,3132,67,1356
2963,15939,635,3,Business,7,4,38384,7,4,38404,7,4,38794,7,4,40092,7,4,40926,6,24.4,-1.3019925,36.7833825,-1.2602337,36.7990548,933,834,20,1688
2964,17787,2828,3,Business,29,4,53237,29,4,53266,29,4,53494,29,4,54031,29,4,54740,3,24.7,-1.2584143,36.8048002,-1.2615888,36.7928732,547,709,29,765
2965,25733,1792,3,Business,5,4,40578,5,4,40617,5,4,40944,5,4,41041,5,4,42549,15,23.25888921888938,-1.2924639,36.7795798,-1.2212785,36.8086067,103,1508,39,424
2966,10901,265,3,Business,11,1,50793,11,1,51386,11,1,51815,11,1,52664,11,1,53523,6,28.1,-1.300921,36.828195,-1.2662229,36.8360397,206,859,593,1278
2967,7253,2271,3,Business,29,1,53235,29,1,53348,29,1,54028,29,1,54094,29,1,55895,14,23.25888921888938,-1.272828,36.816608,-1.293515,36.897607,318,1801,113,746
2968,13291,2696,3,Personal,3,5,32240,3,5,32275,3,5,32388,3,5,32696,3,5,33720,5,23.25888921888938,-1.3039706,36.7688174,-1.2896431,36.8086201,829,1024,35,421
2969,11139,640,3,Business,30,1,45924,30,1,45943,30,1,46010,30,1,46772,30,1,47331,3,22.5,-1.304033,36.7848695,-1.3026036,36.7934877,247,559,19,829
2970,24484,1329,3,Business,6,4,49389,6,4,49434,6,4,51429,6,4,52222,6,4,58080,20,23.25888921888938,-1.273056,36.811298,-1.1998362,36.9292872,64,5858,45,2788
2971,25936,1725,3,Business,24,4,61756,24,4,62690,24,4,65456,24,4,65970,24,4,67772,16,21.3,-1.1867519,36.8369389,-1.2680709,36.7929823,260,1802,934,3280
2972,10362,3599,3,Business,14,2,39129,14,2,40184,14,2,43225,14,2,43957,14,2,45393,10,23.25888921888938,-1.3302996,36.8707935,-1.2990606,36.8033028,427,1436,1055,3773
2973,6416,2956,3,Business,28,4,44063,28,4,44082,28,4,44131,28,4,45112,28,4,46820,9,27.8,-1.3004062,36.829741,-1.2584143,36.8048002,178,1708,19,1030
2974,22273,2509,3,Business,4,4,33314,4,4,33968,4,4,35174,4,4,35731,4,4,37758,23,21.7,-1.3700383,36.9190174,-1.2571472,36.7950633,901,2027,654,1763
2975,309,2229,3,Business,13,1,58977,13,1,59134,13,1,60557,13,1,60845,13,1,62156,5,23.25888921888938,-1.3247683,36.85803,-1.3324865,36.8938303,27,1311,157,1711
2976,15764,393,3,Business,20,3,38466,20,3,38486,20,3,38570,20,3,39371,20,3,40424,7,26.6,-1.3167113,36.8301563,-1.3083266,36.8494756,145,1053,20,885
2977,19353,2279,3,Business,15,1,51170,15,1,51251,15,1,52873,15,1,53882,15,1,56691,8,23.25888921888938,-1.298529,36.816482,-1.2571472,36.7950633,352,2809,81,2631
2978,4402,157,3,Business,14,6,61463,14,6,61519,14,6,61994,14,6,62707,14,6,63317,2,19.1,-1.2320941,36.8152017,-1.2248308,36.8012573,427,610,56,1188
2979,12000,3632,1,Personal,25,2,38900,25,2,38918,25,2,39306,25,2,39659,25,2,41919,8,23.9,-1.288002,36.827379,-1.290821,36.774477,703,2260,18,741
2980,6936,1977,2,Personal,14,2,51415,14,2,51446,14,2,51794,14,2,52139,14,2,53144,4,24.2,-1.2795796,36.819062,-1.2790653,36.7907262,74,1005,31,693
2981,11547,2956,3,Business,18,1,45719,18,1,45744,18,1,46368,18,1,46626,18,1,47143,2,28.1,-1.2527958,36.8003131,-1.2584143,36.8048002,399,517,25,882
2982,16590,868,3,Business,19,6,35501,19,6,35561,19,6,35850,19,6,36106,19,6,36413,3,21.5,-1.2783849,36.8163445,-1.265715,36.823815,819,307,60,545
2983,20547,893,3,Business,13,3,36760,13,3,36788,13,3,37432,13,3,37505,13,3,38212,4,17.1,-1.2663194,36.809901,-1.2607622,36.8227608,660,707,28,717
2984,16603,51,2,Personal,18,1,46159,18,1,46245,18,1,47519,18,1,47783,18,1,51018,22,23.25888921888938,-1.2580991,36.7941519,-1.1441247,36.7197047,802,3235,86,1538
2985,11751,3372,3,Business,7,4,47112,7,4,47234,7,4,47447,7,4,48073,7,4,49603,10,17.2,-1.304033,36.7848695,-1.3169591,36.7000029,379,1530,122,839
2986,14019,3291,3,Business,15,6,46512,15,6,46550,15,6,46725,15,6,48601,15,6,49113,4,21.9,-1.272828,36.816608,-1.2600926,36.8088685,404,512,38,2051
2987,13831,2200,3,Business,26,1,57413,26,1,58899,26,1,59508,26,1,59806,26,1,60333,2,19.8,-1.290894,36.822971,-1.28878,36.8168312,942,527,1486,907
2988,15595,3621,3,Business,6,1,49878,6,1,49946,6,1,50460,6,1,50817,6,1,52389,13,23.25888921888938,-1.2836583,36.7886014,-1.3352545,36.8659639,427,1572,68,871
2989,11774,868,3,Business,6,6,49424,6,6,49438,6,6,49825,6,6,50470,6,6,51444,6,28.2,-1.307143,36.825009,-1.265715,36.823815,686,974,14,1032
2990,16392,2932,1,Personal,12,5,36201,12,5,36254,12,5,36625,12,5,36811,12,5,37469,6,18.4,-1.263894,36.77163,-1.2658315,36.809049,536,658,53,557
2991,16820,1368,3,Business,30,2,39402,30,2,39803,30,2,41068,30,2,41884,30,2,44106,13,23.25888921888938,-1.2571472,36.7950633,-1.302453,36.8668919,155,2222,401,2081
2992,14228,2112,3,Business,7,4,48704,7,4,48715,7,4,49603,7,4,50361,7,4,50364,5,31.0,-1.2285835,36.8826468,-1.2156006,36.8916865,633,3,11,1646
2993,20188,811,3,Personal,10,2,43122,10,2,43149,10,2,44254,10,2,44369,10,2,45497,8,20.3,-1.2963097,36.7688221,-1.2600616,36.7870182,312,1128,27,1220
2994,22846,2733,3,Business,6,2,38482,6,2,38593,6,2,38814,6,2,40287,6,2,40863,2,24.9,-1.2941449,36.7592641,-1.2963097,36.7688221,215,576,111,1694
2995,26542,2271,3,Business,2,3,48265,2,3,48432,2,3,48745,2,3,50415,2,3,51891,14,26.2,-1.272828,36.816608,-1.293515,36.897607,670,1476,167,1983
2996,8454,2100,3,Business,12,1,41211,12,1,41743,12,1,42400,12,1,42501,12,1,44134,8,23.6,-1.2765736,36.8513646,-1.2413316,36.8785525,744,1633,532,758
2997,5327,867,3,Business,15,6,36283,15,6,36384,15,6,37902,15,6,38131,15,6,39428,15,19.2,-1.2991441,36.7528804,-1.3167113,36.8301563,344,1297,101,1747
2998,16203,2532,3,Business,17,5,54340,17,5,54364,17,5,54475,17,5,54739,17,5,55748,6,23.25888921888938,-1.2551895,36.7822034,-1.2884146,36.8107668,709,1009,24,375
2999,1186,2112,3,Business,21,3,53605,21,3,53635,21,3,53931,21,3,54682,21,3,55214,4,23.0,-1.2297202,36.8819507,-1.2156006,36.8916865,237,532,30,1047
3000,22637,2801,3,Business,23,3,31790,23,3,31799,23,3,32347,23,3,32784,23,3,34186,8,16.8,-1.2595422,36.7871178,-1.2896399,36.8124498,103,1402,9,985
3001,24757,2982,3,Business,13,4,37277,13,4,37334,13,4,37954,13,4,38977,13,4,43396,18,23.5,-1.300921,36.828195,-1.177202,36.8351183,656,4419,57,1643
3002,12787,2008,3,Business,1,5,33279,1,5,33299,1,5,33322,1,5,34561,1,5,35811,14,23.0,-1.2508229,36.7895263,-1.2210264,36.8893138,90,1250,20,1262
3003,7766,1120,3,Personal,28,1,38865,28,1,38914,28,1,39504,28,1,39660,28,1,40277,3,22.8,-1.2638788,36.7998462,-1.2629818,36.8135865,103,617,49,746
3004,3900,1340,3,Business,19,2,54391,19,2,54765,19,2,55318,19,2,55571,19,2,56229,4,30.2,-1.2735999,36.8218131,-1.2707179,36.7979713,268,658,374,806
3005,17340,3402,3,Business,25,4,50974,25,4,51340,25,4,51604,25,4,52057,25,4,52664,5,20.6,-1.3109868,36.8459114,-1.2966911,36.8333422,848,607,366,717
3006,11658,1482,3,Business,1,4,34903,1,4,34926,1,4,35267,1,4,35340,1,4,37098,11,23.25888921888938,-1.338579,36.8963038,-1.29666,36.828668,402,1758,23,414
3007,10883,635,3,Business,27,6,39795,27,6,41322,27,6,42107,27,6,44576,27,6,45372,12,23.25888921888938,-1.2602337,36.7990548,-1.2208123,36.8565261,61,796,1527,3254
3008,27339,633,3,Business,24,4,36478,24,4,38144,24,4,38980,24,4,39131,24,4,39929,5,24.3,-1.2770708,36.8231093,-1.3004062,36.829741,576,798,1666,987
3009,18175,1724,3,Business,27,3,54733,27,3,54808,27,3,54849,27,3,56631,27,3,58286,13,23.25888921888938,-1.2551895,36.7822034,-1.3043952,36.7664138,101,1655,75,1823
3010,13145,2956,3,Business,12,5,34230,12,5,34248,12,5,34550,12,5,34749,12,5,35659,3,18.6,-1.2584143,36.8048002,-1.2551895,36.7822034,674,910,18,501
3011,23137,2982,3,Business,3,4,30837,3,4,30850,3,4,31195,3,4,32013,3,4,33772,18,20.4,-1.300921,36.828195,-1.177202,36.8351183,932,1759,13,1163
3012,27070,1473,3,Business,30,5,32126,30,5,32522,30,5,33097,30,5,34087,30,5,36539,23,19.0,-1.3700383,36.9190174,-1.2571472,36.7950633,364,2452,396,1565
3013,12993,3493,1,Personal,2,1,51358,2,1,51577,2,1,52211,2,1,52715,2,1,53470,7,19.8,-1.2912668,36.7656703,-1.2623805,36.7805404,116,755,219,1138
3014,1779,1271,3,Business,21,3,38260,21,3,38271,21,3,38281,21,3,39344,21,3,42747,19,21.8,-1.3244885,36.897792,-1.254191,36.8099132,402,3403,11,1073
3015,12627,3711,3,Business,28,3,49693,28,3,49735,28,3,49974,28,3,50321,28,3,52116,17,23.25888921888938,-1.3014461,36.7661381,-1.369429,36.762751,609,1795,42,586
3016,13019,1006,1,Personal,17,5,31002,17,5,31020,17,5,31508,17,5,32139,17,5,34281,18,14.5,-1.2729217,36.7624829,-1.2363092,36.8823617,379,2142,18,1119
3017,19645,1419,3,Personal,17,1,54872,17,1,57672,17,1,59005,17,1,59678,17,1,60413,6,22.4,-1.2728947,36.8079426,-1.285969,36.789205,818,735,2800,2006
3018,17726,3239,3,Personal,29,2,33154,29,2,33263,29,2,33697,29,2,34235,29,2,36014,8,16.5,-1.2839322,36.8292426,-1.3197107,36.8054354,845,1779,109,972
3019,24965,2371,3,Personal,5,3,43829,5,3,43938,5,3,44419,5,3,49270,5,3,50882,12,18.9,-1.2844072,36.8247296,-1.2636435,36.9087594,359,1612,109,5332
3020,17952,393,3,Business,26,2,38281,26,2,38290,26,2,38295,26,2,38573,26,2,39660,4,27.7,-1.3167113,36.8301563,-1.3004062,36.829741,519,1087,9,283
3021,25502,1927,3,Business,13,2,66056,13,2,66064,13,2,66067,13,2,66783,13,2,67703,10,23.4,-1.3169591,36.7000029,-1.3472066,36.7692638,874,920,8,719
3022,11724,2675,1,Personal,19,6,51226,19,6,51251,19,6,51807,19,6,53164,19,6,54089,9,24.1,-1.2675132,36.8014826,-1.3145124,36.8400018,753,925,25,1913
3023,27239,190,3,Business,8,1,48884,8,1,48955,8,1,51417,8,1,51910,8,1,52533,6,29.6,-1.3278522,36.8711134,-1.3270347,36.8667362,763,623,71,2955
3024,20034,2956,3,Business,26,2,45578,26,2,45595,26,2,45658,26,2,46958,26,2,47073,1,26.3,-1.2571472,36.7950633,-1.2584143,36.8048002,875,115,17,1363
3025,21242,3560,3,Business,4,5,37455,4,5,38465,4,5,38933,4,5,39427,4,5,40268,1,17.1,-1.290894,36.822971,-1.279395,36.825364,569,841,1010,962
3026,6668,928,3,Business,29,2,54767,29,2,54808,29,2,55206,29,2,55985,29,2,57086,8,26.8,-1.2551895,36.7822034,-1.2945041,36.8151527,191,1101,41,1177
3027,21907,3355,3,Business,3,3,50964,3,3,51055,3,3,52619,3,3,53105,3,3,56947,10,27.0,-1.2859912,36.8756811,-1.3052491,36.8223899,333,3842,91,2050
3028,12702,1329,3,Business,1,1,61738,1,1,61809,1,1,62084,1,1,62272,1,1,64815,8,27.4,-1.273056,36.811298,-1.2315181,36.8140543,166,2543,71,463
3029,16535,2200,3,Business,21,5,39240,21,5,46120,21,5,46649,21,5,47707,21,5,48230,2,22.7,-1.290894,36.822971,-1.2848174,36.826163,489,523,6880,1587
3030,6850,1106,1,Personal,13,4,33582,13,4,33627,13,4,34008,13,4,34727,13,4,36408,12,18.8,-1.2684667,36.8002891,-1.3353385,36.7778749,882,1681,45,1100
3031,21818,2412,3,Business,28,1,38328,28,1,38510,28,1,40985,28,1,41201,28,1,42393,10,23.7,-1.2285835,36.8826468,-1.2880129,36.8308097,906,1192,182,2691
3032,11209,2330,3,Business,5,5,42906,5,5,42989,5,5,43752,5,5,44108,5,5,44930,2,24.3,-1.3015197,36.7658456,-1.2856664,36.7559838,548,822,83,1119
3033,5733,1724,3,Business,10,4,43987,10,4,43994,10,4,44404,10,4,44941,10,4,45877,7,24.5,-1.2551895,36.7822034,-1.2545163,36.8243717,658,936,7,947
3034,11415,2956,3,Business,12,2,33290,12,2,33771,12,2,35310,12,2,35629,12,2,37394,7,17.8,-1.225322,36.80855,-1.2584143,36.8048002,452,1765,481,1858
3035,1859,2523,3,Business,8,5,48963,8,5,49081,8,5,50809,8,5,51376,8,5,56198,7,27.0,-1.2861765,36.8209086,-1.2551895,36.7822034,206,4822,118,2295
3036,15477,625,3,Business,2,3,45999,2,3,46525,2,3,48779,2,3,49127,2,3,49796,5,23.5,-1.2600926,36.8088685,-1.265715,36.823815,753,669,526,2602
3037,22875,1594,3,Business,20,3,51055,20,3,51079,20,3,51097,20,3,51871,20,3,53069,5,29.2,-1.2285835,36.8826468,-1.2156006,36.8916865,614,1198,24,792
3038,6608,2112,3,Business,24,5,55649,24,5,55745,24,5,56422,24,5,56974,24,5,58819,19,23.2,-1.2156006,36.8916865,-1.2629461,36.7653137,539,1845,96,1229
3039,27106,2200,3,Business,12,5,42845,12,5,43506,12,5,43732,12,5,44428,12,5,48438,5,24.7,-1.290894,36.822971,-1.3040651,36.7981254,88,4010,661,922
3040,26638,1880,3,Business,12,2,50954,12,2,50998,12,2,51178,12,2,52845,12,2,53782,11,23.25888921888938,-1.2571472,36.7950633,-1.2662306,36.710789,783,937,44,1847
3041,23198,3557,3,Business,21,5,36016,21,5,36120,21,5,37209,21,5,37938,21,5,38789,6,20.1,-1.2854174,36.7951152,-1.2546732,36.8086796,532,851,104,1818
3042,13878,186,3,Business,21,4,45006,21,4,45043,21,4,45603,21,4,45749,21,4,47663,5,28.1,-1.2825816,36.8092346,-1.2571472,36.7950633,819,1914,37,706
3043,18537,1927,3,Business,20,4,52934,20,4,53871,20,4,53878,20,4,55020,20,4,58220,15,25.4,-1.2597529,36.806629,-1.3472066,36.7692638,704,3200,937,1149
3044,8594,2625,1,Personal,9,6,54774,9,6,55059,9,6,56713,9,6,58241,9,6,60671,12,19.1,-1.2248308,36.8012573,-1.2432,36.7414006,301,2430,285,3182
3045,5993,496,3,Business,20,4,60564,20,4,60936,20,4,61437,20,4,61518,20,4,62256,4,22.9,-1.2551895,36.7822034,-1.2734413,36.8129353,190,738,372,582
3046,26090,1927,3,Business,19,2,36373,19,2,36383,19,2,36485,19,2,38452,19,2,42582,19,26.7,-1.2927792,36.9053492,-1.3472066,36.7692638,900,4130,10,2069
3047,22475,1245,3,Business,17,6,42616,17,6,42656,17,6,44095,17,6,45141,17,6,49039,17,23.8,-1.300921,36.828195,-1.3198615,36.7110323,244,3898,40,2485
3048,21589,1346,3,Business,6,3,56161,6,3,56257,6,3,57569,6,3,57696,6,3,59822,6,27.7,-1.2695287,36.7981777,-1.2917868,36.7872675,540,2126,96,1439
3049,7113,3201,3,Business,9,3,46779,9,3,46796,9,3,47520,9,3,47670,9,3,48260,2,25.2,-1.2584143,36.8048002,-1.2561334,36.7990458,580,590,17,874
3050,27841,2803,3,Business,4,2,45220,4,2,48197,4,2,48571,4,2,48859,4,2,49681,3,24.0,-1.2765736,36.8513646,-1.2689599,36.8398401,521,822,2977,662
3051,7822,3647,3,Business,8,5,33676,8,5,33727,8,5,34436,8,5,34845,8,5,35898,8,20.7,-1.272639,36.794723,-1.2653185,36.8358841,427,1053,51,1118
3052,3034,1927,3,Business,22,1,36546,22,1,36646,22,1,40668,22,1,46482,22,1,47450,12,24.9,-1.290894,36.822971,-1.3463042,36.768164,926,968,100,9836
3053,13367,2271,3,Business,2,6,39207,2,6,39270,2,6,40155,2,6,40810,2,6,42271,13,24.0,-1.2850325,36.822932,-1.293515,36.897607,297,1461,63,1540
3054,23960,1927,3,Business,20,3,37451,20,3,37459,20,3,37463,20,3,37729,20,3,39356,14,20.7,-1.3472066,36.7692638,-1.2594539,36.8067841,26,1627,8,270
3055,28055,1073,3,Business,30,4,53646,30,4,53710,30,4,54375,30,4,54744,30,4,55491,8,20.7,-1.290641,36.812941,-1.2563242,36.7911568,216,747,64,1034
3056,84,186,3,Business,5,5,52153,5,5,53397,5,5,54240,5,5,54431,5,5,56996,23,27.6,-1.3700383,36.9190174,-1.2571472,36.7950633,48,2565,1244,1034
3057,13798,3211,3,Personal,3,2,33248,3,2,33346,3,2,34594,3,2,34874,3,2,36596,9,15.1,-1.2783772,36.8201617,-1.2804664,36.7701111,844,1722,98,1528
3058,23977,3586,3,Business,3,1,37934,3,1,38770,3,1,39395,3,1,39932,3,1,42199,9,22.3,-1.2869041,36.8240057,-1.275442,36.7660207,235,2267,836,1162
3059,25455,1502,3,Business,20,3,39864,20,3,39948,20,3,40266,20,3,41531,20,3,46266,12,26.2,-1.290894,36.822971,-1.2232123,36.8932547,268,4735,84,1583
3060,22443,2688,2,Personal,22,3,49612,22,3,49710,22,3,49740,22,3,51073,22,3,52543,4,25.8,-1.296797,36.7764525,-1.2897215,36.7945959,414,1470,98,1363
3061,17365,671,1,Personal,22,3,35533,22,3,35713,22,3,37876,22,3,38098,22,3,39763,10,23.2,-1.2343087,36.84749,-1.302559,36.819555,320,1665,180,2385
3062,25062,20,3,Business,7,5,35988,7,5,36030,7,5,36431,7,5,36657,7,5,37809,9,20.4,-1.2648363,36.8023754,-1.3125593,36.8430941,878,1152,42,627
3063,5788,2982,3,Business,26,5,56159,26,5,56536,26,5,57368,26,5,57721,26,5,58896,7,23.25888921888938,-1.300921,36.828195,-1.325469,36.862403,551,1175,377,1185
3064,23155,1710,3,Personal,11,1,52062,11,1,52071,11,1,52096,11,1,52797,11,1,56255,24,28.0,-1.2963097,36.7688221,-1.1829533,36.718327,786,3458,9,726
3065,17142,2246,1,Personal,18,4,53917,18,4,53974,18,4,54970,18,4,55331,18,4,56701,10,26.8,-1.2821883,36.8269611,-1.249526,36.7711579,208,1370,57,1357
3066,23941,1469,3,Business,30,2,31130,30,2,31203,30,2,34466,30,2,34694,30,2,35507,4,17.4,-1.2551895,36.7822034,-1.2617131,36.8051999,219,813,73,3491
3067,22386,1535,1,Business,19,4,37249,19,4,37343,19,4,37997,19,4,39303,19,4,40783,9,20.2,-1.2945179,36.7685349,-1.2571472,36.7950633,5,1480,94,1960
3068,23979,3415,1,Personal,7,5,30413,7,5,31370,7,5,33064,7,5,37090,7,5,40186,36,18.4,-1.4383017,36.9806911,-1.2697662,36.7595857,938,3096,957,5720
3069,19683,1280,3,Business,3,1,38034,3,1,38052,3,1,38123,3,1,39279,3,1,41365,18,22.3,-1.2551895,36.7822034,-1.3343129,36.8854175,120,2086,18,1227
3070,910,3147,3,Business,26,2,35670,26,2,36003,26,2,37456,26,2,37766,26,2,38734,7,21.8,-1.3173869,36.8112044,-1.3472066,36.7692638,411,968,333,1763
3071,13252,1500,3,Business,2,4,46553,2,4,46609,2,4,46974,2,4,47128,2,4,48870,13,23.25888921888938,-1.2638185,36.7930057,-1.3228003,36.8306435,155,1742,56,519
3072,14128,393,3,Business,2,5,46129,2,5,47494,2,5,47970,2,5,50968,2,5,53256,10,25.3,-1.3177547,36.8303703,-1.2574219,36.7927073,762,2288,1365,3474
3073,26232,3404,3,Business,21,3,41944,21,3,41967,21,3,41975,21,3,43042,21,3,44046,11,22.2,-1.2283403,36.8822756,-1.279395,36.825364,659,1004,23,1075
3074,28135,1966,3,Business,1,5,41191,1,5,41222,1,5,43799,1,5,44162,1,5,45428,20,28.6,-1.2917868,36.7872675,-1.3700383,36.9190174,222,1266,31,2940
3075,10712,2866,3,Business,25,1,42717,25,1,42738,25,1,42753,25,1,43320,25,1,43984,3,27.1,-1.2551895,36.7822034,-1.2495931,36.8065087,576,664,21,582
3076,7264,2258,3,Business,17,3,38037,17,3,38058,17,3,38070,17,3,38495,17,3,38950,3,25.6,-1.2646084,36.8028645,-1.2635089,36.7887337,446,455,21,437
3077,20060,2956,3,Business,11,2,63845,11,2,63884,11,2,64562,11,2,64780,11,2,65544,3,21.0,-1.2584143,36.8048002,-1.2551895,36.7822034,547,764,39,896
3078,7974,2149,1,Personal,19,5,64884,19,5,64959,19,5,65306,19,5,65611,19,5,66954,11,24.2,-1.2675332,36.808561,-1.2127345,36.7903289,116,1343,75,652
3079,10309,1342,3,Business,30,2,60041,30,2,60053,30,2,60091,30,2,60602,30,2,61384,4,23.6,-1.3025826,36.7670807,-1.2882803,36.7815881,785,782,12,549
3080,2468,2330,3,Business,12,2,50684,12,2,50727,12,2,51121,12,2,51665,12,2,53070,11,27.1,-1.2524916,36.8656196,-1.2326041,36.8009029,377,1405,43,938
3081,23680,2112,3,Business,8,6,47750,8,6,47765,8,6,49401,8,6,51532,8,6,54442,12,23.25888921888938,-1.28878,36.8168312,-1.2156006,36.8916865,739,2910,15,3767
3082,17817,3222,3,Business,11,1,49892,11,1,49983,11,1,50007,11,1,51480,11,1,51487,3,29.1,-1.2551895,36.7822034,-1.2638132,36.7849775,242,7,91,1497
3083,9540,3674,3,Business,4,2,52411,4,2,53281,4,2,54215,4,2,54475,4,2,55844,7,22.5,-1.2551895,36.7822034,-1.2880883,36.8227336,894,1369,870,1194
3084,22656,1004,3,Business,14,2,53736,14,2,53961,14,2,55057,14,2,55143,14,2,58182,18,23.25888921888938,-1.3250048,36.8697188,-1.2235201,36.8020608,183,3039,225,1182
3085,16064,2412,3,Business,26,4,39798,26,4,39810,26,4,40625,26,4,41337,26,4,44229,14,18.9,-1.2297202,36.8819507,-1.2571472,36.7950633,614,2892,12,1527
3086,12596,2521,3,Business,25,5,56881,25,5,56917,25,5,57109,25,5,57223,25,5,59163,14,29.1,-1.3167113,36.8301563,-1.306378,36.7519845,523,1940,36,306
3087,9646,1500,3,Business,2,2,42735,2,2,42912,2,2,44044,2,2,45372,2,2,46632,8,26.4,-1.3004062,36.829741,-1.2638185,36.7930057,507,1260,177,2460
3088,18961,198,3,Business,1,5,37604,1,5,37688,1,5,39580,1,5,39733,1,5,40592,8,28.7,-1.3396256,36.8863135,-1.3705766,36.9120742,242,859,84,2045
3089,19958,1246,3,Business,10,1,34950,10,1,35649,10,1,36586,10,1,36917,10,1,37659,2,18.6,-1.2527958,36.8003131,-1.2682478,36.8072852,112,742,699,1268
3090,23108,186,3,Business,20,2,37024,20,2,38118,20,2,38569,20,2,38950,20,2,39750,4,19.7,-1.2571472,36.7950633,-1.2890399,36.8164942,259,800,1094,832
3091,5071,2112,3,Business,25,1,48740,25,1,49398,25,1,50287,25,1,50556,25,1,53387,6,30.3,-1.2156006,36.8916865,-1.2413316,36.8785525,660,2831,658,1158
3092,14931,510,3,Business,24,3,40968,24,3,40978,24,3,40982,24,3,41097,24,3,43927,28,20.1,-1.2860183,36.8975338,-1.3192808,36.7121888,408,2830,10,119
3093,13150,3283,3,Business,10,1,59541,10,1,59559,10,1,60360,10,1,61266,10,1,61924,5,18.9,-1.2600926,36.8088685,-1.2628473,36.781805,864,658,18,1707
3094,7979,2956,3,Business,28,2,56758,28,2,56988,28,2,57186,28,2,57719,28,2,58854,7,23.4,-1.2584143,36.8048002,-1.225322,36.80855,882,1135,230,731
3095,18213,142,3,Business,11,2,51607,11,2,52914,11,2,53525,11,2,54723,11,2,56137,10,22.4,-1.2517448,36.7924971,-1.2963097,36.7688221,536,1414,1307,1809
3096,22492,1500,3,Business,10,1,45998,10,1,46049,10,1,46085,10,1,48055,10,1,48322,13,18.5,-1.2638185,36.7930057,-1.3228003,36.8306435,702,267,51,2006
3097,3318,3149,3,Business,18,6,37676,18,6,37693,18,6,37767,18,6,38565,18,6,39105,5,21.3,-1.3004062,36.829741,-1.3167113,36.8301563,591,540,17,872
3098,5248,1075,3,Business,4,2,35030,4,2,40067,4,2,40090,4,2,40406,4,2,40974,3,20.3,-1.2527958,36.8003131,-1.2551895,36.7822034,205,568,5037,339
3099,517,393,3,Business,20,3,57297,20,3,57315,20,3,58425,20,3,59349,20,3,60110,4,29.4,-1.3167113,36.8301563,-1.3004062,36.829741,349,761,18,2034
3100,7670,3091,3,Business,11,2,35251,11,2,35379,11,2,38017,11,2,38568,11,2,40361,9,19.6,-1.279395,36.825364,-1.3025826,36.7670807,819,1793,128,3189
3101,18264,125,1,Personal,31,5,50095,31,5,50105,31,5,50190,31,5,50953,31,5,55146,17,19.8,-1.287741,36.8175255,-1.2000518,36.7805946,6,4193,10,848
3102,23045,2436,3,Business,9,2,45025,9,2,45065,9,2,46994,9,2,48023,9,2,51441,12,21.8,-1.2551895,36.7822034,-1.3104734,36.7363698,328,3418,40,2958
3103,18991,1149,3,Personal,15,2,37778,15,2,39776,15,2,39789,15,2,40274,15,2,41061,4,22.8,-1.279285,36.8260574,-1.291899,36.809705,100,787,1998,498
3104,6803,824,3,Business,28,4,55991,28,4,56005,28,4,56209,28,4,58060,28,4,59757,18,29.9,-1.2914308,36.8018867,-1.207546,36.7913976,801,1697,14,2055
3105,17851,1329,3,Business,22,5,46979,22,5,46991,22,5,47433,22,5,47654,22,5,48379,5,23.25888921888938,-1.273056,36.811298,-1.291055,36.786744,655,725,12,663
3106,1163,1340,3,Business,30,5,36327,30,5,36391,30,5,37076,30,5,37279,30,5,38226,4,19.2,-1.2707179,36.7979713,-1.2734594,36.8170558,167,947,64,888
3107,25354,1329,3,Business,8,5,43952,8,5,45576,8,5,46154,8,5,46297,8,5,48532,12,28.5,-1.273056,36.811298,-1.2239241,36.8707489,210,2235,1624,721
3108,20268,69,3,Personal,16,4,54967,16,4,55024,16,4,55297,16,4,55501,16,4,57726,7,23.25888921888938,-1.2979147,36.7857814,-1.2698306,36.7644059,269,2225,57,477
3109,12469,186,3,Business,18,4,38483,18,4,38521,18,4,38643,18,4,39126,18,4,42335,24,25.7,-1.2571472,36.7950633,-1.3611971,36.6538278,215,3209,38,605
3110,13872,2691,3,Business,13,3,41201,13,3,41224,13,3,42962,13,3,43344,13,3,45163,8,19.9,-1.2857671,36.7875614,-1.2551895,36.7822034,755,1819,23,2120
3111,2348,1527,3,Business,8,1,57944,8,1,58343,8,1,59408,8,1,60748,8,1,61121,4,29.0,-1.3228003,36.8306435,-1.3004062,36.829741,349,373,399,2405
3112,20048,3741,2,Personal,27,5,50375,27,5,50658,27,5,53235,27,5,54320,27,5,55720,6,24.2,-1.2892898,36.7874315,-1.269534,36.80697,836,1400,283,3662
3113,9739,552,3,Business,27,4,42965,27,4,42971,27,4,43522,27,4,43753,27,4,46106,23,22.8,-1.3014461,36.7661381,-1.3632162,36.9108253,199,2353,6,782
3114,14466,3647,3,Business,10,3,37601,10,3,37685,10,3,38217,10,3,38431,10,3,39493,8,27.8,-1.272639,36.794723,-1.2653185,36.8358841,576,1062,84,746
3115,27711,2284,1,Personal,2,6,42086,2,6,42840,2,6,44561,2,6,45193,2,6,46325,10,24.0,-1.2147539,36.7993624,-1.2517392,36.8249608,870,1132,754,2353
3116,17697,2069,3,Business,4,6,48000,4,6,48810,4,6,49446,4,6,50120,4,6,51072,6,23.25888921888938,-1.2296618,36.8438272,-1.228911,36.881876,670,952,810,1310
3117,18495,2978,3,Business,1,5,52104,1,5,52158,1,5,52703,1,5,53434,1,5,56389,12,28.5,-1.2551895,36.7822034,-1.325681,36.7959072,205,2955,54,1276
3118,255,2509,3,Business,13,3,47714,13,3,47801,13,3,48360,13,3,49381,13,3,50527,5,29.4,-1.2571472,36.7950633,-1.286553,36.8273374,341,1146,87,1580
3119,24272,393,3,Business,24,1,30471,24,1,32023,24,1,32709,24,1,35229,24,1,35781,4,15.6,-1.3177547,36.8303703,-1.3004062,36.829741,731,552,1552,3206
3120,559,816,3,Business,18,1,55156,18,1,55192,18,1,55378,18,1,56743,18,1,57928,6,30.8,-1.2527958,36.8003131,-1.290894,36.822971,845,1185,36,1551
3121,21327,1250,1,Personal,17,2,45075,17,2,45562,17,2,46935,17,2,47350,17,2,48252,5,18.8,-1.3014461,36.7661381,-1.2675334,36.7658246,851,902,487,1788
3122,16134,3565,3,Business,18,7,48639,18,7,52284,18,7,52840,18,7,53436,18,7,55178,9,27.5,-1.2286304,36.8422473,-1.2227615,36.8989174,473,1742,3645,1152
3123,18229,2139,3,Personal,10,3,69256,10,3,69368,10,3,70263,10,3,72224,10,3,73538,9,24.3,-1.2336611,36.806181,-1.1926935,36.7574155,438,1314,112,2856
3124,5573,3222,3,Business,5,3,54454,5,3,54689,5,3,56503,5,3,56623,5,3,59609,5,25.0,-1.2551895,36.7822034,-1.2731645,36.7900343,547,2986,235,1934
3125,1983,718,3,Business,13,1,43380,13,1,43409,13,1,43416,13,1,43691,13,1,44137,3,23.25888921888938,-1.2551895,36.7822034,-1.2665327,36.8108799,576,446,29,282
3126,6466,3560,3,Business,28,5,57561,28,5,57732,28,5,58409,28,5,58809,28,5,59614,5,25.4,-1.2527958,36.8003131,-1.279395,36.825364,576,805,171,1077
3127,16612,3732,1,Personal,19,7,43510,19,7,43534,19,7,44535,19,7,44711,19,7,47390,18,18.1,-1.2790653,36.7907262,-1.2092548,36.8043842,452,2679,24,1177
3128,4058,3517,3,Business,26,1,34299,26,1,34320,26,1,34322,26,1,35915,26,1,37307,15,17.6,-1.300921,36.828195,-1.3882008,36.7699445,120,1392,21,1595
3129,17133,478,3,Business,5,2,32878,5,2,32891,5,2,32895,5,2,33322,5,2,35014,15,21.2,-1.2551895,36.7822034,-1.3216456,36.7145156,523,1692,13,431
3130,25515,1724,3,Business,27,3,39171,27,3,39228,27,3,40231,27,3,40991,27,3,42847,14,26.2,-1.32189,36.8589727,-1.2907854,36.7774108,25,1856,57,1763
3131,21841,2491,1,Personal,17,3,38876,17,3,39072,17,3,39183,17,3,39865,17,3,40969,4,25.3,-1.3084722,36.8224665,-1.2878149,36.8146245,338,1104,196,793
3132,4856,517,3,Business,31,1,43516,31,1,47412,31,1,47420,31,1,48019,31,1,48778,11,21.2,-1.3167113,36.8301563,-1.2574219,36.7927073,39,759,3896,607
3133,24084,2523,3,Business,11,2,51393,11,2,53671,11,2,54130,11,2,54247,11,2,57189,8,22.1,-1.2551895,36.7822034,-1.2944292,36.7793569,646,2942,2278,576
3134,8245,3050,3,Business,8,5,62183,8,5,62235,8,5,62686,8,5,66293,8,5,67879,14,25.3,-1.2945074,36.8083195,-1.3169591,36.7000029,205,1586,52,4058
3135,16429,2989,3,Business,7,1,29727,7,1,29808,7,1,31260,7,1,31648,7,1,34415,20,21.6,-1.3472066,36.7692638,-1.2413316,36.8785525,486,2767,81,1840
3136,7207,1271,3,Business,16,3,37123,16,3,37180,16,3,39140,16,3,39637,16,3,41708,14,22.9,-1.3244885,36.897792,-1.238018,36.870424,457,2071,57,2457
3137,6535,1780,3,Personal,16,3,37795,16,3,37819,16,3,37905,16,3,37989,16,3,41963,15,22.8,-1.3103985,36.9114173,-1.298529,36.816482,237,3974,24,170
3138,22647,3517,3,Business,19,2,34748,19,2,34769,19,2,35365,19,2,37507,19,2,41228,27,21.2,-1.300921,36.828195,-1.15135,36.9566534,519,3721,21,2738
3139,26174,393,3,Business,22,2,53635,22,2,53639,22,2,53804,22,2,54453,22,2,56237,14,25.4,-1.3167113,36.8301563,-1.306378,36.7519845,523,1784,4,814
3140,14718,2701,3,Business,1,4,38397,1,4,39041,1,4,39833,1,4,41643,1,4,41965,11,23.25888921888938,-1.2283403,36.8822756,-1.2765736,36.8513646,744,322,644,2602
3141,1651,552,3,Business,31,3,47125,31,3,48788,31,3,51130,31,3,51604,31,3,54327,13,26.9,-1.2860183,36.8975338,-1.3632162,36.9108253,206,2723,1663,2816
3142,6445,1246,3,Business,8,3,42386,8,3,42612,8,3,42646,8,3,44792,8,3,44802,2,22.1,-1.263987,36.798891,-1.2682478,36.8072852,51,10,226,2180
3143,18162,3053,3,Personal,15,5,40069,15,5,40101,15,5,40816,15,5,42539,15,5,44470,8,26.6,-1.2534301,36.8000983,-1.23966,36.75258,172,1931,32,2438
3144,27594,3329,1,Business,20,5,64749,20,5,68435,20,5,69213,20,5,69310,20,5,70253,5,19.8,-1.2859576,36.8197604,-1.2672588,36.8000252,672,943,3686,875
3145,18815,795,3,Personal,4,3,40234,4,3,40268,4,3,40639,4,3,41984,4,3,42486,1,16.9,-1.2624531,36.8228476,-1.26278,36.82641,103,502,34,1716
3146,23446,2154,3,Business,27,1,43349,27,1,44662,27,1,45566,27,1,46371,27,1,47181,6,20.8,-1.2859912,36.8756811,-1.2765736,36.8513646,907,810,1313,1709
3147,20189,136,3,Business,23,6,45911,23,6,45923,23,6,46048,23,6,46800,23,6,47544,2,26.4,-1.2531983,36.8069669,-1.2629039,36.8048286,547,744,12,877
3148,4912,2112,3,Business,22,5,35683,22,5,35744,22,5,36153,22,5,36493,22,5,37441,9,22.1,-1.2156006,36.8916865,-1.178056,36.9312342,484,948,61,749
3149,3555,868,3,Business,7,5,55824,7,5,56084,7,5,56274,7,5,57883,7,5,58860,6,23.25888921888938,-1.307143,36.825009,-1.2663631,36.8163329,2,977,260,1799
3150,22514,3149,3,Business,14,4,52563,14,4,52648,14,4,52707,14,4,54556,14,4,55143,6,27.4,-1.3077869,36.8443207,-1.3167113,36.8301563,901,587,85,1908
3151,21649,1544,3,Business,3,1,54948,3,1,54996,3,1,56614,3,1,56909,3,1,59431,4,23.1,-1.2861765,36.8209086,-1.293973,36.80169,168,2522,48,1913
3152,1840,970,3,Business,21,3,51649,21,3,51993,21,3,52616,21,3,52719,21,3,54838,7,23.0,-1.2551895,36.7822034,-1.2852,36.82397,726,2119,344,726
3153,23040,3091,3,Business,28,5,41223,28,5,41245,28,5,41262,28,5,42877,28,5,44774,18,25.0,-1.2283403,36.8822756,-1.3012008,36.764868,179,1897,22,1632
3154,21944,914,3,Business,15,4,45984,15,4,46012,15,4,47854,15,4,48301,15,4,50810,17,24.5,-1.2670213,36.7994482,-1.216682,36.9085778,470,2509,28,2289
3155,25415,2255,1,Personal,24,4,59170,24,4,59192,24,4,60191,24,4,61770,24,4,64188,15,21.2,-1.289498,36.818878,-1.3169591,36.7000029,360,2418,22,2578
3156,14427,909,3,Business,28,3,50999,28,3,53165,28,3,54247,28,3,54705,28,3,55442,7,23.25888921888938,-1.207546,36.7913976,-1.225322,36.80855,769,737,2166,1540
3157,7282,204,1,Personal,20,4,63000,20,4,63025,20,4,63860,20,4,63981,20,4,64814,6,24.9,-1.3173869,36.8112044,-1.2964924,36.7873649,328,833,25,956
3158,2385,2066,3,Business,31,2,52880,31,2,52932,31,2,52945,31,2,53478,31,2,56184,11,22.3,-1.316961,36.820337,-1.264384,36.7674128,777,2706,52,546
3159,4046,2086,1,Personal,30,6,41244,30,6,41330,30,6,42432,30,6,42636,30,6,43515,7,22.2,-1.2994194,36.7647917,-1.2657709,36.7305746,312,879,86,1306
3160,11277,928,3,Business,18,1,49139,18,1,49200,18,1,49240,18,1,49995,18,1,51223,9,29.4,-1.2551895,36.7822034,-1.2857671,36.7875614,708,1228,61,795
3161,182,510,3,Business,25,4,29039,25,4,29129,25,4,29892,25,4,30183,25,4,31416,7,23.25888921888938,-1.2860183,36.8975338,-1.3078335,36.8670353,148,1233,90,1054
3162,22239,3491,3,Business,4,5,55638,4,5,57539,4,5,57752,4,5,58520,4,5,61104,11,23.25888921888938,-1.279395,36.825364,-1.2283403,36.8822756,178,2584,1901,981
3163,24531,1264,1,Personal,16,2,32652,16,2,32659,16,2,32835,16,2,33162,16,2,34094,4,23.25888921888938,-1.2707179,36.7979713,-1.2807567,36.8076073,22,932,7,503
3164,6693,2457,3,Business,26,5,42182,26,5,47389,26,5,49311,26,5,49647,26,5,52408,8,23.25888921888938,-1.2551895,36.7822034,-1.3047132,36.8089553,559,2761,5207,2258
3165,4177,1500,3,Business,24,3,38611,24,3,38668,24,3,38721,24,3,42027,24,3,42031,8,23.25888921888938,-1.3004062,36.829741,-1.2638185,36.7930057,507,4,57,3359
3166,16265,2987,3,Business,29,1,41744,29,1,42104,29,1,42137,29,1,42807,29,1,44298,4,23.25888921888938,-1.270212,36.8210877,-1.260232,36.807334,51,1491,360,703
3167,28136,3506,1,Personal,1,1,26251,1,1,26659,1,1,28555,1,1,28745,1,1,29934,6,18.2,-1.2563531,36.7896742,-1.2655306,36.828148,50,1189,408,2086
3168,6418,2789,3,Business,11,1,26131,11,1,26233,11,1,26931,11,1,27167,11,1,30745,41,18.1,-1.304735,36.7846054,-1.0568484,36.7779822,932,3578,102,934
3169,26908,71,3,Business,11,1,33016,11,1,33084,11,1,35319,11,1,35770,11,1,37470,5,14.5,-1.2821108,36.8250555,-1.262073,36.7986087,89,1700,68,2686
3170,26750,3251,3,Business,31,4,51357,31,4,51660,31,4,52116,31,4,52550,31,4,53523,6,22.8,-1.2833534,36.8165865,-1.287139,36.768308,100,973,303,890
3171,7158,3517,3,Business,7,3,41870,7,3,41891,7,3,42810,7,3,42908,7,3,44461,16,25.2,-1.3882008,36.7699445,-1.300921,36.828195,343,1553,21,1017
3172,464,53,3,Business,8,5,55089,8,5,55135,8,5,57029,8,5,57406,8,5,59173,8,30.6,-1.3167113,36.8301563,-1.2770708,36.8231093,653,1767,46,2271
3174,26168,111,3,Business,1,4,42426,1,4,42980,1,4,43685,1,4,43838,1,4,45330,7,23.25888921888938,-1.2551895,36.7822034,-1.2672002,36.8245542,660,1492,554,858
3175,26669,733,3,Business,17,2,49055,17,2,49071,17,2,49434,17,2,49693,17,2,52053,16,24.4,-1.2551895,36.7822034,-1.3169591,36.7000029,519,2360,16,622
3176,24670,1133,3,Business,13,4,37537,13,4,37558,13,4,37776,13,4,37854,13,4,38254,3,18.5,-1.2571472,36.7950633,-1.2738936,36.8035805,409,400,21,296
3177,4355,2066,3,Business,27,3,35742,27,3,35892,27,3,36771,27,3,36890,27,3,38358,7,23.25888921888938,-1.3210189,36.8410551,-1.2850638,36.813096,411,1468,150,998
3178,16577,1133,3,Business,1,5,38898,1,5,40018,1,5,41660,1,5,41749,1,5,44584,5,26.7,-1.2571472,36.7950633,-1.2889024,36.8187402,311,2835,1120,1731
3179,14355,478,3,Business,11,1,45336,11,1,45948,11,1,49576,11,1,50311,11,1,53004,8,28.7,-1.2551895,36.7822034,-1.2830276,36.8297516,119,2693,612,4363
3180,5749,302,3,Business,4,2,58042,4,2,58887,4,2,59310,4,2,62904,4,2,64686,8,21.1,-1.2815287,36.8534203,-1.2649605,36.7981777,882,1782,845,4017
3181,9993,972,3,Business,24,6,44064,24,6,45607,24,6,46414,24,6,46654,24,6,47588,6,24.0,-1.2862033,36.8152966,-1.3205164,36.8098882,89,934,1543,1047
3182,3964,25,1,Personal,21,6,39634,21,6,39685,21,6,41561,21,6,41943,21,6,44692,6,16.3,-1.2982391,36.7950991,-1.2805233,36.7494508,465,2749,51,2258
3183,11093,1724,3,Business,7,5,34495,7,5,34600,7,5,35769,7,5,35946,7,5,37915,7,18.1,-1.2551895,36.7822034,-1.2885504,36.8066908,19,1969,105,1346
3184,5910,2480,3,Personal,3,5,35927,3,5,35944,3,5,37062,3,5,38245,3,5,39585,14,21.6,-1.3508657,36.9019028,-1.3024794,36.8228284,620,1340,17,2301
3185,24597,1133,3,Business,27,1,43887,27,1,43900,27,1,44434,27,1,44870,27,1,46127,11,23.8,-1.3332749,36.8708147,-1.2778465,36.8180077,648,1257,13,970
3186,5281,1378,2,Personal,22,5,48188,22,5,48229,22,5,48927,22,5,49232,22,5,50183,4,23.25888921888938,-1.2628638,36.8070399,-1.2611642,36.7949932,147,951,41,1003
3187,12680,1500,3,Business,6,1,28960,6,1,29651,6,1,30550,6,1,31458,6,1,32431,8,23.25888921888938,-1.3004062,36.829741,-1.2638185,36.7930057,92,973,691,1807
3188,21001,2069,3,Business,25,1,36141,25,1,36170,25,1,37594,25,1,38160,25,1,39480,16,25.7,-1.2628473,36.781805,-1.228911,36.881876,426,1320,29,1990
3189,10720,3647,3,Business,14,3,37034,14,3,37161,14,3,37870,14,3,37999,14,3,39291,7,24.5,-1.272639,36.794723,-1.3012902,36.80964,849,1292,127,838
3190,25021,2069,3,Business,23,2,41389,23,2,41469,23,2,41803,23,2,42280,23,2,43059,9,23.25888921888938,-1.265715,36.823815,-1.228911,36.881876,96,779,80,811
3191,27550,3017,3,Business,24,4,66255,24,4,66344,24,4,66854,24,4,66970,24,4,67266,2,21.2,-1.299313,36.7831488,-1.294598,36.781639,334,296,89,626
3192,23357,2634,3,Business,3,5,41161,3,5,41245,3,5,41709,3,5,42073,3,5,44531,21,23.25888921888938,-1.2963097,36.7688221,-1.3160977,36.9131642,205,2458,84,828
3193,27882,1500,3,Business,29,3,57162,29,3,57422,29,3,57433,29,3,59184,29,3,59191,9,20.9,-1.2638185,36.7930057,-1.3004062,36.829741,349,7,260,1762
3194,17612,3562,2,Personal,3,4,54070,3,4,54172,3,4,55075,3,4,55463,3,4,59907,16,25.2,-1.2650182,36.7926717,-1.2816507,36.8770543,753,4444,102,1291
3195,5913,238,3,Business,5,2,46061,5,2,46069,5,2,46073,5,2,47199,5,2,47201,15,25.5,-1.3077869,36.8443207,-1.362953,36.904214,239,2,8,1130
3196,11440,3291,3,Business,9,5,42490,9,5,42991,9,5,44010,9,5,44826,9,5,46830,8,25.7,-1.307143,36.825009,-1.2600926,36.8088685,719,2004,501,1835
3197,23833,1245,3,Business,8,4,50493,8,4,50807,8,4,51364,8,4,54240,8,4,56738,5,27.4,-1.300921,36.828195,-1.295408,36.802892,949,2498,314,3433
3198,7841,1976,3,Business,25,1,43940,25,1,43952,25,1,43975,25,1,44319,25,1,45192,7,25.7,-1.257028,36.7810435,-1.2615048,36.8116724,523,873,12,367
3199,27187,2767,3,Business,16,4,41444,16,4,41510,16,4,41944,16,4,42198,16,4,43147,5,14.7,-1.2612893,36.8147402,-1.25373,36.78793,857,949,66,688
3200,5487,1304,3,Business,31,5,54192,31,5,54211,31,5,54311,31,5,55133,31,5,59018,19,20.0,-1.2551895,36.7822034,-1.3601057,36.767584,720,3885,19,922
3201,14335,1787,3,Business,30,2,54393,30,2,54855,30,2,55801,30,2,56097,30,2,57477,15,23.25888921888938,-1.2283403,36.8822756,-1.2551895,36.7822034,8,1380,462,1242
3202,28044,53,3,Business,2,4,40496,2,4,40564,2,4,41030,2,4,41955,2,4,44160,6,23.25888921888938,-1.3077869,36.8443207,-1.2770708,36.8231093,341,2205,68,1391
3203,11780,3295,3,Business,22,3,40095,22,3,40147,22,3,41277,22,3,41639,22,3,42965,5,22.9,-1.2571472,36.7950633,-1.2841726,36.8179589,213,1326,52,1492
3204,3849,1687,3,Business,2,4,30965,2,4,30995,2,4,34276,2,4,34343,2,4,36117,11,23.25888921888938,-1.2357874,36.870708,-1.2884799,36.8217918,815,1774,30,3348
3205,25388,2154,3,Business,25,5,46731,25,5,46747,25,5,46774,25,5,48761,25,5,49616,4,23.5,-1.2885529,36.8160141,-1.2651643,36.8072214,100,855,16,2014
3206,20656,3436,1,Personal,18,6,50054,18,6,50081,18,6,50489,18,6,51470,18,6,53473,11,20.6,-1.250476,36.802013,-1.2973034,36.7756907,865,2003,27,1389
3207,19473,755,1,Personal,21,6,45566,21,6,45590,21,6,46125,21,6,48578,21,6,52488,13,16.7,-1.282357,36.782501,-1.2289456,36.7651122,329,3910,24,2988
3208,27391,3621,3,Business,30,6,57591,30,6,57615,30,6,58250,30,6,58614,30,6,60148,15,28.4,-1.2836583,36.7886014,-1.3289028,36.8719683,678,1534,24,999
3209,16269,375,3,Business,7,5,41072,7,5,42458,7,5,44297,7,5,44564,7,5,47144,5,25.3,-1.277285,36.813266,-1.2525704,36.7955754,726,2580,1386,2106
3210,21494,3291,3,Business,13,3,39560,13,3,39572,13,3,40821,13,3,42055,13,3,44226,16,24.8,-1.293515,36.897607,-1.2600926,36.8088685,276,2171,12,2483
3211,8464,640,3,Business,27,3,52094,27,3,52934,27,3,52961,27,3,54116,27,3,55949,6,23.25888921888938,-1.304033,36.7848695,-1.2833106,36.8240238,431,1833,840,1182
3212,5172,510,3,Business,4,2,56517,4,2,56790,4,2,58569,4,2,59043,4,2,61477,21,23.8,-1.2551895,36.7822034,-1.2860183,36.8975338,38,2434,273,2253
3213,4941,2829,3,Business,17,3,50133,17,3,50153,17,3,50779,17,3,51241,17,3,51823,2,23.25888921888938,-1.2571472,36.7950633,-1.2631614,36.810602,68,582,20,1088
3214,13876,3674,3,Business,3,5,57873,3,5,58076,3,5,58585,3,5,58840,3,5,62188,8,23.25888921888938,-1.2551895,36.7822034,-1.2922992,36.7983035,343,3348,203,764
3215,1559,2587,3,Business,14,1,54694,14,1,59421,14,1,59613,14,1,59943,14,1,62193,10,24.6,-1.2413316,36.8785525,-1.28878,36.8168312,48,2250,4727,522
3216,8884,3201,3,Business,13,3,56487,13,3,56528,13,3,56565,13,3,57234,13,3,57355,2,27.1,-1.2615888,36.7928732,-1.2584143,36.8048002,56,121,41,706
3217,3221,1976,3,Business,30,3,39964,30,3,39994,30,3,40041,30,3,40929,30,3,42025,7,25.2,-1.257028,36.7810435,-1.287428,36.7800821,101,1096,30,935
3218,2174,3711,3,Business,23,3,67435,23,3,67477,23,3,67964,23,3,69538,23,3,69550,3,24.3,-1.3012008,36.764868,-1.2765492,36.7669809,246,12,42,2061
3219,6815,219,3,Personal,6,1,40131,6,1,40621,6,1,41495,6,1,41670,6,1,42460,6,20.3,-1.2668256,36.8063128,-1.305023,36.80294,754,790,490,1049
3220,20098,1884,1,Personal,20,4,44260,20,4,44303,20,4,44850,20,4,44994,20,4,46281,4,24.6,-1.2807298,36.8299116,-1.3049317,36.8225732,338,1287,43,691
3221,16137,2150,3,Business,20,1,49894,20,1,50027,20,1,51095,20,1,53443,20,1,53919,9,23.25888921888938,-1.303596,36.778378,-1.344446,36.756597,119,476,133,3416
3222,19751,2383,3,Business,4,2,51150,4,2,51279,4,2,55866,4,2,56592,4,2,57370,2,23.8,-1.2608993,36.799246,-1.2516391,36.8114886,547,778,129,5313
3223,25723,868,3,Business,20,3,41986,20,3,42013,20,3,42247,20,3,42531,20,3,43423,7,26.5,-1.2628473,36.781805,-1.265715,36.823815,786,892,27,518
3224,4022,42,3,Business,29,1,56448,29,1,56508,29,1,58339,29,1,58510,29,1,59266,4,24.2,-1.2564152,36.7792803,-1.2551895,36.7822034,878,756,60,2002
3225,26234,533,3,Business,29,1,64982,29,1,65017,29,1,65935,29,1,66567,29,1,67462,6,23.2,-1.2765492,36.7669809,-1.2551895,36.7822034,171,895,35,1550
3226,21316,3525,3,Business,21,4,47145,21,4,49496,21,4,49897,21,4,50316,21,4,51689,13,26.5,-1.3700383,36.9190174,-1.3239488,36.8316835,519,1373,2351,820
3227,13633,3091,3,Business,6,4,50118,6,4,51637,6,4,51753,6,4,52839,6,4,53666,9,23.25888921888938,-1.2551895,36.7822034,-1.3012008,36.764868,379,827,1519,1202
3228,13263,928,3,Business,13,1,48210,13,1,48228,13,1,48507,13,1,51447,13,1,53083,8,23.25888921888938,-1.2878913,36.8089253,-1.2551895,36.7822034,451,1636,18,3219
3229,8376,187,3,Business,22,6,55046,22,6,55279,22,6,56176,22,6,56293,22,6,60783,27,26.0,-1.2859912,36.8756811,-1.3165542,36.700067,48,4490,233,1014
3230,1864,1764,1,Personal,7,4,34162,7,4,36071,7,4,37173,7,4,37654,7,4,39760,10,14.3,-1.3307951,36.7977548,-1.2930705,36.8279433,635,2106,1909,1583
3231,17215,309,3,Business,3,1,37571,3,1,37623,3,1,39213,3,1,39332,3,1,41196,17,21.4,-1.2156006,36.8916865,-1.2571472,36.7950633,958,1864,52,1709
3232,13199,1402,3,Business,14,5,55945,14,5,60292,14,5,60999,14,5,62041,14,5,62770,1,23.0,-1.290894,36.822971,-1.281754,36.8324229,150,729,4347,1749
3233,4396,517,3,Business,10,1,31133,10,1,31138,10,1,31315,10,1,31596,10,1,33657,14,18.3,-1.3228003,36.8306435,-1.306378,36.7519845,523,2061,5,458
3234,14197,3657,2,Personal,20,5,45376,20,5,45497,20,5,47409,20,5,48157,20,5,50245,14,18.3,-1.22606,36.80039,-1.278498,36.7731432,159,2088,121,2660
3235,706,1205,3,Business,25,4,50958,25,4,50970,25,4,51384,25,4,51928,25,4,53039,8,23.25888921888938,-1.2495931,36.8065087,-1.2873232,36.7658572,484,1111,12,958
3236,26857,662,1,Personal,9,4,39043,9,4,39090,9,4,39787,9,4,40023,9,4,42712,15,23.8,-1.2951724,36.7758148,-1.3368903,36.767101,265,2689,47,933
3237,8091,1075,3,Business,28,1,52421,28,1,52513,28,1,53348,28,1,53597,28,1,54637,8,26.2,-1.2326041,36.8009029,-1.2527958,36.8003131,263,1040,92,1084
3238,20652,3151,1,Personal,29,2,36719,29,2,36806,29,2,38025,29,2,38669,29,2,39943,7,21.6,-1.3271684,36.8173021,-1.312469,36.815177,101,1274,87,1863
3239,1894,635,3,Business,8,5,38644,8,5,38682,8,5,39458,8,5,40342,8,5,41956,7,28.2,-1.3081376,36.8329772,-1.2602337,36.7990548,590,1614,38,1660
3240,24223,3595,1,Personal,13,5,58169,13,5,58200,13,5,58507,13,5,58966,13,5,61722,17,19.3,-1.2596241,36.762407,-1.2219929,36.8349924,101,2756,31,766
3241,25877,1102,3,Business,29,5,45467,29,5,45508,29,5,46189,29,5,48581,29,5,50349,10,26.9,-1.3333374,36.8667362,-1.3047132,36.8089553,855,1768,41,3073
3242,945,3282,3,Personal,26,2,52724,26,2,52754,26,2,53056,26,2,53678,26,2,54910,7,29.5,-1.2925919,36.8170577,-1.290059,36.7703475,906,1232,30,924
3243,16695,2100,3,Business,25,2,55851,25,2,55972,25,2,55984,25,2,60808,25,2,60812,4,23.8,-1.2765736,36.8513646,-1.3083777,36.8590077,179,4,121,4836
3244,1070,1471,3,Business,24,5,54140,24,5,54322,24,5,56571,24,5,56816,24,5,57981,1,23.1,-1.2635433,36.7970804,-1.2571472,36.7950633,223,1165,182,2494
3245,9427,3434,3,Business,13,6,33245,13,6,33286,13,6,33450,13,6,34359,13,6,34537,5,19.9,-1.2963097,36.7688221,-1.3043952,36.7664138,168,178,41,1073
3246,21118,2190,3,Business,15,3,61910,15,3,61924,15,3,62060,15,3,62442,15,3,66094,11,20.8,-1.301953,36.788458,-1.3298487,36.8248917,334,3652,14,518
3247,7927,3560,3,Business,27,1,59663,27,1,59757,27,1,61454,27,1,62833,27,1,62852,1,23.25888921888938,-1.290894,36.822971,-1.279395,36.825364,819,19,94,3076
3248,11896,2658,3,Business,11,1,34625,11,1,34653,11,1,35105,11,1,36359,11,1,37819,8,18.0,-1.2885029,36.825605,-1.2975066,36.7689423,25,1460,28,1706
3249,26850,1244,3,Business,7,6,45606,7,6,45625,7,6,46404,7,6,47082,7,6,48146,8,18.8,-1.272828,36.816608,-1.303596,36.778378,427,1064,19,1457
3250,10085,2956,3,Business,24,3,35789,24,3,35803,24,3,35975,24,3,36785,24,3,37404,5,23.25888921888938,-1.279395,36.825364,-1.2584143,36.8048002,953,619,14,982
3251,5350,2523,3,Business,28,3,47041,28,3,47458,28,3,47711,28,3,47791,28,3,49525,7,23.25888921888938,-1.2551895,36.7822034,-1.2875845,36.8135104,661,1734,417,333
3252,349,1955,3,Business,19,5,61113,19,5,61123,19,5,61153,19,5,61834,19,5,64046,12,24.2,-1.3332749,36.8708147,-1.2927792,36.9053492,81,2212,10,711
3253,2692,1850,3,Business,15,1,37195,15,1,37235,15,1,37494,15,1,37558,15,1,38592,3,20.9,-1.2551895,36.7822034,-1.259919,36.808244,913,1034,40,323
3254,9834,3201,3,Business,10,1,30645,10,1,32125,10,1,32731,10,1,33054,10,1,35201,6,16.6,-1.305936,36.85095,-1.2897368,36.8226783,211,2147,1480,929
3255,8364,2200,3,Business,12,2,40171,12,2,40212,12,2,40692,12,2,41479,12,2,41855,1,28.0,-1.290894,36.822971,-1.2880129,36.8308097,377,376,41,1267
3256,26030,1363,3,Business,2,3,29953,2,3,30043,2,3,30204,2,3,30351,2,3,31392,10,20.0,-1.3004062,36.829741,-1.2991441,36.7528804,670,1041,90,308
3257,27396,2803,3,Business,24,4,55171,24,4,55216,24,4,55766,24,4,56007,24,4,56709,3,28.1,-1.2765736,36.8513646,-1.2703428,36.8336071,928,702,45,791
3258,23944,2701,3,Business,24,5,38642,24,5,39413,24,5,41666,24,5,42803,24,5,44581,18,21.5,-1.3562374,36.9042954,-1.2765736,36.8513646,524,1778,771,3390
3259,5358,3091,3,Business,11,2,48208,11,2,48428,11,2,49614,11,2,50329,11,2,51834,11,21.2,-1.2860183,36.8975338,-1.290894,36.822971,20,1505,220,1901
3260,8023,1246,3,Business,26,5,34090,26,5,34572,26,5,35299,26,5,35450,26,5,36965,16,23.25888921888938,-1.3700383,36.9190174,-1.312469,36.815177,412,1515,482,878
3261,25008,814,3,Business,10,4,54085,10,4,54098,10,4,54270,10,4,54648,10,4,56822,9,25.4,-1.3014461,36.7661381,-1.2571472,36.7950633,829,2174,13,550
3262,10924,2523,3,Business,11,5,40217,11,5,40267,11,5,40481,11,5,40864,11,5,42086,8,21.1,-1.2551895,36.7822034,-1.2914531,36.7810162,74,1222,50,597
3263,6471,2532,3,Business,5,3,38447,5,3,39313,5,3,39817,5,3,39989,5,3,41003,8,22.3,-1.2551895,36.7822034,-1.2950408,36.8098172,550,1014,866,676
3264,25978,3291,3,Business,7,4,50516,7,4,50548,7,4,50752,7,4,51167,7,4,51742,5,31.2,-1.2628473,36.781805,-1.2600926,36.8088685,649,575,32,619
3265,13919,1882,3,Business,12,3,36332,12,3,36343,12,3,36604,12,3,37010,12,3,37676,5,21.3,-1.2956882,36.7861845,-1.3014461,36.7661381,881,666,11,667
3266,25787,3092,3,Personal,28,4,36472,28,4,36547,28,4,38013,28,4,38100,28,4,39385,6,23.25888921888938,-1.2675979,36.8155653,-1.2978459,36.7912964,467,1285,75,1553
3267,14437,186,3,Business,8,4,36828,8,4,37040,8,4,37756,8,4,38344,8,4,40759,23,26.3,-1.3700383,36.9190174,-1.2571472,36.7950633,532,2415,212,1304
3268,18404,1500,3,Business,5,2,36912,5,2,36958,5,2,37333,5,2,38102,5,2,39549,10,23.7,-1.2991441,36.7528804,-1.2638185,36.7930057,829,1447,46,1144
3269,2928,1882,3,Business,19,6,43665,19,6,43717,19,6,44454,19,6,44643,19,6,45172,2,25.4,-1.277018,36.820337,-1.287781,36.817866,360,529,52,926
3270,6252,391,3,Business,22,3,48073,22,3,49657,22,3,51473,22,3,52079,22,3,53000,5,24.2,-1.2602337,36.7990548,-1.2784063,36.8222933,921,921,1584,2422
3271,1787,2523,3,Business,25,4,42908,25,4,42942,25,4,43341,25,4,44015,25,4,45621,8,23.25888921888938,-1.2551895,36.7822034,-1.284877,36.7875208,422,1606,34,1073
3272,17609,2279,3,Business,30,2,54509,30,2,54913,30,2,56422,30,2,57052,30,2,59035,3,27.4,-1.2897368,36.8226783,-1.3012902,36.80964,206,1983,404,2139
3273,17759,136,3,Business,1,5,51866,1,5,52053,1,5,54472,1,5,55413,1,5,56914,20,31.9,-1.2874648,36.8271985,-1.3254522,36.7216584,336,1501,187,3360
3274,6719,3674,3,Business,6,2,52317,6,2,52333,6,2,52405,6,2,52758,6,2,54493,22,27.7,-1.2551895,36.7822034,-1.1851027,36.9392531,551,1735,16,425
3275,4245,1500,3,Business,9,2,31340,9,2,31370,9,2,32475,9,2,34472,9,2,34904,4,21.0,-1.3077869,36.8443207,-1.3004062,36.829741,43,432,30,3102
3276,17557,1075,3,Business,10,5,39632,10,5,39673,10,5,40107,10,5,40956,10,5,42380,3,23.25888921888938,-1.2527958,36.8003131,-1.2551895,36.7822034,427,1424,41,1283
3277,9518,2289,3,Business,25,5,42448,25,5,42500,25,5,43085,25,5,43275,25,5,47983,13,21.0,-1.2553615,36.7895376,-1.2990731,36.8488058,742,4708,52,775
3278,23186,151,3,Business,25,4,53836,25,4,54021,25,4,54419,25,4,54962,25,4,56168,8,20.8,-1.2620725,36.8026517,-1.2969741,36.7856612,726,1206,185,941
3279,8507,3621,3,Business,21,4,50433,21,4,50449,21,4,51025,21,4,51995,21,4,53337,12,31.0,-1.2836583,36.7886014,-1.329568,36.8520825,678,1342,16,1546
3280,2554,562,3,Business,20,1,50183,20,1,50196,20,1,50587,20,1,51755,20,1,53350,13,23.25888921888938,-1.3227181,36.8528097,-1.333148,36.922453,709,1595,13,1559
3281,22504,393,3,Business,14,1,50898,14,1,51016,14,1,51149,14,1,51378,14,1,53239,14,25.9,-1.3167113,36.8301563,-1.306378,36.7519845,523,1861,118,362
3282,17623,2114,2,Personal,11,2,46984,11,2,47142,11,2,48150,11,2,50239,11,2,50962,5,25.6,-1.3133974,36.8018636,-1.2834945,36.812937,851,723,158,3097
3283,15408,3390,3,Personal,29,5,35101,29,5,35147,29,5,36354,29,5,37104,29,5,38569,5,20.9,-1.2866012,36.8195691,-1.2609721,36.8480813,436,1465,46,1957
3284,25872,318,2,Personal,29,2,56302,29,2,56502,29,2,57078,29,2,57402,29,2,59812,25,23.8,-1.2137756,36.7996657,-1.3117411,36.7106558,116,2410,200,900
3285,23024,496,3,Business,20,3,31336,20,3,31446,20,3,32082,20,3,32298,20,3,34267,10,20.9,-1.2551895,36.7822034,-1.2948533,36.7991616,953,1969,110,852
3286,26709,2539,3,Business,16,3,55686,16,3,55724,16,3,56193,16,3,56392,16,3,56975,8,27.0,-1.2930037,36.8126474,-1.2647126,36.8049247,576,583,38,668
3287,2308,475,3,Business,20,4,45495,20,4,45515,20,4,46233,20,4,50338,20,4,52546,18,27.8,-1.2571472,36.7950633,-1.3339943,36.7263409,167,2208,20,4823
3288,7630,2701,3,Business,21,4,41059,21,4,41076,21,4,41080,21,4,44068,21,4,44470,11,25.4,-1.2232123,36.8932547,-1.2765736,36.8513646,633,402,17,2992
3289,1116,1754,3,Business,24,1,62345,24,1,62901,24,1,62905,24,1,63272,24,1,65236,17,22.5,-1.2860183,36.8975338,-1.3191788,36.8895401,114,1964,556,371
3290,11025,2330,3,Business,30,3,52060,30,3,52067,30,3,52100,30,3,53817,30,3,54294,9,29.1,-1.2649605,36.7981777,-1.2326041,36.8009029,137,477,7,1750
3291,4215,770,1,Personal,11,4,43651,11,4,43787,11,4,44915,11,4,45273,11,4,47494,12,23.7,-1.3145553,36.7493849,-1.3258649,36.8000584,64,2221,136,1486
3292,15472,1304,3,Business,18,4,37818,18,4,37926,18,4,38822,18,4,39721,18,4,42756,14,25.5,-1.3332749,36.8708147,-1.2770652,36.795423,662,3035,108,1795
3293,15223,867,3,Business,13,3,27413,13,3,27465,13,3,28612,13,3,28898,13,3,30669,10,17.2,-1.3004062,36.829741,-1.2991441,36.7528804,206,1771,52,1433
3294,18408,2523,3,Business,29,3,55166,29,3,55215,29,3,55691,29,3,55794,29,3,56961,8,18.8,-1.2551895,36.7822034,-1.2821378,36.7740428,474,1167,49,579
3295,9484,517,3,Business,4,5,53913,4,5,53951,4,5,54191,4,5,54764,4,5,56921,14,23.25888921888938,-1.3167113,36.8301563,-1.306378,36.7519845,523,2157,38,813
3296,19499,1502,3,Business,14,5,34018,14,5,37927,14,5,39446,14,5,40942,14,5,42721,12,21.6,-1.290894,36.822971,-1.2232123,36.8932547,281,1779,3909,3015
3297,12269,2018,1,Personal,1,1,55312,1,1,55578,1,1,57174,1,1,57434,1,1,64711,5,25.4,-1.2871384,36.8227962,-1.2954364,36.8490361,612,7277,266,1856
3298,25350,1959,3,Business,24,3,51201,24,3,51233,24,3,52249,24,3,52520,24,3,53350,6,23.25888921888938,-1.2647975,36.8215183,-1.2551895,36.7822034,710,830,32,1287
3299,23695,2069,3,Business,27,3,53500,27,3,53541,27,3,53725,27,3,54142,27,3,55570,16,29.7,-1.2628473,36.781805,-1.228911,36.881876,709,1428,41,601
3300,6454,3688,3,Business,7,5,56837,7,5,57160,7,5,57475,7,5,57571,7,5,59186,10,23.25888921888938,-1.2551895,36.7822034,-1.3050379,36.7943452,903,1615,323,411
3301,21178,3264,3,Business,5,3,58997,5,3,59002,5,3,59071,5,3,59202,5,3,59330,3,24.8,-1.2551895,36.7822034,-1.2642665,36.7788286,259,128,5,200
3302,27289,53,3,Business,14,4,45897,14,4,46066,14,4,47048,14,4,47218,14,4,48984,11,25.1,-1.2991441,36.7528804,-1.2770708,36.8231093,99,1766,169,1152
3303,16552,1285,3,Business,30,4,50109,30,4,50155,30,4,51318,30,4,51638,30,4,52696,4,23.25888921888938,-1.3024794,36.8228284,-1.2787447,36.8182891,694,1058,46,1483
3304,6032,393,3,Business,18,4,35607,18,4,35619,18,4,35624,18,4,38393,18,4,38396,11,23.25888921888938,-1.3167113,36.8301563,-1.2638185,36.7930057,39,3,12,2774
3305,25690,2330,3,Business,17,3,67369,17,3,67436,17,3,68022,17,3,68189,17,3,69625,10,23.25888921888938,-1.3040812,36.7924217,-1.3192789,36.7112991,269,1436,67,753
3306,19415,2509,3,Business,20,5,40029,20,5,40051,20,5,40066,20,5,40538,20,5,42492,20,18.7,-1.2571472,36.7950633,-1.3700383,36.9190174,648,1954,22,487
3307,3533,1500,3,Business,30,2,57493,30,2,58071,30,2,58707,30,2,60016,30,2,61676,11,23.25888921888938,-1.3167113,36.8301563,-1.2638185,36.7930057,910,1660,578,1945
3308,20241,3389,1,Personal,15,1,51709,15,1,51726,15,1,52922,15,1,53680,15,1,55574,19,23.25888921888938,-1.2661264,36.8030359,-1.3653687,36.7337644,882,1894,17,1954
3309,16790,2886,3,Personal,24,1,64084,24,1,64277,24,1,65434,24,1,65660,24,1,66820,6,22.4,-1.2576187,36.8293332,-1.2637591,36.7903832,275,1160,193,1383
3310,22106,633,3,Business,15,2,53975,15,2,53983,15,2,54318,15,2,54391,15,2,56035,11,24.7,-1.2991441,36.7528804,-1.3004062,36.829741,523,1644,8,408
3311,5859,858,1,Personal,2,4,34755,2,4,34769,2,4,36228,2,4,36708,2,4,40376,7,13.5,-1.28856,36.827399,-1.2551895,36.7822034,19,3668,14,1939
3312,385,3586,3,Business,17,3,44482,17,3,44495,17,3,45513,17,3,45712,17,3,48665,10,25.6,-1.275442,36.7660207,-1.2810889,36.8247135,829,2953,13,1217
3313,20737,2627,3,Business,17,3,52584,17,3,52866,17,3,52882,17,3,54024,17,3,56246,5,23.25888921888938,-1.2571472,36.7950633,-1.2857548,36.819062,576,2222,282,1158
3314,8742,3404,3,Business,12,2,40815,12,2,40915,12,2,41354,12,2,42738,12,2,43716,5,28.0,-1.2571472,36.7950633,-1.279395,36.825364,953,978,100,1823
3315,26264,1004,3,Business,7,5,44260,7,5,45758,7,5,46268,7,5,46940,7,5,48160,5,23.25888921888938,-1.3250048,36.8697188,-1.314291,36.8478646,829,1220,1498,1182
3316,25891,2583,3,Personal,24,1,50841,24,1,50908,24,1,50990,24,1,51659,24,1,51666,2,23.25888921888938,-1.2707179,36.7979713,-1.2807,36.808066,51,7,67,751
3317,20794,283,3,Business,3,1,52541,3,1,52577,3,1,52700,3,1,54304,3,1,55652,4,23.6,-1.2804227,36.8250375,-1.2715686,36.8023526,12,1348,36,1727
3318,12839,3201,3,Business,15,5,54879,15,5,55257,15,5,55562,15,5,56376,15,5,58973,6,28.0,-1.28878,36.8168312,-1.2584143,36.8048002,686,2597,378,1119
3319,15065,26,1,Personal,2,3,37391,2,3,37515,2,3,37941,2,3,38222,2,3,38949,6,22.2,-1.2598589,36.7470168,-1.2569503,36.7834728,122,727,124,707
3320,27155,3599,3,Business,7,5,33439,7,5,34500,7,5,37810,7,5,38239,7,5,39390,7,25.3,-1.3302996,36.8707935,-1.3270347,36.8667362,810,1151,1061,3739
3321,9553,2789,3,Business,8,1,36522,8,1,36552,8,1,37778,8,1,38713,8,1,40321,7,27.8,-1.304735,36.7846054,-1.265432,36.795034,269,1608,30,2161
3322,13257,136,3,Business,20,1,40117,20,1,40133,20,1,40967,20,1,41073,20,1,42045,6,23.25888921888938,-1.3376931,36.7512668,-1.3254522,36.7216584,815,972,16,940
3323,26523,1439,3,Business,17,1,51338,17,1,51481,17,1,52221,17,1,53179,17,1,54906,3,24.8,-1.297324,36.7878632,-1.2962487,36.7772971,847,1727,143,1698
3324,13533,180,2,Personal,11,2,66470,11,2,66544,11,2,66939,11,2,68152,11,2,68736,4,23.4,-1.2668611,36.7956387,-1.2813498,36.7930729,379,584,74,1608
3325,13740,3647,3,Business,10,1,45958,10,1,46256,10,1,46819,10,1,47090,10,1,49881,14,18.7,-1.272639,36.794723,-1.3121154,36.7109299,576,2791,298,834
3326,27631,2789,3,Business,28,1,58270,28,1,58387,28,1,58816,28,1,59562,28,1,60509,4,25.3,-1.304735,36.7846054,-1.2885364,36.7995016,559,947,117,1175
3327,22695,2069,3,Business,19,6,60008,19,6,60038,19,6,60752,19,6,61270,19,6,62713,9,26.2,-1.265715,36.823815,-1.228911,36.881876,819,1443,30,1232
3328,15084,1724,3,Business,25,2,48246,25,2,48279,25,2,48571,25,2,48943,25,2,49560,2,27.3,-1.2551895,36.7822034,-1.2566586,36.7929682,62,617,33,664
3329,17520,3560,3,Business,18,1,46307,18,1,46729,18,1,47521,18,1,48781,18,1,53918,17,31.0,-1.279395,36.825364,-1.3705766,36.9120742,267,5137,422,2052
3330,17951,867,3,Business,28,4,32406,28,4,32427,28,4,32875,28,4,35477,28,4,35759,11,19.7,-1.2770708,36.8231093,-1.2991441,36.7528804,41,282,21,3050
3331,12644,2509,3,Business,3,3,33806,3,3,33832,3,3,34109,3,3,34422,3,3,36673,20,18.5,-1.2571472,36.7950633,-1.3700383,36.9190174,937,2251,26,590
3332,11868,3587,1,Personal,18,6,43278,18,6,43293,18,6,43554,18,6,43769,18,6,44250,2,18.9,-1.2941792,36.7633637,-1.2864865,36.7661462,449,481,15,476
3333,16602,3283,3,Business,7,5,54502,7,5,54620,7,5,55410,7,5,56034,7,5,56650,4,23.25888921888938,-1.266837,36.799249,-1.2628473,36.781805,427,616,118,1414
3334,11955,1243,1,Business,7,2,58764,7,2,58881,7,2,59525,7,2,60020,7,2,61330,9,23.0,-1.3034396,36.8329998,-1.2551895,36.7822034,754,1310,117,1139
3335,10830,2956,3,Business,2,2,47210,2,2,47353,2,2,48683,2,2,49638,2,2,50095,2,29.2,-1.2551895,36.7822034,-1.2584143,36.8048002,318,457,143,2285
3336,9857,2112,3,Business,11,1,34021,11,1,34042,11,1,34182,11,1,34699,11,1,36300,14,18.2,-1.2156006,36.8916865,-1.2676026,36.8103629,31,1601,21,657
3337,11434,3365,2,Personal,19,3,52943,19,3,55684,19,3,56296,19,3,57626,19,3,62195,9,25.4,-1.3197099,36.8312312,-1.2684934,36.8249394,179,4569,2741,1942
3338,3279,3404,3,Business,13,2,52590,13,2,54209,13,2,54676,13,2,54908,13,2,58849,7,26.4,-1.279395,36.825364,-1.2551895,36.7822034,660,3941,1619,699
3339,16618,1962,1,Personal,28,2,44608,28,2,44636,28,2,44957,28,2,45261,28,2,47135,15,17.4,-1.2287314,36.8367354,-1.2959769,36.7853374,88,1874,28,625
3340,10993,2066,3,Business,23,2,35830,23,2,36046,23,2,36973,23,2,37852,23,2,39933,6,23.25888921888938,-1.3210189,36.8410551,-1.2854193,36.8296162,155,2081,216,1806
3341,6150,1271,3,Business,28,3,45068,28,3,45344,28,3,45366,28,3,46054,28,3,48445,29,23.25888921888938,-1.3244885,36.897792,-1.1404395,36.9668024,345,2391,276,710
3342,22129,653,3,Business,17,3,58907,17,3,58984,17,3,59415,17,3,59578,17,3,61319,15,24.8,-1.279395,36.825364,-1.3251247,36.8995926,31,1741,77,594
3343,2599,3091,3,Business,14,1,55144,14,1,55170,14,1,56139,14,1,56475,14,1,58161,8,25.7,-1.3012008,36.764868,-1.2615888,36.7928732,328,1686,26,1305
3344,18599,3560,3,Business,29,5,63442,29,5,63520,29,5,65338,29,5,68203,29,5,68218,5,28.2,-1.279395,36.825364,-1.307241,36.8302368,613,15,78,4683
3345,5578,2216,3,Business,7,5,38287,7,5,38344,7,5,38392,7,5,38833,7,5,39337,4,23.25888921888938,-1.2551895,36.7822034,-1.2736095,36.8011282,161,504,57,489
3346,21964,868,3,Business,7,5,36126,7,5,36147,7,5,36376,7,5,38737,7,5,40055,6,23.25888921888938,-1.307143,36.825009,-1.2663631,36.8163329,591,1318,21,2590
3347,7751,265,3,Business,31,3,41073,31,3,41269,31,3,42077,31,3,44201,31,3,47044,6,24.7,-1.2699491,36.8135968,-1.300921,36.828195,555,2843,196,2932
3348,22144,2066,3,Business,22,3,35691,22,3,35720,22,3,36485,22,3,36606,22,3,37574,10,15.3,-1.316961,36.820337,-1.2850113,36.7610856,676,968,29,886
3349,22605,1500,3,Business,11,6,34698,11,6,34712,11,6,34714,11,6,36048,11,6,36150,8,23.25888921888938,-1.3004062,36.829741,-1.2638185,36.7930057,472,102,14,1336
3350,22264,2075,1,Personal,31,2,62242,31,2,62274,31,2,62772,31,2,63748,31,2,65027,8,20.0,-1.2791714,36.8255997,-1.3052084,36.7691387,105,1279,32,1474
3351,4597,2982,3,Business,25,1,40439,25,1,40459,25,1,41377,25,1,43113,25,1,46305,18,25.3,-1.300921,36.828195,-1.177202,36.8351183,448,3192,20,2654
3352,18750,474,3,Business,6,5,54660,6,5,54750,6,5,55254,6,5,55428,6,5,56781,4,22.3,-1.264945,36.784678,-1.2567849,36.8140543,228,1353,90,678
3353,22809,2726,3,Personal,14,1,54653,14,1,54664,14,1,55119,14,1,55689,14,1,58857,12,25.9,-1.2812624,36.7714609,-1.3271684,36.8173021,46,3168,11,1025
3354,7407,627,3,Business,4,4,58191,4,4,58259,4,4,58443,4,4,59359,4,4,59630,8,27.2,-1.2551895,36.7822034,-1.2908427,36.7829424,411,271,68,1100
3355,20840,928,3,Business,20,1,39205,20,1,39415,20,1,39492,20,1,40708,20,1,41539,7,23.25888921888938,-1.2551895,36.7822034,-1.290724,36.81947,438,831,210,1293
3356,23572,1839,1,Personal,12,7,47504,12,7,47520,12,7,48046,12,7,48495,12,7,50131,10,19.5,-1.288621,36.778846,-1.3314048,36.8229367,465,1636,16,975
3357,18351,3647,3,Business,6,4,58596,6,4,58651,6,4,59213,6,4,60337,6,4,61134,5,22.6,-1.272639,36.794723,-1.2891064,36.7743692,857,797,55,1686
3358,25054,1882,1,Business,4,4,68681,4,4,69145,4,4,70203,4,4,71074,4,4,72073,8,23.25888921888938,-1.2268871,36.8073946,-1.2591019,36.800577,178,999,464,1929
3359,14783,111,3,Business,9,4,45856,9,4,46046,9,4,46140,9,4,46427,9,4,48978,19,23.25888921888938,-1.2551895,36.7822034,-1.3343055,36.7329632,952,2551,190,381
3360,12651,1075,3,Business,22,2,42484,22,2,42502,22,2,45228,22,2,45406,22,2,45763,3,24.1,-1.2527958,36.8003131,-1.2615888,36.7928732,56,357,18,2904
3361,23675,2412,3,Business,28,5,45410,28,5,45459,28,5,45895,28,5,46721,28,5,47870,13,25.0,-1.2571472,36.7950633,-1.2297202,36.8819507,726,1149,49,1262
3362,2508,1413,1,Business,18,4,38286,18,4,38492,18,4,39514,18,4,39725,18,4,40710,4,25.3,-1.2830057,36.8175478,-1.2740396,36.7993518,477,985,206,1233
3363,26811,1811,2,Personal,10,2,35849,10,2,35974,10,2,36398,10,2,36993,10,2,39540,8,16.3,-1.294869,36.815327,-1.2804664,36.7701111,431,2547,125,1019
3364,7091,3355,3,Business,30,7,60061,30,7,63909,30,7,64861,30,7,65135,30,7,66536,10,25.1,-1.3472066,36.7692638,-1.3052491,36.8223899,612,1401,3848,1226
3365,5320,633,3,Business,10,4,47692,10,4,47744,10,4,48146,10,4,48735,10,4,49015,4,25.4,-1.3004062,36.829741,-1.3077869,36.8443207,878,280,52,991
3366,5481,2423,3,Business,12,2,36584,12,2,36601,12,2,36621,12,2,37097,12,2,37645,5,17.8,-1.2551895,36.7822034,-1.2596241,36.762407,649,548,17,496
3367,27313,3686,3,Business,12,2,41581,12,2,41642,12,2,42251,12,2,42338,12,2,45026,6,28.0,-1.2551895,36.7822034,-1.2743253,36.7721049,167,2688,61,696
3368,24547,2582,3,Business,11,1,38187,11,1,38219,11,1,39188,11,1,39369,11,1,42223,18,26.5,-1.2551895,36.7822034,-1.3343129,36.8854175,118,2854,32,1150
3369,15202,1363,3,Business,19,4,31807,19,4,31837,19,4,32019,19,4,32094,19,4,32796,4,14.5,-1.3004062,36.829741,-1.3077869,36.8443207,951,702,30,257
3370,5176,1271,3,Business,12,3,58096,12,3,60630,12,3,60744,12,3,61454,12,3,62152,8,24.4,-1.3244885,36.897792,-1.3332749,36.8708147,116,698,2534,824
3371,11409,2582,3,Business,17,5,29354,17,5,29372,17,5,29389,17,5,32984,17,5,34387,24,23.25888921888938,-1.3343129,36.8854175,-1.2551895,36.7822034,746,1403,18,3612
3372,790,791,3,Business,5,5,31570,5,5,31581,5,5,32441,5,5,32620,5,5,36498,17,17.8,-1.2931446,36.7613971,-1.3610501,36.7520889,680,3878,11,1039
3373,23472,391,3,Business,29,3,52861,29,3,53245,29,3,54180,29,3,55271,29,3,56817,5,20.9,-1.300921,36.828195,-1.2784063,36.8222933,183,1546,384,2026
3374,6760,1712,1,Personal,6,4,31682,6,4,31712,6,4,32911,6,4,33257,6,4,34482,13,17.9,-1.3206958,36.8769553,-1.305568,36.820064,820,1225,30,1545
3375,2636,552,3,Business,12,6,47649,12,6,47676,12,6,48122,12,6,48370,12,6,50339,14,23.25888921888938,-1.2852569,36.8976121,-1.3562374,36.9042954,547,1969,27,694
3376,24738,20,3,Business,20,1,46566,20,1,46609,20,1,46933,20,1,47099,20,1,48787,13,23.25888921888938,-1.2628638,36.8070399,-1.3343129,36.8637112,807,1688,43,490
3377,1943,3372,3,Business,18,3,38816,18,3,38876,18,3,39258,18,3,40048,18,3,42974,11,19.9,-1.3169591,36.7000029,-1.2969741,36.7856612,844,2926,60,1172
3378,20207,3368,2,Personal,5,5,47847,5,5,50240,5,5,50975,5,5,51295,5,5,52166,9,26.8,-1.362319,36.743983,-1.3187761,36.8069926,536,871,2393,1055
3379,18467,3686,3,Business,24,4,43388,24,4,43425,24,4,43787,24,4,44150,24,4,44665,1,24.4,-1.2551895,36.7822034,-1.2606254,36.783056,755,515,37,725
3380,12331,635,3,Business,15,4,28700,15,4,28832,15,4,30282,15,4,32859,15,4,34011,7,19.7,-1.3016417,36.8271679,-1.2599563,36.7993439,778,1152,132,4027
3381,6462,3340,3,Business,10,5,50542,10,5,50582,10,5,51563,10,5,53081,10,5,56173,21,21.7,-1.2097181,36.7942591,-1.2751928,36.7429386,208,3092,40,2499
3382,27148,2767,3,Business,13,4,46947,13,4,47004,13,4,47664,13,4,47827,13,4,48448,1,22.0,-1.257773,36.795486,-1.2580991,36.7941519,279,621,57,823
3383,8875,2200,3,Business,11,7,38797,11,7,39295,11,7,39303,11,7,39778,11,7,40409,2,25.2,-1.28878,36.8168312,-1.290894,36.822971,206,631,498,483
3384,16341,3621,3,Business,5,5,33932,5,5,33985,5,5,34772,5,5,34988,5,5,37847,16,19.8,-1.2836583,36.7886014,-1.3610501,36.7520889,778,2859,53,1003
3385,27688,3149,3,Business,15,3,42799,15,3,42831,15,3,43285,15,3,43902,15,3,45871,12,23.25888921888938,-1.3167113,36.8301563,-1.276954,36.765926,690,1969,32,1071
3386,21661,867,3,Business,14,4,32552,14,4,32787,14,4,32908,14,4,34641,14,4,36059,10,17.9,-1.2996533,36.8292629,-1.2991441,36.7528804,101,1418,235,1854
3387,17292,3355,3,Business,15,2,56295,15,2,56349,15,2,56887,15,2,57225,15,2,58757,7,24.4,-1.2571472,36.7950633,-1.3052491,36.8223899,817,1532,54,876
3388,5447,3135,3,Personal,23,1,39782,23,1,39789,23,1,39854,23,1,40049,23,1,43247,16,18.5,-1.2470959,36.8729823,-1.3194518,36.869396,260,3198,7,260
3389,18740,2258,3,Business,24,3,36371,24,3,38289,24,3,39685,24,3,39868,24,3,42655,5,19.9,-1.2571472,36.7950633,-1.2793642,36.8295717,171,2787,1918,1579
3390,12445,1363,3,Business,16,2,44622,16,2,44710,16,2,44829,16,2,45235,16,2,46981,5,23.25888921888938,-1.3004062,36.829741,-1.2770708,36.8231093,686,1746,88,525
3391,14168,2295,1,Personal,31,2,47237,31,2,47320,31,2,48507,31,2,48741,31,2,50407,7,22.1,-1.2857117,36.7968296,-1.2835586,36.8125641,722,1666,83,1421
3392,24792,2700,3,Business,23,7,68988,23,7,69470,23,7,70200,23,7,70881,23,7,71891,8,19.6,-1.3052672,36.7538539,-1.2845835,36.8079121,565,1010,482,1411
3393,10876,3613,3,Business,23,2,56984,23,2,57420,23,2,58584,23,2,59229,23,2,60972,6,19.0,-1.2733622,36.7704045,-1.2676041,36.8062903,952,1743,436,1809
3394,2294,3291,3,Business,27,6,37680,27,6,37719,27,6,38429,27,6,38752,27,6,40494,17,23.25888921888938,-1.344446,36.756597,-1.2600926,36.8088685,790,1742,39,1033
3395,4969,1719,3,Business,14,4,40075,14,4,40268,14,4,41643,14,4,41795,14,4,43590,16,19.2,-1.296797,36.7764525,-1.2330694,36.745451,379,1795,193,1527
3396,7300,3701,3,Business,12,1,41310,12,1,41702,12,1,42148,12,1,42595,12,1,43921,8,23.7,-1.2903643,36.8319433,-1.2684239,36.7952462,403,1326,392,893
3397,9545,1721,3,Business,14,4,30036,14,4,30113,14,4,30979,14,4,31658,14,4,36355,13,17.7,-1.2551895,36.7822034,-1.3053578,36.8607913,131,4697,77,1545
3398,13028,2017,3,Business,22,2,40908,22,2,41089,22,2,41991,22,2,42229,22,2,43456,7,19.2,-1.2865096,36.8169364,-1.2963097,36.7688221,412,1227,181,1140
3399,4225,2987,3,Business,28,2,59826,28,2,59862,28,2,60420,28,2,60583,28,2,61553,4,18.2,-1.270212,36.8210877,-1.260232,36.807334,4,970,36,721
3400,21630,972,3,Business,4,4,35230,4,4,35331,4,4,37319,4,4,37483,4,4,38403,7,18.3,-1.2862033,36.8152966,-1.31861,36.8113967,726,920,101,2152
3401,16669,1011,1,Personal,8,6,62703,8,6,62718,8,6,63848,8,6,64438,8,6,65872,13,23.0,-1.3071754,36.7773762,-1.2321733,36.7974377,208,1434,15,1720
3402,20769,391,3,Business,15,3,55431,15,3,55528,15,3,55914,15,3,60392,15,3,62890,5,25.2,-1.300921,36.828195,-1.2784063,36.8222933,921,2498,97,4864
3403,23775,2987,3,Business,3,5,40973,3,5,41007,3,5,41293,3,5,41556,3,5,43206,9,21.2,-1.270212,36.8210877,-1.3014461,36.7661381,427,1650,34,549
3404,18035,1859,3,Business,12,5,37503,12,5,37553,12,5,38096,12,5,38394,12,5,39776,7,24.3,-1.2626765,36.795599,-1.2993666,36.8232195,89,1382,50,841
3405,23912,2701,3,Business,29,1,34658,29,1,34742,29,1,34745,29,1,37058,29,1,39321,4,19.0,-1.281754,36.8324229,-1.2765736,36.8513646,456,2263,84,2316
3406,22616,331,1,Personal,19,5,55632,19,5,56285,19,5,57084,19,5,57635,19,5,59276,14,27.6,-1.1992502,36.8294932,-1.255392,36.792539,247,1641,653,1350
3407,16167,981,3,Business,20,3,57711,20,3,58267,20,3,59928,20,3,60121,20,3,61575,8,21.8,-1.281597,36.826482,-1.3030794,36.7771764,88,1454,556,1854
3408,3256,126,3,Personal,3,1,34820,3,1,34881,3,1,35595,3,1,35733,3,1,37290,7,18.1,-1.2731477,36.7950803,-1.295723,36.822692,778,1557,61,852
3409,13683,2100,3,Business,1,4,50213,1,4,51982,1,4,53150,1,4,53233,1,4,54322,8,23.25888921888938,-1.2765736,36.8513646,-1.2413316,36.8785525,817,1089,1769,1251
3410,14368,393,3,Business,1,5,32188,1,5,32208,1,5,32221,1,5,34398,1,5,34403,4,23.25888921888938,-1.3167113,36.8301563,-1.3004062,36.829741,619,5,20,2190
3411,13990,1205,3,Business,24,5,51536,24,5,52648,24,5,53300,24,5,53842,24,5,55698,8,22.9,-1.2495931,36.8065087,-1.2904696,36.7963745,427,1856,1112,1194
3412,15556,3517,3,Business,10,1,32447,10,1,32472,10,1,32482,10,1,35152,10,1,35638,16,16.5,-1.300921,36.828195,-1.3882008,36.7699445,70,486,25,2680
3413,25293,53,3,Business,17,4,44927,17,4,47468,17,4,48517,17,4,48987,17,4,50164,8,28.0,-1.3167113,36.8301563,-1.2770708,36.8231093,725,1177,2541,1519
3414,21475,1131,3,Business,29,3,62116,29,3,62195,29,3,62399,29,3,62869,29,3,64742,13,21.2,-1.2527958,36.8003131,-1.207546,36.7913976,139,1873,79,674
3415,26816,1500,3,Business,4,4,37952,4,4,38000,4,4,38551,4,4,39341,4,4,40951,10,25.3,-1.2991441,36.7528804,-1.2638185,36.7930057,926,1610,48,1341
3416,18932,1220,3,Personal,4,3,37511,4,3,37520,4,3,37608,4,3,38808,4,3,40494,14,17.1,-1.2567464,36.7915273,-1.2156006,36.8916865,116,1686,9,1288
3417,8852,633,3,Business,12,1,29437,12,1,29529,12,1,31445,12,1,32066,12,1,32678,4,19.6,-1.3077869,36.8443207,-1.3004062,36.829741,684,612,92,2537
3418,9524,3291,3,Business,16,4,35164,16,4,35190,16,4,35585,16,4,35953,16,4,37410,4,23.25888921888938,-1.2663631,36.8163329,-1.2600926,36.8088685,204,1457,26,763
3419,5367,3318,3,Business,29,5,55443,29,5,55489,29,5,56103,29,5,56174,29,5,57312,4,29.0,-1.3077869,36.8443207,-1.3004062,36.829741,343,1138,46,685
3420,6874,3423,1,Personal,9,7,50011,9,7,51566,9,7,51952,9,7,52085,9,7,53057,7,25.9,-1.2590031,36.8078168,-1.3056847,36.8101341,103,972,1555,519
3421,18403,3557,3,Business,11,4,44095,11,4,44102,11,4,44443,11,4,45054,11,4,46327,6,23.7,-1.2894818,36.7880534,-1.2546732,36.8086796,948,1273,7,952
3422,13184,3647,3,Business,8,5,46108,8,5,46160,8,5,46441,8,5,46822,8,5,47889,7,24.3,-1.2971877,36.8270159,-1.272639,36.794723,875,1067,52,662
3423,27069,3777,1,Personal,25,1,70124,25,1,70245,25,1,70555,25,1,71172,25,1,71885,6,23.25888921888938,-1.2925792,36.79069,-1.267452,36.806015,86,713,121,927
3424,17883,3599,3,Business,4,2,43740,4,2,45742,4,2,48349,4,2,48874,4,2,50638,12,22.3,-1.3302996,36.8707935,-1.297101,36.798243,416,1764,2002,3132
3425,17480,496,3,Business,30,2,43690,30,2,43960,30,2,44863,30,2,45017,30,2,46177,8,23.25888921888938,-1.2551895,36.7822034,-1.2940713,36.7890758,937,1160,270,1057
3426,9920,1927,3,Business,28,3,49710,28,3,49738,28,3,51670,28,3,52499,28,3,54829,20,23.25888921888938,-1.3463042,36.768164,-1.2413316,36.8785525,870,2330,28,2761
3427,19306,1156,2,Personal,8,1,38321,8,1,38481,8,1,39107,8,1,40155,8,1,41444,10,24.5,-1.324282,36.86625,-1.2861874,36.8128448,871,1289,160,1674
3428,9780,1271,3,Business,22,5,52806,22,5,52843,22,5,53781,22,5,53976,22,5,57227,23,23.25888921888938,-1.3244885,36.897792,-1.3107918,36.761794,890,3251,37,1133
3429,7598,900,2,Personal,2,2,37470,2,2,37880,2,2,38580,2,2,38819,2,2,44198,20,21.2,-1.3508036,36.7093385,-1.2590031,36.8078168,805,5379,410,939
3430,16522,2828,3,Business,12,2,42877,12,2,42929,12,2,43605,12,2,43727,12,2,44191,2,21.2,-1.2615888,36.7928732,-1.2560455,36.7800867,726,464,52,798
3431,20417,1856,3,Business,4,4,52803,4,4,53067,4,4,53790,4,4,54560,4,4,55988,8,27.5,-1.273009,36.802807,-1.3126476,36.831455,709,1428,264,1493
3432,5360,1205,3,Business,1,3,43661,1,3,43695,1,3,44412,1,3,44644,1,3,46037,4,20.0,-1.2810807,36.8144229,-1.2654228,36.8033218,754,1393,34,949
3433,21833,1189,2,Personal,21,1,47222,21,1,47375,21,1,48268,21,1,48538,21,1,53181,4,20.2,-1.2842665,36.7967626,-1.281553,36.8185334,844,4643,153,1163
3434,26298,2523,3,Business,26,1,43790,26,1,44880,26,1,45675,26,1,45769,26,1,46670,9,23.2,-1.2551895,36.7822034,-1.3090727,36.8315262,425,901,1090,889
3435,5316,1329,3,Business,13,1,55218,13,1,55408,13,1,56245,13,1,56425,13,1,57402,7,23.25888921888938,-1.273056,36.811298,-1.2670841,36.7680551,576,977,190,1017
3436,21726,3222,3,Business,18,2,32638,18,2,32658,18,2,32673,18,2,34045,18,2,35859,8,16.3,-1.2551895,36.7822034,-1.295156,36.8094306,116,1814,20,1387
3437,11793,978,1,Personal,25,3,43998,25,3,44100,25,3,45464,25,3,46583,25,3,49187,5,23.25888921888938,-1.3084067,36.8345014,-1.2767856,36.8285595,616,2604,102,2483
3438,23255,3331,3,Business,14,3,33776,14,3,34250,14,3,35015,14,3,35087,14,3,36423,5,18.3,-1.2551895,36.7822034,-1.2711982,36.8240199,228,1336,474,837
3439,4496,3434,3,Business,26,5,31499,26,5,31590,26,5,33482,26,5,33791,26,5,34882,5,23.25888921888938,-1.2963097,36.7688221,-1.3041129,36.8104939,855,1091,91,2201
3440,22622,53,3,Business,6,3,33499,6,3,33697,6,3,34197,6,3,35808,6,3,36429,7,16.6,-1.2638185,36.7930057,-1.2770708,36.8231093,953,621,198,2111
3441,13117,3635,1,Business,24,1,46629,24,1,46648,24,1,46654,24,1,47467,24,1,48049,3,22.3,-1.2584143,36.8048002,-1.2615888,36.7928732,51,582,19,819
3442,638,393,3,Business,9,4,50236,9,4,50282,9,4,51358,9,4,51659,9,4,54614,14,23.25888921888938,-1.3167113,36.8301563,-1.306378,36.7519845,411,2955,46,1377
3443,23511,2763,3,Business,18,3,43643,18,3,43698,18,3,44234,18,3,44499,18,3,47773,5,19.9,-1.2551895,36.7822034,-1.2711982,36.8240199,415,3274,55,801
3444,20782,419,3,Business,6,3,53715,6,3,53746,6,3,54746,6,3,55129,6,3,56977,21,27.7,-1.2571472,36.7950633,-1.3562374,36.9042954,717,1848,31,1383
3445,27352,2055,3,Business,18,1,43544,18,1,44448,18,1,45275,18,1,45459,18,1,47334,13,23.25888921888938,-1.2895164,36.825984,-1.214328,36.7911903,330,1875,904,1011
3446,12826,420,3,Business,30,2,45359,30,2,46449,30,2,48444,30,2,48824,30,2,51594,22,27.4,-1.2384923,36.9007845,-1.2720806,36.7751959,900,2770,1090,2375
3447,14094,3201,3,Business,10,1,33798,10,1,33954,10,1,37183,10,1,39069,10,1,39904,7,18.4,-1.225322,36.80855,-1.2584143,36.8048002,250,835,156,5115
3448,6062,1500,3,Business,16,4,34139,16,4,34211,16,4,34241,16,4,38303,16,4,39350,8,23.25888921888938,-1.3004062,36.829741,-1.2638185,36.7930057,547,1047,72,4092
3449,958,1687,3,Business,10,1,56354,10,1,56617,10,1,57203,10,1,57814,10,1,58501,3,18.4,-1.2626574,36.8014034,-1.2755629,36.8131522,576,687,263,1197
3450,15627,2195,1,Business,17,2,52025,17,2,52064,17,2,52068,17,2,53190,17,2,54207,11,24.6,-1.265715,36.823815,-1.331619,36.847976,886,1017,39,1126
3451,23587,238,3,Business,18,4,52569,18,4,52615,18,4,53383,18,4,53731,18,4,58264,16,23.25888921888938,-1.2991441,36.7528804,-1.3077869,36.8443207,267,4533,46,1116
3452,25989,3283,3,Business,28,2,39250,28,2,39282,28,2,39751,28,2,40153,28,2,41257,6,21.2,-1.2663631,36.8163329,-1.2628473,36.781805,289,1104,32,871
3453,22237,2615,1,Personal,13,3,55335,13,3,56363,13,3,57755,13,3,59328,13,3,61354,9,23.4,-1.336582,36.871737,-1.302559,36.819555,755,2026,1028,2965
3454,11539,391,3,Business,23,2,36792,23,2,36825,23,2,37232,23,2,37402,23,2,39648,5,23.25888921888938,-1.2784063,36.8222933,-1.3081376,36.8329772,456,2246,33,577
3455,27420,2150,3,Business,18,4,31733,18,4,31747,18,4,32459,18,4,33258,18,4,35125,11,23.25888921888938,-1.303596,36.778378,-1.344446,36.756597,435,1867,14,1511
3456,23276,3718,3,Business,7,3,57716,7,3,57892,7,3,58331,7,3,59069,7,3,62327,23,28.3,-1.2650027,36.8126242,-1.29192,36.95459,884,3258,176,1177
3457,19372,2330,3,Business,2,2,52363,2,2,52417,2,2,53797,2,2,53898,2,2,56331,7,29.5,-1.2671943,36.8062533,-1.2873232,36.7658572,167,2433,54,1481
3458,26144,2801,3,Business,22,2,58955,22,2,58982,22,2,59937,22,2,60447,22,2,61685,11,24.9,-1.2595422,36.7871178,-1.233433,36.8004202,52,1238,27,1465
3459,19386,2457,3,Business,23,4,35371,23,4,35452,23,4,36920,23,4,37117,23,4,40537,11,23.25888921888938,-1.2551895,36.7822034,-1.3002865,36.7491504,279,3420,81,1665
3460,15291,1482,3,Business,1,1,40021,1,1,40042,1,1,40443,1,1,40657,1,1,43247,18,23.25888921888938,-1.2649605,36.7981777,-1.3196979,36.7009845,863,2590,21,615
3461,5528,3203,3,Business,14,5,35727,14,5,35740,14,5,35811,14,5,36145,14,5,37603,16,18.1,-1.303596,36.778378,-1.228911,36.881876,933,1458,13,405
3462,26957,393,3,Business,18,2,37563,18,2,45232,18,2,45651,18,2,47190,18,2,48630,10,22.7,-1.3177547,36.8303703,-1.2574219,36.7927073,731,1440,7669,1958
3463,16709,2330,3,Business,10,5,52562,10,5,54215,10,5,54700,10,5,55421,10,5,56518,10,23.25888921888938,-1.2524916,36.8656196,-1.2642903,36.8002137,438,1097,1653,1206
3464,7566,3599,3,Business,28,3,47312,28,3,47498,28,3,48474,28,3,50712,28,3,52933,17,23.25888921888938,-1.3302996,36.8707935,-1.2949439,36.7604214,551,2221,186,3214
3465,20204,2212,3,Business,17,5,51316,17,5,51356,17,5,51662,17,5,52031,17,5,52834,5,23.25888921888938,-1.2571472,36.7950633,-1.280753,36.8191175,206,803,40,675
3466,6017,393,3,Business,11,5,48294,11,5,48351,11,5,48848,11,5,49157,11,5,51109,14,26.2,-1.3167113,36.8301563,-1.306378,36.7519845,583,1952,57,806
3467,7594,1280,3,Business,20,3,53101,20,3,53114,20,3,53137,20,3,53865,20,3,54320,3,29.2,-1.2551895,36.7822034,-1.265338,36.8088155,958,455,13,751
3468,19127,635,3,Business,11,5,55450,11,5,60145,11,5,60674,11,5,61887,11,5,63298,7,20.6,-1.3007481,36.8341778,-1.2602337,36.7990548,720,1411,4695,1742
3469,26795,2956,3,Business,20,2,46467,20,2,48844,20,2,49493,20,2,49686,20,2,52001,6,24.0,-1.290894,36.822971,-1.2584143,36.8048002,674,2315,2377,842
3470,20112,3080,3,Business,3,1,44356,3,1,47984,3,1,48622,3,1,49587,3,1,52561,21,23.2,-1.2825223,36.9014566,-1.2551895,36.7822034,62,2974,3628,1603
3471,19588,2523,3,Business,16,4,38075,16,4,38137,16,4,38512,16,4,38868,16,4,38869,4,23.25888921888938,-1.2551895,36.7822034,-1.2566689,36.7796952,253,1,62,731
3472,22599,2701,3,Business,30,3,57124,30,3,58043,30,3,58684,30,3,58878,30,3,60053,7,25.3,-1.279395,36.825364,-1.311208,36.778743,844,1175,919,835
3473,14864,2587,3,Business,10,3,56079,10,3,56136,10,3,57236,10,3,57925,10,3,61468,16,30.5,-1.323615,36.700475,-1.28878,36.8168312,195,3543,57,1789
3474,14272,2532,3,Business,19,5,33706,19,5,34087,19,5,35423,19,5,35610,19,5,36840,7,20.4,-1.2551895,36.7822034,-1.2934657,36.8212737,79,1230,381,1523
3475,1985,1075,3,Business,24,7,33335,24,7,34342,24,7,36106,24,7,37663,24,7,39450,1,20.5,-1.2584143,36.8048002,-1.2527958,36.8003131,119,1787,1007,3321
3476,11388,2944,3,Personal,6,4,51720,6,4,51937,6,4,53056,6,4,53870,6,4,55451,10,21.1,-1.2772989,36.8526035,-1.2642333,36.7795483,815,1581,217,1933
3477,27068,1245,3,Business,27,6,45324,27,6,45447,27,6,45571,27,6,46366,27,6,49041,19,23.25888921888938,-1.3198615,36.7110323,-1.3159197,36.8516724,427,2675,123,919
3478,13710,868,3,Business,2,2,52151,2,2,52210,2,2,52445,2,2,55654,2,2,55913,10,29.5,-1.228911,36.881876,-1.265715,36.823815,445,259,59,3444
3479,27125,1075,3,Business,6,3,46948,6,3,46966,6,3,47020,6,3,47471,6,3,49273,13,23.25888921888938,-1.2285835,36.8826468,-1.2527958,36.8003131,210,1802,18,505
3480,1280,2956,3,Business,16,6,30909,16,6,31432,16,6,33533,16,6,35519,16,6,35740,5,20.1,-1.2584143,36.8048002,-1.2857548,36.819062,436,221,523,4087
3481,20908,1500,3,Business,21,3,59869,21,3,60156,21,3,60172,21,3,60838,21,3,62219,8,23.25888921888938,-1.3004062,36.829741,-1.2574219,36.7927073,515,1381,287,682
3482,8137,3521,3,Business,27,3,44246,27,3,44281,27,3,44647,27,3,45390,27,3,46002,2,26.0,-1.2701582,36.8074433,-1.2696908,36.81519,96,612,35,1109
3483,8887,3434,3,Business,6,3,56145,6,3,56164,6,3,56487,6,3,56746,6,3,57806,6,23.25888921888938,-1.2963097,36.7688221,-1.302559,36.819555,341,1060,19,582
3484,17825,635,3,Business,15,5,33988,15,5,34025,15,5,34560,15,5,35642,15,5,36336,7,19.2,-1.300921,36.828195,-1.2599563,36.7993439,61,694,37,1617
3485,6467,1329,3,Business,1,5,54697,1,5,54710,1,5,54912,1,5,54995,1,5,55568,3,28.7,-1.273056,36.811298,-1.263499,36.8014548,783,573,13,285
3486,19882,1500,3,Business,15,1,57676,15,1,57814,15,1,58188,15,1,59607,15,1,59874,6,23.25888921888938,-1.2770708,36.8231093,-1.2638185,36.7930057,812,267,138,1793
3487,14104,1651,3,Business,7,2,30824,7,2,30947,7,2,31361,7,2,31432,7,2,33595,21,23.25888921888938,-1.3562374,36.9042954,-1.2551895,36.7822034,863,2163,123,485
3488,21308,496,3,Business,10,1,58255,10,1,58297,10,1,58645,10,1,59238,10,1,60299,7,18.5,-1.2571472,36.7950633,-1.2944292,36.7793569,709,1061,42,941
3489,26471,1246,3,Business,21,1,40608,21,1,40696,21,1,41420,21,1,41971,21,1,42645,5,25.5,-1.2571472,36.7950633,-1.2619524,36.823472,741,674,88,1275
3490,20562,1768,1,Personal,3,3,39891,3,3,39934,3,3,40505,3,3,41045,3,3,42458,10,23.8,-1.301809,36.75643,-1.2750257,36.8157165,905,1413,43,1111
3491,13330,3647,3,Business,14,4,48013,14,4,48141,14,4,48885,14,4,49183,14,4,50118,6,27.6,-1.272639,36.794723,-1.298437,36.781971,576,935,128,1042
3492,11219,393,3,Business,19,1,41502,19,1,41629,19,1,41835,19,1,43835,19,1,45767,14,24.5,-1.3177547,36.8303703,-1.306378,36.7519845,515,1932,127,2206
3493,26784,3372,3,Business,8,3,50432,8,3,50452,8,3,51109,8,3,51374,8,3,53096,11,25.7,-1.3169591,36.7000029,-1.2969741,36.7856612,844,1722,20,922
3494,10224,868,3,Business,9,4,54891,9,4,54945,9,4,55919,9,4,56195,9,4,56724,3,26.0,-1.2783849,36.8163445,-1.265715,36.823815,882,529,54,1250
3495,27905,2714,1,Personal,8,5,51754,8,5,52794,8,5,56243,8,5,56502,8,5,60346,27,21.7,-1.3518598,36.7324661,-1.2235201,36.8020608,421,3844,1040,3708
3496,21146,136,3,Business,25,1,61660,25,1,61671,25,1,62689,25,1,62980,25,1,66466,20,23.25888921888938,-1.2962832,36.7849683,-1.3190102,36.9230693,330,3486,11,1309
3497,12898,393,3,Business,15,4,42833,15,4,44576,15,4,46684,15,4,47207,15,4,48566,10,24.4,-1.3177547,36.8303703,-1.2574219,36.7927073,532,1359,1743,2631
3498,26904,2232,2,Personal,22,5,53068,22,5,53386,22,5,54314,22,5,55164,22,5,56481,10,23.25888921888938,-1.2846475,36.8275903,-1.2256671,36.8148558,812,1317,318,1778
3499,24790,2596,3,Business,18,1,53140,18,1,53184,18,1,53627,18,1,54329,18,1,56056,17,30.6,-1.2963097,36.7688221,-1.2300082,36.8867427,247,1727,44,1145
3500,3536,1273,2,Personal,22,7,50631,22,7,50642,22,7,51090,22,7,51554,22,7,51743,2,19.2,-1.2786894,36.8032321,-1.2687974,36.7960339,858,189,11,912
3501,14677,635,3,Business,19,2,56077,19,2,57101,19,2,58552,19,2,58833,19,2,61074,15,30.0,-1.3198615,36.7110323,-1.2602337,36.7990548,269,2241,1024,1732
3502,10204,53,3,Business,10,3,45273,10,3,45302,10,3,45318,10,3,48784,10,3,48798,5,30.8,-1.3004062,36.829741,-1.2770708,36.8231093,507,14,29,3482
3503,64,1746,3,Business,2,4,61841,2,4,61891,2,4,63874,2,4,64366,2,4,67807,20,23.8,-1.3065588,36.9076533,-1.296797,36.7764525,549,3441,50,2475
3504,21418,2066,3,Business,4,2,42219,4,2,42357,4,2,43311,4,2,43598,4,2,45003,13,18.7,-1.316961,36.820337,-1.327079,36.881469,320,1405,138,1241
3505,14270,3496,3,Business,28,1,50791,28,1,50871,28,1,51573,28,1,52028,28,1,52465,2,24.4,-1.300921,36.828195,-1.3092358,36.836384,654,437,80,1157
3506,12919,1300,3,Personal,22,5,59294,22,5,59568,22,5,60049,22,5,64292,22,5,66532,7,28.5,-1.2795819,36.8307141,-1.277783,36.7816464,276,2240,274,4724
3507,13796,2423,3,Business,30,2,38719,30,2,38948,30,2,39610,30,2,40248,30,2,42111,8,23.25888921888938,-1.2551895,36.7822034,-1.2995101,36.8185828,245,1863,229,1300
3508,11836,2330,3,Business,8,1,56553,8,1,56577,8,1,57892,8,1,58116,8,1,59192,6,29.4,-1.2642903,36.8002137,-1.2944081,36.7897046,709,1076,24,1539
3509,16457,868,3,Business,12,2,49471,12,2,49529,12,2,50161,12,2,50426,12,2,51763,9,23.25888921888938,-1.318062,36.849326,-1.265715,36.823815,728,1337,58,897
3510,11302,246,3,Business,27,5,49184,27,5,49208,27,5,49535,27,5,49803,27,5,51048,17,24.0,-1.2156006,36.8916865,-1.2584143,36.8048002,844,1245,24,595
3511,16482,1500,3,Business,26,2,46108,26,2,46122,26,2,46643,26,2,47148,26,2,48265,8,27.4,-1.3004062,36.829741,-1.2638185,36.7930057,56,1117,14,1026
3512,27619,1245,3,Business,27,6,37538,27,6,38501,27,6,39652,27,6,41135,27,6,43769,19,23.25888921888938,-1.300921,36.828195,-1.3198615,36.7110323,427,2634,963,2634
3513,861,2523,3,Business,30,2,35927,30,2,36169,30,2,36785,30,2,39959,30,2,39961,17,23.25888921888938,-1.2551895,36.7822034,-1.2778747,36.8831829,953,2,242,3790
3514,28116,1492,1,Personal,28,5,36443,28,5,36528,28,5,37855,28,5,38159,28,5,40424,15,25.1,-1.2911796,36.8215068,-1.1855066,36.8254646,96,2265,85,1631
3515,25319,2421,2,Personal,15,1,36264,15,1,36292,15,1,36924,15,1,37266,15,1,39285,20,23.25888921888938,-1.2724096,36.8135361,-1.3447079,36.91105,409,2019,28,974
3516,17700,1148,3,Business,25,6,36301,25,6,36320,25,6,37747,25,6,39673,25,6,43258,17,23.25888921888938,-1.3099295,36.8436807,-1.3671327,36.7564238,2,3585,19,3353
3517,1616,1329,3,Business,9,3,48525,9,3,48547,9,3,48866,9,3,48976,9,3,49947,7,25.3,-1.273056,36.811298,-1.225021,36.801816,655,971,22,429
3518,16259,2523,3,Business,18,4,52463,18,4,52680,18,4,53500,18,4,55213,18,4,55558,2,23.25888921888938,-1.2551895,36.7822034,-1.2580991,36.7941519,436,345,217,2533
3519,16856,2523,3,Business,10,1,35091,10,1,35105,10,1,35113,10,1,35550,10,1,37670,14,18.1,-1.2551895,36.7822034,-1.302453,36.8668919,105,2120,14,445
3520,25159,3674,3,Business,13,2,52798,13,2,52836,13,2,52867,13,2,53175,13,2,54529,12,26.3,-1.2551895,36.7822034,-1.3097713,36.849494,120,1354,38,339
3521,2229,2956,3,Business,16,4,50271,16,4,50290,16,4,50681,16,4,51200,16,4,52816,9,23.25888921888938,-1.3014461,36.7661381,-1.2584143,36.8048002,535,1616,19,910
3522,13273,867,3,Business,11,4,35677,11,4,35759,11,4,36075,11,4,36551,11,4,37522,9,22.0,-1.2638185,36.7930057,-1.2991441,36.7528804,438,971,82,792
3523,15941,1363,3,Business,7,5,52188,7,5,52504,7,5,53707,7,5,53794,7,5,55962,5,23.25888921888938,-1.3004062,36.829741,-1.2770708,36.8231093,109,2168,316,1290
3524,9233,3201,3,Business,18,4,36173,18,4,36963,18,4,37006,18,4,37267,18,4,38035,4,20.6,-1.2805757,36.8223948,-1.264272,36.7978791,583,768,790,304
3525,21851,1637,3,Business,21,1,45360,21,1,45587,21,1,46373,21,1,46608,21,1,48155,15,25.6,-1.207546,36.7913976,-1.2615888,36.7928732,611,1547,227,1021
3526,26422,186,3,Business,10,1,50228,10,1,53713,10,1,53944,10,1,54961,10,1,59825,23,19.0,-1.3700383,36.9190174,-1.2571472,36.7950633,498,4864,3485,1248
3527,14422,3373,1,Personal,14,2,54470,14,2,54485,14,2,54513,14,2,56090,14,2,60038,15,23.8,-1.296797,36.7764525,-1.3581253,36.7444904,179,3948,15,1605
3528,5434,1502,3,Business,29,1,32486,29,1,32506,29,1,33348,29,1,33470,29,1,34885,14,19.1,-1.2566586,36.7929682,-1.2232123,36.8932547,854,1415,20,964
3529,27190,136,3,Business,13,1,58998,13,1,59019,13,1,59418,13,1,59675,13,1,62609,16,19.1,-1.2914795,36.8248973,-1.3326173,36.7146233,213,2934,21,656
3530,15439,3669,3,Business,29,3,42309,29,3,42373,29,3,46658,29,3,47685,29,3,48256,2,23.25888921888938,-1.2615888,36.7928732,-1.2560455,36.7800867,427,571,64,5312
3531,21031,1081,3,Business,20,3,42411,20,3,42581,20,3,43984,20,3,44548,20,3,45421,5,26.3,-1.304127,36.805743,-1.290894,36.822971,206,873,170,1967
3532,13438,1363,3,Business,7,5,53429,7,5,54495,7,5,54965,7,5,55167,7,5,58379,10,23.25888921888938,-1.3004062,36.829741,-1.2991441,36.7528804,907,3212,1066,672
3533,24288,3560,3,Business,21,1,40398,21,1,40420,21,1,42152,21,1,42352,21,1,43438,13,25.4,-1.2232123,36.8932547,-1.279395,36.825364,456,1086,22,1932
3534,7215,1066,3,Personal,30,3,45755,30,3,45810,30,3,46756,30,3,47198,30,3,48288,5,25.2,-1.2527958,36.8003131,-1.2728069,36.7962362,205,1090,55,1388
3535,14612,60,3,Business,8,3,49160,8,3,49915,8,3,50499,8,3,51086,8,3,51953,7,23.25888921888938,-1.228911,36.881876,-1.2296618,36.8438272,276,867,755,1171
3536,16394,1207,3,Business,9,5,68896,9,5,68902,9,5,68916,9,5,69688,9,5,71697,12,25.0,-1.2629666,36.8068369,-1.2351541,36.8748505,584,2009,6,786
3537,2426,3426,3,Business,5,2,56433,5,2,57195,5,2,58096,5,2,59029,5,2,60767,9,27.7,-1.2584143,36.8048002,-1.3012008,36.764868,540,1738,762,1834
3538,15462,2987,3,Business,31,2,45333,31,2,45558,31,2,46310,31,2,46441,31,2,47921,11,18.7,-1.270212,36.8210877,-1.3280091,36.8524146,322,1480,225,883
3539,166,1244,3,Business,26,6,39982,26,6,40116,26,6,41815,26,6,42943,26,6,45949,16,25.9,-1.3346773,36.8842734,-1.303596,36.778378,520,3006,134,2827
3540,20344,3517,3,Business,4,5,48969,4,5,49154,4,5,49600,4,5,51013,4,5,52606,16,24.0,-1.300921,36.828195,-1.3882008,36.7699445,100,1593,185,1859
3541,15865,1500,3,Business,15,5,36605,15,5,36613,15,5,36644,15,5,36980,15,5,38503,13,19.3,-1.2638185,36.7930057,-1.3228003,36.8306435,448,1523,8,367
3542,19903,635,3,Business,6,4,59996,6,4,60039,6,4,60484,6,4,60598,6,4,61302,5,22.4,-1.2857764,36.8236622,-1.2599563,36.7993439,676,704,43,559
3543,24730,2691,3,Business,15,3,31251,15,3,31272,15,3,31658,15,3,31959,15,3,32844,8,16.6,-1.2857671,36.7875614,-1.2571472,36.7950633,449,885,21,687
3544,24705,496,3,Business,22,3,37246,22,3,37404,22,3,38016,22,3,38502,22,3,40889,5,23.2,-1.2571472,36.7950633,-1.2845748,36.8217666,467,2387,158,1098
3545,14438,2804,3,Business,17,1,43809,17,1,43915,17,1,45449,17,1,46570,17,1,46574,1,23.9,-1.2642903,36.8002137,-1.2571472,36.7950633,49,4,106,2655
3546,5336,1245,3,Business,18,4,44362,18,4,44408,18,4,44863,18,4,46347,18,4,47867,17,23.25888921888938,-1.300921,36.828195,-1.3198615,36.7110323,299,1520,46,1939
3547,21340,1363,3,Business,24,3,38983,24,3,39605,24,3,40080,24,3,40393,24,3,41548,3,20.1,-1.3004062,36.829741,-1.3012173,36.8093987,96,1155,622,788
3548,7318,1458,1,Personal,27,7,38745,27,7,40010,27,7,41410,27,7,41872,27,7,43161,14,20.3,-1.274381,36.7272265,-1.3075974,36.8100855,103,1289,1265,1862
3549,20330,2464,3,Business,29,3,57736,29,3,58891,29,3,59526,29,3,59898,29,3,60995,5,20.9,-1.2584143,36.8048002,-1.279395,36.825364,849,1097,1155,1007
3550,23466,635,3,Business,14,3,38305,14,3,38415,14,3,38949,14,3,40810,14,3,41573,5,24.5,-1.300921,36.828195,-1.3218128,36.86190381,858,763,110,2395
3551,1418,393,3,Business,31,4,31149,31,4,31167,31,4,31177,31,4,32077,31,4,32622,4,20.5,-1.3167113,36.8301563,-1.3004062,36.829741,842,545,18,910
3552,15025,2169,2,Personal,14,6,33766,14,6,33791,14,6,34772,14,6,35041,14,6,37219,11,15.0,-1.3205164,36.8098882,-1.2539293,36.7920748,88,2178,25,1250
3553,23672,391,3,Business,7,2,36535,7,2,36587,7,2,37196,7,2,37589,7,2,38450,5,16.5,-1.2777924,36.8231577,-1.3010429,36.8353335,414,861,52,1002
3554,24857,3621,3,Business,13,4,46175,13,4,46228,13,4,48079,13,4,48276,13,4,51904,23,22.2,-1.2836583,36.7886014,-1.1931364,36.9476629,570,3628,53,2048
3555,5273,1244,3,Business,6,3,55121,6,3,55168,6,3,55288,6,3,55934,6,3,57180,8,27.5,-1.307143,36.825009,-1.303596,36.778378,433,1246,47,766
3556,14447,3317,2,Personal,25,2,49371,25,2,49878,25,2,52259,25,2,52509,25,2,54798,17,26.9,-1.1859289,36.8951552,-1.2517392,36.8249608,581,2289,507,2631
3557,10480,2207,3,Business,18,1,39762,18,1,39801,18,1,40445,18,1,40764,18,1,42062,3,28.0,-1.2547101,36.8093272,-1.2696908,36.81519,205,1298,39,963
3558,13077,3372,3,Business,31,4,67263,31,4,67305,31,4,68178,31,4,69149,31,4,69813,5,22.1,-1.2860372,36.7549573,-1.2872751,36.7889153,449,664,42,1844
3559,16938,1433,1,Personal,21,6,36912,21,6,36922,21,6,37487,21,6,40398,21,6,42870,21,16.3,-1.2653589,36.8090021,-1.2995252,36.6871615,427,2472,10,3476
3560,24261,970,3,Business,10,3,55269,10,3,55331,10,3,55353,10,3,56452,10,3,58218,8,30.5,-1.2857241,36.8203481,-1.2551895,36.7822034,338,1766,62,1121
3561,5010,2801,3,Business,23,2,46119,23,2,46174,23,2,46366,23,2,46610,23,2,47354,2,23.25888921888938,-1.2674274,36.7870827,-1.25681,36.7730826,695,744,55,436
3562,22934,1122,3,Personal,21,2,39801,21,2,40860,21,2,42400,21,2,43670,21,2,44370,12,22.7,-1.3244885,36.897792,-1.2882279,36.9682691,75,700,1059,2810
3563,8821,640,3,Business,1,1,41120,1,1,41147,1,1,41441,1,1,41634,1,1,43408,8,24.0,-1.304033,36.7848695,-1.2656079,36.8114464,731,1774,27,487
3564,7886,3641,3,Business,2,5,51846,2,5,52641,2,5,53081,2,5,53348,2,5,54714,5,25.1,-1.2551895,36.7822034,-1.2515637,36.8119508,340,1366,795,707
3565,22690,3517,3,Business,15,2,52927,15,2,52934,15,2,53281,15,2,55009,15,2,57169,15,24.7,-1.300921,36.828195,-1.3882008,36.7699445,340,2160,7,2075
3566,22444,901,1,Personal,5,4,40758,5,4,40828,5,4,41316,5,4,42168,5,4,43977,16,23.25888921888938,-1.3688433,36.7402114,-1.2854989,36.8218183,791,1809,70,1340
3567,24624,2008,3,Business,10,4,61212,10,4,61396,10,4,61736,10,4,62957,10,4,65018,16,23.5,-1.2508229,36.7895263,-1.2434951,36.6760986,247,2061,184,1561
3568,15678,893,3,Business,17,5,59116,17,5,59130,17,5,59350,17,5,60103,17,5,61611,11,18.9,-1.2663194,36.809901,-1.2224231,36.8560094,882,1508,14,973
3569,11752,1305,1,Personal,21,4,60156,21,4,60182,21,4,60984,21,4,61441,21,4,63229,17,19.8,-1.2915307,36.7905865,-1.2297202,36.8745508,116,1788,26,1259
3570,13918,788,3,Business,14,3,42050,14,3,42065,14,3,42434,14,3,42840,14,3,45201,8,24.5,-1.225322,36.80855,-1.2571472,36.7950633,345,2361,15,775
3571,4688,2330,3,Business,3,1,43588,3,1,43680,3,1,43961,3,1,44155,3,1,45022,11,21.7,-1.3143328,36.8137434,-1.2671943,36.8062533,168,867,92,475
3572,23025,393,3,Business,7,3,35751,7,3,37289,7,3,37305,7,3,38262,7,3,39801,10,25.1,-1.3177547,36.8303703,-1.2574219,36.7927073,208,1539,1538,973
3573,9927,517,3,Business,31,1,43494,31,1,46499,31,1,46503,31,1,47003,31,1,47005,4,21.2,-1.3167113,36.8301563,-1.3004062,36.829741,619,2,3005,504
3574,27987,391,3,Business,20,3,36499,20,3,36731,20,3,39262,20,3,40386,20,3,41005,5,27.0,-1.300921,36.828195,-1.2867454,36.8259017,785,619,232,3655
3575,27928,2330,3,Business,5,5,51190,5,5,51299,5,5,51661,5,5,52638,5,5,54150,6,26.5,-1.2267055,36.8013889,-1.2602688,36.7992556,882,1512,109,1339
3576,4899,2164,3,Business,15,5,54965,15,5,62693,15,5,63040,15,5,63235,15,5,64320,6,27.6,-1.2551895,36.7822034,-1.285382,36.8162878,411,1085,7728,542
3577,3522,2216,3,Business,17,4,52717,17,4,52792,17,4,53475,17,4,53641,17,4,55827,10,28.1,-1.2551895,36.7822034,-1.3108783,36.8392726,26,2186,75,849
3578,4638,1207,3,Business,2,2,48320,2,2,48363,2,2,49100,2,2,50589,2,2,52639,9,26.0,-1.2705661,36.8080368,-1.2745321,36.765088,612,2050,43,2226
3579,23260,1142,1,Personal,22,2,65734,22,2,65771,22,2,67379,22,2,68065,22,2,70192,14,18.1,-1.255945,36.783509,-1.2772154,36.6872972,789,2127,37,2294
3580,12441,2083,3,Personal,25,1,42920,25,1,42930,25,1,43667,25,1,44381,25,1,45725,11,25.5,-1.2981239,36.8367977,-1.2615888,36.7928732,858,1344,10,1451
3581,10376,2676,3,Business,1,3,55496,1,3,55579,1,3,56403,1,3,58447,1,3,58849,2,23.7,-1.3047482,36.7849672,-1.2963097,36.7688221,882,402,83,2868
3582,26429,1500,3,Business,2,2,37544,2,2,39463,2,2,40294,2,2,41035,2,2,42291,8,21.0,-1.3004062,36.829741,-1.2574219,36.7927073,87,1256,1919,1572
3583,16795,627,3,Business,12,5,43447,12,5,43459,12,5,43467,12,5,43947,12,5,44827,3,26.6,-1.2551895,36.7822034,-1.2584505,36.807181,349,880,12,488
3584,12404,1459,3,Business,23,5,51243,23,5,52206,23,5,53489,23,5,54843,23,5,56602,15,26.4,-1.264945,36.784678,-1.3307985,36.8036471,101,1759,963,2637
3585,24071,552,3,Business,23,5,41606,23,5,41919,23,5,43244,23,5,45475,23,5,47902,22,24.1,-1.3472066,36.7692638,-1.3632162,36.9108253,581,2427,313,3556
3586,27062,2123,1,Personal,24,4,56334,24,4,56458,24,4,57558,24,4,58694,24,4,59603,4,22.9,-1.285386,36.8304605,-1.2758847,36.8085897,808,909,124,2236
3587,5411,3647,3,Business,16,2,53665,16,2,53737,16,2,54324,16,2,54709,16,2,55874,8,23.25888921888938,-1.272639,36.794723,-1.2653185,36.8358841,924,1165,72,972
3588,14483,3569,3,Personal,8,5,50385,8,5,52043,8,5,53629,8,5,53988,8,5,57517,20,30.6,-1.2586742,36.810996,-1.3858142,36.7641498,622,3529,1658,1945
3589,15854,1402,3,Business,8,1,39960,8,1,40061,8,1,41383,8,1,42206,8,1,47181,12,27.7,-1.2813012,36.8323962,-1.3472066,36.7692638,521,4975,101,2145
3590,15614,2344,3,Business,19,2,58386,19,2,58486,19,2,59168,19,2,59560,19,2,61437,8,28.2,-1.298529,36.816482,-1.2551895,36.7822034,372,1877,100,1074
3591,14588,412,3,Business,30,2,53018,30,2,53909,30,2,54118,30,2,54267,30,2,56627,12,23.25888921888938,-1.228911,36.881876,-1.266837,36.799249,488,2360,891,358
3592,172,2866,3,Business,5,3,58642,5,3,60489,5,3,60933,5,3,61138,5,3,64940,11,22.6,-1.2551895,36.7822034,-1.3197323,36.8120386,267,3802,1847,649
3593,17793,3635,1,Business,24,1,63061,24,1,63137,24,1,64112,24,1,64292,24,1,65379,8,24.6,-1.2615888,36.7928732,-1.2729121,36.8325402,537,1087,76,1155
3594,12923,909,3,Business,18,1,58048,18,1,58259,18,1,59240,18,1,59400,18,1,61099,10,30.6,-1.2765736,36.8513646,-1.225322,36.80855,148,1699,211,1141
3595,17578,2956,3,Business,2,4,58683,2,4,58765,2,4,59588,2,4,60214,2,4,61940,14,23.25888921888938,-1.207546,36.7913976,-1.2584143,36.8048002,78,1726,82,1449
3596,20239,3404,3,Business,21,5,60555,21,5,60610,21,5,60803,21,5,60906,21,5,61934,5,23.2,-1.2584143,36.8048002,-1.279395,36.825364,879,1028,55,296
3597,14920,2000,3,Business,14,3,43844,14,3,43850,14,3,44029,14,3,44423,14,3,45766,14,24.5,-1.2551895,36.7822034,-1.3332749,36.8708147,649,1343,6,573
3598,12815,718,1,Business,6,4,47077,6,4,47097,6,4,47119,6,4,47846,6,4,50006,14,21.9,-1.2551895,36.7822034,-1.329568,36.8520825,79,2160,20,749
3599,12003,3422,3,Business,27,6,36111,27,6,40756,27,6,41339,27,6,41790,27,6,44284,15,23.25888921888938,-1.2776783,36.81319,-1.3258394,36.7118422,937,2494,4645,1034
3600,23879,1271,3,Business,6,4,57527,6,4,58452,6,4,59856,6,4,60230,6,4,63022,26,22.4,-1.3244885,36.897792,-1.3949989,36.7654761,519,2792,925,1778
3601,16448,1974,3,Personal,3,3,61090,3,3,61107,3,3,61873,3,3,62876,3,3,63217,9,27.4,-1.3013102,36.7963702,-1.2538731,36.7850223,678,341,17,1769
3602,19331,2457,3,Business,15,2,38568,15,2,38640,15,2,39395,15,2,39469,15,2,40420,8,24.4,-1.2551895,36.7822034,-1.3047132,36.8089553,932,951,72,829
3603,3906,3701,3,Business,13,1,41173,13,1,41185,13,1,41470,13,1,41556,13,1,42871,5,23.25888921888938,-1.2612574,36.7879622,-1.2519787,36.7806491,521,1315,12,371
3604,16180,3326,3,Business,6,4,43625,6,4,43708,6,4,44078,6,4,46155,6,4,49017,8,24.0,-1.2571472,36.7950633,-1.3090727,36.8315262,517,2862,83,2447
3605,19429,1927,3,Business,17,3,53481,17,3,53557,17,3,55103,17,3,55476,17,3,57272,12,23.25888921888938,-1.3472066,36.7692638,-1.2855799,36.8176209,855,1796,76,1919
3606,14344,432,3,Business,30,4,59221,30,4,59315,30,4,60087,30,4,60588,30,4,62090,9,23.25888921888938,-1.2584143,36.8048002,-1.3012008,36.764868,770,1502,94,1273
3607,21246,3669,3,Business,14,3,63000,14,3,63053,14,3,63936,14,3,64880,14,3,64912,2,23.7,-1.2615888,36.7928732,-1.2685707,36.8064961,642,32,53,1827
3608,17627,2987,3,Business,18,1,50243,18,1,50335,18,1,51822,18,1,52216,18,1,53334,9,17.4,-1.270212,36.8210877,-1.3014461,36.7661381,886,1118,92,1881
3609,12475,1544,3,Business,2,4,39221,2,4,39500,2,4,40509,2,4,41110,2,4,42611,7,23.25888921888938,-1.2924173,36.7797814,-1.2813012,36.8323962,953,1501,279,1610
3610,16775,2685,1,Personal,5,4,38704,5,4,38737,5,4,40484,5,4,40768,5,4,42233,8,23.25888921888938,-1.2899,36.7794355,-1.2590031,36.8078168,140,1465,33,2031
3611,9775,2987,3,Business,23,3,43518,23,3,43552,23,3,44358,23,3,44596,23,3,46446,13,22.0,-1.270212,36.8210877,-1.2927792,36.9053492,103,1850,34,1044
3612,3447,393,3,Business,30,2,52546,30,2,52674,30,2,52683,30,2,53980,30,2,53984,4,23.25888921888938,-1.3167113,36.8301563,-1.3004062,36.829741,515,4,128,1306
3613,24996,53,3,Business,6,3,52287,6,3,52374,6,3,53051,6,3,53492,6,3,54740,9,27.6,-1.2770708,36.8231093,-1.3167113,36.8301563,518,1248,87,1118
3614,6251,2982,3,Business,4,1,31616,4,1,31625,4,1,32040,4,1,35039,4,1,37761,18,22.0,-1.300921,36.828195,-1.177202,36.8351183,148,2722,9,3414
3615,11216,2884,2,Personal,28,1,51327,28,1,52071,28,1,52345,28,1,52909,28,1,53964,9,24.5,-1.2517448,36.7924971,-1.2764692,36.7580111,379,1055,744,838
3616,21752,1888,1,Personal,2,1,68942,2,1,68978,2,1,69744,2,1,70300,2,1,72758,14,19.3,-1.2629944,36.7998816,-1.3246123,36.7902267,159,2458,36,1322
3617,20821,393,3,Business,24,3,58843,24,3,58856,24,3,58935,24,3,60050,24,3,60739,4,23.25888921888938,-1.3167113,36.8301563,-1.3004062,36.829741,349,689,13,1194
3618,21214,3494,1,Personal,7,4,37637,7,4,39726,7,4,39761,7,4,40222,7,4,41133,7,17.0,-1.2733223,36.7951005,-1.2935303,36.7988142,216,911,2089,496
3619,1208,2535,2,Personal,22,5,38906,22,5,38935,22,5,39113,22,5,39710,22,5,41270,9,21.9,-1.2622087,36.7880877,-1.294221,36.7719395,116,1560,29,775
3620,9652,1710,3,Personal,22,3,47084,22,3,47694,22,3,48985,22,3,49202,22,3,50042,6,24.5,-1.2877501,36.8146599,-1.2963097,36.7688221,539,840,610,1508
3621,17661,3091,3,Business,3,3,37814,3,3,37864,3,3,38316,3,3,40016,3,3,40655,7,27.2,-1.290894,36.822971,-1.3117395,36.8592009,61,639,50,2152
3622,22821,1469,3,Business,29,2,41087,29,2,41211,29,2,41557,29,2,42153,29,2,43258,7,23.7,-1.2551895,36.7822034,-1.2963492,36.8093377,89,1105,124,942
3623,22115,3080,3,Business,13,2,37333,13,2,37354,13,2,39885,13,2,40651,13,2,43440,19,22.2,-1.2860183,36.8975338,-1.2551895,36.7822034,554,2789,21,3297
3624,22369,1205,3,Business,19,1,40390,19,1,40470,19,1,41838,19,1,42181,19,1,44141,8,24.7,-1.257309,36.8060084,-1.2873232,36.7658572,219,1960,80,1711
3625,2057,2201,3,Personal,9,2,56844,9,2,56991,9,2,59463,9,2,61279,9,2,64101,18,27.9,-1.3195373,36.923047,-1.2556108,36.8400444,300,2822,147,4288
3626,2633,2509,3,Business,25,1,54602,25,1,54645,25,1,56348,25,1,56716,25,1,57924,6,28.1,-1.2571472,36.7950633,-1.2989287,36.8163082,25,1208,43,2071
3627,9810,393,3,Business,21,5,31048,21,5,33054,21,5,33766,21,5,35775,21,5,35782,4,19.5,-1.3167113,36.8301563,-1.3004062,36.829741,555,7,2006,2721
3628,25749,816,3,Business,11,6,47008,11,6,47565,11,6,48605,11,6,48972,11,6,50984,8,22.0,-1.3014461,36.7661381,-1.290894,36.822971,592,2012,557,1407
3629,17282,1146,3,Business,21,2,51942,21,2,51997,21,2,52651,21,2,53844,21,2,55245,7,25.1,-1.3167113,36.8301563,-1.3083266,36.8494756,321,1401,55,1847
3630,16832,3599,3,Business,4,6,33784,4,6,33900,4,6,35380,4,6,36357,4,6,38130,11,23.25888921888938,-1.3302996,36.8707935,-1.290789,36.8024859,675,1773,116,2457
3631,12131,2195,3,Business,20,6,47734,20,6,47755,20,6,47981,20,6,48521,20,6,50027,16,23.25888921888938,-1.2628473,36.781805,-1.228911,36.881876,422,1506,21,766
3632,4629,3165,3,Personal,23,1,32644,23,1,32674,23,1,33733,23,1,34147,23,1,36123,6,14.3,-1.2610837,36.8021315,-1.293973,36.80169,486,1976,30,1473
3633,947,198,3,Business,21,2,51036,21,2,51161,21,2,53270,21,2,53342,21,2,55465,26,25.2,-1.3396256,36.8863135,-1.3234404,36.7087633,48,2123,125,2181
3634,2386,3647,3,Business,30,3,40370,30,3,40409,30,3,41284,30,3,41554,30,3,43013,7,25.2,-1.272639,36.794723,-1.2972659,36.7708647,281,1459,39,1145
3635,15695,868,3,Business,10,3,54240,10,3,54275,10,3,54826,10,3,55537,10,3,57056,8,30.6,-1.303596,36.778378,-1.265715,36.823815,306,1519,35,1262
3636,1715,1787,3,Business,5,5,41814,5,5,42324,5,5,44410,5,5,45823,5,5,46962,9,24.5,-1.2859912,36.8756811,-1.2283403,36.8822756,589,1139,510,3499
3637,18884,2700,3,Business,10,6,43275,10,6,43322,10,6,43918,10,6,44370,10,6,44776,3,24.0,-1.2812376,36.8264821,-1.2845835,36.8079121,726,406,47,1048
3638,25073,1850,3,Business,28,1,42068,28,1,42108,28,1,42523,28,1,42963,28,1,44197,8,23.5,-1.2551895,36.7822034,-1.3033012,36.8170864,674,1234,40,855
3639,20089,280,1,Personal,12,6,68250,12,6,68299,12,6,69418,12,6,70456,12,6,72903,8,20.1,-1.2696183,36.8021778,-1.2850645,36.8426837,159,2447,49,2157
3640,14967,393,3,Business,18,1,40078,18,1,40175,18,1,40677,18,1,40830,18,1,41553,4,28.2,-1.3167113,36.8301563,-1.3004062,36.829741,349,723,97,655
3641,13966,92,1,Personal,3,3,48537,3,3,49185,3,3,50474,3,3,52058,3,3,54108,14,26.9,-1.1997066,36.7739715,-1.2715686,36.8023526,257,2050,648,2873
3642,15922,2200,3,Business,25,1,49891,25,1,49958,25,1,50662,25,1,51834,25,1,56067,8,30.1,-1.290894,36.822971,-1.2612974,36.7993448,907,4233,67,1876
3643,15577,391,3,Business,23,3,38858,23,3,39055,23,3,40874,23,3,41442,23,3,43561,6,23.25888921888938,-1.2599563,36.7993439,-1.2867454,36.8259017,511,2119,197,2387
3644,7427,238,3,Business,25,1,46835,25,1,46854,25,1,47423,25,1,47556,25,1,49074,15,27.1,-1.3077869,36.8443207,-1.362953,36.904214,943,1518,19,702
3645,12612,540,3,Business,30,2,48612,30,2,48790,30,2,49289,30,2,49729,30,2,51144,10,23.25888921888938,-1.2551895,36.7822034,-1.2976368,36.7519827,937,1415,178,939
3646,13504,3283,3,Business,7,1,32270,7,1,32374,7,1,32766,7,1,33330,7,1,35270,18,21.3,-1.344446,36.756597,-1.2628473,36.781805,768,1940,104,956
3647,18296,3295,3,Business,15,3,39750,15,3,39787,15,3,40184,15,3,40670,15,3,42297,12,23.25888921888938,-1.2571472,36.7950633,-1.3029578,36.871099,770,1627,37,883
3648,27937,552,3,Business,7,1,44891,7,1,45134,7,1,46333,7,1,46474,7,1,48707,23,25.0,-1.3632162,36.9108253,-1.2413316,36.8785525,505,2233,243,1340
3649,27753,2717,3,Business,14,2,40774,14,2,40829,14,2,41550,14,2,42418,14,2,43189,7,21.3,-1.2839568,36.8233106,-1.2551895,36.7822034,857,771,55,1589
3650,18316,3686,3,Business,25,2,34973,25,2,34981,25,2,35029,25,2,36181,25,2,38613,22,18.0,-1.2551895,36.7822034,-1.3342256,36.9106741,38,2432,8,1200
3651,11602,1159,1,Personal,24,5,37766,24,5,37878,24,5,38626,24,5,39559,24,5,41493,9,21.2,-1.3068448,36.8348641,-1.272517,36.877848,519,1934,112,1681
3652,26961,478,3,Business,30,2,42169,30,2,42560,30,2,43227,30,2,43316,30,2,44767,4,23.25888921888938,-1.2551895,36.7822034,-1.2728058,36.8049903,953,1451,391,756
3653,12327,242,3,Business,29,5,35416,29,5,40667,29,5,40981,29,5,41156,29,5,42624,8,19.5,-1.2551895,36.7822034,-1.3024794,36.8228284,808,1468,5251,489
3654,10401,1642,3,Business,5,5,52683,5,5,52755,5,5,53647,5,5,54333,5,5,56132,4,27.6,-1.2628638,36.8070399,-1.2726506,36.7960153,166,1799,72,1578
3655,1526,3727,3,Business,4,5,31838,4,5,32004,4,5,33779,4,5,34109,4,5,35446,7,19.4,-1.2866012,36.8195691,-1.2963097,36.7688221,449,1337,166,2105
3656,24860,2101,1,Personal,20,5,45268,20,5,45304,20,5,45600,20,5,45953,20,5,48655,15,18.3,-1.291216,36.8746657,-1.2866521,36.780966,618,2702,36,649
3657,21768,3445,1,Personal,3,5,59590,3,5,59615,3,5,61802,3,5,61977,3,5,62785,4,22.6,-1.2615983,36.8083096,-1.2516793,36.786481,452,808,25,2362
3658,4581,3300,3,Business,13,1,53716,13,1,53732,13,1,55458,13,1,56272,13,1,57651,13,19.6,-1.3313643,36.8577422,-1.303596,36.778378,213,1379,16,2540
3659,26095,393,3,Business,11,2,48954,11,2,49063,11,2,49224,11,2,49574,11,2,51414,13,21.5,-1.3167113,36.8301563,-1.2991441,36.7528804,211,1840,109,511
3660,27522,30,1,Personal,31,5,52225,31,5,52252,31,5,53102,31,5,53207,31,5,53612,2,20.0,-1.2675613,36.8133001,-1.252973,36.8165107,754,405,27,955
3661,26968,1184,3,Personal,22,2,46341,22,2,46480,22,2,47699,22,2,48419,22,2,49873,6,19.5,-1.2860198,36.8176562,-1.3043649,36.7816132,844,1454,139,1939
3662,17529,2412,3,Business,1,3,35406,1,3,35414,1,3,35443,1,3,36647,1,3,38502,12,23.25888921888938,-1.2297202,36.8819507,-1.296567,36.819852,272,1855,8,1233
3663,27675,3204,1,Personal,8,3,28916,8,3,28960,8,3,29656,8,3,30622,8,3,32008,11,17.2,-1.264788,36.7883897,-1.3076262,36.8325382,446,1386,44,1662
3664,17784,3222,3,Business,30,5,54442,30,5,54470,30,5,57080,30,5,57425,30,5,59446,14,24.5,-1.2551895,36.7822034,-1.329568,36.8520825,523,2021,28,2955
3665,20054,3201,3,Business,27,3,48457,27,3,48483,27,3,48632,27,3,49399,27,3,49693,1,29.3,-1.2571472,36.7950633,-1.2584143,36.8048002,647,294,26,916
3666,6342,928,3,Business,30,3,36268,30,3,37324,30,3,38169,30,3,38236,30,3,40052,7,25.0,-1.2551895,36.7822034,-1.2872652,36.8267613,206,1816,1056,912
3667,6085,2479,1,Personal,20,7,46647,20,7,46664,20,7,47449,20,7,47762,20,7,49061,18,20.0,-1.271672,36.783604,-1.320722,36.8803076,103,1299,17,1098
3668,10099,1329,3,Business,24,5,52555,24,5,52579,24,5,52847,24,5,53211,24,5,54278,4,23.1,-1.273056,36.811298,-1.256958,36.8144929,761,1067,24,632
3669,26613,2803,3,Business,6,3,47679,6,3,53912,6,3,55702,6,3,55916,6,3,56692,6,21.6,-1.2765736,36.8513646,-1.2574976,36.8705638,397,776,6233,2004
3670,17439,20,3,Business,28,4,32808,28,4,32909,28,4,35185,28,4,35299,28,4,37580,13,19.5,-1.3277439,36.8646958,-1.2629666,36.8068369,763,2281,101,2390
3671,14950,3194,3,Business,13,3,31783,13,3,31872,13,3,33165,13,3,33486,13,3,35621,5,20.3,-1.2850638,36.813096,-1.312469,36.815177,304,2135,89,1614
3672,3146,562,3,Business,31,5,46372,31,5,46960,31,5,48172,31,5,48586,31,5,50569,17,21.8,-1.3227181,36.8528097,-1.378256,36.747862,675,1983,588,1626
3673,15926,627,3,Business,16,1,44660,16,1,44678,16,1,44799,16,1,45477,16,1,47093,9,19.5,-1.2551895,36.7822034,-1.2983462,36.8139996,101,1616,18,799
3674,7417,2631,1,Personal,4,3,47072,4,3,47100,4,3,47624,4,3,47901,4,3,48741,6,17.2,-1.2845871,36.8234834,-1.2889003,36.7844029,629,840,28,801
3675,11953,788,3,Business,28,1,35105,28,1,35493,28,1,37366,28,1,38091,28,1,41125,10,23.9,-1.279395,36.825364,-1.225322,36.80855,332,3034,388,2598
3676,24795,2532,3,Business,5,5,57325,5,5,57437,5,5,58531,5,5,59552,5,5,60978,6,24.7,-1.2571472,36.7950633,-1.2824911,36.8218042,906,1426,112,2115
3677,9505,325,3,Business,19,2,34566,19,2,34578,19,2,34593,19,2,35154,19,2,35699,3,21.0,-1.2551895,36.7822034,-1.25537,36.7756,952,545,12,576
3678,17385,2987,3,Business,6,5,55261,6,5,58965,6,5,59263,6,5,59498,6,5,60158,4,22.6,-1.270212,36.8210877,-1.260232,36.807334,851,660,3704,533
3679,21831,1148,3,Business,8,5,56317,8,5,58100,8,5,59398,8,5,59813,8,5,61780,5,25.3,-1.3100586,36.8500329,-1.3319197,36.8501483,311,1967,1783,1713
3680,19868,738,3,Business,4,4,50989,4,4,51216,4,4,52963,4,4,53336,4,4,54629,11,24.6,-1.288148,36.7850276,-1.3261985,36.7926168,38,1293,227,2120
3681,15146,3669,3,Business,10,5,49762,10,5,51032,10,5,51586,10,5,53258,10,5,56679,17,23.25888921888938,-1.2615888,36.7928732,-1.2491258,36.6894253,256,3421,1270,2226
3682,24847,868,3,Business,17,5,35970,17,5,36006,17,5,36264,17,5,37238,17,5,38164,9,23.25888921888938,-1.331619,36.847976,-1.265715,36.823815,675,926,36,1232
3683,16336,136,3,Business,26,2,33097,26,2,33121,26,2,33378,26,2,33587,26,2,34628,5,22.0,-1.3254522,36.7216584,-1.3287648,36.7445732,628,1041,24,466
3684,2066,2670,1,Personal,8,1,34450,8,1,34498,8,1,34551,8,1,34816,8,1,35454,4,19.6,-1.305399,36.8221849,-1.3240024,36.8119022,88,638,48,318
3685,17836,3222,3,Business,6,3,54380,6,3,54553,6,3,55385,6,3,55606,6,3,57823,15,27.4,-1.2551895,36.7822034,-1.317151,36.865734,761,2217,173,1053
3686,17742,2271,3,Business,15,6,38899,15,6,38923,15,6,38982,15,6,39979,15,6,42448,17,23.25888921888938,-1.2600926,36.8088685,-1.293515,36.897607,574,2469,24,1056
3687,14683,265,3,Business,19,2,52463,19,2,55372,19,2,56763,19,2,57255,19,2,59120,10,30.2,-1.3472066,36.7692638,-1.300921,36.828195,605,1865,2909,1883
3688,9564,436,1,Personal,4,3,38930,4,3,39169,4,3,40165,4,3,40588,4,3,42554,10,17.2,-1.2950041,36.8143583,-1.329424,36.862726,329,1966,239,1419
3689,8551,302,3,Business,9,6,61277,9,6,61334,9,6,62181,9,6,62333,9,6,65260,12,28.0,-1.2649605,36.7981777,-1.2987697,36.746851,132,2927,57,999
3690,13045,3149,3,Business,16,4,58043,16,4,58122,16,4,58539,16,4,59845,16,4,60251,5,23.25888921888938,-1.3004062,36.829741,-1.3167113,36.8301563,328,406,79,1723
3691,7148,111,3,Business,4,2,52289,4,2,52338,4,2,53035,4,2,53676,4,2,55038,14,20.3,-1.2551895,36.7822034,-1.2297202,36.8819507,882,1362,49,1338
3692,19225,3647,3,Business,6,1,46115,6,1,46845,6,1,47104,6,1,47528,6,1,52943,18,23.25888921888938,-1.3073803,36.6825842,-1.272639,36.794723,831,5415,730,683
3693,25474,624,3,Business,27,2,48065,27,2,48089,27,2,48592,27,2,49036,27,2,50533,15,25.6,-1.303596,36.778378,-1.22978,36.836215,178,1497,24,947
3694,12522,367,3,Personal,22,2,40185,22,2,42052,22,2,42460,22,2,42842,22,2,43348,2,19.5,-1.2866269,36.8246368,-1.2824911,36.8218042,742,506,1867,790
3695,6728,1346,3,Business,15,1,37582,15,1,37601,15,1,37648,15,1,38065,15,1,38798,6,23.25888921888938,-1.2917868,36.7872675,-1.2695287,36.7981777,720,733,19,464
3696,21461,391,3,Business,30,2,41804,30,2,41922,30,2,42221,30,2,44577,30,2,45754,5,23.25888921888938,-1.300921,36.828195,-1.2867454,36.8259017,411,1177,118,2655
3697,25198,533,3,Business,5,2,54277,5,2,56968,5,2,57205,5,2,58110,5,2,60931,17,23.25888921888938,-1.3637665,36.7269036,-1.2765492,36.7669809,779,2821,2691,1142
3698,8987,1245,3,Business,8,3,31608,8,3,31643,8,3,32194,8,3,32717,8,3,33785,6,17.5,-1.300921,36.828195,-1.3026036,36.7934877,281,1068,35,1074
3699,5715,391,3,Business,22,4,51650,22,4,54227,22,4,55554,22,4,56615,22,4,57886,5,26.2,-1.300921,36.828195,-1.2850694,36.8236625,812,1271,2577,2388
3700,16343,1147,2,Personal,31,5,47649,31,5,47702,31,5,48268,31,5,48805,31,5,49862,9,19.9,-1.2781868,36.8236786,-1.3024388,36.859699,207,1057,53,1103
3701,2034,3547,3,Business,11,4,42846,11,4,42855,11,4,43371,11,4,43479,11,4,45813,17,25.6,-1.2761408,36.7710839,-1.3194518,36.869396,541,2334,9,624
3702,19088,439,3,Business,18,1,43934,18,1,43961,18,1,46024,18,1,46260,18,1,50559,25,26.7,-1.3250048,36.8697188,-1.2633397,36.7454238,418,4299,27,2299
3703,9388,2112,3,Business,31,4,42443,31,4,42452,31,4,42602,31,4,44621,31,4,46740,13,26.6,-1.2527958,36.8003131,-1.2156006,36.8916865,205,2119,9,2169
3704,3735,2828,3,Business,26,5,56471,26,5,56876,26,5,57244,26,5,57708,26,5,58278,3,23.25888921888938,-1.2685707,36.8064961,-1.2615888,36.7928732,578,570,405,832
3705,11786,2523,3,Business,20,3,55902,20,3,55994,20,3,56665,20,3,56994,20,3,58356,7,29.4,-1.2551895,36.7822034,-1.2989934,36.8136694,506,1362,92,1000
3706,21496,1557,3,Business,17,1,42219,17,1,42232,17,1,42699,17,1,43854,17,1,44484,7,24.8,-1.2808155,36.8136842,-1.2551895,36.7822034,189,630,13,1622
3707,19720,496,3,Business,30,2,42691,30,2,45186,30,2,45409,30,2,47568,30,2,50106,8,23.25888921888938,-1.2551895,36.7822034,-1.2958261,36.8304671,119,2538,2495,2382
3708,22090,1724,3,Business,21,4,28688,21,4,28778,21,4,29011,21,4,30332,21,4,33961,15,22.0,-1.2551895,36.7822034,-1.3267689,36.8756255,875,3629,90,1554
3709,24839,2074,2,Personal,31,4,42202,31,4,42216,31,4,43240,31,4,44705,31,4,46378,9,21.9,-1.2960064,36.7582367,-1.2741728,36.7969108,140,1673,14,2489
3710,17616,2112,3,Business,23,3,42960,23,3,42968,23,3,43394,23,3,43739,23,3,45452,13,23.25888921888938,-1.2584143,36.8048002,-1.2156006,36.8916865,804,1713,8,771
3711,3104,3222,3,Business,18,5,53199,18,5,53318,18,5,53835,18,5,53998,18,5,58423,6,26.9,-1.2551895,36.7822034,-1.2407027,36.7650043,131,4425,119,680
3712,19940,478,3,Business,6,2,47818,6,2,47854,6,2,48203,6,2,48496,6,2,48590,3,25.1,-1.2551895,36.7822034,-1.2630899,36.7800761,881,94,36,642
3713,2655,880,3,Personal,30,4,41705,30,4,41715,30,4,42170,30,4,42500,30,4,43130,4,20.1,-1.2995135,36.7933633,-1.2892529,36.7740575,312,630,10,785
3714,11867,570,3,Business,30,4,54782,30,4,55229,30,4,56216,30,4,56305,30,4,58609,7,23.25888921888938,-1.2551895,36.7822034,-1.291768,36.8297208,868,2304,447,1076
3715,6087,733,3,Business,13,3,51403,13,3,53487,13,3,54025,13,3,54588,13,3,55214,7,27.0,-1.2551895,36.7822034,-1.2795549,36.7627011,862,626,2084,1101
3716,3707,867,3,Business,26,3,39135,26,3,39175,26,3,39975,26,3,40122,26,3,42042,14,24.0,-1.3077869,36.8443207,-1.306378,36.7519845,496,1920,40,947
3717,5908,2404,2,Personal,3,3,56344,3,3,56915,3,3,57698,3,3,60033,3,3,61595,8,23.4,-1.3233955,36.8562944,-1.305716,36.809882,565,1562,571,3118
3718,17528,2200,3,Business,12,5,53265,12,5,56004,12,5,56119,12,5,56370,12,5,57326,10,27.0,-1.290894,36.822971,-1.2413316,36.8785525,622,956,2739,366
3719,9068,1389,3,Business,3,6,54129,3,6,54167,3,6,54794,3,6,56347,3,6,57772,14,22.2,-1.2584143,36.8048002,-1.207546,36.7913976,913,1425,38,2180
3720,4801,393,3,Business,17,4,43267,17,4,43291,17,4,43657,17,4,43896,17,4,45407,14,25.3,-1.3167113,36.8301563,-1.306378,36.7519845,623,1511,24,605
3721,17605,1961,3,Business,27,1,44210,27,1,44287,27,1,45386,27,1,45638,27,1,46647,9,21.0,-1.303596,36.778378,-1.3188359,36.7038526,709,1009,77,1351
3722,17950,1004,3,Business,17,5,51184,17,5,51237,17,5,52179,17,5,52606,17,5,54494,14,23.25888921888938,-1.3250048,36.8697188,-1.2603996,36.7972272,829,1888,53,1369
3723,23118,1719,3,Business,26,1,37474,26,1,37495,26,1,38984,26,1,40035,26,1,41509,15,22.8,-1.2395125,36.7455843,-1.296797,36.7764525,101,1474,21,2540
3724,23415,1268,1,Personal,21,4,62337,21,4,62378,21,4,62917,21,4,63097,21,4,64686,9,19.8,-1.293554,36.763113,-1.2988168,36.8198572,105,1589,41,719
3725,10060,876,3,Business,14,1,49127,14,1,49149,14,1,50397,14,1,50540,14,1,51332,7,25.9,-1.2746236,36.8254455,-1.2897215,36.7945959,886,792,22,1391
3726,17204,1787,3,Business,22,5,60711,22,5,61036,22,5,61280,22,5,61380,22,5,62961,12,28.6,-1.2527958,36.8003131,-1.2283403,36.8822756,318,1581,325,344
3727,27784,540,3,Business,20,4,57675,20,4,57756,20,4,60651,20,4,61417,20,4,64303,7,22.5,-1.2571472,36.7950633,-1.298744,36.8178237,52,2886,81,3661
3728,10235,2593,2,Business,4,4,51592,4,4,51624,4,4,52637,4,4,52865,4,4,54353,7,24.9,-1.2615888,36.7928732,-1.3021707,36.8168444,844,1488,32,1241
3729,23627,136,3,Business,8,5,35819,8,5,36796,8,5,38147,8,5,38239,8,5,41375,17,23.25888921888938,-1.3326173,36.7146233,-1.2590031,36.8078168,735,3136,977,1443
3730,35,2801,3,Business,8,3,48458,8,3,48476,8,3,51035,8,3,51626,8,3,52716,7,23.25888921888938,-1.2674274,36.7870827,-1.2827545,36.7936129,921,1090,18,3150
3731,8457,2199,1,Personal,9,2,48812,9,2,49311,9,2,49691,9,2,50116,9,2,53987,7,22.4,-1.2914795,36.8248973,-1.2568564,36.8050742,268,3871,499,805
3732,10772,346,3,Business,2,2,55127,2,2,55969,2,2,57379,2,2,57888,2,2,59721,5,29.3,-1.2584143,36.8048002,-1.28878,36.8168312,779,1833,842,1919
3733,8923,53,3,Business,27,1,54246,27,1,54362,27,1,54847,27,1,55367,27,1,57316,6,22.9,-1.2770708,36.8231093,-1.2556732,36.7927849,27,1949,116,1005
3734,26121,420,3,Business,31,5,56434,31,5,56544,31,5,57744,31,5,59091,31,5,61363,13,20.0,-1.3129578,36.8463197,-1.2517448,36.7924971,754,2272,110,2547
3735,6865,2415,3,Personal,13,3,33374,13,3,33527,13,3,34269,13,3,36094,13,3,37473,4,16.1,-1.2832653,36.8248575,-1.305716,36.809882,46,1379,153,2567
3736,23906,113,3,Business,13,1,54449,13,1,54498,13,1,54992,13,1,55542,13,1,56951,7,19.6,-1.2963097,36.7688221,-1.2663558,36.8055646,229,1409,49,1044
3737,17525,867,3,Business,25,3,27317,25,3,30811,25,3,31656,25,3,33163,25,3,34716,10,13.5,-1.2996533,36.8292629,-1.306378,36.7519845,663,1553,3494,2352
3738,22666,2066,3,Business,13,1,39926,13,1,40049,13,1,42230,13,1,42554,13,1,43911,8,23.25888921888938,-1.3210189,36.8410551,-1.2853821,36.8333546,56,1357,123,2505
3739,12588,2412,3,Business,11,2,46184,11,2,46371,11,2,46433,11,2,46633,11,2,48051,11,19.6,-1.2285835,36.8826468,-1.290894,36.822971,320,1418,187,262
3740,4716,3765,1,Personal,17,1,39196,17,1,39213,17,1,41916,17,1,42992,17,1,45272,18,25.2,-1.3124922,36.8804974,-1.2800648,36.762267,620,2280,17,3779
3741,21844,3291,3,Business,17,1,36752,17,1,36789,17,1,37229,17,1,37705,17,1,38327,4,18.1,-1.265715,36.823815,-1.2600926,36.8088685,882,622,37,916
3742,14993,868,3,Business,12,2,61025,12,2,61059,12,2,61831,12,2,61938,12,2,63063,4,28.2,-1.2600926,36.8088685,-1.265715,36.823815,849,1125,34,879
3743,27559,3291,3,Business,14,3,40316,14,3,40335,14,3,40632,14,3,41157,14,3,41901,4,24.4,-1.272828,36.816608,-1.2600926,36.8088685,685,744,19,822
3744,12196,970,3,Business,28,2,44433,28,2,44506,28,2,44991,28,2,45279,28,2,46696,8,21.1,-1.2571472,36.7950633,-1.2651574,36.7474347,162,1417,73,773
3745,13776,1402,3,Business,25,5,38879,25,5,39203,25,5,39843,25,5,40208,25,5,41367,1,26.6,-1.290894,36.822971,-1.2813012,36.8323962,104,1159,324,1005
3746,21515,649,3,Business,21,4,52244,21,4,52285,21,4,52418,21,4,52989,21,4,53462,3,26.5,-1.256855,36.804132,-1.2551895,36.7822034,647,473,41,704
3747,9532,1882,3,Business,29,5,32405,29,5,32478,29,5,33992,29,5,34228,29,5,36410,17,20.7,-1.287781,36.817866,-1.323615,36.700475,448,2182,73,1750
3748,19021,909,3,Business,25,4,65279,25,4,65352,25,4,66511,25,4,66935,25,4,69531,10,23.25888921888938,-1.2527958,36.8003131,-1.225322,36.80855,108,2596,73,1583
3749,2687,53,3,Business,4,2,42763,4,2,43023,4,2,43446,4,2,43771,4,2,44717,5,20.6,-1.3004062,36.829741,-1.2770708,36.8231093,894,946,260,748
3750,22659,2989,3,Business,20,6,50436,20,6,51075,20,6,51967,20,6,53600,20,6,53718,11,28.3,-1.3472066,36.7692638,-1.301796,36.8012024,612,118,639,2525
3751,24226,3599,3,Business,26,2,47010,26,2,47047,26,2,47884,26,2,49277,26,2,51635,13,31.1,-1.3302996,36.8707935,-1.2744447,36.7861339,675,2358,37,2230
3752,17608,2956,3,Business,6,6,56118,6,6,56147,6,6,56914,6,6,58289,6,6,58294,6,28.1,-1.28878,36.8168312,-1.2584143,36.8048002,119,5,29,2142
3753,9149,2212,3,Business,22,5,42303,22,5,42709,22,5,43443,22,5,44269,22,5,45242,8,28.5,-1.2772989,36.8526035,-1.2571472,36.7950633,291,973,406,1560
3754,3492,1280,3,Business,17,4,45817,17,4,45905,17,4,46781,17,4,46857,17,4,47531,5,25.4,-1.2551895,36.7822034,-1.2736466,36.8164042,547,674,88,952
3755,20359,1927,3,Business,22,4,54628,22,4,55402,22,4,56201,22,4,57099,22,4,58590,16,26.5,-1.3323107,36.8692616,-1.3463042,36.768164,559,1491,774,1697
3756,19936,1500,3,Business,13,1,51204,13,1,51236,13,1,51256,13,1,54187,13,1,54277,8,23.25888921888938,-1.3004062,36.829741,-1.2638185,36.7930057,472,90,32,2951
3757,25879,286,3,Business,1,6,34692,1,6,34994,1,6,35475,1,6,36440,1,6,37903,11,17.7,-1.2551895,36.7822034,-1.3080097,36.7494062,322,1463,302,1446
3758,1702,2200,3,Business,21,5,46665,21,5,46899,21,5,47070,21,5,47878,21,5,54978,5,22.7,-1.290894,36.822971,-1.2591019,36.800577,554,7100,234,979
3759,5579,1687,3,Business,11,5,49130,11,5,49215,11,5,50302,11,5,51491,11,5,53531,4,26.4,-1.2899256,36.815551,-1.2633049,36.8031251,237,2040,85,2276
3760,21688,2481,2,Personal,2,7,64407,2,7,64415,2,7,66187,2,7,67383,2,7,68762,13,23.25888921888938,-1.3205294,36.8197262,-1.3705953,36.7406699,179,1379,8,2968
3761,21162,136,3,Business,12,4,57588,12,4,57641,12,4,58691,12,4,58871,12,4,61546,21,21.7,-1.2914795,36.8248973,-1.3326173,36.7146233,105,2675,53,1230
3762,1126,2801,3,Business,21,2,47906,21,2,47937,21,2,48500,21,2,49733,21,2,50238,5,24.8,-1.2566689,36.7796952,-1.2674274,36.7870827,448,505,31,1796
3763,7980,1075,3,Business,30,6,40457,30,6,40469,30,6,42305,30,6,42645,30,6,44256,15,26.5,-1.2156006,36.8916865,-1.2527958,36.8003131,510,1611,12,2176
3764,10711,2066,3,Business,10,5,37601,10,5,37607,10,5,38017,10,5,38606,10,5,39299,5,19.3,-1.316961,36.820337,-1.2918862,36.8070622,754,693,6,999
3765,8022,567,3,Business,25,2,46079,25,2,47305,25,2,47529,25,2,49040,25,2,50307,7,26.9,-1.280027,36.825293,-1.2963097,36.7688221,571,1267,1226,1735
3766,22113,1340,3,Business,25,5,41624,25,5,41634,25,5,41752,25,5,42141,25,5,44650,17,26.4,-1.2707179,36.7979713,-1.3167218,36.8852763,19,2509,10,507
3767,3059,2587,3,Business,11,2,51047,11,2,51537,11,2,53520,11,2,54254,11,2,55206,2,25.6,-1.290894,36.822971,-1.28878,36.8168312,268,952,490,2717
3768,27394,3599,3,Business,11,2,40000,11,2,40954,11,2,42961,11,2,43983,11,2,46712,12,19.5,-1.3302996,36.8707935,-1.3043821,36.7840586,661,2729,954,3029
3769,9742,3701,3,Business,27,3,43842,27,3,43854,27,3,44435,27,3,44556,27,3,45956,17,25.8,-1.2612574,36.7879622,-1.2077542,36.8710987,932,1400,12,702
3770,17111,1461,2,Personal,31,2,62164,31,2,62254,31,2,62560,31,2,62950,31,2,63628,5,19.9,-1.2720769,36.8180604,-1.2710749,36.8014519,207,678,90,696
3771,2351,1589,3,Business,9,7,49728,9,7,50784,9,7,50956,9,7,51047,9,7,54952,18,18.0,-1.225322,36.80855,-1.2835228,36.7437619,60,3905,1056,263
3772,18410,635,3,Business,27,6,34766,27,6,36967,27,6,37877,27,6,38885,27,6,40496,8,23.25888921888938,-1.3016417,36.8271679,-1.2599563,36.7993439,131,1611,2201,1918
3773,10436,635,3,Business,14,5,46356,14,5,46388,14,5,46771,14,5,47525,14,5,48376,4,24.2,-1.2599563,36.7993439,-1.2822753,36.7916886,620,851,32,1137
3774,4665,1500,3,Business,24,3,30696,24,3,30915,24,3,32906,24,3,33893,24,3,35626,8,23.25888921888938,-1.3004062,36.829741,-1.2638185,36.7930057,435,1733,219,2978
3775,14119,3647,3,Business,15,3,58069,15,3,58140,15,3,58686,15,3,58973,15,3,60205,9,26.0,-1.272639,36.794723,-1.2703428,36.8336071,708,1232,71,833
3776,5989,2931,3,Business,12,5,42906,12,5,42912,12,5,42921,12,5,43044,12,5,46645,18,26.5,-1.2452664,36.8028541,-1.294215,36.8977958,796,3601,6,132
3777,18526,2733,3,Business,15,5,45434,15,5,45496,15,5,47430,15,5,47735,15,5,48654,6,25.7,-1.311706,36.802841,-1.2963097,36.7688221,269,919,62,2239
3778,11429,2106,1,Personal,22,5,47377,22,5,47464,22,5,48036,22,5,49254,22,5,50632,6,23.25888921888938,-1.2769628,36.815049,-1.3143523,36.8038275,444,1378,87,1790
3779,22464,867,3,Business,7,1,39852,7,1,43080,7,1,44261,7,1,44801,7,1,46432,10,24.9,-1.2996533,36.8292629,-1.2991441,36.7528804,576,1631,3228,1721
3780,15155,3727,2,Business,3,3,40318,3,3,40469,3,3,41614,3,3,41694,3,3,42915,8,24.2,-1.2963097,36.7688221,-1.2600616,36.7870182,328,1221,151,1225
3781,4791,1363,3,Business,7,1,48018,7,1,48805,7,1,49474,7,1,49567,7,1,50619,5,26.8,-1.3004062,36.829741,-1.2752846,36.8027022,436,1052,787,762
3782,9299,2330,3,Business,7,2,44811,7,2,45230,7,2,46161,7,2,46419,7,2,48478,4,23.1,-1.2614329,36.8094365,-1.2751225,36.8228392,519,2059,419,1189
3783,14823,3091,3,Business,26,3,48890,26,3,48970,26,3,49472,26,3,50403,26,3,51493,6,27.0,-1.3012008,36.764868,-1.2939132,36.8081606,565,1090,80,1433
3784,27587,2828,3,Business,30,2,56014,30,2,56033,30,2,56585,30,2,57534,30,2,60558,14,27.3,-1.2615888,36.7928732,-1.3251384,36.7860195,793,3024,19,1501
3785,10775,1271,3,Business,8,1,53240,8,1,53277,8,1,54705,8,1,55852,8,1,58020,24,29.8,-1.3244885,36.897792,-1.3107918,36.761794,746,2168,37,2575
3786,21774,2801,3,Business,5,5,44547,5,5,44572,5,5,46374,5,5,46651,5,5,50942,16,24.3,-1.3104506,36.8687235,-1.2595422,36.7871178,668,4291,25,2079
3787,19662,1500,3,Business,9,2,31690,9,2,31740,9,2,31992,9,2,32705,9,2,34511,8,20.8,-1.3004062,36.829741,-1.2638185,36.7930057,155,1806,50,965
3788,6099,2801,3,Business,19,3,37978,19,3,38492,19,3,41756,19,3,43697,19,3,46279,7,22.1,-1.289081,36.8300409,-1.2650182,36.7926717,268,2582,514,5205
3789,12007,2829,3,Business,17,5,51504,17,5,51588,17,5,54610,17,5,56460,17,5,58510,18,23.25888921888938,-1.3289016,36.8765964,-1.2571472,36.7950633,865,2050,84,4872
3790,17512,3560,3,Business,5,6,38791,5,6,38807,5,6,39735,5,6,41244,5,6,41671,1,22.3,-1.290894,36.822971,-1.279395,36.825364,88,427,16,2437
3791,3521,914,3,Business,4,2,46185,4,2,47755,4,2,49396,4,2,50097,4,2,50808,3,23.9,-1.2571472,36.7950633,-1.2670213,36.7994482,547,711,1570,2342
3792,1304,53,3,Business,11,4,38169,11,4,38212,11,4,39794,11,4,40138,11,4,41908,11,25.7,-1.2991441,36.7528804,-1.2770708,36.8231093,448,1770,43,1926
3793,20928,627,3,Business,23,5,54044,23,5,54466,23,5,55220,23,5,55765,23,5,58642,12,26.6,-1.2551895,36.7822034,-1.3056581,36.8445565,708,2877,422,1299
3794,22163,2528,3,Business,15,5,64498,15,5,64520,15,5,64670,15,5,65167,15,5,66478,17,28.0,-1.2551895,36.7822034,-1.3261837,36.698124,690,1311,22,647
3795,2132,2330,3,Business,11,2,46071,11,2,46341,11,2,47587,11,2,48737,11,2,50262,14,21.4,-1.285908,36.8980126,-1.2921463,36.8029626,126,1525,270,2396
3796,22095,2691,3,Business,21,4,59709,21,4,59745,21,4,60128,21,4,60321,21,4,62971,8,23.25888921888938,-1.2551895,36.7822034,-1.2857671,36.7875614,686,2650,36,576
3797,4928,3214,3,Business,30,2,42816,30,2,42885,30,2,44173,30,2,44774,30,2,45189,2,22.4,-1.289795,36.7957132,-1.295432,36.7870052,29,415,69,1889
3798,27378,1029,2,Personal,12,2,43527,12,2,43613,12,2,44565,12,2,48381,12,2,51710,8,21.1,-1.2765492,36.7669809,-1.2507752,36.7556628,140,3329,86,4768
3799,21097,3669,3,Business,10,5,45688,10,5,46088,10,5,47559,10,5,48439,10,5,49398,6,23.25888921888938,-1.2793686,36.8259233,-1.2615888,36.7928732,193,959,400,2351
3800,26032,239,1,Personal,26,3,61469,26,3,61521,26,3,62039,26,3,62716,26,3,64688,11,19.5,-1.32571,36.805533,-1.273808,36.8402896,85,1972,52,1195
3801,22319,867,3,Business,14,4,43168,14,4,43195,14,4,43199,14,4,44412,14,4,46495,10,25.2,-1.2996533,36.8292629,-1.2991441,36.7528804,901,2083,27,1217
3802,70,635,3,Business,10,5,36338,10,5,36356,10,5,36991,10,5,37078,10,5,37478,3,13.4,-1.2534952,36.7825215,-1.2599563,36.7993439,409,400,18,722
3803,3207,3689,3,Business,8,4,34930,8,4,34944,8,4,35465,8,4,36733,8,4,37648,1,20.4,-1.2584143,36.8048002,-1.2527958,36.8003131,611,915,14,1789
3804,470,2358,4,Business,29,3,63323,29,3,63396,29,3,63995,29,3,64718,29,3,65905,2,19.2,-1.302222,36.75873,-1.296797,36.7764525,846,1187,73,1322
3805,15984,685,3,Business,6,1,56013,6,1,56201,6,1,56671,6,1,56893,6,1,58913,13,23.25888921888938,-1.3255316,36.711542,-1.2726506,36.7960153,654,2020,188,692
3806,12621,496,3,Business,5,5,48130,5,5,48150,5,5,48457,5,5,48785,5,5,49241,2,27.6,-1.2551895,36.7822034,-1.2561334,36.7990458,690,456,20,635
3807,26653,1286,1,Personal,30,6,57165,30,6,57817,30,6,59337,30,6,60318,30,6,61069,6,21.8,-1.2819626,36.7540971,-1.294336,36.795332,522,751,652,2501
3808,12493,2702,3,Personal,15,6,37918,15,6,37928,15,6,38008,15,6,38931,15,6,40906,10,21.8,-1.2736646,36.8142774,-1.3174857,36.8019937,89,1975,10,1003
3809,24991,265,3,Business,7,3,55033,7,3,57035,7,3,58049,7,3,58601,7,3,60089,8,28.1,-1.3006208,36.7727444,-1.300921,36.828195,532,1488,2002,1566
3810,8598,2804,3,Business,14,1,56832,14,1,56848,14,1,57085,14,1,57781,14,1,58949,8,25.6,-1.2852139,36.751683,-1.2551895,36.7822034,932,1168,16,933
3811,21051,2504,3,Business,11,4,45561,11,4,45579,11,4,46181,11,4,46268,11,4,52065,9,25.8,-1.2963097,36.7688221,-1.2601197,36.7985271,699,5797,18,689
3812,12995,635,3,Business,8,1,50092,8,1,50105,8,1,50377,8,1,51014,8,1,52006,8,24.8,-1.2599563,36.7993439,-1.22589,36.7822548,178,992,13,909
3813,5706,3621,3,Business,11,2,59303,11,2,59460,11,2,59950,11,2,60134,11,2,62189,7,20.5,-1.2836583,36.7886014,-1.2567546,36.7808241,624,2055,157,674
3814,5821,393,3,Business,10,1,47867,10,1,47963,10,1,49552,10,1,49668,10,1,50180,4,18.5,-1.3228003,36.8306435,-1.3004062,36.829741,567,512,96,1705
3815,15138,2865,1,Personal,23,6,58012,23,6,58146,23,6,59487,23,6,62458,23,6,63699,8,23.25888921888938,-1.2789683,36.8284768,-1.3275191,36.7992817,584,1241,134,4312
3816,14997,1319,1,Personal,27,4,32369,27,4,32381,27,4,32451,27,4,33186,27,4,35217,25,18.9,-1.2615888,36.7928732,-1.3773235,36.9365672,875,2031,12,805
3817,1889,1340,3,Business,7,2,44643,7,2,44669,7,2,45619,7,2,47018,7,2,49898,20,23.3,-1.2602386,36.7503491,-1.2628424,36.8950641,574,2880,26,2349
3818,21604,3300,3,Business,17,3,46190,17,3,46274,17,3,48453,17,3,48695,17,3,52642,11,23.25888921888938,-1.331619,36.847976,-1.303596,36.778378,106,3947,84,2421
3819,24731,3647,3,Business,6,1,53522,6,1,53544,6,1,53675,6,1,53926,6,1,58040,16,23.25888921888938,-1.272639,36.794723,-1.298037,36.6934582,831,4114,22,382
3820,4510,2330,3,Business,11,2,58858,11,2,59666,11,2,59672,11,2,60297,11,2,60845,3,21.0,-1.3015197,36.7658456,-1.2868601,36.7738025,74,548,808,631
3821,5694,1384,3,Business,29,5,33719,29,5,33764,29,5,34718,29,5,35508,29,5,37974,22,20.8,-1.2517448,36.7924971,-1.2675827,36.9272661,263,2466,45,1744
3822,18181,1246,3,Business,15,5,40797,15,5,40813,15,5,41091,15,5,41799,15,5,44062,20,26.5,-1.3700383,36.9190174,-1.2978908,36.7963215,551,2263,16,986
3823,10524,627,3,Business,3,2,44234,3,2,44302,3,2,45394,3,2,45620,3,2,49472,9,18.5,-1.2551895,36.7822034,-1.2983462,36.8139996,89,3852,68,1318
3824,11767,2903,2,Personal,16,2,47119,16,2,47147,16,2,47720,16,2,47827,16,2,48294,3,23.7,-1.2637057,36.80517,-1.2456412,36.7955298,22,467,28,680
3825,22516,540,3,Business,16,3,38534,16,3,38543,16,3,38652,16,3,39403,16,3,39667,3,23.0,-1.2551895,36.7822034,-1.2636814,36.8029965,74,264,9,860
3826,10151,972,3,Business,18,6,37053,18,6,37250,18,6,37655,18,6,37777,18,6,39869,7,15.7,-1.2862033,36.8152966,-1.32256,36.8396386,857,2092,197,527
3827,23197,1502,3,Business,20,3,53052,20,3,53103,20,3,53839,20,3,53915,20,3,56041,17,28.2,-1.225322,36.80855,-1.2232123,36.8932547,108,2126,51,812
3828,16864,2330,3,Business,30,2,54026,30,2,55095,30,2,55485,30,2,55851,30,2,56904,10,23.25888921888938,-1.2687407,36.7373043,-1.2671943,36.8062533,269,1053,1069,756
3829,1800,2828,3,Business,7,6,51330,7,6,51348,7,6,51368,7,6,53202,7,6,53257,3,21.5,-1.2584143,36.8048002,-1.2615888,36.7928732,51,55,18,1854
3830,12110,2349,3,Business,4,5,35793,4,5,35889,4,5,36164,4,5,36515,4,5,38819,6,17.6,-1.2784495,36.7981729,-1.262471,36.8194216,101,2304,96,626
3831,3531,2330,3,Business,14,3,48543,14,3,48570,14,3,49494,14,3,49785,14,3,52535,16,25.5,-1.2267055,36.8013889,-1.3015197,36.7658456,38,2750,27,1215
3832,71,1191,1,Personal,29,5,41034,29,5,41067,29,5,41326,29,5,41541,29,5,43229,11,19.9,-1.3352545,36.8659639,-1.2962832,36.7849683,192,1688,33,474
3833,21171,1271,3,Business,12,2,57269,12,2,57674,12,2,58206,12,2,59033,12,2,61833,19,23.0,-1.3244885,36.897792,-1.296139,36.780316,379,2800,405,1359
3834,14145,186,3,Business,5,4,43100,5,4,44018,5,4,44553,5,4,45715,5,4,48759,24,23.25888921888938,-1.3700383,36.9190174,-1.2579304,36.8019667,631,3044,918,1697
3835,23665,1926,3,Business,29,4,57340,29,4,59644,29,4,60377,29,4,60565,29,4,63309,6,20.9,-1.287821,36.827056,-1.2571472,36.7950633,436,2744,2304,921
3836,7014,1336,3,Business,19,5,47301,19,5,48490,19,5,49548,19,5,50033,19,5,50821,2,27.5,-1.2891922,36.825189,-1.2909536,36.8407162,857,788,1189,1543
3837,11877,2174,3,Business,23,5,36779,23,5,36804,23,5,37296,23,5,38371,23,5,41184,11,24.1,-1.2482781,36.884092,-1.261795,36.822333,82,2813,25,1567
3838,10277,1075,3,Business,29,4,51225,29,4,53260,29,4,54053,29,4,54557,29,4,56647,9,24.8,-1.2765736,36.8513646,-1.2527958,36.8003131,79,2090,2035,1297
3839,2104,1075,3,Business,23,2,36695,23,2,36708,23,2,38583,23,2,39730,23,2,41632,15,23.25888921888938,-1.2156006,36.8916865,-1.2527958,36.8003131,266,1902,13,3022
3840,2691,2419,1,Personal,24,1,32375,24,1,32393,24,1,32408,24,1,33570,24,1,34129,3,15.5,-1.2551895,36.7822034,-1.2663351,36.8099425,881,559,18,1177
3841,25108,627,3,Business,28,4,61892,28,4,61987,28,4,62414,28,4,62600,28,4,67251,12,28.1,-1.2551895,36.7822034,-1.2416156,36.8736721,793,4651,95,613
3842,11558,1384,3,Business,30,4,59613,30,4,59951,30,4,60535,30,4,61027,30,4,64063,8,23.25888921888938,-1.2517448,36.7924971,-1.2707534,36.837893,930,3036,338,1076
3843,15720,393,3,Business,6,4,38624,6,4,38682,6,4,39477,6,4,40008,6,4,40786,4,19.9,-1.3228003,36.8306435,-1.3004062,36.829741,35,778,58,1326
3844,25661,1882,1,Business,13,1,63002,13,1,63035,13,1,63575,13,1,63800,13,1,64990,8,19.1,-1.2268871,36.8073946,-1.2591019,36.800577,208,1190,33,765
3845,23742,1927,3,Business,13,3,61446,13,3,63734,13,3,64579,13,3,64796,13,3,66174,10,27.3,-1.3169591,36.7000029,-1.3472066,36.7692638,419,1378,2288,1062
3846,6784,2469,3,Business,26,1,63197,26,1,63967,26,1,64558,26,1,64952,26,1,65752,5,20.1,-1.303924,36.8758792,-1.308231,36.857306,675,800,770,985
3847,14346,1964,3,Personal,14,1,46013,14,1,46097,14,1,47115,14,1,47411,14,1,50179,10,23.7,-1.32671,36.8600138,-1.2904753,36.8144721,743,2768,84,1314
3848,3591,1850,3,Business,27,1,52508,27,1,52556,27,1,53205,27,1,53891,27,1,55048,6,23.1,-1.2571472,36.7950633,-1.2890847,36.8048724,131,1157,48,1335
3849,5237,2391,1,Personal,19,5,76229,19,5,77334,19,5,78371,19,5,78869,19,5,79046,1,20.1,-1.2955961,36.7703081,-1.2993094,36.7772069,299,177,1105,1535
3850,15719,2330,3,Business,17,5,53203,17,5,53229,17,5,53562,17,5,53991,17,5,54847,3,23.25888921888938,-1.3015197,36.7658456,-1.294597,36.7742999,161,856,26,762
3851,2213,2112,3,Business,27,4,46226,27,4,46251,27,4,47335,27,4,47785,27,4,48842,5,23.0,-1.2285835,36.8826468,-1.2156006,36.8916865,649,1057,25,1534
3852,26450,2987,3,Business,25,5,41626,25,5,42432,25,5,43526,25,5,43672,25,5,44359,3,21.1,-1.270212,36.8210877,-1.2649605,36.7981777,103,687,806,1240
3853,8850,2069,3,Business,10,6,44469,10,6,44482,10,6,45199,10,6,45985,10,6,48560,13,23.8,-1.293515,36.897607,-1.228911,36.881876,554,2575,13,1503
3854,26861,2587,3,Business,21,5,51153,21,5,51165,21,5,52127,21,5,53175,21,5,54113,6,27.3,-1.2551895,36.7822034,-1.28878,36.8168312,336,938,12,2010
3855,4512,1363,3,Business,31,4,52994,31,4,53142,31,4,53737,31,4,53801,31,4,54155,4,28.6,-1.3004062,36.829741,-1.312469,36.815177,88,354,148,659
3856,11325,517,3,Business,29,4,37281,29,4,37292,29,4,37805,29,4,38648,29,4,38650,5,21.4,-1.3177547,36.8303703,-1.3077869,36.8443207,188,2,11,1356
3857,508,1417,3,Business,2,2,53264,2,2,53278,2,2,53832,2,2,55915,2,2,58782,20,29.4,-1.3362908,36.9154568,-1.2741728,36.7969108,863,2867,14,2637
3858,15741,1154,3,Business,19,3,43312,19,3,43362,19,3,45057,19,3,45470,19,3,47466,20,22.4,-1.2917868,36.7872675,-1.3700383,36.9190174,440,1996,50,2108
3859,15501,2066,3,Business,13,1,40497,13,1,40630,13,1,41428,13,1,41637,13,1,42781,8,17.0,-1.316961,36.820337,-1.2655477,36.8001682,726,1144,133,1007
3860,26506,2457,3,Business,9,4,53637,9,4,53720,9,4,55117,9,4,55291,9,4,56324,5,23.25888921888938,-1.2551895,36.7822034,-1.2740461,36.7985198,547,1033,83,1571
3861,9755,3557,3,Business,21,2,54367,21,2,54429,21,2,55154,21,2,55937,21,2,58807,8,24.9,-1.3012173,36.8093987,-1.2546732,36.8086796,411,2870,62,1508
3862,20350,3331,3,Business,5,3,37621,5,3,38114,5,3,38426,5,3,39951,5,3,41149,14,22.5,-1.2551895,36.7822034,-1.2294985,36.8775495,598,1198,493,1837
3863,27470,1517,1,Personal,16,2,56390,16,2,56864,16,2,57318,16,2,57850,16,2,59104,9,27.5,-1.3099295,36.8436807,-1.2662716,36.8150237,116,1254,474,986
3864,11814,2008,3,Business,21,2,43846,21,2,43901,21,2,44308,21,2,44589,21,2,48243,6,22.5,-1.2508229,36.7895263,-1.2791714,36.8255997,831,3654,55,688
3865,15552,3647,3,Business,1,1,41316,1,1,41372,1,1,41981,1,1,42208,1,1,44317,18,23.25888921888938,-1.272639,36.794723,-1.298037,36.6934582,147,2109,56,836
3866,15099,2956,3,Business,24,2,49553,24,2,49564,24,2,50946,24,2,51121,24,2,52036,4,18.6,-1.2584143,36.8048002,-1.2562249,36.7868661,415,915,11,1557
3867,25884,633,3,Business,7,4,35922,7,4,35953,7,4,36146,7,4,36405,7,4,37170,4,23.25888921888938,-1.3077869,36.8443207,-1.3004062,36.829741,611,765,31,452
3868,19914,3291,3,Business,27,6,32643,27,6,32709,27,6,33665,27,6,34046,27,6,34548,5,23.25888921888938,-1.2628473,36.781805,-1.2600926,36.8088685,783,502,66,1337
3869,10780,393,3,Business,14,4,43303,14,4,43822,14,4,44518,14,4,45890,14,4,46793,5,23.9,-1.3167113,36.8301563,-1.3077869,36.8443207,856,903,519,2068
3870,4986,3300,3,Business,4,2,36199,4,2,36232,4,2,37433,4,2,38538,4,2,40347,17,20.3,-1.228911,36.881876,-1.303596,36.778378,75,1809,33,2306
3871,19660,526,2,Personal,27,1,36345,27,1,36362,27,1,36776,27,1,37075,27,1,38157,4,16.8,-1.268572,36.802839,-1.2650502,36.7956371,754,1082,17,713
3872,26415,1245,3,Business,29,5,59346,29,5,59406,29,5,60000,29,5,61291,29,5,63429,17,27.9,-1.300921,36.828195,-1.3198615,36.7110323,691,2138,60,1885
3873,15286,1930,2,Personal,17,1,44129,17,1,44143,17,1,44354,17,1,44530,17,1,45883,10,25.0,-1.2873232,36.7658572,-1.2655306,36.828148,88,1353,14,387
3874,22996,1081,3,Business,6,3,37182,6,3,37194,6,3,37710,6,3,37927,6,3,40057,13,22.3,-1.2551895,36.7822034,-1.321846,36.82826,598,2130,12,733
3875,5144,1389,3,Business,19,3,64928,19,3,64937,19,3,65834,19,3,66381,19,3,68055,13,22.5,-1.2534301,36.8000983,-1.207546,36.7913976,191,1674,9,1444
3876,4981,1179,3,Business,22,4,52417,22,4,52876,22,4,53807,22,4,54216,22,4,58456,21,26.5,-1.3700383,36.9190174,-1.2917868,36.7872675,498,4240,459,1340
3877,3619,2271,3,Business,2,2,53779,2,2,54570,2,2,55202,2,2,59329,2,2,60659,9,29.3,-1.3343129,36.8854175,-1.293515,36.897607,855,1330,791,4759
3878,21211,1959,1,Business,22,3,38059,22,3,38067,22,3,39452,22,3,39649,22,3,41657,9,22.9,-1.257873,36.843612,-1.255956,36.789867,54,2008,8,1582
3879,25719,393,3,Business,11,1,31007,11,1,31023,11,1,31170,11,1,32112,11,1,33808,11,18.2,-1.3167113,36.8301563,-1.2638185,36.7930057,523,1696,16,1089
3880,20199,1169,1,Personal,29,5,58336,29,5,59091,29,5,60754,29,5,60963,29,5,61983,4,20.5,-1.2902539,36.8211322,-1.2996713,36.7945858,88,1020,755,1872
3881,5146,3194,3,Business,9,2,42521,9,2,42641,9,2,43214,9,2,43374,9,2,44704,9,22.2,-1.2551895,36.7822034,-1.2854174,36.7951152,268,1330,120,733
3882,8010,393,3,Business,15,2,46564,15,2,46585,15,2,46587,15,2,47217,15,2,49285,11,24.2,-1.3167113,36.8301563,-1.2574219,36.7927073,914,2068,21,632
3883,18314,186,3,Business,19,2,47600,19,2,47691,19,2,48111,19,2,48708,19,2,49930,6,27.4,-1.2571472,36.7950633,-1.2985749,36.8088,318,1222,91,1017
3884,17168,2982,3,Business,9,5,41457,9,5,42431,9,5,45067,9,5,45317,9,5,48987,18,25.7,-1.177202,36.8351183,-1.300921,36.828195,810,3670,974,2886
3885,2030,1527,3,Business,5,5,32988,5,5,32997,5,5,33527,5,5,34061,5,5,34900,4,19.6,-1.3077869,36.8443207,-1.3004062,36.829741,709,839,9,1064
3886,16000,3647,3,Business,15,4,39292,15,4,39508,15,4,40342,15,4,40538,15,4,42012,8,24.2,-1.272639,36.794723,-1.306245,36.8192978,685,1474,216,1030
3887,8994,186,3,Business,22,5,55324,22,5,55469,22,5,56524,22,5,57534,22,5,60122,20,30.8,-1.2571472,36.7950633,-1.3700383,36.9190174,154,2588,145,2065
3888,21310,633,3,Business,26,1,50432,26,1,50828,26,1,51797,26,1,52489,26,1,53307,4,22.2,-1.3077869,36.8443207,-1.3004062,36.829741,654,818,396,1661
3889,1626,3115,3,Business,20,1,38563,20,1,38623,20,1,38825,20,1,39559,20,1,41645,14,23.25888921888938,-1.3189252,36.8617269,-1.2963097,36.7688221,459,2086,60,936
3890,4775,2869,3,Business,21,2,36621,21,2,36645,21,2,36977,21,2,37436,21,2,38134,3,23.25888921888938,-1.2763494,36.7671783,-1.3025826,36.7670807,678,698,24,791
3891,24123,2503,2,Business,18,4,46555,18,4,46612,18,4,46680,18,4,47741,18,4,48572,8,25.4,-1.2925236,36.7795556,-1.2551895,36.7822034,79,831,57,1129
3892,8876,1798,3,Business,26,5,37079,26,5,37314,26,5,37709,26,5,37908,26,5,42177,10,23.25888921888938,-1.2615888,36.7928732,-1.3080097,36.7494062,708,4269,235,594
3893,21339,3686,3,Business,10,1,36402,10,1,36615,10,1,37324,10,1,37483,10,1,38569,8,16.5,-1.2551895,36.7822034,-1.2913205,36.8223569,434,1086,213,868
3894,13239,1893,3,Personal,7,5,43691,7,5,43804,7,5,44162,7,5,44313,7,5,46782,4,25.7,-1.2668071,36.8068157,-1.2934657,36.8212737,857,2469,113,509
3895,7046,1484,3,Business,4,1,55347,4,1,55379,4,1,55451,4,1,56244,4,1,57449,3,28.6,-1.2551895,36.7822034,-1.2527958,36.8003131,828,1205,32,865
3896,177,1082,1,Personal,7,7,59254,7,7,60276,7,7,61855,7,7,61947,7,7,63211,12,23.1,-1.2606138,36.6963627,-1.307198,36.7502243,731,1264,1022,1671
3897,22566,3772,1,Personal,29,6,27532,29,6,27587,29,6,29778,29,6,29956,29,6,30771,9,18.0,-1.3054537,36.8284768,-1.2668093,36.7966542,208,815,55,2369
3898,24210,2100,3,Business,12,5,59668,12,5,61055,12,5,61112,12,5,61702,12,5,63093,10,25.9,-1.2765736,36.8513646,-1.2571472,36.7950633,89,1391,1387,647
3899,19607,53,3,Business,15,5,54429,15,5,54860,15,5,54905,15,5,59030,15,5,60338,5,17.9,-1.3004062,36.829741,-1.2770708,36.8231093,291,1308,431,4170
3900,735,1325,2,Personal,18,4,46743,18,4,46761,18,4,47597,18,4,48282,18,4,49988,15,25.5,-1.1855066,36.8254646,-1.215312,36.9049037,208,1706,18,1521
3901,10962,733,3,Business,13,3,51851,13,3,52746,13,3,53255,13,3,53740,13,3,55819,13,27.4,-1.2551895,36.7822034,-1.2998093,36.8595226,958,2079,895,994
3902,8695,412,3,Business,4,1,54162,4,1,54232,4,1,54236,4,1,56042,4,1,56169,6,28.5,-1.2858945,36.8161197,-1.2628473,36.781805,41,127,70,1810
3903,13422,1500,3,Business,4,1,32093,4,1,32152,4,1,34127,4,1,34977,4,1,36768,8,21.8,-1.3004062,36.829741,-1.2638185,36.7930057,590,1791,59,2825
3904,20363,2174,3,Business,14,2,45137,14,2,45259,14,2,45268,14,2,48687,14,2,48694,16,23.25888921888938,-1.2482781,36.884092,-1.2016077,36.930397,86,7,122,3428
3905,7883,3239,1,Personal,8,6,32299,8,6,32321,8,6,34433,8,6,34528,8,6,37276,13,18.1,-1.2844072,36.8247296,-1.2613677,36.9067336,208,2748,22,2207
3906,6933,1044,2,Personal,18,6,49161,18,6,49175,18,6,49489,18,6,50489,18,6,50794,2,20.6,-1.2882603,36.8188821,-1.284835,36.8152125,45,305,14,1314
3907,6363,374,2,Personal,8,5,72908,8,5,73510,8,5,74272,8,5,74379,8,5,75011,5,18.2,-1.2831463,36.7636022,-1.2900727,36.7890059,334,632,602,869
3908,10771,571,3,Business,24,4,55886,24,4,56861,24,4,58896,24,4,59555,24,4,63486,19,25.9,-1.3236332,36.701152,-1.2627937,36.8156957,660,3931,975,2694
3909,12903,1075,3,Business,17,4,41053,17,4,41077,17,4,41659,17,4,42010,17,4,42608,1,25.3,-1.2649605,36.7981777,-1.2527958,36.8003131,733,598,24,933
3910,11249,2523,3,Business,12,2,39611,12,2,39718,12,2,40753,12,2,41265,12,2,43186,8,24.7,-1.2551895,36.7822034,-1.295156,36.8094306,863,1921,107,1547
3911,27854,3547,3,Business,1,1,46047,1,1,46062,1,1,46673,1,1,48616,1,1,52179,16,23.25888921888938,-1.3189252,36.8617269,-1.2856319,36.7672998,435,3563,15,2554
3912,21102,190,3,Business,29,1,44115,29,1,44337,29,1,45680,29,1,48317,29,1,49224,6,23.25888921888938,-1.3237,36.876194,-1.3270347,36.8667362,956,907,222,3980
3913,19541,393,3,Business,19,2,40020,19,2,40030,19,2,40034,19,2,40580,19,2,42080,14,26.8,-1.3167113,36.8301563,-1.306378,36.7519845,111,1500,10,550
3914,6586,391,3,Business,11,1,50678,11,1,53863,11,1,54804,11,1,55446,11,1,56250,5,28.1,-1.2602337,36.7990548,-1.2784063,36.8222933,336,804,3185,1583
3915,4102,1336,3,Business,4,5,60172,4,5,61706,4,5,62514,4,5,62808,4,5,63528,2,21.8,-1.290894,36.822971,-1.2885029,36.825605,583,720,1534,1102
3916,3507,3635,1,Business,27,4,46505,27,4,46516,27,4,46747,27,4,46906,27,4,47634,3,22.6,-1.2584143,36.8048002,-1.2615888,36.7928732,96,728,11,390
3917,8765,1500,3,Business,8,4,31519,8,4,31739,8,4,32490,8,4,34670,8,4,35636,8,20.4,-1.3004062,36.829741,-1.2574219,36.7927073,620,966,220,2931
3918,977,2982,3,Business,5,3,35821,5,3,36369,5,3,38054,5,3,39430,5,3,42104,18,22.2,-1.300921,36.828195,-1.177202,36.8351183,661,2674,548,3061
3919,14080,2412,3,Business,28,2,37923,28,2,37982,28,2,39714,28,2,39894,28,2,43105,14,21.2,-1.2283403,36.8822756,-1.290894,36.822971,788,3211,59,1912
3920,10700,2828,3,Business,13,3,45778,13,3,45797,13,3,46142,13,3,46998,13,3,49668,22,20.0,-1.2649605,36.7981777,-1.4039004,36.7543649,620,2670,19,1201
3921,13466,1882,3,Business,4,6,38621,4,6,38866,4,6,40141,4,6,40758,4,6,42276,14,23.25888921888938,-1.2156006,36.8916865,-1.2591019,36.800577,930,1518,245,1892
3922,12665,893,3,Business,14,2,48172,14,2,48266,14,2,48612,14,2,49026,14,2,50146,8,23.25888921888938,-1.2663194,36.809901,-1.2985153,36.7876043,337,1120,94,760
3923,3941,3647,3,Business,17,4,36630,17,4,36820,17,4,37292,17,4,37447,17,4,38728,3,23.25888921888938,-1.272639,36.794723,-1.272798,36.8124195,512,1281,190,627
3924,11032,2195,3,Business,8,6,61908,8,6,61925,8,6,62549,8,6,62989,8,6,64137,9,22.0,-1.265715,36.823815,-1.228911,36.881876,309,1148,17,1064
3925,5597,496,3,Business,9,2,41413,9,2,41434,9,2,41525,9,2,41813,9,2,45838,16,27.1,-1.2551895,36.7822034,-1.275034,36.881586,730,4025,21,379
3926,8973,633,3,Business,22,2,56752,22,2,56780,22,2,56787,22,2,57634,22,2,58794,4,25.5,-1.3077869,36.8443207,-1.3004062,36.829741,39,1160,28,854
3927,8178,136,3,Business,13,4,51811,13,4,51926,13,4,52233,13,4,52845,13,4,54737,16,22.2,-1.2908945,36.8246514,-1.3254522,36.7216584,320,1892,115,919
3928,19981,3560,3,Business,5,2,55022,5,2,55546,5,2,55823,5,2,56273,5,2,57281,5,27.3,-1.2588181,36.8106709,-1.279395,36.825364,828,1008,524,727
3929,4604,635,3,Business,8,6,35928,8,6,35992,8,6,36003,8,6,37658,8,6,38145,7,18.4,-1.3016417,36.8271679,-1.2599563,36.7993439,179,487,64,1666
3930,14231,2423,3,Business,3,3,55973,3,3,55982,3,3,56505,3,3,59751,3,3,60368,4,27.4,-1.2571472,36.7950633,-1.2676851,36.8209429,279,617,9,3769
3931,4662,136,3,Business,8,5,50640,8,5,50700,8,5,51293,8,5,51621,8,5,53182,16,27.0,-1.3233496,36.8139159,-1.3254522,36.7216584,523,1561,60,921
3932,6962,1205,3,Business,12,2,50537,12,2,50599,12,2,51174,12,2,51247,12,2,52183,3,27.0,-1.2495931,36.8065087,-1.2561964,36.7885001,953,936,62,648
3933,9206,1995,3,Business,3,5,59086,3,5,59282,3,5,59933,3,5,60294,3,5,61937,3,23.25888921888938,-1.2677278,36.8001549,-1.2551895,36.7822034,281,1643,196,1012
3934,14283,640,3,Business,26,2,56259,26,2,56649,26,2,57401,26,2,58370,26,2,60120,6,29.9,-1.2969741,36.7856612,-1.28359,36.823092,61,1750,390,1721
3935,2049,2828,3,Business,22,5,33676,22,5,35048,22,5,36237,22,5,36754,22,5,39360,13,23.25888921888938,-1.2615888,36.7928732,-1.3263105,36.8622904,772,2606,1372,1706
3936,28263,238,3,Business,16,2,40494,16,2,43732,16,2,44259,16,2,44342,16,2,44737,3,23.25888921888938,-1.3077869,36.8443207,-1.308366,36.823613,299,395,3238,610
3937,4513,412,3,Business,5,2,30589,5,2,30614,5,2,31285,5,2,32781,5,2,32829,2,21.1,-1.2600926,36.8088685,-1.266837,36.799249,61,48,25,2167
3938,9786,2330,3,Business,7,2,38143,7,2,38164,7,2,38858,7,2,39282,7,2,40401,9,23.25888921888938,-1.2645318,36.7981775,-1.2687407,36.7373043,484,1119,21,1118
3939,21862,3431,1,Personal,26,4,37490,26,4,37511,26,4,38342,26,4,39303,26,4,40251,8,18.8,-1.282285,36.822655,-1.2572139,36.7914876,726,948,21,1792
3940,26878,187,3,Business,26,1,46289,26,1,47111,26,1,48686,26,1,49394,26,1,53142,22,22.4,-1.3226302,36.8719901,-1.3165542,36.700067,928,3748,822,2283
3941,5017,393,3,Business,8,2,56329,8,2,56369,8,2,56540,8,2,57369,8,2,59182,11,25.3,-1.3167113,36.8301563,-1.2574219,36.7927073,330,1813,40,1000
3942,3392,3686,3,Business,13,2,55803,13,2,58970,13,2,59467,13,2,59753,13,2,63402,10,23.7,-1.2551895,36.7822034,-1.2287282,36.8115304,829,3649,3167,783
3943,25231,635,3,Business,14,5,53065,14,5,56645,14,5,58132,14,5,58664,14,5,60649,16,23.0,-1.319613,36.711055,-1.2599563,36.7993439,310,1985,3580,2019
3944,19101,1402,3,Business,3,3,41003,3,3,41385,3,3,41853,3,3,42175,3,3,43587,5,27.4,-1.2584143,36.8048002,-1.2813012,36.8323962,709,1412,382,790
3945,11358,552,3,Business,6,3,41645,6,3,43337,6,3,45291,6,3,45650,6,3,48545,21,20.0,-1.3562374,36.9042954,-1.2553615,36.7895376,322,2895,1692,2313
3946,18964,1482,3,Business,2,2,61867,2,2,62026,2,2,63424,2,2,63841,2,2,65194,7,28.4,-1.2822773,36.7953121,-1.2664135,36.8322682,99,1353,159,1815
3947,1213,3557,3,Business,4,4,33158,4,4,33297,4,4,34196,4,4,34968,4,4,36023,8,21.8,-1.29387,36.7907813,-1.2546732,36.8086796,445,1055,139,1671
3948,17500,2828,3,Business,30,5,45873,30,5,45916,30,5,46237,30,5,46557,30,5,48028,3,23.8,-1.2584143,36.8048002,-1.2615888,36.7928732,228,1471,43,641
3949,23075,1500,3,Business,22,5,31972,22,5,31992,22,5,32139,22,5,33726,22,5,34908,8,22.4,-1.3004062,36.829741,-1.2638185,36.7930057,349,1182,20,1734
3950,24201,2956,3,Business,25,4,56543,25,4,56779,25,4,57668,25,4,57903,25,4,58637,3,23.25888921888938,-1.2584143,36.8048002,-1.2551895,36.7822034,709,734,236,1124
3951,18688,3283,3,Business,6,4,34693,6,4,34948,6,4,35407,6,4,35861,6,4,36595,5,18.8,-1.2600926,36.8088685,-1.2628473,36.781805,646,734,255,913
3952,25104,381,2,Personal,31,2,47530,31,2,47577,31,2,48060,31,2,48727,31,2,49383,5,22.3,-1.2632269,36.8032616,-1.2534992,36.7965565,379,656,47,1150
3953,24650,2112,3,Business,21,4,62525,21,4,62596,21,4,62924,21,4,64289,21,4,66064,12,23.25888921888938,-1.279395,36.825364,-1.2156006,36.8916865,248,1775,71,1693
3954,19022,540,3,Business,22,3,50007,22,3,50595,22,3,51193,22,3,51369,22,3,52173,7,24.2,-1.2551895,36.7822034,-1.2897978,36.8267388,491,804,588,774
3955,11099,2964,3,Business,30,2,35803,30,2,35839,30,2,36444,30,2,36693,30,2,37906,9,23.25888921888938,-1.2551895,36.7822034,-1.2977565,36.8025534,96,1213,36,854
3956,15776,265,3,Business,5,3,34697,5,3,34857,5,3,35360,5,3,35768,5,3,36883,6,17.8,-1.2739008,36.8139772,-1.300921,36.828195,596,1115,160,911
3957,3119,3754,3,Business,3,4,54579,3,4,54609,3,4,54642,3,4,55252,3,4,56761,12,26.1,-1.2571472,36.7950633,-1.3271684,36.8173021,539,1509,30,643
3958,516,1920,3,Business,29,4,34561,29,4,34572,29,4,34932,29,4,35281,29,4,36072,4,18.8,-1.2551895,36.7822034,-1.2668454,36.7940642,720,791,11,709
3959,12881,390,1,Personal,25,5,32760,25,5,32904,25,5,33832,25,5,34356,25,5,35242,5,16.8,-1.2828362,36.8189236,-1.2601,36.796528,338,886,144,1452
3960,12474,2216,3,Business,28,5,50104,28,5,51928,28,5,53062,28,5,53274,28,5,54681,12,25.3,-1.2867627,36.883446,-1.295156,36.8094306,187,1407,1824,1346
3961,25214,3718,3,Business,5,1,41956,5,1,42000,5,1,43785,5,1,44144,5,1,44584,3,24.3,-1.2650027,36.8126242,-1.26071,36.8206332,315,440,44,2144
3962,4728,393,3,Business,8,1,47304,8,1,47554,8,1,48293,8,1,48842,8,1,50277,8,29.7,-1.3167113,36.8301563,-1.2770708,36.8231093,306,1435,250,1288
3963,20984,1148,3,Business,22,5,46161,22,5,48151,22,5,49551,22,5,50451,22,5,51671,5,31.2,-1.3100586,36.8500329,-1.3319197,36.8501483,787,1220,1990,2300
3964,24909,3363,1,Personal,28,2,35969,28,2,36056,28,2,38045,28,2,38529,28,2,40649,7,17.6,-1.279395,36.8356241,-1.297101,36.798243,179,2120,87,2473
3965,13639,2828,3,Business,1,4,34298,1,4,34322,1,4,34579,1,4,35940,1,4,38624,13,23.25888921888938,-1.2615888,36.7928732,-1.3332749,36.8708147,574,2684,24,1618
3966,12859,1329,3,Business,11,1,51953,11,1,52048,11,1,52752,11,1,52871,11,1,55679,13,28.1,-1.273056,36.811298,-1.2778747,36.8831829,611,2808,95,823
3967,24135,3149,3,Business,15,2,46620,15,2,46640,15,2,46865,15,2,47132,15,2,47914,7,24.3,-1.3077869,36.8443207,-1.3167113,36.8301563,685,782,20,492
3968,13643,2956,3,Business,16,4,44449,16,4,44474,16,4,44685,16,4,44982,16,4,49740,16,23.25888921888938,-1.2584143,36.8048002,-1.216682,36.9085778,250,4758,25,508
3969,24934,604,3,Business,22,1,37152,22,1,37522,22,1,37949,22,1,38142,22,1,39150,3,24.8,-1.2551895,36.7822034,-1.2575407,36.7868197,548,1008,370,620
3970,27924,3521,3,Business,11,4,45385,11,4,45471,11,4,45813,11,4,46550,11,4,47218,5,25.8,-1.3179056,36.8393819,-1.2874648,36.8271985,438,668,86,1079
3971,450,3686,3,Business,1,5,44310,1,5,44323,1,5,44622,1,5,44845,1,5,45428,5,26.6,-1.2551895,36.7822034,-1.2760462,36.8074697,622,583,13,522
3972,23068,1133,3,Business,28,2,36155,28,2,36221,28,2,36842,28,2,37338,28,2,37614,4,18.5,-1.2696824,36.8026164,-1.2571472,36.7950633,147,276,66,1117
3973,17931,1096,3,Personal,25,1,54101,25,1,54117,25,1,54662,25,1,54909,25,1,55324,2,29.9,-1.303711,36.8154933,-1.2997244,36.8158016,351,415,16,792
3974,5423,2901,3,Business,7,5,49980,7,5,50047,7,5,51053,7,5,51772,7,5,53244,14,23.25888921888938,-1.2976788,36.8027916,-1.3411887,36.8950653,622,1472,67,1725
3975,173,1244,3,Business,21,5,34377,21,5,34382,21,5,34387,21,5,35365,21,5,36241,9,20.0,-1.303596,36.778378,-1.3204931,36.7043102,874,876,5,983
3976,17498,2200,3,Business,27,3,52065,27,3,58622,27,3,59220,27,3,59705,27,3,61793,9,27.5,-1.2859912,36.8756811,-1.290894,36.822971,43,2088,6557,1083
3977,11064,1976,3,Business,4,2,56327,4,2,56384,4,2,56827,4,2,57034,4,2,59339,26,23.7,-1.257028,36.7810435,-1.3476332,36.9084805,648,2305,57,650
3978,24007,970,3,Business,12,5,51543,12,5,51619,12,5,52026,12,5,52462,12,5,53382,8,23.25888921888938,-1.2571472,36.7950633,-1.3080696,36.8237191,576,920,76,843
3979,12768,2330,3,Business,8,1,49338,8,1,49634,8,1,50471,8,1,50628,8,1,51782,9,29.7,-1.2124582,36.802894,-1.2645318,36.7981775,72,1154,296,994
3980,18591,1952,1,Personal,14,1,51652,14,1,52617,14,1,55677,14,1,56279,14,1,60159,24,25.5,-1.2654663,36.9090598,-1.2877226,36.7585631,581,3880,965,3662
3981,28253,909,3,Business,29,1,56207,29,1,56235,29,1,56929,29,1,57540,29,1,59853,13,23.25888921888938,-1.2283403,36.8822756,-1.225322,36.80855,272,2313,28,1305
3982,4120,1439,3,Business,8,2,42130,8,2,42197,8,2,43033,8,2,43266,8,2,44290,6,23.3,-1.2962487,36.7772971,-1.2962437,36.8196435,548,1024,67,1069
3983,26228,3149,3,Business,7,4,50163,7,4,50235,7,4,50423,7,4,52263,7,4,52669,6,30.9,-1.3004062,36.829741,-1.3167113,36.8301563,411,406,72,2028
3984,14521,868,3,Business,12,3,35448,12,3,38334,12,3,39632,12,3,41001,12,3,42056,9,19.3,-1.331619,36.847976,-1.2663631,36.8163329,864,1055,2886,2667
3985,24721,1028,1,Personal,28,4,33456,28,4,33703,28,4,35265,28,4,36225,28,4,37884,11,23.25888921888938,-1.2100103,36.797424,-1.2684319,36.8165853,101,1659,247,2522
3986,7806,2961,3,Personal,4,5,41582,4,5,41635,4,5,46227,4,5,47256,4,5,51467,26,17.3,-1.3251247,36.8995926,-1.213896,36.7980885,26,4211,53,5621
3987,15904,1502,3,Business,15,5,60662,15,5,60702,15,5,61364,15,5,61864,15,5,63599,17,27.6,-1.2232123,36.8932547,-1.2551895,36.7822034,8,1735,40,1162
3988,244,3291,3,Business,17,5,40765,17,5,40784,17,5,40882,17,5,41410,17,5,43299,11,23.25888921888938,-1.303596,36.778378,-1.2600926,36.8088685,958,1889,19,626
3989,23085,1561,3,Business,25,1,48567,25,1,50474,25,1,51972,25,1,53958,25,1,54688,7,27.9,-1.3124922,36.8804974,-1.328259,36.860975,448,730,1907,3484
3990,10816,1889,3,Personal,30,3,35380,30,3,35410,30,3,35809,30,3,36407,30,3,37600,10,17.2,-1.2767916,36.8200965,-1.2937613,36.7579401,786,1193,30,997
3991,14698,136,3,Business,20,3,44551,20,3,44573,20,3,44997,20,3,45201,20,3,47735,19,26.3,-1.3254522,36.7216584,-1.3074566,36.8614804,778,2534,22,628
3992,16229,3496,3,Business,11,5,55030,11,5,55998,11,5,57909,11,5,60021,11,5,62187,21,24.2,-1.2847613,36.967084,-1.300921,36.828195,207,2166,968,4023
3993,5829,1209,3,Business,7,1,34905,7,1,35193,7,1,35518,7,1,35836,7,1,36323,4,21.6,-1.3228003,36.8306435,-1.3004062,36.829741,523,487,288,643
3994,17917,1329,3,Business,27,2,59533,27,2,59566,27,2,61165,27,2,61264,27,2,62375,6,22.2,-1.273056,36.811298,-1.2940853,36.7866665,674,1111,33,1698
3995,6334,635,3,Business,7,4,35834,7,4,35857,7,4,37255,7,4,38384,7,4,40425,7,27.7,-1.3081376,36.8329772,-1.2602337,36.7990548,459,2041,23,2527
3996,6970,186,3,Business,31,5,56660,31,5,57465,31,5,57473,31,5,58053,31,5,59986,6,24.7,-1.2889914,36.8209443,-1.2571472,36.7950633,531,1933,805,588
3997,24200,3404,3,Business,5,3,46495,5,3,48079,5,3,48508,5,3,49290,5,3,51401,13,25.2,-1.2232123,36.8932547,-1.279395,36.825364,648,2111,1584,1211
3998,17303,2936,2,Personal,16,1,62602,16,1,62610,16,1,62770,16,1,64049,16,1,65692,12,23.25888921888938,-1.3169591,36.7000029,-1.3662774,36.7607811,672,1643,8,1439
3999,6285,1502,3,Business,16,5,52658,16,5,56788,16,5,58426,16,5,59159,16,5,61880,11,23.25888921888938,-1.3154433,36.806386,-1.2915971,36.8809029,646,2721,4130,2371
4000,4891,1934,2,Personal,16,4,25151,16,4,25369,16,4,26555,16,4,26811,16,4,27822,10,13.4,-1.2502923,36.7887568,-1.304033,36.7848695,598,1011,218,1442
4001,10577,1707,3,Personal,30,2,60654,30,2,61340,30,2,61853,30,2,62144,30,2,64169,17,23.25888921888938,-1.2921233,36.806386,-1.1793857,36.8311248,674,2025,686,804
4002,10348,1210,2,Personal,12,5,53913,12,5,53926,12,5,53932,12,5,54547,12,5,55188,6,27.1,-1.2658335,36.8042867,-1.2850454,36.7938777,393,641,13,621
4003,11649,2804,3,Business,21,3,37365,21,3,37465,21,3,37694,21,3,38640,21,3,39981,8,22.0,-1.2551895,36.7822034,-1.2996363,36.8186864,19,1341,100,1175
4004,869,3647,3,Business,7,4,43460,7,4,43523,7,4,43999,7,4,44373,7,4,46301,15,27.7,-1.272639,36.794723,-1.2129686,36.8861765,937,1928,63,850
4005,14103,2461,3,Business,26,6,49154,26,6,49198,26,6,50430,26,6,50709,26,6,52350,10,24.2,-1.284423,36.820545,-1.237705,36.7663283,888,1641,44,1511
4006,13637,2412,3,Business,28,5,52556,28,5,52706,28,5,54370,28,5,55423,28,5,56576,9,25.6,-1.2297202,36.8819507,-1.2236966,36.9290782,408,1153,150,2717
4007,21360,830,3,Business,29,1,56411,29,1,56541,29,1,56546,29,1,57612,29,1,58501,6,24.5,-1.2551895,36.7822034,-1.2793686,36.8259233,713,889,130,1071
4008,19384,627,3,Business,20,3,46239,20,3,46305,20,3,46901,20,3,47096,20,3,48599,12,27.2,-1.2551895,36.7822034,-1.3056581,36.8445565,576,1503,66,791
4009,1578,909,3,Business,25,4,55064,25,4,55589,25,4,56719,25,4,57317,25,4,59450,16,20.6,-1.3052491,36.8223899,-1.225322,36.80855,532,2133,525,1728
4010,18923,412,3,Business,13,4,52223,13,4,52247,13,4,52403,13,4,52914,13,4,54067,8,23.2,-1.307143,36.825009,-1.266837,36.799249,211,1153,24,667
4011,2013,2195,3,Business,15,3,35601,15,3,35625,15,3,35841,15,3,37031,15,3,38261,12,23.25888921888938,-1.2600926,36.8088685,-1.228911,36.881876,383,1230,24,1406
4012,5163,3194,3,Business,28,4,57066,28,4,58855,28,4,59588,28,4,59854,28,4,60850,4,25.6,-1.2571472,36.7950633,-1.2738287,36.8182811,167,996,1789,999
4013,21979,1443,1,Personal,5,6,55387,5,6,56369,5,6,57957,5,6,60220,5,6,61910,9,22.7,-1.2750798,36.8451936,-1.3154433,36.806386,742,1690,982,3851
4014,10468,323,3,Business,13,3,50415,13,3,50470,13,3,50542,13,3,52137,13,3,52523,4,29.3,-1.2611987,36.8060913,-1.2551895,36.7822034,925,386,55,1667
4015,11948,3214,3,Business,10,5,54664,10,5,54818,10,5,55526,10,5,55659,10,5,56217,1,23.25888921888938,-1.2899733,36.7908611,-1.289795,36.7957132,427,558,154,841
4016,8837,3230,2,Personal,3,4,32793,3,4,33826,3,4,34448,3,4,36014,3,4,37217,5,17.2,-1.2655306,36.828148,-1.2914795,36.8248973,89,1203,1033,2188
4017,17167,1004,3,Business,30,4,51302,30,4,51386,30,4,51968,30,4,52666,30,4,53815,6,23.25888921888938,-1.3088295,36.8385975,-1.3250048,36.8697188,890,1149,84,1280
4018,3286,1724,3,Business,5,5,30406,5,5,30429,5,5,31716,5,5,32738,5,5,34383,5,19.6,-1.2638132,36.7849775,-1.2551895,36.7822034,155,1645,23,2309
4019,14289,3467,1,Personal,13,4,34906,13,4,36209,13,4,37439,13,4,37655,13,4,39794,18,18.4,-1.2388499,36.8727268,-1.3333155,36.8065341,727,2139,1303,1446
4020,12541,867,3,Business,27,6,36700,27,6,36741,27,6,37618,27,6,38081,27,6,39734,14,23.25888921888938,-1.2991441,36.7528804,-1.3167113,36.8301563,161,1653,41,1340
4021,25577,928,3,Business,11,1,45822,11,1,45852,11,1,46614,11,1,46756,11,1,47251,2,26.6,-1.2551895,36.7822034,-1.2592428,36.7894541,932,495,30,904
4022,25754,496,3,Business,18,4,50651,18,4,50699,18,4,51177,18,4,51354,18,4,52857,4,26.9,-1.2551895,36.7822034,-1.2645023,36.8033789,876,1503,48,655
4023,642,1927,3,Business,22,4,46763,22,4,48374,22,4,48665,22,4,49129,22,4,50078,10,26.4,-1.305399,36.8221849,-1.3472066,36.7692638,810,949,1611,755
4024,2800,1402,3,Business,17,1,52477,18,2,47813,18,2,50385,18,2,50512,18,2,53152,11,25.6,-1.225322,36.80855,-1.281754,36.8324229,928,2640,81736,2699
4025,8835,778,3,Business,19,2,42023,19,2,42062,19,2,42511,19,2,43278,19,2,43903,3,26.6,-1.2535486,36.7933541,-1.2601197,36.7985271,461,625,39,1216
4026,3391,2828,3,Business,3,2,58340,3,2,58562,3,2,58919,3,2,59581,3,2,64006,15,18.9,-1.2615888,36.7928732,-1.3248812,36.859699,279,4425,222,1019
4027,12935,3647,3,Business,3,5,61522,3,5,61681,3,5,61859,3,5,62310,3,5,63781,5,23.25888921888938,-1.272639,36.794723,-1.2748221,36.7817865,815,1471,159,629
4028,6071,2412,3,Business,20,4,47077,20,4,51099,20,4,51314,20,4,51752,20,4,52210,3,25.3,-1.223452,36.8659278,-1.2285835,36.8826468,517,458,4022,653
4029,7206,1363,3,Business,14,4,32813,14,4,34350,14,4,34760,14,4,34901,14,4,36651,4,15.3,-1.3004062,36.829741,-1.2819785,36.8101512,285,1750,1537,551
4030,21328,1584,3,Business,8,1,42401,8,1,42731,8,1,43811,8,1,44639,8,1,45527,7,27.7,-1.2842021,36.8281144,-1.2969741,36.7856612,291,888,330,1908
4031,22373,3222,3,Business,19,1,43409,19,1,43473,19,1,44319,19,1,44432,19,1,48296,14,24.7,-1.2551895,36.7822034,-1.2516167,36.8678844,147,3864,64,959
4032,7896,1754,3,Business,9,3,32752,9,3,32761,9,3,32769,9,3,32980,9,3,35656,19,17.7,-1.2860183,36.8975338,-1.255956,36.789867,589,2676,9,219
4033,18441,633,3,Business,20,3,47512,20,3,47531,20,3,47598,20,3,47798,20,3,51203,4,27.0,-1.3004062,36.829741,-1.304127,36.805743,349,3405,19,267
4034,20951,812,1,Personal,28,6,40280,28,6,40312,28,6,41218,28,6,41853,28,6,43423,18,24.1,-1.2791224,36.8306878,-1.2121451,36.9044352,103,1570,32,1541
4035,6051,3450,3,Business,7,4,56006,7,4,56292,7,4,56917,7,4,57574,7,4,58686,10,27.9,-1.2551895,36.7822034,-1.304023,36.788389,416,1112,286,1282
4036,18534,2343,3,Business,31,4,31583,31,4,31823,31,4,32324,31,4,32903,31,4,34643,10,17.5,-1.2959613,36.7684114,-1.2809708,36.834855,46,1740,240,1080
4037,27840,3718,3,Business,28,3,38598,28,3,39245,28,3,40820,28,3,41370,28,3,42986,5,23.25888921888938,-1.2972835,36.809687,-1.2650027,36.8126242,362,1616,647,2125
4038,7847,2271,3,Business,2,3,42474,2,3,42479,2,3,42482,2,3,43784,2,3,45022,14,24.1,-1.272828,36.816608,-1.293515,36.897607,886,1238,5,1305
4039,13887,3491,3,Business,19,2,38416,19,2,38459,19,2,38818,19,2,39549,19,2,41262,9,27.5,-1.2796151,36.8910091,-1.2283403,36.8822756,168,1713,43,1090
4040,18958,1304,3,Business,27,2,56294,27,2,56483,27,2,57203,27,2,57403,27,2,60863,19,25.7,-1.3226302,36.8719901,-1.3104734,36.7363698,62,3460,189,920
4041,12733,1584,3,Business,13,1,45989,13,1,46007,13,1,46770,13,1,47896,13,1,49241,9,17.2,-1.2623805,36.7805404,-1.2969741,36.7856612,520,1345,18,1889
4042,8192,393,3,Business,1,5,30571,1,5,30597,1,5,31161,1,5,32224,1,5,33416,11,23.0,-1.3167113,36.8301563,-1.2638185,36.7930057,858,1192,26,1627
4043,26285,788,3,Business,10,4,50779,10,4,50845,10,4,51372,10,4,52468,10,4,53605,8,25.4,-1.2571472,36.7950633,-1.225322,36.80855,178,1137,66,1623
4044,13862,1271,3,Business,17,2,48070,17,2,48077,17,2,48593,17,2,50881,17,2,52033,14,24.3,-1.30927,36.81326,-1.3244885,36.897792,844,1152,7,2804
4045,9800,393,3,Business,23,4,56666,23,4,56728,23,4,57510,23,4,58010,23,4,59778,11,24.7,-1.3228003,36.8306435,-1.2638185,36.7930057,158,1768,62,1282
4046,16215,2587,3,Business,25,6,45209,25,6,45224,25,6,45605,25,6,46635,25,6,47110,2,23.25888921888938,-1.290894,36.822971,-1.28878,36.8168312,449,475,15,1411
4047,15951,1583,3,Business,8,2,42624,8,2,42651,8,2,43334,8,2,43520,8,2,46695,20,21.3,-1.299813,36.7871392,-1.3700383,36.9190174,543,3175,27,869
4048,778,1976,3,Business,2,1,48675,2,1,48702,2,1,49599,2,1,50052,2,1,51379,8,19.8,-1.301953,36.788458,-1.257028,36.7810435,312,1327,27,1350
4049,15528,2330,3,Business,13,4,47185,13,4,48147,13,4,49310,13,4,51886,13,4,54055,8,22.2,-1.2642903,36.8002137,-1.304735,36.7846054,454,2169,962,3739
4050,26498,2154,3,Business,8,6,35874,8,6,35888,8,6,36102,8,6,37350,8,6,38427,8,16.8,-1.2527958,36.7976244,-1.2765736,36.8513646,72,1077,14,1462
4051,12545,661,3,Business,22,2,55276,22,2,55309,22,2,55996,22,2,56924,22,2,57806,4,21.5,-1.2950044,36.7512209,-1.2963097,36.7688221,329,882,33,1615
4052,1583,1955,3,Business,22,4,59712,22,4,61078,22,4,61643,22,4,62286,22,4,64125,17,24.2,-1.2859912,36.8756811,-1.2955334,36.7742857,456,1839,1366,1208
4053,23399,1410,3,Business,25,1,47732,25,1,48748,25,1,52354,25,1,52835,25,1,56410,33,30.3,-1.3882008,36.7699445,-1.2847613,36.967084,168,3575,1016,4087
4054,14900,2365,3,Personal,26,2,46626,26,2,46650,26,2,47246,26,2,47500,26,2,48335,12,26.3,-1.3299925,36.879832,-1.3277315,36.8374612,49,835,24,850
4055,27799,2866,3,Business,7,5,58422,7,5,58787,7,5,60577,7,5,60830,7,5,64843,23,21.4,-1.2551895,36.7822034,-1.3448483,36.9004081,831,4013,365,2043
4056,7013,2823,3,Business,14,4,39726,14,4,40286,14,4,40808,14,4,41011,14,4,47166,9,19.1,-1.3014461,36.7661381,-1.2551895,36.7822034,46,6155,560,725
4057,9883,3432,3,Business,28,2,34152,28,2,34221,28,2,35623,28,2,37414,28,2,38543,10,18.9,-1.3139898,36.8676986,-1.283962,36.8142095,68,1129,69,3193
4058,1798,3727,3,Business,7,2,61752,7,2,61765,7,2,61776,7,2,61902,7,2,63128,4,23.2,-1.2963097,36.7688221,-1.2764692,36.7580111,939,1226,13,137
4059,20997,3291,3,Business,4,1,51541,4,1,51611,4,1,51854,4,1,52799,4,1,53380,4,23.25888921888938,-1.272828,36.816608,-1.2600926,36.8088685,698,581,70,1188
4060,4894,2956,3,Business,29,1,36829,29,1,36881,29,1,37714,29,1,38498,29,1,39556,6,23.25888921888938,-1.2615888,36.7928732,-1.2897368,36.8226783,119,1058,52,1617
4061,25183,2982,3,Business,14,4,52820,14,4,57622,14,4,58032,14,4,58913,14,4,60436,7,21.2,-1.300921,36.828195,-1.325469,36.862403,549,1523,4802,1291
4062,17984,635,3,Business,24,1,40012,24,1,40120,24,1,40768,24,1,41023,24,1,42207,8,22.9,-1.3016417,36.8271679,-1.2599563,36.7993439,340,1184,108,903
4063,13345,478,3,Business,13,3,37170,13,3,37208,13,3,38086,13,3,42251,13,3,44116,12,25.0,-1.3099295,36.8436807,-1.2571472,36.7950633,194,1865,38,5043
4064,18207,3487,3,Business,28,2,49712,28,2,49782,28,2,50896,28,2,51901,28,2,53140,5,23.4,-1.279395,36.825364,-1.2527958,36.8003131,921,1239,70,2119
4065,26374,393,3,Business,29,1,39167,29,1,39490,29,1,39493,29,1,43654,29,1,43655,14,23.25888921888938,-1.3167113,36.8301563,-1.2991441,36.7528804,239,1,323,4164
4066,5362,2064,2,Personal,6,1,58737,6,1,58763,6,1,58925,6,1,59280,6,1,60118,3,24.7,-1.2675132,36.8014826,-1.262212,36.7886506,338,838,26,517
4067,12394,370,1,Personal,2,4,61865,2,4,61875,2,4,62087,2,4,62554,2,4,64061,8,23.7,-1.3028391,36.7951112,-1.2649605,36.7981777,322,1507,10,679
4068,11068,3404,3,Business,21,5,33856,21,5,33963,21,5,34683,21,5,35080,21,5,35643,2,19.5,-1.279395,36.825364,-1.290894,36.822971,404,563,107,1117
4069,26574,136,3,Business,11,6,42576,11,6,42593,11,6,42868,11,6,43271,11,6,43817,1,23.25888921888938,-1.2654716,36.7983635,-1.2531983,36.8069669,172,546,17,678
4070,5152,53,3,Business,16,3,47399,16,3,47751,16,3,48449,16,3,48849,16,3,50351,11,27.2,-1.2991441,36.7528804,-1.2770708,36.8231093,576,1502,352,1098
4071,11451,1690,3,Business,13,3,52245,13,3,54253,13,3,54440,13,3,54867,13,3,55926,4,23.6,-1.304033,36.7848695,-1.2977768,36.8110285,312,1059,2008,614
4072,9578,3560,3,Business,23,6,41895,23,6,41958,23,6,42475,23,6,42985,23,6,44071,5,23.25888921888938,-1.2591019,36.800577,-1.279395,36.825364,456,1086,63,1027
4073,27495,1075,3,Business,30,3,61920,30,3,62030,30,3,62522,30,3,63028,30,3,64559,5,27.2,-1.2527958,36.8003131,-1.2811503,36.8235884,407,1531,110,998
4074,26951,2412,3,Business,24,5,51155,24,5,51369,24,5,51394,24,5,52527,24,5,54099,15,22.8,-1.2283403,36.8822756,-1.2551895,36.7822034,788,1572,214,1158
4075,16761,2324,1,Personal,14,1,48574,14,1,48775,14,1,50381,14,1,50745,14,1,51510,3,25.7,-1.2934675,36.7659545,-1.2860203,36.7832538,279,765,201,1970
4076,2514,323,3,Business,31,3,43000,31,3,43019,31,3,43232,31,3,45393,31,3,47585,21,24.8,-1.2551895,36.7822034,-1.3632162,36.9108253,38,2192,19,2374
4077,19979,136,3,Business,22,1,44258,22,1,44284,22,1,44491,22,1,45039,22,1,47231,20,25.0,-1.2536042,36.8064895,-1.3094447,36.9107706,45,2192,26,755
4078,26170,848,3,Personal,22,2,50891,22,2,50978,22,2,52207,22,2,52766,22,2,54937,17,21.5,-1.3122474,36.8728544,-1.2527374,36.7776152,742,2171,87,1788
4079,6917,3222,3,Business,24,3,54304,24,3,54381,24,3,54810,24,3,55068,24,3,57003,8,18.5,-1.2551895,36.7822034,-1.295156,36.8094306,775,1935,77,687
4080,1605,530,2,Personal,23,4,60298,23,4,60311,23,4,60824,23,4,61618,23,4,64229,20,20.2,-1.271996,36.826296,-1.3610501,36.7520889,449,2611,13,1307
4081,13279,3201,3,Business,8,5,42870,8,5,42903,8,5,43293,8,5,43921,8,5,44304,1,24.1,-1.2561334,36.7990458,-1.2584143,36.8048002,540,383,33,1018
4082,22884,661,3,Business,6,5,44400,6,5,48381,6,5,49111,6,5,50040,6,5,50803,4,22.4,-1.2950044,36.7512209,-1.2963097,36.7688221,140,763,3981,1659
4083,6914,20,3,Business,1,4,41266,1,4,41310,1,4,41774,1,4,42303,1,4,44564,20,23.25888921888938,-1.2616841,36.801999,-1.369541,36.907455,578,2261,44,993
4084,25370,3064,3,Business,14,4,54963,14,4,55121,14,4,55357,14,4,55738,14,4,56851,6,27.4,-1.2571472,36.7950633,-1.2985749,36.8088,937,1113,158,617
4085,25190,3291,3,Business,27,4,45532,27,4,46445,27,4,47875,27,4,49861,27,4,52404,18,23.8,-1.3393547,36.8910035,-1.2600926,36.8088685,416,2543,913,3416
4086,23316,1205,3,Business,30,2,50021,30,2,50674,30,2,51310,30,2,51624,30,2,53042,7,23.25888921888938,-1.2495931,36.8065087,-1.2958383,36.8073162,484,1418,653,950
4087,15431,435,3,Business,16,4,35709,16,4,35738,16,4,36902,16,4,37817,16,4,39458,11,23.25888921888938,-1.2333206,36.8304981,-1.300921,36.828195,143,1641,29,2079
4088,24435,3123,1,Personal,9,4,62050,9,4,62133,9,4,64329,9,4,65410,9,4,66407,3,23.0,-1.2739208,36.8310153,-1.2859576,36.8197604,229,997,83,3277
4089,14203,1642,3,Business,14,4,38701,14,4,39934,14,4,40567,14,4,40736,14,4,41805,9,23.6,-1.2726506,36.7960153,-1.3082781,36.831651,205,1069,1233,802
4090,26242,2982,3,Business,10,5,52549,10,5,52691,10,5,52717,10,5,53678,10,5,55242,18,23.25888921888938,-1.177202,36.8351183,-1.300921,36.828195,61,1564,142,987
4091,14976,892,2,Personal,25,2,38141,25,2,38158,25,2,39047,25,2,39397,25,2,42157,15,23.9,-1.2243841,36.8024757,-1.312475,36.8225778,882,2760,17,1239
4092,8301,87,2,Personal,22,2,38458,22,2,38544,22,2,39360,22,2,39580,22,2,41182,7,19.2,-1.2735236,36.7992196,-1.3004311,36.7524273,432,1602,86,1036
4093,983,2069,3,Business,22,1,37289,22,1,37344,22,1,37883,22,1,39848,22,1,41020,13,25.1,-1.307143,36.825009,-1.228911,36.881876,878,1172,55,2504
4094,10359,246,3,Business,28,5,37866,28,5,37875,28,5,38546,28,5,39481,28,5,40149,3,23.8,-1.2584143,36.8048002,-1.2551895,36.7822034,275,668,9,1606
4095,26338,3686,3,Business,26,2,55031,26,2,55062,26,2,55328,26,2,57209,26,2,57271,8,29.5,-1.2551895,36.7822034,-1.2964547,36.8178123,275,62,31,2147
4096,4068,2587,3,Business,27,4,53392,27,4,54463,27,4,55340,27,4,55664,27,4,55673,2,25.3,-1.281754,36.8324229,-1.28878,36.8168312,284,9,1071,1201
4097,13985,3686,3,Business,8,5,54665,8,5,54697,8,5,55646,8,5,55896,8,5,59971,20,27.0,-1.2551895,36.7822034,-1.3450912,36.8972662,205,4075,32,1199
4098,13655,2216,3,Business,11,5,43511,11,5,46545,11,5,47492,11,5,47746,11,5,49219,6,20.9,-1.2551895,36.7822034,-1.2844013,36.8227553,831,1473,3034,1201
4099,6542,3557,3,Business,9,5,33030,9,5,33094,9,5,34754,9,5,35320,9,5,35900,3,20.4,-1.2519787,36.7806491,-1.2622145,36.8087391,101,580,64,2226
4100,5949,1878,1,Business,4,4,70870,4,4,71052,4,4,73980,4,4,74287,4,4,78359,18,23.25888921888938,-1.2551895,36.7822034,-1.3327068,36.7797238,578,4072,182,3235
4101,6475,2174,3,Business,28,6,39918,28,6,40002,28,6,40035,28,6,42951,28,6,44274,6,23.8,-1.2482781,36.884092,-1.2241625,36.8851115,307,1323,84,2949
4102,2511,3599,3,Business,3,1,50202,3,1,51737,3,1,53437,3,1,54196,3,1,55548,12,23.2,-1.3302996,36.8707935,-1.262492,36.8038837,25,1352,1535,2459
4103,22847,2521,3,Business,16,5,49937,16,5,50127,16,5,50140,16,5,50486,16,5,53105,14,23.25888921888938,-1.3177547,36.8303703,-1.306378,36.7519845,157,2619,190,359
4104,26834,1601,1,Personal,28,4,34036,28,4,34072,28,4,34589,28,4,34819,28,4,35497,5,23.25888921888938,-1.25537,36.7756,-1.2613754,36.795771,795,678,36,747
4105,712,2174,3,Business,3,4,37992,3,4,37995,3,4,38122,3,4,40538,3,4,46802,28,23.7,-1.2482781,36.884092,-1.391222,36.760676,307,6264,3,2543
4106,4853,2828,3,Business,23,6,42983,23,6,42998,23,6,43040,23,6,44667,23,6,44938,3,23.25888921888938,-1.2584143,36.8048002,-1.2615888,36.7928732,446,271,15,1669
4107,14665,393,3,Business,20,1,37627,20,1,37673,20,1,38742,20,1,39929,20,1,40327,4,23.25888921888938,-1.3167113,36.8301563,-1.3004062,36.829741,710,398,46,2256
4108,17831,3647,3,Business,7,4,61245,7,4,61288,7,4,61907,7,4,62757,7,4,62759,4,25.7,-1.272639,36.794723,-1.2765492,36.7669809,295,2,43,1469
4109,13051,1796,3,Business,6,3,37282,6,3,37471,6,3,38116,6,3,38556,6,3,39280,7,22.6,-1.307143,36.825009,-1.331619,36.847976,114,724,189,1085
4110,6175,1552,1,Personal,15,6,32264,15,6,32312,15,6,33003,15,6,33520,15,6,33633,2,17.7,-1.2668093,36.7966542,-1.2676091,36.7862555,172,113,48,1208
4111,13812,3686,3,Business,14,3,54383,14,3,57755,14,3,58660,14,3,58862,14,3,60393,7,25.7,-1.2551895,36.7822034,-1.2830276,36.8297516,554,1531,3372,1107
4112,23519,3491,3,Business,13,3,35114,13,3,35533,13,3,36721,13,3,37108,13,3,41352,11,20.4,-1.2803667,36.8247756,-1.2283403,36.8822756,311,4244,419,1575
4113,16239,788,3,Business,3,4,46957,3,4,46982,3,4,47771,3,4,48154,3,4,49511,10,23.3,-1.225322,36.80855,-1.2885315,36.8230419,31,1357,25,1172
4114,16816,3718,3,Business,5,5,56944,5,5,57371,5,5,57908,5,5,58379,5,5,59278,8,26.4,-1.2566078,36.7832089,-1.2879697,36.8020506,427,899,427,1008
4115,3222,496,3,Business,30,4,53178,30,4,53198,30,4,53299,30,4,54608,30,4,54612,2,20.8,-1.2551895,36.7822034,-1.2561334,36.7990458,881,4,20,1410
4116,8846,3127,3,Business,30,3,34590,30,3,34693,30,3,37529,30,3,37903,30,3,40526,5,19.8,-1.2760462,36.8074697,-1.2918246,36.801585,456,2623,103,3210
4117,6489,3749,1,Personal,21,1,55354,21,1,55358,21,1,56799,21,1,56983,21,1,58618,10,21.7,-1.279285,36.8255639,-1.3314446,36.8264081,116,1635,4,1625
4118,7907,393,3,Business,8,5,45764,8,5,45959,8,5,46193,8,5,46668,8,5,48193,8,24.0,-1.3167113,36.8301563,-1.2770708,36.8231093,660,1525,195,709
4119,21451,1966,3,Business,16,4,58120,16,4,59137,16,4,60734,16,4,61385,16,4,64171,21,23.25888921888938,-1.3700383,36.9190174,-1.2917868,36.7872675,519,2786,1017,2248
4120,8651,1544,3,Business,9,4,43203,9,4,43264,9,4,43806,9,4,46309,9,4,47952,18,23.25888921888938,-1.1924678,36.7880546,-1.2977969,36.8104085,812,1643,61,3045
4121,11018,3491,3,Business,24,1,62216,24,1,62226,24,1,62700,24,1,62972,24,1,64955,11,24.4,-1.263987,36.798891,-1.2297202,36.8819507,72,1983,10,746
4122,6676,3610,1,Personal,17,5,51852,17,5,51919,17,5,52517,17,5,52691,17,5,54401,6,20.0,-1.285386,36.8304605,-1.2940713,36.7890758,552,1710,67,772
4123,24869,635,3,Business,27,1,57052,27,1,57112,27,1,57316,27,1,59606,27,1,59611,8,23.25888921888938,-1.2602337,36.7990548,-1.2544269,36.7507293,491,5,60,2494
4124,17501,1017,3,Business,12,3,42035,12,3,42066,12,3,42615,12,3,43825,12,3,45290,4,23.2,-1.2663351,36.8099425,-1.2551895,36.7822034,116,1465,31,1759
4125,25127,2133,1,Personal,12,6,74541,12,6,74565,12,6,76104,12,6,76649,12,6,78744,20,19.8,-1.2691211,36.8243806,-1.3673224,36.9161975,95,2095,24,2084
4126,15813,3080,3,Business,21,2,33416,21,2,33459,21,2,33944,21,2,34041,21,2,34925,4,23.25888921888938,-1.2551895,36.7822034,-1.2753109,36.8130185,520,884,43,582
4127,12329,972,3,Business,14,3,52578,14,3,53210,14,3,53974,14,3,54124,14,3,55337,10,25.7,-1.2862033,36.8152966,-1.3263005,36.8637914,31,1213,632,914
4128,10841,3378,3,Personal,28,4,40747,28,4,40761,28,4,40842,28,4,41537,28,4,44796,9,28.0,-1.2551895,36.7822034,-1.2948751,36.7938907,876,3259,14,776
4129,22001,1965,1,Personal,3,1,36132,3,1,36163,3,1,36318,3,1,36750,3,1,38730,14,15.2,-1.2697141,36.7981777,-1.2143387,36.7914548,620,1980,31,587
4130,5338,1146,3,Business,14,5,50914,14,5,50941,14,5,51107,14,5,51689,14,5,52633,7,23.2,-1.3167113,36.8301563,-1.3083266,36.8494756,211,944,27,748
4131,9227,2801,3,Business,10,1,34385,10,1,34460,10,1,35355,10,1,35757,10,1,40280,16,16.5,-1.3104506,36.8687235,-1.2674274,36.7870827,195,4523,75,1297
4132,18771,2989,3,Business,2,3,50093,2,3,50112,2,3,50444,2,3,50978,2,3,52909,20,26.2,-1.2860183,36.8975338,-1.3472066,36.7692638,31,1931,19,866
4133,16532,3418,3,Business,12,5,47698,12,5,47883,12,5,49540,12,5,49885,12,5,51974,9,23.25888921888938,-1.2828186,36.8232798,-1.2887613,36.7730538,709,2089,185,2002
4134,11813,3499,1,Personal,7,6,41897,7,6,46477,7,6,47499,7,6,47823,7,6,49016,8,19.2,-1.3178263,36.7141818,-1.2885713,36.7649818,636,1193,4580,1346
4135,3845,2066,3,Business,12,5,37677,12,5,37701,12,5,38363,12,5,39201,12,5,40149,12,26.3,-1.3210189,36.8410551,-1.369541,36.907455,126,948,24,1500
4136,27767,1245,3,Business,7,2,40255,7,2,40277,7,2,40603,7,2,42079,7,2,44636,16,23.25888921888938,-1.300921,36.828195,-1.3760172,36.7412505,581,2557,22,1802
4137,3505,3149,3,Business,27,2,52057,27,2,52436,27,2,52738,27,2,55218,27,2,55698,5,25.4,-1.3004062,36.829741,-1.3177547,36.8303703,555,480,379,2782
4138,4194,685,3,Business,13,1,52381,13,1,52964,13,1,53331,13,1,53546,13,1,55688,14,23.25888921888938,-1.2726506,36.7960153,-1.323615,36.700475,177,2142,583,582
4139,27147,2113,2,Personal,8,5,55294,8,5,56120,8,5,56156,8,5,57423,8,5,59034,8,21.3,-1.2738167,36.8157821,-1.275442,36.7660207,379,1611,826,1303
4140,12580,3338,3,Business,14,5,53006,14,5,53027,14,5,53708,14,5,54453,14,5,55273,7,23.2,-1.2932786,36.7834311,-1.2551895,36.7822034,315,820,21,1426
4141,15919,2164,3,Business,9,2,44158,9,2,44194,9,2,44415,9,2,44949,9,2,46237,4,26.9,-1.2551895,36.7822034,-1.269534,36.80697,630,1288,36,755
4142,27044,265,3,Business,29,5,42421,29,5,42481,29,5,44223,29,5,44509,29,5,48189,11,26.9,-1.300921,36.828195,-1.26972,36.7658533,507,3680,60,2028
4143,16318,2956,3,Business,10,1,52376,10,1,52452,10,1,52923,10,1,53246,10,1,53642,3,18.1,-1.2584143,36.8048002,-1.2551895,36.7822034,937,396,76,794
4144,17406,2523,3,Business,14,5,34794,14,5,42530,14,5,43017,14,5,43207,14,5,43893,2,21.7,-1.2551895,36.7822034,-1.2580991,36.7941519,566,686,7736,677
4145,26972,1349,1,Personal,26,3,44900,26,3,44923,26,3,45944,26,3,48384,26,3,48716,25,24.2,-1.1891303,36.896427,-1.286622,36.75637,387,332,23,3461
4146,27530,3334,1,Personal,8,3,42406,8,3,42415,8,3,42692,8,3,42918,8,3,44017,7,22.0,-1.2699442,36.8206553,-1.2951264,36.798382,754,1099,9,503
4147,15639,2523,3,Business,13,1,33323,13,1,33487,13,1,33535,13,1,34358,13,1,35581,6,23.25888921888938,-1.2551895,36.7822034,-1.2721619,36.7690648,215,1223,164,871
4148,27793,1306,2,Personal,6,6,52548,6,6,52663,6,6,53318,6,6,53448,6,6,54145,6,28.2,-1.2839026,36.80893,-1.274377,36.770452,622,697,115,785
4149,7885,633,3,Business,1,5,37342,1,5,37402,1,5,37929,1,5,38749,1,5,42200,12,28.4,-1.2991441,36.7528804,-1.3004062,36.829741,156,3451,60,1347
4150,6833,3689,3,Business,5,1,64504,5,1,64524,5,1,64920,5,1,65703,5,1,67363,10,24.2,-1.3014461,36.7661381,-1.2527958,36.8003131,105,1660,20,1179
4151,26243,830,3,Business,12,2,64730,12,2,64843,12,2,64873,12,2,65422,12,2,65863,2,28.3,-1.2551895,36.7822034,-1.2584143,36.8048002,881,441,113,579
4152,966,2956,3,Business,19,3,57276,19,3,57576,19,3,61172,19,3,61384,19,3,66053,5,22.6,-1.2584143,36.8048002,-1.2857548,36.819062,86,4669,300,3808
4153,20552,610,1,Personal,28,6,56938,28,6,57037,28,6,58792,28,6,59404,28,6,60426,3,24.8,-1.3090663,36.8136865,-1.32573,36.801356,939,1022,99,2367
4154,18643,3420,3,Business,2,4,42794,2,4,42827,2,4,43125,2,4,43663,2,4,44619,6,23.25888921888938,-1.3046007,36.8211743,-1.265981,36.7936121,106,956,33,836
4155,18506,972,3,Business,1,1,36228,1,1,36240,1,1,36579,1,1,36663,1,1,37733,17,18.3,-1.2862033,36.8152966,-1.341891,36.761269,74,1070,12,423
4156,14778,517,3,Business,30,3,45155,30,3,45218,30,3,45254,30,3,46218,30,3,46938,4,25.2,-1.3167113,36.8301563,-1.3004062,36.829741,523,720,63,1000
4157,16125,3506,1,Personal,29,2,57534,29,2,57666,29,2,58772,29,2,58902,29,2,59968,11,23.9,-1.3052672,36.7538539,-1.3516579,36.7298363,103,1066,132,1236
4158,4747,258,2,Personal,17,3,47999,17,3,48930,17,3,49426,17,3,50618,17,3,54285,39,28.3,-1.428932,36.963932,-1.3192808,36.7121888,692,3667,931,1688
4159,12129,186,3,Business,18,1,58442,18,1,58476,18,1,59034,18,1,59213,18,1,59945,5,30.6,-1.2825816,36.8092346,-1.2571472,36.7950633,622,732,34,737
4160,26978,972,3,Business,22,4,44509,22,4,44691,22,4,46846,22,4,47169,22,4,47627,2,22.5,-1.2862033,36.8152966,-1.2859714,36.8056536,237,458,182,2478
4161,2319,649,3,Business,18,5,50004,18,5,50812,18,5,51649,18,5,51806,18,5,53006,11,24.5,-1.2964396,36.7760609,-1.2626906,36.7827022,782,1200,808,994
4162,22416,1890,1,Personal,21,5,47332,21,5,47341,21,5,48791,21,5,49452,21,5,51087,15,27.2,-1.2658335,36.8042867,-1.2540928,36.69782,328,1635,9,2111
4163,19167,867,3,Business,25,5,36035,25,5,38744,25,5,39198,25,5,41100,25,5,42347,10,26.6,-1.3004062,36.829741,-1.2991441,36.7528804,555,1247,2709,2356
4164,4628,714,3,Business,18,5,54586,18,5,54733,18,5,55596,18,5,56126,18,5,57991,9,27.0,-1.2628638,36.8070399,-1.2326041,36.8009029,518,1865,147,1393
4165,26895,342,2,Personal,3,5,32424,3,5,32435,3,5,33274,3,5,33422,3,5,34942,9,17.2,-1.2916155,36.8407913,-1.264788,36.7883897,194,1520,11,987
4166,10459,1724,3,Business,22,2,54501,22,2,54555,22,2,55375,22,2,55863,22,2,57791,16,21.3,-1.2626906,36.7827022,-1.312745,36.875715,620,1928,54,1308
4167,16862,2523,3,Business,8,2,39189,8,2,39197,8,2,39422,8,2,40029,8,2,42256,20,23.4,-1.2551895,36.7822034,-1.3586568,36.9116812,647,2227,8,832
4168,122,2989,3,Business,19,4,51898,19,4,51908,19,4,52238,19,4,52625,19,4,54417,17,20.4,-1.3463042,36.768164,-1.2551895,36.7822034,726,1792,10,717
4169,27506,966,3,Business,1,1,48043,1,1,48070,1,1,48684,1,1,48818,1,1,50797,18,23.25888921888938,-1.3339943,36.7263409,-1.305087,36.862673,548,1979,27,748
4170,10481,3295,3,Business,23,5,38709,23,5,43151,23,5,44188,23,5,44584,23,5,46573,8,24.3,-1.2909536,36.8407162,-1.2571472,36.7950633,769,1989,4442,1433
4171,19252,3517,3,Business,6,1,58559,6,1,59193,6,1,60057,6,1,61211,6,1,63457,16,23.25888921888938,-1.300921,36.828195,-1.3882008,36.7699445,325,2246,634,2018
4172,12729,2956,3,Business,5,2,43018,5,2,43066,5,2,43862,5,2,43984,5,2,47103,10,21.6,-1.2584143,36.8048002,-1.2413316,36.8785525,752,3119,48,918
4173,27324,2066,3,Business,5,4,56070,5,4,56112,5,4,57016,5,4,57115,5,4,59195,14,22.2,-1.316961,36.820337,-1.3123977,36.902807,347,2080,42,1003
4174,19327,1329,3,Business,29,4,66764,29,4,66768,29,4,66774,29,4,66849,29,4,67389,6,20.8,-1.273056,36.811298,-1.2623805,36.7805404,345,540,4,81
4175,5677,517,3,Business,9,6,40478,9,6,40488,9,6,40501,9,6,41072,9,6,41077,5,24.7,-1.3167113,36.8301563,-1.3077869,36.8443207,619,5,10,584
4176,10743,2066,3,Business,8,5,37003,8,5,37186,8,5,37891,8,5,38335,8,5,39252,4,23.25888921888938,-1.316961,36.820337,-1.3083582,36.8379036,905,917,183,1149
4177,22904,393,3,Business,12,5,50998,12,5,51220,12,5,51234,12,5,54613,12,5,55250,4,23.25888921888938,-1.3167113,36.8301563,-1.3004062,36.829741,331,637,222,3393
4178,27570,789,1,Personal,6,5,56766,6,5,56847,6,5,57729,6,5,57890,6,5,58554,8,22.6,-1.2924639,36.7795798,-1.2671001,36.7977185,312,664,81,1043
4179,12179,635,3,Business,29,3,42254,29,3,42277,29,3,42500,29,3,43183,29,3,46382,10,23.25888921888938,-1.3081376,36.8329772,-1.2602337,36.7990548,158,3199,23,906
4180,141,893,3,Business,24,6,39241,24,6,39331,24,6,39920,24,6,40942,24,6,42713,13,24.1,-1.2664852,36.7919817,-1.2146739,36.8560568,574,1771,90,1611
4181,9616,3283,3,Business,1,1,42624,1,1,44039,1,1,45214,1,1,46362,1,1,46938,6,23.25888921888938,-1.272828,36.816608,-1.2628473,36.781805,61,576,1415,2323
4182,2394,1363,3,Business,29,5,37438,29,5,37566,29,5,38374,29,5,40753,29,5,40756,10,26.7,-1.3004062,36.829741,-1.2991441,36.7528804,507,3,128,3187
4183,11380,2200,3,Business,16,3,47017,16,3,47023,16,3,47189,16,3,47838,16,3,48565,7,24.2,-1.279395,36.825364,-1.2626906,36.7827022,742,727,6,815
4184,5990,2908,3,Personal,9,4,39337,9,4,39355,9,4,39367,9,4,39825,9,4,40525,6,23.25888921888938,-1.2890399,36.8164942,-1.2929747,36.7646358,564,700,18,470
4185,140,2523,3,Business,2,2,32717,2,2,32855,2,2,33471,2,2,34001,2,2,34891,9,20.6,-1.2551895,36.7822034,-1.2786703,36.826044,383,890,138,1146
4186,2768,909,3,Business,25,4,52179,25,4,52210,25,4,52951,25,4,53564,25,4,55144,13,23.25888921888938,-1.225322,36.80855,-1.2506561,36.7522989,72,1580,31,1354
4187,16980,469,3,Personal,4,3,45680,4,3,45714,4,3,47987,4,3,48331,4,3,50722,18,16.8,-1.3253826,36.8822315,-1.2730895,36.8374777,494,2391,34,2617
4188,7933,3621,3,Business,20,2,29514,20,2,29534,20,2,30054,20,2,30274,20,2,31433,10,18.9,-1.2836583,36.7886014,-1.2664227,36.7453671,446,1159,20,740
4189,20518,2523,3,Business,10,3,35144,10,3,35158,10,3,35193,10,3,36182,10,3,36714,5,21.6,-1.2551895,36.7822034,-1.2619185,36.759662,108,532,14,1024
4190,14414,2956,3,Business,6,3,48890,6,3,49052,6,3,49711,6,3,50488,6,3,51841,14,23.25888921888938,-1.207546,36.7913976,-1.2584143,36.8048002,669,1353,162,1436
4191,9705,2330,3,Business,18,1,40841,18,1,40915,18,1,42799,18,1,42969,18,1,43636,5,28.1,-1.3040812,36.7924217,-1.2890715,36.8157588,223,667,74,2054
4192,16175,1329,3,Business,24,5,58819,24,5,61169,24,5,61288,24,5,61493,24,5,63662,9,20.2,-1.273056,36.811298,-1.3226515,36.8195682,576,2169,2350,324
4193,24192,635,3,Business,27,2,46883,27,2,46902,27,2,46932,27,2,47897,27,2,49066,6,23.7,-1.3016417,36.8271679,-1.3229345,36.8566974,920,1169,19,995
4194,17368,2691,3,Business,7,1,36012,7,1,36291,7,1,36763,7,1,36929,7,1,38320,8,18.2,-1.2857671,36.7875614,-1.255956,36.789867,216,1391,279,638
4195,18488,1084,2,Personal,9,1,64681,9,1,64805,9,1,65028,9,1,65463,9,1,66128,3,20.3,-1.2840354,36.7867427,-1.3007345,36.7741017,86,665,124,658
4196,22339,2100,3,Business,8,6,53905,8,6,58114,8,6,58575,8,6,58929,8,6,60510,6,23.3,-1.2859912,36.8756811,-1.2765736,36.8513646,849,1581,4209,815
4197,26259,2801,3,Business,4,1,53621,4,1,53649,4,1,53744,4,1,54286,4,1,54539,3,28.8,-1.2595422,36.7871178,-1.255956,36.772901,258,253,28,637
4198,17968,3560,3,Business,28,4,54030,28,4,54133,28,4,55338,28,4,56273,28,4,56557,1,27.4,-1.28878,36.8168312,-1.279395,36.825364,411,284,103,2140
4199,26681,1081,3,Business,5,2,52941,5,2,52957,5,2,53645,5,2,54175,5,2,55940,10,27.7,-1.2413316,36.8785525,-1.290894,36.822971,462,1765,16,1218
4200,5794,2801,3,Business,13,4,32444,13,4,32499,13,4,32860,13,4,33217,13,4,34401,11,18.7,-1.2674274,36.7870827,-1.307726,36.839117,205,1184,55,718
4201,25883,3520,1,Personal,18,4,41706,18,4,41731,18,4,44561,18,4,44717,18,4,46965,9,25.3,-1.2962862,36.7604041,-1.2793859,36.8218002,829,2248,25,2986
4202,23490,269,3,Business,30,3,55845,30,3,58305,30,3,59056,30,3,59232,30,3,60580,12,25.2,-1.3332749,36.8708147,-1.2927792,36.9053492,742,1348,2460,927
4203,20368,3291,3,Business,28,4,44044,28,4,45115,28,4,45402,28,4,46574,28,4,47206,5,27.9,-1.2628473,36.781805,-1.2600926,36.8088685,269,632,1071,1459
4204,2011,2258,3,Business,31,3,53053,31,3,53470,31,3,53573,31,3,53904,31,3,55601,7,27.1,-1.2571472,36.7950633,-1.3011768,36.818364,46,1697,417,434
4205,20328,136,3,Business,27,5,42568,27,5,42572,27,5,44213,27,5,44670,27,5,46263,8,22.5,-1.273425,36.84469,-1.260232,36.807334,229,1593,4,2098
4206,14855,990,3,Business,6,3,39935,6,3,40712,6,3,41307,6,3,41429,6,3,41938,4,20.0,-1.3343138,36.7086793,-1.3266489,36.7033691,478,509,777,717
4207,17091,2142,2,Personal,23,3,55275,23,3,56013,23,3,56655,23,3,56839,23,3,57754,3,22.1,-1.2882411,36.8274955,-1.3047132,36.8089553,948,915,738,826
4208,17675,2904,3,Personal,18,3,41255,18,3,41269,18,3,42092,18,3,42230,18,3,45699,5,20.0,-1.2970896,36.7771786,-1.2746436,36.803682,752,3469,14,961
4209,25477,1502,3,Business,22,3,34875,22,3,34913,22,3,37775,22,3,38151,22,3,41340,12,23.3,-1.279395,36.825364,-1.2232123,36.8932547,155,3189,38,3238
4210,23225,2066,3,Business,8,1,62912,8,1,63193,8,1,64081,8,1,65014,8,1,67412,6,18.3,-1.316961,36.820337,-1.2986563,36.7833661,932,2398,281,1821
4211,16901,3688,3,Business,12,2,39343,12,2,39362,12,2,39374,12,2,40832,12,2,42137,12,24.7,-1.2551895,36.7822034,-1.3104734,36.7363698,579,1305,19,1470
4212,15329,528,2,Personal,22,2,49501,22,2,50144,22,2,50512,22,2,50833,22,2,54034,9,21.4,-1.2866544,36.8217978,-1.3251825,36.7897587,123,3201,643,689
4213,8899,1076,1,Personal,3,2,47232,3,2,47536,3,2,48789,3,2,48992,3,2,50974,9,20.0,-1.3200277,36.8206816,-1.2693102,36.7981777,312,1982,304,1456
4214,9969,517,3,Business,7,5,43406,7,5,43503,7,5,43665,7,5,44223,7,5,46411,14,25.0,-1.3177547,36.8303703,-1.306378,36.7519845,523,2188,97,720
4215,24408,2454,3,Business,28,4,61687,28,4,61734,28,4,63085,28,4,63783,28,4,65865,15,25.8,-1.2286304,36.8422473,-1.2993231,36.7753372,907,2082,47,2049
4216,20810,393,3,Business,27,3,30290,27,3,30308,27,3,30313,27,3,31100,27,3,32208,8,23.25888921888938,-1.3167113,36.8301563,-1.2770708,36.8231093,901,1108,18,792
4217,20849,1346,3,Business,3,5,49426,3,5,49457,3,5,49991,3,5,50435,3,5,50816,2,25.1,-1.299813,36.7871392,-1.301796,36.8012024,798,381,31,978
4218,5076,3651,3,Business,3,2,45021,3,2,45077,3,2,45586,3,2,45810,3,2,46347,5,18.5,-1.2579304,36.8019667,-1.2793804,36.7924183,795,537,56,733
4219,18609,868,3,Business,9,3,44726,9,3,44746,9,3,45514,9,3,45959,9,3,46723,9,25.4,-1.2296618,36.8438272,-1.265715,36.823815,86,764,20,1213
4220,20599,2216,3,Business,21,4,39557,21,4,39580,21,4,40275,21,4,40902,21,4,42069,10,27.9,-1.2551895,36.7822034,-1.2287282,36.8115304,177,1167,23,1322
4221,26279,3686,3,Business,16,2,35900,16,2,36037,16,2,36784,16,2,38314,16,2,38945,5,23.3,-1.2551895,36.7822034,-1.2684319,36.8165853,726,631,137,2277
4222,13611,1874,3,Business,9,2,53631,9,2,53648,9,2,54684,9,2,54775,9,2,57707,20,30.6,-1.2571472,36.7950633,-1.3700383,36.9190174,216,2932,17,1127
4223,1500,3326,3,Business,8,1,52705,8,1,52814,8,1,53277,8,1,53847,8,1,54897,8,29.8,-1.2571472,36.7950633,-1.3090727,36.8315262,99,1050,109,1033
4224,4439,442,3,Personal,13,3,52074,13,3,52097,13,3,52563,13,3,52691,13,3,54989,16,27.0,-1.2609745,36.7886626,-1.207546,36.7913976,937,2298,23,594
4225,11776,3355,3,Business,20,1,60554,20,1,60605,20,1,61142,20,1,61334,20,1,62555,8,20.5,-1.305399,36.8221849,-1.2551895,36.7822034,519,1221,51,729
4226,13573,3222,3,Business,26,5,35385,26,5,35414,26,5,36609,26,5,36917,26,5,38974,8,23.25888921888938,-1.2551895,36.7822034,-1.295156,36.8094306,155,2057,29,1503
4227,25505,186,3,Business,23,5,56147,23,5,56479,23,5,56828,23,5,57835,23,5,59818,20,26.4,-1.2571472,36.7950633,-1.3700383,36.9190174,107,1983,332,1356
4228,27274,3326,3,Business,8,2,36031,8,2,36078,8,2,36859,8,2,37853,8,2,41476,22,19.2,-1.2551895,36.7822034,-1.341804,36.920576,357,3623,47,1775
4229,27151,733,3,Business,26,1,55957,26,1,56038,26,1,56810,26,1,56984,26,1,60320,15,22.1,-1.2551895,36.7822034,-1.207546,36.7913976,778,3336,81,946
4230,10948,2021,3,Business,12,5,39993,12,5,40056,12,5,41900,12,5,41974,12,5,43847,18,26.7,-1.377114,36.726466,-1.29475,36.83421,572,1873,63,1918
4231,15831,1527,3,Business,11,2,53574,11,2,53639,11,2,53659,11,2,54395,11,2,54819,4,21.3,-1.3077869,36.8443207,-1.3004062,36.829741,891,424,65,756
4232,27139,2866,3,Business,6,4,45974,6,4,46029,6,4,47852,6,4,48421,6,4,53096,16,19.7,-1.3562374,36.9042954,-1.2913246,36.8019522,200,4675,55,2392
4233,3246,3201,3,Business,6,3,46227,6,3,46247,6,3,49202,6,3,49458,6,3,51013,3,27.7,-1.2584143,36.8048002,-1.2551895,36.7822034,540,1555,20,3211
4234,3957,3669,3,Business,11,1,62487,11,1,62556,11,1,62919,11,1,64327,11,1,65804,5,23.25888921888938,-1.2615888,36.7928732,-1.2628009,36.8262921,205,1477,69,1771
4235,6649,3283,3,Business,5,5,48359,5,5,48380,5,5,49889,5,5,49970,5,5,51049,7,27.6,-1.2628473,36.781805,-1.303596,36.778378,177,1079,21,1590
4236,22691,1976,3,Business,18,1,59142,18,1,59226,18,1,59829,18,1,59999,18,1,61191,9,28.7,-1.257028,36.7810435,-1.2655306,36.828148,933,1192,84,773
4237,22132,2112,3,Business,23,6,61472,23,6,61917,23,6,62699,23,6,65315,23,6,67305,12,23.25888921888938,-1.290894,36.822971,-1.2156006,36.8916865,787,1990,445,3398
4238,26491,2200,3,Business,6,2,45966,6,2,46288,6,2,47162,6,2,47555,6,2,50527,8,25.0,-1.3014461,36.7661381,-1.290894,36.822971,548,2972,322,1267
4239,13731,1502,3,Business,7,5,62173,7,5,63088,7,5,63537,7,5,64369,7,5,65489,17,23.1,-1.2232123,36.8932547,-1.2551895,36.7822034,222,1120,915,1281
4240,21896,510,3,Business,4,5,46272,4,5,48729,4,5,49543,4,5,50522,4,5,54924,16,23.25888921888938,-1.3190102,36.9230693,-1.2860183,36.8975338,518,4402,2457,1793
4241,26061,997,3,Business,9,5,27511,9,5,28613,9,5,30300,9,5,30460,9,5,32643,9,20.3,-1.3110438,36.7850004,-1.2947678,36.8416866,412,2183,1102,1847
4242,21564,865,3,Business,4,2,55914,4,2,56728,4,2,58131,4,2,59133,4,2,63186,4,22.7,-1.2456412,36.7955298,-1.2551895,36.7822034,109,4053,814,2405
4243,5368,552,3,Business,14,4,50382,14,4,50835,14,4,53715,14,4,54391,14,4,57536,17,28.0,-1.279395,36.825364,-1.3632162,36.9108253,452,3145,453,3556
4244,16671,1500,3,Business,4,4,46509,4,4,46551,4,4,46971,4,4,48468,4,4,49888,8,25.3,-1.3004062,36.829741,-1.2638185,36.7930057,690,1420,42,1917
4245,23681,3370,3,Business,12,1,59601,12,1,68230,12,1,68237,12,1,68563,12,1,69693,7,23.6,-1.2615888,36.7928732,-1.2897508,36.8256156,406,1130,8629,333
4246,7296,1874,3,Business,14,4,55367,14,4,61512,14,4,62021,14,4,62082,14,4,64355,7,26.3,-1.2571472,36.7950633,-1.304592,36.822007,410,2273,6145,570
4247,12685,2701,3,Business,7,1,49594,7,1,49611,7,1,51602,7,1,53001,7,1,54146,5,20.5,-1.2601709,36.8002238,-1.279395,36.825364,100,1145,17,3390
4248,21255,3525,3,Business,3,3,38150,3,3,39679,3,3,40498,3,3,40677,3,3,42153,12,27.6,-1.3700383,36.9190174,-1.3194518,36.869396,233,1476,1529,998
4249,10642,1932,3,Business,23,1,53228,23,1,53232,23,1,54263,23,1,55114,23,1,56280,10,23.25888921888938,-1.3254542,36.7968763,-1.2985987,36.7809119,844,1166,4,1882
4250,5816,811,2,Personal,11,4,50216,11,4,50229,11,4,51527,11,4,51696,11,4,53046,10,26.7,-1.3219579,36.8414053,-1.285355,36.795287,662,1350,13,1467
4251,7812,2509,3,Business,20,2,55773,20,2,55923,20,2,56149,20,2,56638,20,2,58668,20,23.8,-1.2571472,36.7950633,-1.3700383,36.9190174,931,2030,150,715
4252,13425,788,3,Business,17,4,41914,17,4,41922,17,4,41981,17,4,42848,17,4,44632,16,25.5,-1.2859912,36.8756811,-1.225322,36.80855,952,1784,8,926
4253,13167,2066,3,Business,13,1,53579,13,1,53636,13,1,54298,13,1,55847,13,1,57841,12,19.5,-1.316961,36.820337,-1.2565338,36.870888,234,1994,57,2211
4254,3526,3560,3,Business,5,1,49426,5,1,50891,5,1,51630,5,1,52767,5,1,53631,5,26.0,-1.2591019,36.800577,-1.279395,36.825364,858,864,1465,1876
4255,3373,3318,3,Business,30,2,56848,30,2,57448,30,2,57972,30,2,58954,30,2,60404,10,23.25888921888938,-1.338283,36.8871775,-1.3004062,36.829741,422,1450,600,1506
4256,18649,510,3,Business,9,1,55129,9,1,55133,9,1,55352,9,1,57033,9,1,60122,19,20.9,-1.2551895,36.7822034,-1.2860183,36.8975338,951,3089,4,1900
4257,15851,60,3,Business,13,3,52318,13,3,52337,13,3,53112,13,3,53422,13,3,54152,9,29.0,-1.2296618,36.8438272,-1.265715,36.823815,8,730,19,1085
4258,15184,2069,3,Business,25,6,47110,25,6,47123,25,6,47154,25,6,47751,25,6,49441,12,23.25888921888938,-1.2600926,36.8088685,-1.228911,36.881876,607,1690,13,628
4259,6751,2532,3,Business,16,4,37903,16,4,37962,16,4,38342,16,4,38729,16,4,39701,6,23.25888921888938,-1.2551895,36.7822034,-1.2905033,36.8096462,290,972,59,767
4260,18075,3578,3,Business,1,5,40619,1,5,40631,1,5,41089,1,5,41172,1,5,42455,7,26.3,-1.2527958,36.8003131,-1.2814878,36.7794832,547,1283,12,541
4261,25984,2561,3,Business,18,1,37070,18,1,37282,18,1,37442,18,1,37737,18,1,39586,8,21.3,-1.2551895,36.7822034,-1.3016151,36.8117354,690,1849,212,455
4262,7109,3686,3,Business,22,5,28180,22,5,28189,22,5,29262,22,5,29434,22,5,30015,4,23.25888921888938,-1.2551895,36.7822034,-1.2617028,36.7983849,353,581,9,1245
4263,19263,2358,4,Business,4,2,60528,4,2,60570,4,2,60871,4,2,61363,4,2,62755,2,20.9,-1.302222,36.75873,-1.296797,36.7764525,249,1392,42,793
4264,19776,3686,3,Business,14,1,52426,14,1,52456,14,1,52998,14,1,53133,14,1,54656,7,25.4,-1.255956,36.789867,-1.2993181,36.8098551,782,1523,30,677
4265,21377,1527,3,Business,15,3,42962,15,3,43008,15,3,44278,15,3,44653,15,3,45324,5,23.25888921888938,-1.2770708,36.8231093,-1.3004062,36.829741,610,671,46,1645
4266,2289,3674,3,Business,18,2,38367,18,2,38374,18,2,38774,18,2,39144,18,2,39767,3,23.25888921888938,-1.2551895,36.7822034,-1.257309,36.8060084,446,623,7,770
4267,25421,972,3,Business,2,2,39344,2,2,40062,2,2,40450,2,2,40712,2,2,42163,5,21.0,-1.2862033,36.8152966,-1.307774,36.8407541,845,1451,718,650
4268,8717,3564,1,Personal,16,7,67690,16,7,70223,16,7,71094,16,7,72033,16,7,73436,13,19.5,-1.3472066,36.7692638,-1.3292721,36.6656534,654,1403,2533,1810
4269,17748,1245,3,Business,18,4,39532,18,4,39564,18,4,39671,18,4,42490,18,4,44634,17,23.25888921888938,-1.300921,36.828195,-1.3198615,36.7110323,661,2144,32,2926
4270,27214,1271,3,Business,4,4,44553,4,4,44848,4,4,45482,4,4,46533,4,4,48930,13,23.25888921888938,-1.3244885,36.897792,-1.2777297,36.8455524,101,2397,295,1685
4271,27560,533,3,Business,14,5,61566,14,5,61579,14,5,61793,14,5,62186,14,5,63127,7,22.0,-1.2597529,36.806629,-1.2765492,36.7669809,795,941,13,607
4272,21231,2419,1,Personal,25,3,55522,25,3,55551,25,3,56015,25,3,56590,25,3,60612,9,17.8,-1.2551895,36.7822034,-1.307241,36.8302368,519,4022,29,1039
4273,8128,1976,3,Business,25,1,34503,25,1,34523,25,1,34779,25,1,34855,25,1,35603,10,23.25888921888938,-1.257028,36.7810435,-1.2607622,36.8227608,315,748,20,332
4274,13393,2200,3,Business,12,2,53392,12,2,53522,12,2,54777,12,2,56107,12,2,56113,2,23.25888921888938,-1.279395,36.825364,-1.290894,36.822971,314,6,130,2585
4275,25479,2804,3,Business,29,1,52093,29,1,52139,29,1,53843,29,1,54206,29,1,56012,3,23.25888921888938,-1.2551895,36.7822034,-1.2546732,36.8086796,607,1806,46,2067
4276,8956,3557,3,Business,29,4,41061,29,4,41140,29,4,41392,29,4,41754,29,4,42368,2,21.4,-1.2546732,36.8086796,-1.2682478,36.8072852,56,614,79,614
4277,17190,3283,3,Business,4,5,33529,4,5,33552,4,5,33655,4,5,34481,4,5,35019,5,17.2,-1.2600926,36.8088685,-1.2628473,36.781805,427,538,23,929
4278,14615,3647,3,Business,29,4,56421,29,4,56864,29,4,57560,29,4,57752,29,4,59352,8,24.9,-1.272639,36.794723,-1.2653185,36.8358841,937,1600,443,888
4279,12115,2195,1,Business,28,5,42237,28,5,42286,28,5,42597,28,5,43218,28,5,44405,13,24.9,-1.303596,36.778378,-1.3313643,36.8577422,100,1187,49,932
4280,23662,136,3,Business,8,1,42881,8,1,42898,8,1,45437,8,1,46001,8,1,49052,21,27.8,-1.336582,36.871737,-1.3254522,36.7216584,760,3051,17,3103
4281,22425,3669,3,Business,25,1,40654,25,1,40681,25,1,40930,25,1,41269,25,1,42411,2,25.3,-1.2615888,36.7928732,-1.2564152,36.7792803,576,1142,27,588
4282,6939,1363,3,Business,25,1,33391,25,1,33451,25,1,33473,25,1,33652,25,1,34931,5,21.0,-1.3004062,36.829741,-1.3228003,36.8306435,206,1279,60,201
4283,25309,640,3,Business,10,1,54800,10,1,56765,10,1,57329,10,1,58656,10,1,60732,14,18.8,-1.3246455,36.8754415,-1.304033,36.7848695,449,2076,1965,1891
4284,15694,1299,3,Business,8,4,36586,8,4,36871,8,4,37959,8,4,39924,8,4,40952,4,26.5,-1.2713865,36.8058221,-1.282543,36.824618,477,1028,285,3053
4285,12865,1787,3,Business,25,1,34145,25,1,34261,25,1,34697,25,1,35565,25,1,36967,13,21.3,-1.2967839,36.8128576,-1.2283403,36.8822756,858,1402,116,1304
4286,14076,2523,3,Business,10,4,39282,10,4,39302,10,4,39720,10,4,40105,10,4,42116,18,24.7,-1.2551895,36.7822034,-1.3343129,36.8854175,523,2011,20,803
4287,22975,1363,3,Business,29,3,35528,29,3,35545,29,3,35560,29,3,37145,29,3,37149,10,18.0,-1.3004062,36.829741,-1.2729292,36.7679079,515,4,17,1600
4288,18924,2712,1,Business,17,3,49996,17,3,50004,17,3,50022,17,3,50925,17,3,52758,21,28.6,-1.2252722,36.8756717,-1.2963097,36.7688221,704,1833,8,921
4289,6684,2330,3,Business,20,1,44661,20,1,44674,20,1,44900,20,1,45048,20,1,46561,9,23.25888921888938,-1.2645318,36.7981775,-1.2326041,36.8009029,183,1513,13,374
4290,12576,1990,3,Business,5,2,41160,5,2,41199,5,2,41342,5,2,43530,5,2,45569,9,25.3,-1.286341,36.8172393,-1.275442,36.7660207,564,2039,39,2331
4291,27469,914,3,Business,24,3,52767,24,3,55385,24,3,57200,24,3,57452,24,3,58171,4,18.3,-1.2670213,36.7994482,-1.2816234,36.8239846,171,719,2618,2067
4292,19121,75,2,Personal,17,2,44915,17,2,44958,17,2,45567,17,2,45782,17,2,48183,13,19.0,-1.3014462,36.7607695,-1.261247,36.826993,427,2401,43,824
4293,3139,1769,2,Personal,23,4,77895,23,4,78902,23,4,80022,23,4,80359,23,4,81434,12,18.3,-1.2577289,36.7410772,-1.2782978,36.8273238,116,1075,1007,1457
4294,25473,1244,3,Business,12,2,34115,12,2,34139,12,2,34905,12,2,35616,12,2,37029,9,18.0,-1.2600926,36.8088685,-1.303596,36.778378,427,1413,24,1477
4295,16320,1500,3,Business,8,3,57345,8,3,58050,8,3,58472,8,3,58932,8,3,60594,11,23.25888921888938,-1.3077869,36.8443207,-1.2638185,36.7930057,168,1662,705,882
4296,18133,2423,3,Business,13,3,50166,13,3,58041,13,3,59187,13,3,59325,13,3,60284,6,27.3,-1.2551895,36.7822034,-1.2863371,36.8200261,260,959,7875,1284
4297,3394,2627,3,Business,5,5,44373,5,5,44433,5,5,45819,5,5,46256,5,5,50865,17,24.7,-1.2859912,36.8756811,-1.2571472,36.7950633,99,4609,60,1823
4298,25417,1329,3,Business,17,1,32424,17,1,37649,17,1,40375,17,1,40556,17,1,42255,18,23.8,-1.3653171,36.7530868,-1.273056,36.811298,205,1699,5225,2907
4299,24851,1500,3,Business,7,1,46824,7,1,48580,7,1,49565,7,1,50185,7,1,52278,12,20.5,-1.2569006,36.7925141,-1.3177547,36.8303703,223,2093,1756,1605
4300,12223,3686,3,Business,15,1,51230,15,1,51247,15,1,51275,15,1,51605,15,1,52740,12,23.25888921888938,-1.2551895,36.7822034,-1.318497,36.8296133,848,1135,17,358
4301,8972,2956,3,Business,3,5,35527,3,5,35609,3,5,35818,3,5,37370,3,5,40973,4,23.25888921888938,-1.2584143,36.8048002,-1.2551895,36.7822034,187,3603,82,1761
4302,24776,552,3,Business,24,1,53546,24,1,53592,24,1,54380,24,1,54540,24,1,56131,17,24.8,-1.279395,36.825364,-1.3632162,36.9108253,194,1591,46,948
4303,9901,1249,3,Business,15,5,44690,15,5,44790,15,5,45803,15,5,46241,15,5,48291,13,26.3,-1.2679514,36.8095213,-1.3189252,36.8617269,856,2050,100,1451
4304,15660,2159,3,Business,19,5,36877,19,5,36993,19,5,38296,19,5,38869,19,5,39899,7,25.0,-1.304735,36.7846054,-1.306245,36.8192978,708,1030,116,1876
4305,2581,1768,3,Personal,8,2,43111,8,2,43163,8,2,44431,8,2,44544,8,2,47005,19,23.3,-1.2750257,36.8157165,-1.3229034,36.7127121,263,2461,52,1381
4306,8948,2532,3,Business,13,3,50816,13,3,51053,13,3,51412,13,3,51622,13,3,53277,8,27.3,-1.2551895,36.7822034,-1.2904049,36.8055154,411,1655,237,569
4307,16035,3283,3,Business,16,2,31797,16,2,31818,16,2,32007,16,2,32945,16,2,33969,7,23.25888921888938,-1.303596,36.778378,-1.2628473,36.781805,306,1024,21,1127
4308,7953,3547,3,Business,12,2,37573,12,2,37580,12,2,38047,12,2,38470,12,2,40829,18,24.4,-1.3189252,36.8617269,-1.2856319,36.7672998,25,2359,7,890
4309,22738,1591,2,Personal,6,4,51417,6,4,53054,6,4,54770,6,4,55908,6,4,56926,9,23.3,-1.2616056,36.8790649,-1.2655306,36.828148,179,1018,1637,2854
4310,7037,788,3,Business,10,1,50127,10,1,50136,10,1,50564,10,1,51601,10,1,53126,13,23.25888921888938,-1.290894,36.822971,-1.225322,36.80855,692,1525,9,1465
4311,1714,1340,3,Business,12,2,52614,12,2,52681,12,2,52685,12,2,53102,12,2,55158,16,23.25888921888938,-1.2707179,36.7979713,-1.312122,36.7857712,756,2056,67,421
4312,16988,2234,2,Personal,6,3,63621,6,3,64284,6,3,66401,6,3,66544,6,3,67303,5,20.0,-1.3199976,36.8369216,-1.3222881,36.8275389,890,759,663,2260
4313,15553,1502,3,Business,11,5,58291,11,5,58326,11,5,59276,11,5,59934,11,5,61249,17,20.3,-1.2237773,36.8861711,-1.255956,36.789867,813,1315,35,1608
4314,22226,2150,3,Business,17,5,48235,17,5,48567,17,5,49134,17,5,49460,17,5,50636,9,23.25888921888938,-1.303596,36.778378,-1.344446,36.756597,328,1176,332,893
4315,22866,2627,3,Business,18,1,50124,18,1,50181,18,1,50836,18,1,51035,18,1,51698,2,29.5,-1.2527958,36.8003131,-1.2571472,36.7950633,318,663,57,854
4316,4255,570,3,Business,14,5,51224,14,5,51276,14,5,51655,14,5,52050,14,5,52863,6,22.8,-1.2551895,36.7822034,-1.2825816,36.8092346,50,813,52,774
4317,27541,2900,3,Business,21,4,42254,21,4,42287,21,4,43112,21,4,43348,21,4,44625,9,25.2,-1.2615888,36.7928732,-1.2963097,36.7688221,326,1277,33,1061
4318,20892,3635,1,Business,10,3,33354,10,3,33367,10,3,33657,10,3,38345,10,3,38954,3,22.5,-1.2584143,36.8048002,-1.2615888,36.7928732,453,609,13,4978
4319,6867,2088,1,Personal,29,5,50900,29,5,51501,29,5,51998,29,5,52635,29,5,53442,3,21.1,-1.2884997,36.8183895,-1.2966535,36.8123136,212,807,601,1134
4320,26503,393,3,Business,4,2,56151,4,2,57183,4,2,57535,4,2,57710,4,2,58621,5,22.3,-1.2983042,36.8261141,-1.3228003,36.8306435,211,911,1032,527
4321,1436,3647,3,Business,23,3,38486,23,3,38498,23,3,39021,23,3,39557,23,3,40262,3,23.25888921888938,-1.272639,36.794723,-1.266294,36.8057971,611,705,12,1059
4322,18802,2069,3,Business,22,4,59373,22,4,59430,22,4,59759,22,4,60149,22,4,61613,9,24.4,-1.272828,36.816608,-1.228911,36.881876,660,1464,57,719
4323,11030,111,3,Business,3,1,40007,3,1,40078,3,1,40119,3,1,40866,3,1,42272,12,20.7,-1.2551895,36.7822034,-1.3077749,36.7747247,107,1406,71,788
4324,904,1500,3,Business,12,1,45118,12,1,45765,12,1,46261,12,1,47612,12,1,48851,8,23.9,-1.3004062,36.829741,-1.2574219,36.7927073,518,1239,647,1847
4325,20511,740,1,Personal,6,4,42893,6,4,43003,6,4,44346,6,4,45024,6,4,46514,11,21.9,-1.2830421,36.8819483,-1.2893884,36.828207,124,1490,110,2021
4326,4299,3369,3,Business,3,1,52671,3,1,52876,3,1,54085,3,1,54286,3,1,55856,11,22.9,-1.2973415,36.7707031,-1.2970762,36.8453541,820,1570,205,1410
4327,10990,1075,3,Business,1,5,32847,1,5,33365,1,5,34328,1,5,35035,1,5,38189,18,23.25888921888938,-1.3169591,36.7000029,-1.2527958,36.8003131,831,3154,518,1670
4328,23066,1363,3,Business,15,5,32014,15,5,32095,15,5,32100,15,5,35476,15,5,37056,10,20.5,-1.3004062,36.829741,-1.2991441,36.7528804,828,1580,81,3381
4329,14545,1527,3,Business,15,3,56244,15,3,56277,15,3,56684,15,3,57032,15,3,57460,4,25.9,-1.3077869,36.8443207,-1.3004062,36.829741,910,428,33,755
4330,658,188,1,Personal,17,5,52243,17,5,52297,17,5,53200,17,5,53454,17,5,54561,9,20.0,-1.3078624,36.7697658,-1.3028531,36.8186809,312,1107,54,1157
4331,13208,1209,3,Business,10,3,45084,10,3,45098,10,3,45748,10,3,45911,10,3,47102,9,28.0,-1.2638185,36.7930057,-1.3004062,36.829741,394,1191,14,813
4332,21739,393,3,Business,29,5,30950,29,5,31031,29,5,31914,29,5,32493,29,5,35113,8,20.9,-1.3167113,36.8301563,-1.2770708,36.8231093,507,2620,81,1462
4333,8061,3731,1,Personal,8,2,37057,8,2,37085,8,2,38015,8,2,38154,8,2,39307,9,21.4,-1.3244691,36.8045873,-1.2948781,36.7844523,543,1153,28,1069
4334,15636,1840,1,Personal,22,2,44599,22,2,45378,22,2,48341,22,2,48789,22,2,50088,6,21.1,-1.255956,36.772901,-1.2683272,36.8210353,812,1299,779,3411
4335,20733,3283,3,Business,25,1,59071,25,1,59137,25,1,59948,25,1,61560,25,1,61562,7,28.5,-1.2783849,36.8163445,-1.2628473,36.781805,953,2,66,2423
4336,20604,1154,3,Business,31,3,32167,31,3,32308,31,3,33170,31,3,33374,31,3,35744,5,19.0,-1.2917868,36.7872675,-1.3021707,36.8168444,88,2370,141,1066
4337,10189,3647,3,Business,9,5,44713,9,5,44837,9,5,45403,9,5,45786,9,5,48927,3,25.5,-1.272639,36.794723,-1.2628638,36.8070399,518,3141,124,949
4338,6248,3420,3,Business,11,1,40494,11,1,41138,11,1,42178,11,1,42357,11,1,43269,7,18.1,-1.265981,36.7936121,-1.3046007,36.8211743,726,912,644,1219
4339,17533,3354,3,Business,13,1,46149,13,1,46166,13,1,46557,13,1,47252,13,1,47979,4,23.25888921888938,-1.2571472,36.7950633,-1.274755,36.7906585,56,727,17,1086
4340,3817,2174,3,Business,13,6,34946,13,6,34974,13,6,34977,13,6,38712,13,6,38818,22,26.0,-1.2482781,36.884092,-1.3470009,36.7619454,86,106,28,3738
4341,7030,2009,2,Personal,13,6,38339,13,6,38359,13,6,38544,13,6,38814,13,6,39565,6,24.9,-1.3009173,36.7959207,-1.2851847,36.8314086,409,751,20,455
4342,7239,868,3,Business,12,3,50907,12,3,51009,12,3,51032,12,3,51628,12,3,52302,4,21.0,-1.259478,36.8017813,-1.2663631,36.8163329,607,674,102,619
4343,17102,481,3,Personal,21,2,32539,21,2,32608,21,2,34575,21,2,34903,21,2,36269,4,23.25888921888938,-1.3081376,36.8329772,-1.2802618,36.8191684,448,1366,69,2295
4344,25364,2112,3,Business,15,6,35231,15,6,36274,15,6,37973,15,6,39357,15,6,43524,23,23.25888921888938,-1.3472066,36.7692638,-1.2156006,36.8916865,541,4167,1043,3083
4345,1445,1207,1,Business,10,7,53636,10,7,53675,10,7,54828,10,7,54976,10,7,56408,11,20.8,-1.2667935,36.9021486,-1.2351541,36.8748505,589,1432,39,1301
4346,28204,2828,3,Business,2,6,34212,2,6,37663,2,6,40162,2,6,40736,2,6,41966,15,23.25888921888938,-1.2778747,36.8831829,-1.3319295,36.7924359,675,1230,3451,3073
4347,18203,1207,3,Business,15,5,63377,15,5,63397,15,5,63590,15,5,63744,15,5,65606,14,27.8,-1.2628638,36.8070399,-1.207546,36.7913976,858,1862,20,347
4348,15484,3326,3,Business,14,4,50121,14,4,50621,14,4,51718,14,4,51929,14,4,53449,8,27.8,-1.2551895,36.7822034,-1.2976576,36.8081253,660,1520,500,1308
4349,20371,1073,3,Business,20,3,57953,20,3,57964,20,3,57981,20,3,58957,20,3,60857,9,29.6,-1.2561964,36.7885001,-1.2846026,36.7844073,907,1900,11,993
4350,354,1258,2,Personal,27,4,49233,27,4,51169,27,4,52996,27,4,53406,27,4,58233,21,25.1,-1.3646468,36.7499829,-1.303924,36.8758792,226,4827,1936,2237
4351,19756,2066,3,Business,6,6,47995,6,6,48807,6,6,49379,6,6,50418,6,6,51413,6,27.9,-1.316961,36.820337,-1.2927299,36.7883621,328,995,812,1611
4352,9984,1363,3,Business,2,5,32432,2,5,32472,2,5,32482,2,5,32954,2,5,33512,3,17.9,-1.3004062,36.829741,-1.3047132,36.8089553,69,558,40,482
4353,27016,1471,3,Business,15,5,45038,15,5,45058,15,5,45628,15,5,45891,15,5,47333,8,26.5,-1.2551895,36.7822034,-1.3021707,36.8168444,411,1442,20,833
4354,15980,265,3,Business,5,3,49950,5,3,51509,5,3,51511,5,3,52625,5,3,53261,4,24.8,-1.2825816,36.8092346,-1.300921,36.828195,813,636,1559,1116
4355,17277,3621,3,Business,6,1,37193,6,1,37214,6,1,38376,6,1,39019,6,1,39386,6,23.25888921888938,-1.2836583,36.7886014,-1.2931121,36.8224572,119,367,21,1805
4356,6701,718,3,Business,14,4,54935,14,4,59231,14,4,59536,14,4,59844,14,4,61687,10,26.4,-1.2551895,36.7822034,-1.308217,36.77413,328,1843,4296,613
4357,11304,1993,2,Personal,27,5,34174,27,5,34195,27,5,34745,27,5,34972,27,5,36013,5,16.3,-1.2900727,36.7890059,-1.2871938,36.8195031,857,1041,21,777
4358,9483,238,3,Business,24,4,51643,24,4,52277,24,4,52307,24,4,55756,24,4,55767,5,28.4,-1.32671,36.8600138,-1.3077869,36.8443207,86,11,634,3479
4359,26603,2254,3,Business,17,3,50877,17,3,54131,17,3,55836,17,3,56645,17,3,59396,6,28.2,-1.2564799,36.8112138,-1.290021,36.828206,268,2751,3254,2514
4360,24058,633,3,Business,8,2,49245,8,2,49300,8,2,49307,8,2,51110,8,2,51119,4,25.3,-1.3077869,36.8443207,-1.3004062,36.829741,619,9,55,1810
4361,6941,186,3,Business,14,5,60014,14,5,60162,14,5,60392,14,5,60612,14,5,61722,7,21.3,-1.2883158,36.8199114,-1.2571472,36.7950633,467,1110,148,450
4362,2673,3234,3,Business,8,5,35381,8,5,35411,8,5,37326,8,5,39492,8,5,41785,18,23.25888921888938,-1.3038543,36.8381051,-1.3343138,36.7086793,618,2293,30,4081
4363,10298,2631,1,Personal,5,4,41908,5,4,43848,5,4,44334,5,4,44537,5,4,45238,4,23.25888921888938,-1.2845871,36.8234834,-1.269059,36.8108027,629,701,1940,689
4364,6094,1790,3,Business,28,4,47274,28,4,47303,28,4,47627,28,4,47840,28,4,49829,8,23.25888921888938,-1.2966785,36.7896469,-1.2551895,36.7822034,216,1989,29,537
4365,10068,393,3,Business,13,4,48890,13,4,48910,13,4,49342,13,4,50174,13,4,50793,4,23.1,-1.3228003,36.8306435,-1.3004062,36.829741,891,619,20,1264
4366,12983,3264,3,Business,15,4,58141,15,4,64201,15,4,64643,15,4,64900,15,4,65562,3,25.4,-1.2551895,36.7822034,-1.2642665,36.7788286,958,662,6060,699
4367,28046,1271,3,Business,23,3,56342,23,3,56356,23,3,57617,23,3,58444,23,3,62532,23,27.5,-1.3107918,36.761794,-1.2927792,36.9053492,831,4088,14,2088
4368,16762,3091,3,Business,22,3,53137,22,3,53179,22,3,53747,22,3,54553,22,3,55843,9,25.8,-1.290894,36.822971,-1.3014461,36.7661381,726,1290,42,1374
4369,20902,3283,3,Business,18,4,38995,18,4,39007,18,4,39092,18,4,40355,18,4,41780,13,23.25888921888938,-1.331619,36.847976,-1.2628473,36.781805,710,1425,12,1348
4370,10475,1753,3,Business,17,5,39150,17,5,39215,17,5,39769,17,5,40529,17,5,40800,2,23.25888921888938,-1.2551895,36.7822034,-1.2567464,36.7915273,259,271,65,1314
4371,2858,1502,3,Business,20,3,32656,20,3,32774,20,3,33886,20,3,34632,20,3,36005,14,23.25888921888938,-1.2571472,36.7950633,-1.2232123,36.8932547,275,1373,118,1858
4372,24097,1502,3,Business,4,2,62200,4,2,62208,4,2,62684,4,2,62944,4,2,63453,4,22.3,-1.2283403,36.8822756,-1.2232123,36.8932547,685,509,8,736
4373,15162,3517,3,Business,26,5,33824,26,5,34393,26,5,36442,26,5,37535,26,5,40228,18,23.25888921888938,-1.2867454,36.8259017,-1.3882008,36.7699445,359,2693,569,3142
4374,23891,868,3,Business,18,1,43996,18,1,44138,18,1,45852,18,1,46458,18,1,47922,8,27.8,-1.303596,36.778378,-1.265715,36.823815,652,1464,142,2320
4375,2429,3578,3,Business,27,6,46435,27,6,46452,27,6,47375,27,6,47737,27,6,48201,1,23.25888921888938,-1.2649605,36.7981777,-1.2527958,36.8003131,641,464,17,1285
4376,10861,3686,3,Business,28,1,45007,28,1,45044,28,1,45635,28,1,46052,28,1,47715,8,23.8,-1.2551895,36.7822034,-1.254405,36.747598,486,1663,37,1008
4377,19572,868,3,Business,9,2,47732,9,2,47753,9,2,47939,9,2,48323,9,2,49196,8,27.0,-1.303596,36.778378,-1.265715,36.823815,438,873,21,570
4378,16414,1934,2,Personal,11,2,54571,11,2,54623,11,2,54889,11,2,55515,11,2,56867,10,25.3,-1.304033,36.7848695,-1.2563576,36.7881585,4,1352,52,892
4379,19750,2035,2,Personal,27,1,47745,27,1,47788,27,1,48668,27,1,48769,27,1,49556,4,23.25888921888938,-1.2929577,36.7955434,-1.2790289,36.8039715,749,787,43,981
4380,20061,3326,3,Business,27,3,54205,27,3,54253,27,3,54576,27,3,54638,27,3,56907,4,23.25888921888938,-1.2551895,36.7822034,-1.2670213,36.7994482,45,2269,48,385
4381,136,3434,3,Business,20,2,50682,20,2,50781,20,2,51750,20,2,51961,20,2,54011,20,24.0,-1.2963097,36.7688221,-1.3123562,36.9157558,941,2050,99,1180
4382,198,3263,2,Personal,19,5,60596,19,5,60661,19,5,61504,19,5,64861,19,5,65626,6,24.2,-1.3390024,36.8746657,-1.3221141,36.8636835,179,765,65,4200
4383,2572,2828,2,Business,7,6,34241,7,6,34269,7,6,34295,7,6,36132,7,6,36144,3,14.3,-1.2584143,36.8048002,-1.2615888,36.7928732,51,12,28,1863
4384,6644,3451,1,Personal,16,3,48582,16,3,49507,16,3,50724,16,3,51679,16,3,53740,15,25.5,-1.3322116,36.890379,-1.276975,36.8231488,777,2061,925,2172
4385,9268,2989,3,Business,7,1,29702,7,1,31482,7,1,33457,7,1,34208,7,1,36203,12,21.6,-1.3472066,36.7692638,-1.2866012,36.8195691,412,1995,1780,2726
4386,4321,2200,3,Business,24,3,42029,24,3,44134,24,3,44587,24,3,45247,24,3,46376,6,19.7,-1.2584143,36.8048002,-1.290894,36.822971,726,1129,2105,1113
4387,23682,3493,1,Personal,8,1,30534,8,1,30565,8,1,31351,8,1,31704,8,1,33542,16,19.8,-1.3278463,36.819099,-1.2623805,36.7805404,328,1838,31,1139
4388,8613,84,3,Business,9,4,58394,9,4,58413,9,4,59026,9,4,59745,9,4,60465,3,23.2,-1.2527958,36.8003131,-1.2551895,36.7822034,259,720,19,1332
4389,20183,2271,3,Business,2,2,58032,2,2,58080,2,2,59388,2,2,60129,2,2,62171,12,23.6,-1.331619,36.847976,-1.293515,36.897607,761,2042,48,2049
4390,6674,186,3,Business,22,5,47071,22,5,47342,22,5,48035,22,5,48415,22,5,49411,6,28.7,-1.2571472,36.7950633,-1.2913246,36.8019522,448,996,271,1073
4391,5971,3149,3,Business,4,2,46188,4,2,46651,4,2,46657,4,2,52462,4,2,53048,6,23.7,-1.3004062,36.829741,-1.3177547,36.8303703,848,586,463,5811
4392,7303,1471,3,Business,29,5,49410,29,5,49574,29,5,51278,29,5,51964,29,5,52980,8,21.1,-1.2551895,36.7822034,-1.2864747,36.7973884,101,1016,164,2390
4393,2654,1148,3,Business,7,3,46132,7,3,46342,7,3,47618,7,3,49339,7,3,51954,10,28.4,-1.3100586,36.8500329,-1.3003465,36.7879609,660,2615,210,2997
4394,22714,136,3,Business,11,2,37855,11,2,37928,11,2,38921,11,2,39975,11,2,40848,9,19.5,-1.2313147,36.8016863,-1.2210156,36.855674,484,873,73,2047
4395,11050,1646,3,Business,16,4,44319,16,4,44341,16,4,46295,16,4,46632,16,4,50427,22,23.25888921888938,-1.2517448,36.7924971,-1.3662811,36.7542142,205,3795,22,2291
4396,23488,3719,2,Personal,18,5,58894,18,5,59071,18,5,59220,18,5,60537,18,5,61207,7,22.3,-1.3024794,36.8228284,-1.3318059,36.8359596,832,670,177,1466
4397,7094,1417,3,Business,28,4,48527,28,4,48593,28,4,48741,28,4,49001,28,4,54116,6,27.3,-1.2741728,36.7969108,-1.2940511,36.8219302,88,5115,66,408
4398,20370,2587,3,Business,15,1,54537,15,1,55421,15,1,55425,15,1,56762,15,1,58195,5,23.25888921888938,-1.3165719,36.8420843,-1.28878,36.8168312,613,1433,884,1341
4399,14049,2159,3,Business,12,1,37032,12,1,37081,12,1,38019,12,1,38298,12,1,40336,13,23.7,-1.304735,36.7846054,-1.3668652,36.730459,425,2038,49,1217
4400,23831,2523,3,Business,22,5,54720,22,5,54740,22,5,55692,22,5,56048,22,5,58490,15,23.25888921888938,-1.2551895,36.7822034,-1.2343236,36.8861,192,2442,20,1308
4401,23902,3186,3,Business,28,2,53367,28,2,53484,28,2,54057,28,2,54280,28,2,56404,6,23.3,-1.2980229,36.78865,-1.2822909,36.8193456,826,2124,117,796
4402,243,1500,3,Business,2,6,37353,2,6,37421,2,6,37425,2,6,42263,2,6,42268,8,23.25888921888938,-1.3004062,36.829741,-1.2638185,36.7930057,515,5,68,4842
4403,20572,393,3,Business,8,5,56553,8,5,57448,8,5,57451,8,5,59588,8,5,59591,14,28.2,-1.3167113,36.8301563,-1.306378,36.7519845,10,3,895,2140
4404,21817,338,1,Personal,6,5,49892,6,5,49914,6,5,50281,6,5,50442,6,5,51114,7,22.7,-1.282986,36.767414,-1.2538731,36.7850223,103,672,22,528
4405,10630,868,3,Business,24,3,55229,24,3,55375,24,3,57757,24,3,58690,24,3,61531,14,23.25888921888938,-1.293515,36.897607,-1.265715,36.823815,126,2841,146,3315
4406,11116,2828,3,Business,16,6,65056,16,6,65068,16,6,65565,16,6,66445,16,6,67823,17,23.8,-1.2615888,36.7928732,-1.2333156,36.8963784,103,1378,12,1377
4407,19758,3404,3,Business,24,3,47001,24,3,48372,24,3,48790,24,3,49856,24,3,50977,8,18.6,-1.279395,36.825364,-1.3196809,36.8410572,237,1121,1371,1484
4408,7269,3599,3,Business,30,6,29354,30,6,29368,30,6,32328,30,6,33147,30,6,34665,18,23.25888921888938,-1.3302996,36.8707935,-1.3609149,36.7288735,459,1518,14,3779
4409,5391,3647,3,Business,26,2,36677,26,2,36764,26,2,37144,26,2,37793,26,2,38142,2,23.25888921888938,-1.272639,36.794723,-1.2746436,36.803682,100,349,87,1029
4410,11628,1927,3,Business,18,1,43127,18,1,43160,18,1,43305,18,1,45438,18,1,47017,12,26.8,-1.279395,36.825364,-1.3472066,36.7692638,458,1579,33,2278
4411,27464,1482,3,Business,1,4,43518,1,4,43540,1,4,43663,1,4,43952,1,4,46000,17,23.25888921888938,-1.338579,36.8963038,-1.2583017,36.8023526,771,2048,22,412
4412,20530,2763,3,Business,22,5,54460,22,5,54531,22,5,56164,22,5,57099,22,5,58882,13,27.5,-1.2551895,36.7822034,-1.3270347,36.8667362,300,1783,71,2568
4413,26654,3586,3,Business,15,1,33139,15,1,33165,15,1,33260,15,1,34434,15,1,35398,7,23.25888921888938,-1.2591019,36.800577,-1.275442,36.7660207,467,964,26,1269
4414,20582,2701,3,Business,1,4,33421,1,4,33508,1,4,34254,1,4,35748,1,4,36381,5,23.25888921888938,-1.290894,36.822971,-1.2765736,36.8513646,171,633,87,2240
4415,20996,928,3,Business,30,3,41091,30,3,41212,30,3,41388,30,3,41545,30,3,43043,7,25.2,-1.2551895,36.7822034,-1.2878913,36.8089253,362,1498,121,333
4416,27569,2987,3,Business,7,3,59271,7,3,59526,7,3,59577,7,3,61292,7,3,64323,13,25.3,-1.270212,36.8210877,-1.2927792,36.9053492,718,3031,255,1766
4417,17695,435,3,Business,24,5,54506,24,5,54552,24,5,54559,24,5,55217,24,5,56436,9,23.0,-1.3081376,36.8329772,-1.257681,36.797778,515,1219,46,665
4418,1941,393,3,Business,8,1,39934,8,1,39945,8,1,40070,8,1,41054,8,1,42980,14,28.0,-1.3167113,36.8301563,-1.306378,36.7519845,168,1926,11,1109
4419,25398,178,2,Personal,23,1,31176,23,1,31202,23,1,31853,23,1,32378,23,1,34220,13,14.5,-1.315797,36.8436497,-1.2997463,36.7536549,858,1842,26,1176
4420,15221,412,3,Business,15,1,38321,15,1,38337,15,1,38798,15,1,39327,15,1,39333,4,23.25888921888938,-1.266837,36.799249,-1.272828,36.816608,424,6,16,990
4421,26901,2066,3,Business,1,6,47213,1,6,47221,1,6,47848,1,6,48113,1,6,50128,10,18.5,-1.316961,36.820337,-1.256958,36.8144929,329,2015,8,892
4422,27255,3404,3,Business,26,2,56987,26,2,57153,26,2,57966,26,2,58095,26,2,58771,7,30.8,-1.279395,36.825364,-1.2551895,36.7822034,156,676,166,942
4423,3954,3289,3,Personal,1,5,71616,1,5,71652,1,5,72143,1,5,72455,1,5,72894,3,21.4,-1.3002727,36.7668028,-1.2974406,36.7765953,862,439,36,803
4424,3185,3426,3,Business,7,5,54169,7,5,54238,7,5,54798,7,5,55109,7,5,56585,9,24.7,-1.3014461,36.7661381,-1.2551895,36.7822034,848,1476,69,871
4425,8785,2268,1,Personal,3,5,40362,3,5,40711,3,5,41182,3,5,41804,3,5,42271,4,21.6,-1.3069436,36.8172066,-1.288285,36.815912,754,467,349,1093
4426,7056,633,3,Business,14,4,55179,14,4,55352,14,4,55693,14,4,56952,14,4,57562,5,27.6,-1.3004062,36.829741,-1.3228003,36.8306435,728,610,173,1600
4427,4407,2509,3,Business,17,1,52372,17,1,52545,17,1,54096,17,1,56888,17,1,58683,6,24.8,-1.2571472,36.7950633,-1.2857671,36.7875614,795,1795,173,4343
4428,9530,419,3,Business,16,3,50143,16,3,50185,16,3,50443,16,3,50760,16,3,55103,6,26.9,-1.2571472,36.7950633,-1.3001813,36.811122,446,4343,42,575
4429,15210,2216,3,Business,8,4,40416,8,4,44761,8,4,44819,8,4,45901,8,4,48921,7,26.1,-1.2551895,36.7822034,-1.2830276,36.8297516,477,3020,4345,1140
4430,18796,1724,3,Business,10,1,29803,10,1,29834,10,1,33186,10,1,33315,10,1,34619,5,16.4,-1.2638132,36.7849775,-1.2551895,36.7822034,475,1304,31,3481
4431,19361,1205,3,Business,31,4,35422,31,4,35434,31,4,36890,31,4,37290,31,4,37851,5,20.3,-1.2495931,36.8065087,-1.2475136,36.7703179,607,561,12,1856
4432,17459,2112,3,Business,15,2,52407,15,2,54248,15,2,54877,15,2,55634,15,2,59995,12,24.3,-1.290894,36.822971,-1.2237773,36.8861711,320,4361,1841,1386
4433,20005,1205,3,Business,31,4,37614,31,4,37642,31,4,39027,31,4,39738,31,4,42357,9,26.6,-1.2495931,36.8065087,-1.2159987,36.8226959,953,2619,28,2096
4434,19665,1363,3,Business,17,5,51851,17,5,51930,17,5,52095,17,5,52165,17,5,53255,4,23.25888921888938,-1.3004062,36.829741,-1.2890399,36.8164942,211,1090,79,235
4435,14953,778,3,Business,13,4,43934,13,4,44169,13,4,46563,13,4,47303,13,4,51185,5,21.8,-1.2535486,36.7933541,-1.2564152,36.7792803,741,3882,235,3134
4436,2764,201,3,Business,2,5,41737,2,5,41754,2,5,42018,2,5,42317,2,5,46928,20,23.5,-1.2551895,36.7822034,-1.2742942,36.9194976,38,4611,17,563
4437,12743,158,3,Personal,27,1,48840,27,1,48861,27,1,49051,27,1,49285,27,1,49962,3,23.0,-1.3205164,36.8098882,-1.3041041,36.8171449,216,677,21,424
4438,22241,1250,1,Personal,17,2,42122,17,2,42152,17,2,42897,17,2,43909,17,2,44993,9,19.1,-1.2620741,36.8158147,-1.2743743,36.7657321,648,1084,30,1757
4439,25616,2069,3,Business,1,5,42034,1,5,42292,1,5,42825,1,5,43460,1,5,44370,9,28.6,-1.265715,36.823815,-1.228911,36.881876,329,910,258,1168
4440,3969,2954,1,Personal,22,6,43501,22,6,43536,22,6,43671,22,6,45410,22,6,47650,22,21.1,-1.3257893,36.8940194,-1.2224213,36.8165253,248,2240,35,1874
4441,14570,1205,3,Business,5,1,37721,5,1,37776,5,1,38171,5,1,38470,5,1,39329,4,24.7,-1.257309,36.8060084,-1.2640571,36.7883547,370,859,55,694
4442,21891,3718,3,Business,15,1,53312,15,1,53405,15,1,54093,15,1,54502,15,1,55937,5,23.25888921888938,-1.2650027,36.8126242,-1.2877501,36.8146599,519,1435,93,1097
4443,5034,2374,2,Personal,27,3,45558,27,3,45665,27,3,47110,27,3,47401,27,3,48550,7,23.25888921888938,-1.2884354,36.7606766,-1.2707179,36.7979713,465,1149,107,1736
4444,16179,2330,3,Business,30,4,57948,30,4,58056,30,4,59170,30,4,59348,30,4,61182,8,23.25888921888938,-1.3015197,36.7658456,-1.3192789,36.7112991,602,1834,108,1292
4445,24083,733,3,Business,21,5,38547,21,5,38566,21,5,38992,21,5,39182,21,5,41328,20,22.6,-1.2551895,36.7822034,-1.3251247,36.8995926,685,2146,19,616
4446,12927,2100,3,Business,23,2,43447,23,2,43911,23,2,44619,23,2,45450,23,2,46965,6,18.1,-1.28878,36.8168312,-1.2765736,36.8513646,662,1515,464,1539
4447,6330,2066,3,Business,28,3,61629,28,3,65694,28,3,67045,28,3,67256,28,3,68280,9,23.3,-1.3210189,36.8410551,-1.267452,36.806015,607,1024,4065,1562
4448,23968,1424,3,Business,31,2,38571,31,2,38591,31,2,38940,31,2,39888,31,2,40709,5,18.5,-1.30157,36.7871,-1.3014461,36.7661381,903,821,20,1297
4449,8035,1774,1,Personal,28,5,49443,28,5,49505,28,5,51963,28,5,52347,28,5,55831,26,25.6,-1.260232,36.807334,-1.4027553,36.9514974,446,3484,62,2842
4450,15016,2969,2,Personal,6,5,60729,6,5,60804,6,5,61160,6,5,61540,6,5,62774,6,23.25888921888938,-1.290109,36.824918,-1.2650182,36.7926717,914,1234,75,736
4451,6498,970,3,Business,12,2,36855,12,2,37098,12,2,37603,12,2,37876,12,2,40371,8,17.9,-1.2551895,36.7822034,-1.2935508,36.7948949,650,2495,243,778
4452,25256,1120,3,Personal,19,2,50697,19,2,50714,19,2,51724,19,2,52445,19,2,53288,2,29.5,-1.2643694,36.7854135,-1.2561824,36.7931555,177,843,17,1731
4453,12982,540,3,Business,27,1,52183,27,1,52245,27,1,52930,27,1,53484,27,1,54762,6,23.0,-1.2584143,36.8048002,-1.3010059,36.8216816,709,1278,62,1239
4454,27742,552,3,Business,29,4,42722,29,4,44785,29,4,45719,29,4,45982,29,4,47036,9,21.4,-1.3226302,36.8719901,-1.3632162,36.9108253,43,1054,2063,1197
4455,3790,517,3,Business,2,3,34294,2,3,34303,2,3,34406,2,3,35071,2,3,36748,14,20.1,-1.3167113,36.8301563,-1.306378,36.7519845,188,1677,9,768
4456,24464,230,1,Personal,19,2,61390,19,2,61415,19,2,61827,19,2,62256,19,2,62788,2,19.8,-1.2952784,36.7793271,-1.2880229,36.7892191,312,532,25,841
4457,19687,1925,2,Personal,16,3,56083,16,3,56089,16,3,56105,16,3,56450,16,3,58755,20,25.5,-1.2860183,36.8975338,-1.3337097,36.7659945,742,2305,6,361
4458,24921,393,3,Business,18,5,52159,18,5,52163,18,5,52434,18,5,53041,18,5,55976,14,27.1,-1.3167113,36.8301563,-1.306378,36.7519845,523,2935,4,878
4459,2044,1245,3,Business,22,3,28888,22,3,29615,22,3,30810,22,3,31807,22,3,33905,25,15.4,-1.4332561,36.9562993,-1.300921,36.828195,213,2098,727,2192
4460,27307,1329,3,Business,2,4,50338,2,4,50402,2,4,50806,2,4,50904,2,4,52543,8,23.25888921888938,-1.273056,36.811298,-1.296268,36.785084,660,1639,64,502
4461,3023,2866,3,Business,7,1,53990,7,1,54020,7,1,54057,7,1,54688,7,1,56976,22,27.0,-1.2551895,36.7822034,-1.3692201,36.9252718,647,2288,30,668
4462,8513,393,3,Business,12,2,45040,12,2,45050,12,2,45280,12,2,45714,12,2,46275,4,24.4,-1.3167113,36.8301563,-1.3004062,36.829741,88,561,10,664
4463,15236,3247,3,Business,14,2,40464,14,2,40757,14,2,41267,14,2,41909,14,2,42653,6,23.25888921888938,-1.2889914,36.8209443,-1.2571472,36.7950633,19,744,293,1152
4464,28134,1527,3,Business,21,2,34314,21,2,34377,21,2,36444,21,2,36697,21,2,37479,5,23.25888921888938,-1.2770708,36.8231093,-1.3004062,36.829741,155,782,63,2320
4465,13099,2317,1,Personal,17,3,51918,17,3,51942,17,3,51966,17,3,52841,17,3,55927,24,28.2,-1.3003196,36.8171416,-1.2492584,36.6689141,478,3086,24,899
4466,6438,3115,3,Business,22,3,60162,22,3,60190,22,3,61118,22,3,61516,22,3,62809,2,23.9,-1.2969741,36.7856612,-1.2963097,36.7688221,708,1293,28,1326
4467,8920,1927,3,Business,2,2,42499,2,2,42757,2,2,43559,2,2,44192,2,2,45403,13,26.3,-1.2765736,36.8513646,-1.3472066,36.7692638,377,1211,258,1435
4468,974,3149,3,Business,8,5,35420,8,5,35482,8,5,37166,8,5,38195,8,5,39149,7,28.5,-1.3077869,36.8443207,-1.3167113,36.8301563,916,954,62,2713
4469,6196,2200,3,Business,12,1,38075,12,1,39207,12,1,40158,12,1,42327,12,1,44614,8,23.7,-1.3014461,36.7661381,-1.290894,36.822971,703,2287,1132,3120
4470,1398,1809,3,Business,27,5,42337,27,5,42351,27,5,42840,27,5,43279,27,5,44344,2,22.5,-1.2527958,36.8003131,-1.2646084,36.8028645,933,1065,14,928
4471,8817,393,3,Business,14,2,39218,14,2,39253,14,2,40256,14,2,41859,14,2,41860,4,23.25888921888938,-1.3167113,36.8301563,-1.3004062,36.829741,910,1,35,2606
4472,21483,3689,3,Business,28,5,52216,28,5,52232,28,5,53025,28,5,53329,28,5,54918,7,25.7,-1.2527958,36.8003131,-1.2973654,36.8105527,948,1589,16,1097
4473,7448,718,3,Business,7,4,54689,7,4,54700,7,4,55071,7,4,55167,7,4,56081,3,31.3,-1.2551895,36.7822034,-1.263453,36.7955612,25,914,11,467
4474,13053,868,3,Business,4,1,38936,4,1,38950,4,1,41792,4,1,42531,4,1,43879,9,25.6,-1.318062,36.849326,-1.265715,36.823815,127,1348,14,3581
4475,15360,646,3,Personal,2,2,52132,2,2,52224,2,2,52793,2,2,55039,2,2,56273,16,26.3,-1.2469508,36.8244485,-1.3231725,36.8640177,472,1234,92,2815
4476,12078,3128,1,Personal,22,2,38665,22,2,39416,22,2,40476,22,2,40857,22,2,45186,12,19.5,-1.2047753,36.7915359,-1.2753109,36.8130185,147,4329,751,1441
4477,17432,136,3,Business,22,2,34000,22,2,34026,22,2,34290,22,2,34525,22,2,36882,8,17.3,-1.3025826,36.7670807,-1.2560874,36.7931031,65,2357,26,499
4478,6041,393,3,Business,3,3,44611,3,3,45626,3,3,46210,3,3,47154,3,3,48863,10,24.2,-1.3177547,36.8303703,-1.2574219,36.7927073,62,1709,1015,1528
4479,8410,1406,1,Personal,7,4,39879,7,4,42101,7,4,42277,7,4,42838,7,4,43765,5,17.2,-1.2737013,36.8069122,-1.2883346,36.8148489,116,927,2222,737
4480,14041,1342,3,Business,28,4,63190,28,4,63204,28,4,63486,28,4,64073,28,4,65445,11,23.25888921888938,-1.2584143,36.8048002,-1.3025826,36.7670807,616,1372,14,869
4481,4749,1724,3,Business,8,5,49399,8,5,52866,8,5,53211,8,5,53861,8,5,55725,3,30.6,-1.259382,36.807205,-1.2551895,36.7822034,657,1864,3467,995
4482,22808,1500,3,Business,21,1,46870,21,1,49088,21,1,49100,21,1,50016,21,1,50671,9,21.6,-1.2991441,36.7528804,-1.2569006,36.7925141,687,655,2218,928
4483,5375,2733,3,Business,19,2,45169,19,2,45766,19,2,46664,19,2,47289,19,2,49829,8,27.3,-1.2813012,36.8323962,-1.2963097,36.7688221,831,2540,597,1523
4484,14205,1500,3,Business,18,5,42032,18,5,42041,18,5,42076,18,5,42370,18,5,44129,13,20.0,-1.2574219,36.7927073,-1.3228003,36.8306435,518,1759,9,329
4485,27625,567,3,Business,20,3,38455,20,3,38547,20,3,39050,20,3,39200,20,3,40570,8,26.5,-1.2963097,36.7688221,-1.2753109,36.8130185,269,1370,92,653
4486,23097,111,3,Business,16,4,36279,16,4,36317,16,4,36987,16,4,37499,16,4,40674,13,23.25888921888938,-1.2551895,36.7822034,-1.3270347,36.8667362,831,3175,38,1182
4487,5021,280,1,Personal,2,6,56382,2,6,56899,2,6,57219,2,6,58162,2,6,59003,8,23.8,-1.2696183,36.8021778,-1.2850645,36.8426837,852,841,517,1263
4488,12922,458,3,Business,2,3,31916,2,3,31942,2,3,32732,2,3,33508,2,3,34748,12,18.0,-1.2475248,36.8813444,-1.2729324,36.8115622,408,1240,26,1566
4489,368,1311,3,Business,27,2,51394,27,2,52101,27,2,53446,27,2,54089,27,2,55447,7,25.6,-1.2827651,36.8433831,-1.2358419,36.8564147,343,1358,707,1988
4490,18990,750,1,Personal,10,5,62911,10,5,62961,10,5,64646,10,5,65000,10,5,65780,5,21.1,-1.2876659,36.8179934,-1.3012895,36.8035556,213,780,50,2039
4491,27253,2330,3,Business,19,2,60540,19,2,60571,19,2,61842,19,2,63015,19,2,63025,5,28.5,-1.3040812,36.7924217,-1.2890715,36.8157588,314,10,31,2444
4492,9979,265,3,Business,1,4,32709,1,4,32746,1,4,33192,1,4,33273,1,4,34016,7,23.25888921888938,-1.2996632,36.789841,-1.300921,36.828195,88,743,37,527
4493,942,706,3,Business,28,1,36936,28,1,38471,28,1,38892,28,1,39948,28,1,41113,12,23.6,-1.3559093,36.9100452,-1.3077869,36.8443207,585,1165,1535,1477
4494,20989,1340,3,Business,25,5,36228,25,5,36354,25,5,37657,25,5,37809,25,5,38870,6,20.6,-1.2707179,36.7979713,-1.2969293,36.8027733,521,1061,126,1455
4495,10000,2829,3,Business,15,3,39319,15,3,39398,15,3,39536,15,3,40228,15,3,41811,6,23.25888921888938,-1.2571472,36.7950633,-1.2925919,36.8170577,404,1583,79,830
4496,8883,1500,3,Business,23,3,46013,23,3,46130,23,3,46145,23,3,46740,23,3,48395,10,23.25888921888938,-1.2991441,36.7528804,-1.2574219,36.7927073,931,1655,117,610
4497,13625,3706,2,Personal,11,2,30126,11,2,30748,11,2,32012,11,2,32275,11,2,33833,9,18.6,-1.2518057,36.7997135,-1.2846195,36.7958316,882,1558,622,1527
4498,5594,2956,3,Business,19,1,35783,19,1,35844,19,1,37061,19,1,37668,19,1,38929,9,19.5,-1.3014461,36.7661381,-1.2584143,36.8048002,425,1261,61,1824
4499,25172,1209,3,Business,10,4,36172,10,4,37528,10,4,37538,10,4,37731,10,4,38841,9,18.6,-1.2569006,36.7925141,-1.3004062,36.829741,173,1110,1356,203
4500,16928,1278,3,Personal,17,1,44179,17,1,44252,17,1,45172,17,1,45627,17,1,47070,10,23.6,-1.3226302,36.8719901,-1.303105,36.819135,498,1443,73,1375
4501,3192,3689,3,Business,20,2,63875,20,2,63896,20,2,64511,20,2,65191,20,2,66732,10,23.9,-1.3014461,36.7661381,-1.2527958,36.8003131,427,1541,21,1295
4502,25508,3149,3,Business,13,3,45519,13,3,45540,13,3,45544,13,3,47542,13,3,47966,5,23.25888921888938,-1.3004062,36.829741,-1.3167113,36.8301563,842,424,21,2002
4503,588,1578,3,Business,9,1,55438,9,1,55999,9,1,56091,9,1,56489,9,1,57531,11,21.0,-1.2765736,36.8513646,-1.2551895,36.7822034,101,1042,561,490
4504,3060,371,1,Personal,24,1,45913,24,1,45946,24,1,46376,24,1,46799,24,1,47709,7,22.5,-1.2671001,36.7977185,-1.237177,36.756117,882,910,33,853
4505,3265,3201,3,Business,15,1,54690,15,1,54726,15,1,54929,15,1,55679,15,1,56017,1,23.25888921888938,-1.2605938,36.8073235,-1.2584143,36.8048002,191,338,36,953
4506,23117,2718,3,Business,4,1,54287,4,1,54658,4,1,54942,4,1,55426,4,1,56026,4,22.5,-1.2601,36.796528,-1.267022,36.807941,727,600,371,768
4507,9612,569,3,Personal,22,3,49596,22,3,49627,22,3,49891,22,3,50198,22,3,53224,10,25.5,-1.2871506,36.7582832,-1.3188148,36.8092478,334,3026,31,571
4508,421,2330,3,Business,11,2,49522,11,2,49722,11,2,50417,11,2,50512,11,2,51544,6,21.1,-1.2328823,36.8436797,-1.2355732,36.8786063,158,1032,200,790
4509,2938,1500,3,Business,5,5,38389,5,5,38439,5,5,38867,5,5,39098,5,5,41082,13,24.4,-1.2638185,36.7930057,-1.3228003,36.8306435,436,1984,50,659
4510,4385,1271,3,Business,24,1,43568,24,1,46810,24,1,49414,24,1,50191,24,1,52544,23,24.9,-1.3244885,36.897792,-1.2784722,36.7556652,925,2353,3242,3381
4511,2940,2216,3,Business,30,2,52835,30,2,53013,30,2,54127,30,2,54512,30,2,57337,7,23.25888921888938,-1.2551895,36.7822034,-1.2603179,36.8305747,517,2825,178,1499
4512,14383,2112,3,Business,8,2,49026,8,2,49221,8,2,49563,8,2,52001,8,2,52213,12,25.2,-1.290894,36.822971,-1.2156006,36.8916865,333,212,195,2780
4513,24587,3718,3,Business,15,4,45225,15,4,45291,15,4,46594,15,4,46871,15,4,48687,5,24.5,-1.2906618,36.8131222,-1.2650027,36.8126242,322,1816,66,1580
4514,11759,2030,3,Business,21,5,40522,21,5,47693,21,5,48835,21,5,50390,21,5,51745,8,27.1,-1.3123562,36.9157558,-1.3333725,36.8717613,584,1355,7171,2697
4515,9018,393,3,Business,21,1,40684,21,1,40690,21,1,40829,21,1,41617,21,1,43242,14,25.7,-1.3167113,36.8301563,-1.306378,36.7519845,523,1625,6,927
4516,27680,1245,3,Business,11,1,47963,11,1,48019,11,1,49794,11,1,50685,11,1,54361,19,28.8,-1.300921,36.828195,-1.3198615,36.7110323,787,3676,56,2666
4517,4415,3291,3,Business,1,5,37714,1,5,37800,1,5,38111,1,5,38662,1,5,40494,6,28.7,-1.2600926,36.8088685,-1.2783849,36.8163445,434,1832,86,862
4518,10041,928,3,Business,30,2,54297,30,2,55055,30,2,55176,30,2,55765,30,2,56169,3,23.25888921888938,-1.2551895,36.7822034,-1.256522,36.7864132,16,404,758,710
4519,13137,2587,3,Business,17,5,47166,17,5,47179,17,5,47192,17,5,50383,17,5,51323,6,20.4,-1.2551895,36.7822034,-1.28878,36.8168312,213,940,13,3204
4520,19068,3217,3,Business,19,6,44022,19,6,44028,19,6,44195,19,6,44410,19,6,46893,5,21.8,-1.225322,36.80855,-1.214328,36.7911903,103,2483,6,382
4521,8169,3018,2,Personal,17,1,36073,17,1,36120,17,1,36658,17,1,42404,17,1,43760,7,24.8,-1.2913749,36.8012314,-1.2615983,36.8083096,785,1356,47,6284
4522,16921,909,3,Business,2,2,56838,2,2,57116,2,2,58263,2,2,58374,2,2,60086,14,29.4,-1.225322,36.80855,-1.304023,36.788389,205,1712,278,1258
4523,562,246,3,Business,24,1,47180,24,1,47291,24,1,47764,24,1,48085,24,1,49273,18,22.9,-1.2859912,36.8756811,-1.2584143,36.8048002,404,1188,111,794
4524,13984,2532,3,Business,14,3,53577,14,3,53780,14,3,55067,14,3,55130,14,3,56407,12,25.8,-1.2571472,36.7950633,-1.31553,36.863732,932,1277,203,1350
4525,21320,3647,3,Business,21,4,61209,21,4,61267,21,4,63241,21,4,63426,21,4,65460,10,28.5,-1.272639,36.794723,-1.315343,36.817992,269,2034,58,2159
4526,11190,3406,1,Personal,7,1,57370,7,1,57503,7,1,58739,7,1,59461,7,1,63369,8,20.3,-1.2798711,36.8207118,-1.3004945,36.7727891,56,3908,133,1958
4527,21686,427,3,Personal,18,1,51948,18,1,51981,18,1,51994,18,1,52572,18,1,53411,7,30.9,-1.300921,36.828195,-1.269534,36.80697,472,839,33,591
4528,22387,3689,3,Business,10,2,56133,10,2,58882,10,2,59707,10,2,60902,10,2,61268,5,20.8,-1.2527958,36.8003131,-1.2857548,36.819062,606,366,2749,2020
4529,870,3391,1,Personal,28,2,40663,28,2,40693,28,2,41288,28,2,41628,28,2,42994,10,17.8,-1.3223238,36.8320056,-1.3263415,36.7722827,726,1366,30,935
4530,694,3698,3,Business,13,4,49111,13,4,49557,13,4,51190,13,4,51261,13,4,53825,24,23.3,-1.3244885,36.897792,-1.3108386,36.7555239,218,2564,446,1704
4531,28014,720,3,Personal,28,2,40390,28,2,40425,28,2,40455,28,2,41224,28,2,46978,12,21.3,-1.2372042,36.7605743,-1.2979852,36.8069651,99,5754,35,799
4532,2565,1342,3,Business,17,2,59477,17,2,59495,17,2,59743,17,2,60264,17,2,63201,9,24.0,-1.3014461,36.7661381,-1.2571472,36.7950633,735,2937,18,769
4533,20940,2691,3,Business,10,4,43337,10,4,43342,10,4,43358,10,4,44081,10,4,47144,23,24.6,-1.2551895,36.7822034,-1.373915,36.923362,120,3063,5,739
4534,20588,1081,3,Business,5,2,52989,5,2,53276,5,2,54346,5,2,54865,5,2,56288,11,27.3,-1.2285835,36.8826468,-1.290894,36.822971,168,1423,287,1589
4535,9490,3201,3,Business,24,5,65830,24,5,65848,24,5,66450,24,5,66641,24,5,67145,1,23.25888921888938,-1.2527958,36.8003131,-1.264272,36.7978791,622,504,18,793
4536,19987,3565,3,Business,3,7,45488,3,7,45501,3,7,45510,3,7,45776,3,7,47965,21,28.0,-1.2844665,36.7866113,-1.391222,36.760676,379,2189,13,275
4537,18589,391,3,Business,17,5,43605,17,5,43925,17,5,47434,17,5,47532,17,5,53355,10,23.25888921888938,-1.2867454,36.8259017,-1.2293754,36.8624324,362,5823,320,3607
4538,7287,2311,3,Business,9,3,36190,9,3,39508,9,3,39745,9,3,39998,9,3,41228,6,21.3,-1.2844795,36.7817533,-1.3012902,36.80964,676,1230,3318,490
4539,3557,60,3,Business,16,3,41714,16,3,41868,16,3,42357,16,3,42843,16,3,44084,10,23.0,-1.2600926,36.8088685,-1.2296618,36.8438272,674,1241,154,975
4540,15589,3647,3,Business,22,3,42844,22,3,42917,22,3,43516,22,3,43680,22,3,44722,5,22.9,-1.265432,36.795034,-1.2828362,36.8189236,504,1042,73,763
4541,5505,3091,3,Business,17,3,54622,17,3,54698,17,3,57083,17,3,57164,17,3,60624,9,23.25888921888938,-1.3012008,36.764868,-1.290894,36.822971,92,3460,76,2466
4542,10521,1796,3,Business,25,4,41437,25,4,41452,25,4,41750,25,4,42346,25,4,43575,13,23.25888921888938,-1.2600926,36.8088685,-1.331619,36.847976,484,1229,15,894
4543,12395,1245,3,Business,2,2,33785,2,2,33914,2,2,33973,2,2,36705,2,2,38684,4,15.1,-1.300921,36.828195,-1.3173869,36.8112044,328,1979,129,2791
4544,21217,3491,3,Business,4,2,33408,4,2,36685,4,2,37295,4,2,37669,4,2,41758,11,15.8,-1.2781939,36.8191922,-1.2285835,36.8826468,235,4089,3277,984
4545,14825,909,3,Business,9,2,39683,9,2,39892,9,2,41007,9,2,41143,9,2,43818,10,27.2,-1.225322,36.80855,-1.2880129,36.8308097,660,2675,209,1251
4546,10195,1148,3,Business,4,2,44690,4,2,44710,4,2,45239,4,2,46295,4,2,47336,10,19.0,-1.3100586,36.8500329,-1.2676759,36.801804,116,1041,20,1585
4547,3681,2789,3,Business,26,2,49459,26,2,49798,26,2,50726,26,2,50972,26,2,53503,17,29.8,-1.3634667,36.7389097,-1.304735,36.7846054,227,2531,339,1174
4548,17039,2823,3,Business,16,3,36787,16,3,36826,16,3,37291,16,3,37719,16,3,39574,11,19.8,-1.2601709,36.8002238,-1.3018758,36.7590863,353,1855,39,893
4549,16276,2982,3,Business,29,6,40386,29,6,40476,29,6,43107,29,6,44429,29,6,46389,18,24.0,-1.300921,36.828195,-1.177202,36.8351183,404,1960,90,3953
4550,9321,2779,1,Personal,3,3,28814,3,3,28826,3,3,29759,3,3,29850,3,3,33918,24,18.3,-1.218376,36.8821822,-1.331936,36.8840499,260,4068,12,1024
4551,7145,1544,3,Business,24,5,48554,24,5,48806,24,5,49623,24,5,50334,24,5,55830,8,22.9,-1.2697054,36.8519724,-1.2603403,36.7998848,921,5496,252,1528
4552,5019,3291,3,Business,2,6,42627,2,6,42682,2,6,42973,2,6,45553,2,6,45556,4,27.5,-1.265715,36.823815,-1.2600926,36.8088685,472,3,55,2871
4553,26266,2521,3,Business,11,6,35265,11,6,35304,11,6,35661,11,6,36816,11,6,37729,14,23.25888921888938,-1.3167113,36.8301563,-1.2991441,36.7528804,843,913,39,1512
4554,21969,59,3,Business,11,1,49408,11,1,49420,11,1,50280,11,1,51285,11,1,53417,5,28.2,-1.290894,36.822971,-1.2664491,36.8102685,336,2132,12,1865
4555,16438,2513,3,Personal,23,3,50698,23,3,50724,23,3,51549,23,3,52218,23,3,53022,6,27.3,-1.2905048,36.8037419,-1.3102567,36.8377629,548,804,26,1494
4556,25223,2330,3,Business,25,1,56526,25,1,56546,25,1,56554,25,1,58058,25,1,58067,12,30.0,-1.2536275,36.7987932,-1.2524916,36.8656196,61,9,20,1512
4557,7587,1687,3,Business,26,5,52874,26,5,52907,26,5,53868,26,5,54217,26,5,54808,4,23.25888921888938,-1.2627937,36.8156957,-1.2732803,36.7940377,959,591,33,1310
4558,13370,2279,3,Business,17,4,48697,17,4,52994,17,4,55650,17,4,55717,17,4,57115,5,28.1,-1.2897368,36.8226783,-1.2962832,36.7849683,268,1398,4297,2723
4559,2080,111,3,Business,28,4,55324,28,4,60176,28,4,60379,28,4,60445,28,4,62068,8,28.1,-1.2551895,36.7822034,-1.2913205,36.8223569,448,1623,4852,269
4560,17967,190,3,Business,27,1,55943,27,1,56084,27,1,56412,27,1,57094,27,1,57859,5,23.0,-1.3270347,36.8667362,-1.3390024,36.8746657,218,765,141,1010
4561,9459,148,3,Business,6,2,34589,6,2,34868,6,2,35608,6,2,37085,6,2,37789,7,19.7,-1.2551895,36.7822034,-1.2927799,36.8250456,101,704,279,2217
4562,5541,867,3,Business,7,1,43349,7,1,43389,7,1,44102,7,1,44219,7,1,45728,14,24.9,-1.3077869,36.8443207,-1.2991441,36.7528804,555,1509,40,830
4563,19510,2834,3,Business,12,3,45589,12,3,45848,12,3,46362,12,3,46908,12,3,48946,6,19.4,-1.2584143,36.8048002,-1.290894,36.822971,42,2038,259,1060
4564,24353,3060,3,Business,2,2,61925,2,2,62010,2,2,62808,2,2,62953,2,2,63802,4,28.3,-1.2699491,36.8135968,-1.2534301,36.8000983,910,849,85,943
4565,19254,3217,1,Business,15,3,50245,15,3,50257,15,3,51128,15,3,51445,15,3,55150,20,21.7,-1.2143387,36.7914548,-1.2216291,36.9180415,916,3705,12,1188
4566,5951,1484,3,Business,4,1,36560,4,1,36604,4,1,38329,4,1,39276,4,1,40802,15,21.2,-1.2343236,36.8861,-1.2553615,36.7895376,467,1526,44,2672
4567,14657,2852,1,Personal,18,2,46994,18,2,47022,18,2,47224,18,2,47560,18,2,48089,3,22.9,-1.2571472,36.7950633,-1.2564152,36.7792803,881,529,28,538
4568,22403,2069,3,Business,20,2,56010,20,2,57227,20,2,57569,20,2,57931,20,2,59319,16,23.8,-1.2628473,36.781805,-1.228911,36.881876,620,1388,1217,704
4569,20388,2523,3,Business,14,1,38597,14,1,38608,14,1,39706,14,1,41452,14,1,41851,15,23.3,-1.2516167,36.8678844,-1.2729292,36.7679079,685,399,11,2844
4570,25709,2154,3,Business,30,6,47702,30,6,54380,30,6,54387,30,6,55554,30,6,55574,4,24.0,-1.2765736,36.8513646,-1.2813973,36.8289204,886,20,6678,1174
4571,8968,2561,3,Business,15,1,33943,15,1,34023,15,1,34390,15,1,35419,15,1,36419,6,20.7,-1.2551895,36.7822034,-1.2888261,36.8145446,161,1000,80,1396
4572,15066,3762,1,Personal,11,1,36615,11,1,36671,11,1,36700,11,1,37237,11,1,38338,9,14.7,-1.3028861,36.7943829,-1.263194,36.797624,56,1101,56,566
4573,4092,3257,1,Personal,4,4,42984,4,4,42994,4,4,43295,4,4,43679,4,4,44971,8,23.25888921888938,-1.2661959,36.807544,-1.3016653,36.8323628,247,1292,10,685
4574,9778,265,3,Business,4,5,53592,4,5,54341,4,5,56559,4,5,57473,4,5,61786,5,23.25888921888938,-1.300921,36.828195,-1.3049875,36.8633418,332,4313,749,3132
4575,14059,2985,2,Personal,27,1,46539,27,1,46549,27,1,46993,27,1,47410,27,1,48792,14,23.9,-1.312261,36.794658,-1.22966,36.84401,249,1382,10,861
4576,7548,2344,3,Business,18,3,33506,18,3,33533,18,3,33684,18,3,34336,18,3,34790,3,14.4,-1.2571472,36.7950633,-1.2551895,36.7822034,726,454,27,803
4577,7078,84,3,Business,28,4,35793,28,4,35828,28,4,35988,28,4,36275,28,4,41017,17,22.3,-1.2551895,36.7822034,-1.3472066,36.7692638,880,4742,35,447
4578,17161,633,3,Business,25,1,50629,25,1,50660,25,1,50812,25,1,53271,25,1,54746,10,27.9,-1.3004062,36.829741,-1.2991441,36.7528804,86,1475,31,2611
4579,16728,816,3,Business,13,1,36466,13,1,36522,13,1,37124,13,1,39891,13,1,43198,10,17.4,-1.290894,36.822971,-1.2413316,36.8785525,101,3307,56,3369
4580,8757,1271,3,Business,14,1,54983,14,1,57075,14,1,58204,14,1,58884,14,1,60860,19,25.8,-1.3244885,36.897792,-1.2649605,36.7981777,516,1976,2092,1809
4581,26932,1473,3,Business,14,1,56105,14,1,56480,14,1,56881,14,1,57211,14,1,58964,16,25.9,-1.3700383,36.9190174,-1.3044458,36.8233667,442,1753,375,731
4582,4091,238,3,Business,17,4,51815,17,4,51823,17,4,52207,17,4,52321,17,4,52781,3,27.9,-1.3077869,36.8443207,-1.3166812,36.8594608,858,460,8,498
4583,11184,1182,2,Personal,16,1,38880,16,1,39008,16,1,39873,16,1,40599,16,1,41619,9,19.1,-1.268662,36.8016018,-1.2367559,36.8082168,279,1020,128,1591
4584,9156,393,3,Business,7,4,38619,7,4,38642,7,4,38651,7,4,41407,7,4,41409,14,24.3,-1.3167113,36.8301563,-1.306378,36.7519845,239,2,23,2765
4585,7967,3647,3,Business,21,4,53032,21,4,53083,21,4,53738,21,4,54546,21,4,56296,21,26.4,-1.272639,36.794723,-1.3768823,36.7608932,446,1750,51,1463
4586,5981,3707,3,Personal,10,3,38842,10,3,38859,10,3,38894,10,3,39639,10,3,43417,18,27.9,-1.1708105,36.8336102,-1.2897399,36.8270975,564,3778,17,780
4587,27568,1544,3,Business,23,4,45183,23,4,46233,23,4,47151,23,4,47375,23,4,51456,4,23.4,-1.2869955,36.8202749,-1.273754,36.8005579,148,4081,1050,1142
4588,26954,621,1,Personal,5,5,58790,5,5,59401,5,5,60581,5,5,62282,5,5,63089,2,25.0,-1.3090663,36.8136865,-1.3114875,36.8200312,751,807,611,2881
4589,14370,868,3,Business,28,2,39279,28,2,39313,28,2,39560,28,2,40355,28,2,41121,5,21.4,-1.259478,36.8017813,-1.265715,36.823815,341,766,34,1042
4590,3053,700,3,Business,8,4,50124,8,4,53104,8,4,53558,8,4,54001,8,4,55542,7,27.1,-1.3134312,36.7220484,-1.3307406,36.7533,470,1541,2980,897
4591,8609,1244,3,Business,29,2,33400,29,2,33447,29,2,33585,29,2,35041,29,2,36210,9,18.5,-1.2600926,36.8088685,-1.303596,36.778378,178,1169,47,1594
4592,7208,928,3,Business,29,5,47723,29,5,47758,29,5,48105,29,5,48312,29,5,49936,9,26.9,-1.2551895,36.7822034,-1.2857671,36.7875614,291,1624,35,554
4593,11728,3517,3,Business,11,2,32217,11,2,32229,11,2,32601,11,2,34152,11,2,35562,15,18.4,-1.300921,36.828195,-1.3429554,36.7262559,674,1410,12,1923
4594,1754,710,1,Personal,13,1,55484,13,1,55516,13,1,56746,13,1,57951,13,1,58937,11,19.7,-1.2482781,36.884092,-1.2610837,36.8021315,144,986,32,2435
4595,16225,3283,3,Business,15,2,36554,15,2,36567,15,2,36814,15,2,37035,15,2,37769,6,20.5,-1.265715,36.823815,-1.2628473,36.781805,674,734,13,468
4596,27493,2212,3,Business,13,3,35828,13,3,35956,13,3,36946,13,3,38005,13,3,40176,8,24.6,-1.2830276,36.8297516,-1.2584143,36.8048002,548,2171,128,2049
4597,27354,1402,3,Business,4,2,38187,4,2,38245,4,2,39304,4,2,39463,4,2,40686,8,20.5,-1.2813012,36.8323962,-1.2551895,36.7822034,582,1223,58,1218
4598,19749,2207,3,Business,22,5,32782,22,5,32853,22,5,33300,22,5,33551,22,5,34492,7,22.4,-1.3012237,36.8261656,-1.2696908,36.81519,206,941,71,698
4599,11170,1469,3,Business,23,5,57547,23,5,60860,23,5,61638,23,5,61734,23,5,63667,8,24.8,-1.2551895,36.7822034,-1.3007818,36.8230554,206,1933,3313,874
4600,3967,517,3,Business,31,5,58863,31,5,59085,31,5,59092,31,5,60339,31,5,61207,4,23.5,-1.3228003,36.8306435,-1.3004062,36.829741,349,868,222,1254
4601,13160,1916,1,Personal,10,1,30590,10,1,30632,10,1,30945,10,1,35507,10,1,36323,4,17.9,-1.280465,36.820715,-1.2983805,36.8198439,88,816,42,4875
4602,3129,3718,3,Business,13,2,37752,13,2,38889,13,2,39795,13,2,40155,13,2,43809,5,22.2,-1.2650027,36.8126242,-1.2906618,36.8131222,589,3654,1137,1266
4603,22890,3177,3,Business,19,3,50987,19,3,51012,19,3,51525,19,3,52806,19,3,55453,18,24.2,-1.3253106,36.8903296,-1.301953,36.788458,457,2647,25,1794
4604,15391,3635,1,Business,8,6,59624,8,6,60099,8,6,60930,8,6,61425,8,6,61963,3,23.2,-1.2584143,36.8048002,-1.2615888,36.7928732,427,538,475,1326
4605,4186,391,3,Business,9,4,43085,9,4,45159,9,4,45864,9,4,47276,9,4,49055,5,23.25888921888938,-1.300921,36.828195,-1.2784063,36.8222933,92,1779,2074,2117
4606,26608,1958,3,Business,12,3,39010,12,3,39814,12,3,40156,12,3,40314,12,3,44025,23,19.2,-1.3700383,36.9190174,-1.2571472,36.7950633,488,3711,804,500
4607,19973,1642,3,Business,6,3,56843,6,3,56905,6,3,57783,6,3,58247,6,3,59141,4,23.25888921888938,-1.267568,36.812335,-1.274731,36.7949226,557,894,62,1342
4608,16119,3752,3,Business,22,3,41857,22,3,41948,22,3,43211,22,3,44909,22,3,45420,7,23.0,-1.3379799,36.8835453,-1.34364,36.8925345,168,511,91,2961
4609,17539,3661,3,Business,7,5,34337,7,5,34344,7,5,35540,7,5,35797,7,5,38096,19,20.6,-1.2134646,36.8755266,-1.3208162,36.8451209,685,2299,7,1453
4610,27509,1075,3,Business,28,4,38580,28,4,39035,28,4,40574,28,4,40953,28,4,44109,20,23.8,-1.3562374,36.9042954,-1.2527958,36.8003131,883,3156,455,1918
4611,18017,3443,3,Personal,19,4,55131,19,4,56201,19,4,58027,19,4,58331,19,4,60735,14,20.3,-1.318049,36.713231,-1.2875228,36.816768,79,2404,1070,2130
4612,11478,2195,3,Business,18,6,34962,18,6,34985,18,6,35374,18,6,36880,18,6,37845,9,23.25888921888938,-1.265715,36.823815,-1.228911,36.881876,309,965,23,1895
4613,19001,546,3,Personal,28,1,41125,28,1,41138,28,1,41651,28,1,42062,28,1,43874,7,22.5,-1.2656584,36.8096257,-1.237705,36.7663283,103,1812,13,924
4614,6431,346,3,Business,29,2,47584,29,2,47659,29,2,48058,29,2,48357,29,2,49456,7,21.6,-1.2885529,36.8160141,-1.2579304,36.8019667,726,1099,75,698
4615,25815,3264,3,Business,3,4,45092,3,4,45110,3,4,45129,3,4,45764,3,4,47787,20,23.6,-1.2551895,36.7822034,-1.330608,36.677485,450,2023,18,654
4616,24814,811,2,Personal,17,2,51433,17,2,51805,17,2,52644,17,2,52741,17,2,55197,8,24.5,-1.2963097,36.7688221,-1.2600616,36.7870182,848,2456,372,936
4617,26449,1961,3,Business,18,6,38749,18,6,38812,18,6,39669,18,6,39912,18,6,42128,18,21.1,-1.331619,36.847976,-1.3188359,36.7038526,205,2216,63,1100
4618,17664,3525,3,Business,8,1,36376,8,1,36423,8,1,38823,8,1,40233,8,1,42407,20,27.9,-1.3533402,36.9078924,-1.2571472,36.7950633,856,2174,47,3810
4619,13197,714,3,Business,5,2,52227,5,2,52325,5,2,54534,5,2,55213,5,2,55881,10,23.25888921888938,-1.2607331,36.7428881,-1.2628638,36.8070399,269,668,98,2888
4620,5253,3557,3,Business,22,1,32940,22,1,33005,22,1,33294,22,1,33860,22,1,34356,3,19.9,-1.2546732,36.8086796,-1.2665065,36.7970081,268,496,65,855
4621,13644,3326,3,Business,4,2,38967,4,2,39039,4,2,39478,4,2,40474,4,2,41315,7,20.5,-1.2571472,36.7950633,-1.2932015,36.8284918,921,841,72,1435
4622,6652,1271,3,Business,6,1,54505,6,1,54693,6,1,54698,6,1,57415,6,1,58750,13,24.4,-1.2927792,36.9053492,-1.3332749,36.8708147,589,1335,188,2722
4623,21838,2994,1,Personal,10,3,62653,10,3,63431,10,3,64163,10,3,64860,10,3,65357,2,23.0,-1.2860557,36.8232389,-1.2896659,36.8086426,148,497,778,1429
4624,599,3127,3,Business,4,2,35122,4,2,36735,4,2,38893,4,2,39124,4,2,41695,11,19.3,-1.2814031,36.8201647,-1.2388499,36.8727268,202,2571,1613,2389
4625,26763,1500,3,Business,14,2,35921,14,2,36015,14,2,36265,14,2,36340,14,2,39499,8,23.25888921888938,-1.3004062,36.829741,-1.2638185,36.7930057,298,3159,94,325
4626,3766,3295,3,Business,15,4,45252,15,4,45582,15,4,46132,15,4,46861,15,4,47962,7,24.6,-1.2571472,36.7950633,-1.2942081,36.7820227,72,1101,330,1279
4627,15771,3599,3,Business,22,3,41555,22,3,42135,22,3,43479,22,3,44485,22,3,46141,12,22.9,-1.3302996,36.8707935,-1.3251825,36.7897587,211,1656,580,2350
4628,18794,391,3,Business,20,3,41938,20,3,41952,20,3,42224,20,3,42821,20,3,43454,5,27.1,-1.2602337,36.7990548,-1.2784063,36.8222933,336,633,14,869
4629,25368,2235,3,Personal,25,5,37054,25,5,37060,25,5,37068,25,5,37520,25,5,39468,11,20.5,-1.2927792,36.9053492,-1.290894,36.822971,272,1948,6,460
4630,16189,517,3,Business,6,3,30271,6,3,30293,6,3,30299,6,3,32723,6,3,32726,14,23.25888921888938,-1.3228003,36.8306435,-1.306378,36.7519845,239,3,22,2430
4631,12915,3557,3,Business,14,4,29069,14,4,29466,14,4,30102,14,4,30366,14,4,32451,9,17.7,-1.2546732,36.8086796,-1.3141593,36.8101097,101,2085,397,900
4632,8792,2829,3,Business,12,5,48254,12,5,48292,12,5,48715,12,5,48972,12,5,51527,20,27.3,-1.2571472,36.7950633,-1.3632162,36.9108253,532,2555,38,680
4633,13975,2271,3,Business,30,2,42200,30,2,42619,30,2,43862,30,2,44231,30,2,46664,14,23.25888921888938,-1.293515,36.897607,-1.272828,36.816608,855,2433,419,1612
4634,23169,60,3,Business,16,6,40926,16,6,40989,16,6,42239,16,6,43158,16,6,43667,8,25.7,-1.272828,36.816608,-1.2296618,36.8438272,459,509,63,2169
4635,22346,3371,3,Personal,3,4,34699,3,4,35013,3,4,35825,3,4,37406,3,4,39791,17,17.4,-1.1971261,36.806307,-1.2988168,36.8198572,56,2385,314,2393
4636,18206,2993,2,Personal,15,6,55460,15,6,55476,15,6,56043,15,6,56862,15,6,57866,8,25.7,-1.2594656,36.8019631,-1.2946558,36.760775,148,1004,16,1386
4637,15451,2982,3,Business,5,3,43857,5,3,43864,5,3,43873,5,3,43944,5,3,46760,18,22.5,-1.177202,36.8351183,-1.300921,36.828195,340,2816,7,80
4638,21785,2532,3,Business,17,4,35928,17,4,36098,17,4,36673,17,4,36778,17,4,37891,8,23.25888921888938,-1.2551895,36.7822034,-1.294869,36.815327,131,1113,170,680
4639,7652,437,3,Business,5,1,52686,5,1,52972,5,1,53591,5,1,55329,5,1,56819,8,26.0,-1.2952784,36.7793271,-1.2551895,36.7822034,660,1490,286,2357
4640,13069,3560,3,Business,20,1,52210,20,1,52256,20,1,53115,20,1,53442,20,1,53897,2,23.25888921888938,-1.279395,36.825364,-1.290894,36.822971,622,455,46,1186
4641,16280,713,1,Personal,4,2,51480,4,2,51515,4,2,53112,4,2,53272,4,2,54052,4,20.4,-1.2868838,36.8284259,-1.2731102,36.8133041,531,780,35,1757
4642,2677,1755,3,Personal,12,4,64923,12,4,65014,12,4,65519,12,4,66416,12,4,67253,6,20.7,-1.2610959,36.8281022,-1.2963484,36.8072584,427,837,91,1402
4643,23157,2458,3,Business,15,3,54794,15,3,54831,15,3,55853,15,3,56057,15,3,58546,5,21.6,-1.2791312,36.8161129,-1.2857671,36.7875614,229,2489,37,1226
4644,13472,2330,3,Business,8,3,47458,8,3,47516,8,3,47976,8,3,50728,8,3,50740,3,23.25888921888938,-1.3015197,36.7658456,-1.294597,36.7742999,119,12,58,3212
4645,2047,2154,3,Business,14,1,56792,14,1,56822,14,1,56855,14,1,57922,14,1,59053,7,25.5,-1.2885529,36.8160141,-1.255956,36.789867,633,1131,30,1100
4646,18155,103,3,Business,26,5,65799,26,5,66900,26,5,69778,26,5,70008,26,5,72001,21,23.25888921888938,-1.1668055,36.8304448,-1.2844665,36.7866113,222,1993,1101,3108
4647,10637,2829,3,Business,26,1,42946,26,1,43052,26,1,43079,26,1,43432,26,1,44448,7,23.2,-1.2571472,36.7950633,-1.2857671,36.7875614,89,1016,106,380
4648,17516,2066,3,Business,27,5,31684,27,5,31710,27,5,32108,27,5,32963,27,5,35271,16,16.0,-1.316961,36.820337,-1.218673,36.8888713,951,2308,26,1253
4649,17037,269,3,Business,13,4,35883,13,4,35938,13,4,37327,13,4,37790,13,4,38922,9,18.0,-1.3226302,36.8719901,-1.3632162,36.9108253,48,1132,55,1852
4650,4472,2956,3,Business,4,2,55631,4,2,55671,4,2,56019,4,2,56188,4,2,56726,3,23.9,-1.2584143,36.8048002,-1.2551895,36.7822034,446,538,40,517
4651,11712,3283,3,Business,24,3,44942,24,3,45001,24,3,47741,24,3,48125,24,3,49340,8,19.7,-1.303596,36.778378,-1.2628473,36.781805,559,1215,59,3124
4652,12174,696,2,Personal,28,2,36213,28,2,36291,28,2,36913,28,2,37771,28,2,39227,9,15.9,-1.2858511,36.7946184,-1.321737,36.8179788,726,1456,78,1480
4653,25774,2330,3,Business,11,4,35759,11,4,36051,11,4,36886,11,4,37266,11,4,38341,6,22.1,-1.2642903,36.8002137,-1.2915247,36.8055757,576,1075,292,1215
4654,25253,1500,3,Business,10,4,41277,10,4,43185,10,4,44127,10,4,46881,10,4,48197,8,24.7,-1.3004062,36.829741,-1.2574219,36.7927073,436,1316,1908,3696
4655,18004,868,3,Business,22,6,52054,22,6,52104,22,6,52983,22,6,53535,22,6,54242,4,25.9,-1.2600926,36.8088685,-1.265715,36.823815,427,707,50,1431
4656,21232,3558,2,Personal,13,6,47082,13,6,47204,13,6,48310,13,6,49973,13,6,50674,4,28.2,-1.2856374,36.82289,-1.2912851,36.7972514,662,701,122,2769
4657,21507,53,3,Business,11,6,41175,11,6,41190,11,6,43305,11,6,46479,11,6,47815,8,23.25888921888938,-1.3167113,36.8301563,-1.2770708,36.8231093,155,1336,15,5289
4658,15637,324,3,Personal,18,1,48120,18,1,48131,18,1,48259,18,1,48353,18,1,50119,15,27.9,-1.2653676,36.7911012,-1.332942,36.714065,520,1766,11,222
4659,16674,3434,3,Business,6,1,33422,6,1,33529,6,1,33905,6,1,34402,6,1,35651,8,23.25888921888938,-1.2963097,36.7688221,-1.2813012,36.8323962,99,1249,107,873
4660,27932,10,2,Personal,21,4,38159,21,4,38576,21,4,39699,21,4,40832,21,4,41758,7,21.5,-1.2663778,36.8076024,-1.2930931,36.7559267,427,926,417,2256
4661,14347,2030,3,Business,18,5,43569,18,5,50938,18,5,51806,18,5,51977,18,5,52916,12,27.0,-1.1612808,36.9563278,-1.2156006,36.8916865,845,939,7369,1039
4662,5567,682,2,Personal,26,4,38336,26,4,38386,26,4,38813,26,4,39364,26,4,39984,5,18.8,-1.2947685,36.7785834,-1.2721028,36.7953485,140,620,50,978
4663,26572,1304,3,Business,3,3,58093,3,3,58109,3,3,58141,3,3,58469,3,3,61387,23,27.0,-1.2551895,36.7822034,-1.3440557,36.9099653,102,2918,16,360
4664,19656,2866,3,Business,14,3,52417,14,3,52465,14,3,53002,14,3,53224,14,3,55940,26,25.8,-1.2551895,36.7822034,-1.3916459,36.9305892,353,2716,48,759
4665,12185,2804,3,Business,24,3,55691,24,3,55718,24,3,55972,24,3,56105,24,3,57878,12,23.25888921888938,-1.2551895,36.7822034,-1.3270716,36.8406371,349,1773,27,387
4666,757,391,3,Business,10,5,49955,10,5,50202,10,5,51024,10,5,52044,10,5,53518,5,23.25888921888938,-1.300921,36.828195,-1.2867454,36.8259017,709,1474,247,1842
4667,2972,346,3,Business,12,3,55174,12,3,56541,12,3,57145,12,3,58151,12,3,58718,1,20.8,-1.28878,36.8168312,-1.2795827,36.8197262,272,567,1367,1610
4668,25992,3644,1,Personal,13,5,42122,13,5,42146,13,5,42209,13,5,43151,13,5,44673,5,23.25888921888938,-1.3205507,36.8426247,-1.317411,36.818222,546,1522,24,1005
4669,3800,1886,2,Personal,13,5,63722,13,5,63766,13,5,63815,13,5,64534,13,5,65081,4,19.0,-1.2248308,36.8012573,-1.214328,36.7911903,735,547,44,768
4670,26617,3599,3,Business,10,5,35162,10,5,35246,10,5,37394,10,5,38038,10,5,38998,7,23.25888921888938,-1.3302996,36.8707935,-1.3270347,36.8667362,787,960,84,2792
4671,1719,393,3,Business,28,4,30320,28,4,30336,28,4,30343,28,4,32411,28,4,32413,11,22.5,-1.3167113,36.8301563,-1.2638185,36.7930057,619,2,16,2075
4672,25019,198,3,Business,9,4,55027,9,4,55129,9,4,56481,9,4,56685,9,4,58376,17,25.7,-1.3396256,36.8863135,-1.2682179,36.8009289,207,1691,102,1556
4673,27260,3108,3,Business,22,5,41114,22,5,41178,22,5,41194,22,5,41629,22,5,42787,7,23.25888921888938,-1.2551895,36.7822034,-1.2894795,36.7818534,518,1158,64,451
4674,26448,3019,2,Personal,3,3,43761,3,3,43793,3,3,44091,3,3,44406,3,3,46044,12,23.9,-1.265715,36.808525,-1.3255681,36.8738816,882,1638,32,613
4675,15317,3615,1,Personal,18,3,54578,18,3,54660,18,3,55253,18,3,55354,18,3,57843,16,20.9,-1.2853755,36.8133883,-1.2705913,36.9103344,456,2489,82,694
4676,10105,2817,1,Personal,25,1,36090,25,1,36128,25,1,36184,25,1,36915,25,1,37794,7,15.2,-1.264788,36.7883897,-1.2941557,36.7792012,379,879,38,787
4677,23386,3688,3,Business,9,2,43293,9,2,43298,9,2,43391,9,2,44748,9,2,45666,10,27.0,-1.2551895,36.7822034,-1.3050379,36.7943452,438,918,5,1450
4678,8444,3647,3,Business,2,5,55061,2,5,55253,2,5,55681,2,5,55903,2,5,56731,4,25.3,-1.272639,36.794723,-1.272484,36.815382,726,828,192,650
4679,4906,633,3,Business,4,1,34999,4,1,35020,4,1,35223,4,1,35493,4,1,36429,9,21.7,-1.2638185,36.7930057,-1.3004062,36.829741,154,936,21,473
4680,18490,1471,3,Business,18,4,47618,18,4,47688,18,4,48438,18,4,48996,18,4,49666,7,23.25888921888938,-1.2853222,36.7767778,-1.2551895,36.7822034,96,670,70,1308
4681,5979,3444,1,Personal,28,2,53774,28,2,53801,28,2,54411,28,2,55364,28,2,57640,14,19.6,-1.263419,36.8060348,-1.2884487,36.8912556,86,2276,27,1563
4682,2887,3686,3,Business,18,4,35823,18,4,35846,18,4,35860,18,4,36184,18,4,37276,8,23.25888921888938,-1.2551895,36.7822034,-1.29752,36.7938083,576,1092,23,338
4683,13161,2956,3,Business,21,2,46732,21,2,46800,21,2,46867,21,2,47443,21,2,48051,2,22.4,-1.2551895,36.7822034,-1.2584143,36.8048002,520,608,68,643
4684,15378,772,3,Business,22,4,48772,22,4,49063,22,4,49697,22,4,50409,22,4,52475,14,26.4,-1.2844665,36.7866113,-1.2580531,36.8654628,882,2066,291,1346
4685,18546,3599,3,Business,28,4,36107,28,4,36128,28,4,37511,28,4,38515,28,4,40103,11,23.8,-1.3302996,36.8707935,-1.3329032,36.7888802,675,1588,21,2387
4686,3445,296,3,Business,23,3,30157,23,3,30172,23,3,30447,23,3,31169,23,3,33059,17,23.25888921888938,-1.305459,36.8918707,-1.2571472,36.7950633,620,1890,15,997
4687,21998,3701,3,Business,16,2,36566,16,2,36595,16,2,37114,16,2,37400,16,2,37678,2,23.25888921888938,-1.2612574,36.7879622,-1.2635744,36.781677,161,278,29,805
4688,21973,3149,3,Business,28,2,54263,28,2,54289,28,2,55168,28,2,56098,28,2,56744,6,19.6,-1.3004062,36.829741,-1.3177547,36.8303703,87,646,26,1809
4689,17666,2330,3,Business,25,5,54376,25,5,54402,25,5,55471,25,5,55557,25,5,57337,7,29.4,-1.2915247,36.8055757,-1.2642903,36.8002137,332,1780,26,1155
4690,27758,1335,3,Personal,12,3,49338,12,3,49363,12,3,49394,12,3,49808,12,3,50756,5,26.3,-1.2611987,36.8060913,-1.2613573,36.83402,726,948,25,445
4691,1205,867,3,Business,12,2,50976,12,2,51013,12,2,51895,12,2,52156,12,2,53372,10,27.2,-1.2991441,36.7528804,-1.2638185,36.7930057,24,1216,37,1143
4692,20319,2383,3,Business,20,2,31427,20,2,34854,20,2,36198,20,2,36713,20,2,37886,5,19.2,-1.2855666,36.8194926,-1.2608993,36.799246,290,1173,3427,1859
4693,2823,1496,1,Personal,17,3,45711,17,3,46175,17,3,46993,17,3,47854,17,3,48997,12,25.2,-1.207546,36.7913976,-1.2655306,36.828148,623,1143,464,1679
4694,5659,1874,3,Business,8,5,56700,8,5,58103,8,5,58662,8,5,59038,8,5,62318,16,30.3,-1.2571472,36.7950633,-1.3214765,36.7125341,519,3280,1403,935
4695,5080,2330,3,Business,26,2,67037,26,2,67149,26,2,67728,26,2,68109,26,2,68743,8,29.7,-1.3270197,36.7037303,-1.3015197,36.7658456,628,634,112,960
4696,10685,1075,3,Business,20,6,44648,20,6,44710,20,6,45234,20,6,46103,20,6,47301,13,23.25888921888938,-1.2285835,36.8826468,-1.2527958,36.8003131,8,1198,62,1393
4697,27222,12,3,Business,28,4,50179,28,4,51148,28,4,52471,28,4,52767,28,4,54046,12,23.25888921888938,-1.240021,36.84999,-1.3031315,36.8175661,851,1279,969,1619
4698,14879,432,3,Business,21,2,57937,21,2,58036,21,2,58735,21,2,59363,21,2,61058,12,25.0,-1.3012008,36.764868,-1.2765736,36.8513646,124,1695,99,1327
4699,16164,393,3,Business,14,1,41378,14,1,41396,14,1,41521,14,1,41747,14,1,42181,4,23.5,-1.3167113,36.8301563,-1.3004062,36.829741,523,434,18,351
4700,16621,311,3,Business,11,1,53591,11,1,54692,11,1,55742,11,1,56796,11,1,58146,21,27.9,-1.3700383,36.9190174,-1.2917868,36.7872675,874,1350,1101,2104
4701,12255,3149,3,Business,31,5,56700,31,5,57481,31,5,58353,31,5,59029,31,5,60096,6,24.7,-1.3083266,36.8494756,-1.3228003,36.8306435,178,1067,781,1548
4702,10486,136,3,Business,25,1,56733,25,1,56746,25,1,57285,25,1,57718,25,1,59577,18,28.0,-1.2874648,36.8271985,-1.3254522,36.7216584,785,1859,13,972
4703,10543,1665,1,Personal,21,4,50192,21,4,50246,21,4,51955,21,4,52786,21,4,54931,16,22.4,-1.3207708,36.8685919,-1.2862269,36.7841601,844,2145,54,2540
4704,22495,235,3,Personal,29,2,26682,29,2,26754,29,2,28765,29,2,29202,29,2,32400,16,18.2,-1.2643343,36.7447423,-1.3173869,36.8112044,936,3198,72,2448
4705,27818,640,3,Business,21,2,47444,21,2,47456,21,2,47853,21,2,47954,21,2,50540,12,22.6,-1.2969741,36.7856612,-1.2546502,36.7828633,958,2586,12,498
4706,21988,1384,3,Business,27,3,52113,27,3,52160,27,3,52700,27,3,53023,27,3,54946,19,29.5,-1.2517448,36.7924971,-1.2352916,36.9162792,125,1923,47,863
4707,11978,393,3,Business,13,4,40332,13,4,40343,13,4,40350,13,4,40953,13,4,43370,11,21.8,-1.3167113,36.8301563,-1.2574219,36.7927073,39,2417,11,610
4708,11476,136,3,Business,10,3,32300,10,3,32790,10,3,34851,10,3,35032,10,3,37361,21,21.7,-1.3254522,36.7216584,-1.2549476,36.8269576,855,2329,490,2242
4709,23190,661,3,Business,7,3,71248,7,3,71280,7,3,71811,7,3,72068,7,3,73080,3,21.2,-1.2976559,36.7914147,-1.2963097,36.7688221,130,1012,32,788
4710,26265,928,3,Business,23,1,47738,23,1,47755,23,1,48223,23,1,48902,23,1,51244,12,23.25888921888938,-1.2551895,36.7822034,-1.312734,36.855414,519,2342,17,1147
4711,6957,393,3,Business,24,3,36819,24,3,42519,24,3,42629,24,3,44511,24,3,45610,10,19.9,-1.3177547,36.8303703,-1.2574219,36.7927073,731,1099,5700,1992
4712,12373,3339,3,Business,8,1,52388,8,1,52421,8,1,52504,8,1,53345,8,1,54568,14,25.1,-1.2551895,36.7822034,-1.2297202,36.8819507,100,1223,33,924
4713,23779,475,3,Business,10,4,50509,10,4,50530,10,4,50645,10,4,51043,10,4,52285,12,25.1,-1.2551895,36.7822034,-1.2416156,36.8736721,958,1242,21,513
4714,25579,2330,3,Business,10,1,47688,10,1,47817,10,1,48650,10,1,49068,10,1,50303,9,18.5,-1.3015197,36.7658456,-1.2645318,36.7981775,778,1235,129,1251
4715,8839,346,3,Business,13,4,40302,13,4,40325,13,4,40737,13,4,40865,13,4,41404,1,22.1,-1.28878,36.8168312,-1.2857548,36.819062,831,539,23,540
4716,3883,265,3,Business,16,5,52098,16,5,56905,16,5,57146,16,5,58274,16,5,59109,7,23.25888921888938,-1.2668734,36.8054026,-1.300921,36.828195,539,835,4807,1369
4717,25545,3326,3,Business,7,4,50665,7,4,50683,7,4,50873,7,4,51355,7,4,53279,15,31.0,-1.2551895,36.7822034,-1.3288106,36.8697344,291,1924,18,672
4718,13236,3291,3,Business,30,5,53219,30,5,53279,30,5,53726,30,5,53959,30,5,54340,2,24.8,-1.2673935,36.8030328,-1.2600926,36.8088685,913,381,60,680
4719,1913,798,3,Business,26,3,36883,26,3,36951,26,3,37347,26,3,38217,26,3,40700,11,24.2,-1.304033,36.7848695,-1.258348,36.8449018,100,2483,68,1266
4720,7605,2174,3,Business,8,3,40118,8,3,40124,8,3,40131,8,3,41872,8,3,42539,5,22.1,-1.2482781,36.884092,-1.2297202,36.8819507,946,667,6,1748
4721,8342,970,3,Business,28,5,55700,28,5,56098,28,5,56533,28,5,57999,28,5,59871,8,25.6,-1.2958383,36.8073162,-1.2551895,36.7822034,713,1872,398,1901
4722,4335,3641,3,Business,14,4,33883,14,4,36630,14,4,36674,14,4,36791,14,4,38535,9,18.0,-1.2551895,36.7822034,-1.303105,36.819135,660,1744,2747,161
4723,632,3557,3,Business,8,1,61380,8,1,61410,8,1,61701,8,1,61859,8,1,62156,2,28.9,-1.2495931,36.8065087,-1.2546732,36.8086796,383,297,30,449
4724,19953,2974,3,Business,24,4,45767,24,4,45869,24,4,48621,24,4,48898,24,4,51444,4,22.9,-1.2987748,36.8024593,-1.287428,36.7800821,752,2546,102,3029
4725,17329,1027,3,Personal,11,4,42501,11,4,45879,11,4,46766,11,4,46927,11,4,47844,5,25.6,-1.2728425,36.791039,-1.2797536,36.8223726,576,917,3378,1048
4726,22522,391,3,Business,24,3,53983,24,3,60497,24,3,60523,24,3,61292,24,3,62556,5,18.4,-1.300921,36.828195,-1.2784063,36.8222933,878,1264,6514,795
4727,20434,1578,3,Business,16,2,47230,16,2,47243,16,2,48184,16,2,48416,16,2,49798,5,23.7,-1.2765736,36.8513646,-1.28878,36.8168312,263,1382,13,1173
4728,16949,1705,3,Business,7,3,39012,7,3,41154,7,3,41402,7,3,41607,7,3,42347,6,25.2,-1.2551895,36.7822034,-1.2884799,36.8217918,88,740,2142,453
4729,21653,1500,3,Business,15,1,54068,15,1,54106,15,1,54494,15,1,54662,15,1,56421,11,23.25888921888938,-1.3077869,36.8443207,-1.2638185,36.7930057,796,1759,38,556
4730,25945,2523,3,Business,6,3,53547,6,3,53816,6,3,56861,6,3,57309,6,3,59987,8,23.25888921888938,-1.2551895,36.7822034,-1.295156,36.8094306,106,2678,269,3493
4731,12414,3283,3,Business,16,3,52589,16,3,52630,16,3,55175,16,3,55778,16,3,56339,6,27.1,-1.272828,36.816608,-1.2628473,36.781805,52,561,41,3148
4732,18479,3688,3,Business,30,3,37762,30,3,37886,30,3,37987,30,3,38682,30,3,39782,9,25.0,-1.2551895,36.7822034,-1.2917868,36.7872675,124,1100,124,796
4733,14044,1500,3,Business,26,5,52303,26,5,52341,26,5,52697,26,5,53451,26,5,54774,9,23.25888921888938,-1.2638185,36.7930057,-1.3004062,36.829741,193,1323,38,1110
4734,4997,3404,3,Business,7,4,50933,7,4,51569,7,4,53318,7,4,53752,7,4,55571,8,27.6,-1.279395,36.825364,-1.2765492,36.7669809,778,1819,636,2183
4735,17489,640,3,Business,21,2,37365,21,2,37478,21,2,39518,21,2,39939,21,2,41680,7,22.5,-1.2969741,36.7856612,-1.2821883,36.8269611,831,1741,113,2461
4736,14313,1078,3,Business,21,5,47670,21,5,48643,21,5,48646,21,5,49652,21,5,50436,9,24.5,-1.2793911,36.8304379,-1.2482465,36.8889062,813,784,973,1009
4737,24146,2436,3,Business,30,5,48963,30,5,49210,30,5,50291,30,5,54817,30,5,55908,10,24.7,-1.2551895,36.7822034,-1.2295205,36.8120426,928,1091,247,5607
4738,17813,136,3,Business,12,2,55569,12,2,55668,12,2,56496,12,2,57190,12,2,59296,18,23.25888921888938,-1.2908945,36.8246514,-1.3254522,36.7216584,365,2106,99,1522
4739,4943,186,3,Business,18,5,58710,18,5,58848,18,5,60017,18,5,60255,18,5,60865,4,25.7,-1.2571472,36.7950633,-1.2825816,36.8092346,263,610,138,1407
4740,1773,2216,3,Business,2,5,31722,2,5,31788,2,5,33678,2,5,34131,2,5,35725,3,18.2,-1.2551895,36.7822034,-1.2654348,36.8022464,395,1594,66,2343
4741,21381,1995,3,Business,15,4,43514,15,4,46592,15,4,47499,15,4,47679,15,4,48904,7,24.3,-1.2551895,36.7822034,-1.291829,36.829358,928,1225,3078,1087
4742,24915,2866,3,Business,8,4,31731,8,4,31753,8,4,31760,8,4,37734,8,4,40587,28,20.7,-1.2551895,36.7822034,-1.162368,36.9107603,227,2853,22,5981
4743,19557,2956,3,Business,3,5,44956,3,5,45006,3,5,45834,3,5,45984,3,5,47567,9,21.4,-1.3014461,36.7661381,-1.2584143,36.8048002,140,1583,50,978
4744,4038,393,3,Business,23,3,45364,23,3,45413,23,3,45798,23,3,48693,23,3,50699,14,23.25888921888938,-1.3167113,36.8301563,-1.306378,36.7519845,555,2006,49,3280
4745,25696,1995,3,Business,2,4,60527,2,4,60544,2,4,60560,2,4,61302,2,4,62008,3,23.25888921888938,-1.2551895,36.7822034,-1.2677278,36.8001549,695,706,17,758
4746,25318,2523,3,Business,21,4,59505,21,4,59540,21,4,59909,21,4,60212,21,4,61953,9,28.7,-1.2551895,36.7822034,-1.3074264,36.8226123,26,1741,35,672
4747,20157,788,3,Business,23,5,28691,23,5,28713,23,5,30053,23,5,30999,23,5,32119,12,20.1,-1.225322,36.80855,-1.2494503,36.8531852,101,1120,22,2286
4748,19524,1484,3,Business,14,4,51607,14,4,51734,14,4,52597,14,4,52797,14,4,53561,10,27.8,-1.2551895,36.7822034,-1.2579051,36.7263638,709,764,127,1063
4749,22551,1845,3,Business,25,4,44021,25,4,44028,25,4,44067,25,4,44724,25,4,46581,21,20.0,-1.2917868,36.7872675,-1.3705766,36.9120742,231,1857,7,696
4750,27230,302,3,Business,10,7,54555,10,7,54664,10,7,56018,10,7,56180,10,7,57881,8,29.1,-1.2649605,36.7981777,-1.3064585,36.8119065,459,1701,109,1516
4751,14390,1091,1,Personal,30,3,28846,30,3,29267,30,3,31163,30,3,31535,30,3,32775,6,17.4,-1.2764786,36.8194788,-1.2994217,36.8009779,208,1240,421,2268
4752,25795,2715,3,Personal,3,5,51403,3,5,51555,3,5,52469,3,5,52988,3,5,54532,9,25.0,-1.2951189,36.7699791,-1.312406,36.827447,548,1544,152,1433
4753,11310,391,3,Business,28,4,35398,28,4,35451,28,4,35473,28,4,37558,28,4,38153,17,22.7,-1.2867454,36.8259017,-1.3518598,36.7324661,137,595,53,2107
4754,14273,391,3,Business,17,5,57048,17,5,58129,17,5,58753,17,5,59941,17,5,59971,5,23.25888921888938,-1.300921,36.828195,-1.2867454,36.8259017,855,30,1081,1812
4755,8554,2982,3,Business,30,3,55415,30,3,55453,30,3,57201,30,3,57675,30,3,61335,18,29.0,-1.300921,36.828195,-1.177202,36.8351183,519,3660,38,2222
4756,24317,3331,3,Business,4,2,46327,4,2,48073,4,2,48530,4,2,48669,4,2,50002,8,19.5,-1.2551895,36.7822034,-1.2876155,36.7868444,338,1333,1746,596
4757,10875,3653,2,Personal,17,5,41149,17,5,41183,17,5,42111,17,5,42437,17,5,43636,6,17.6,-1.2724556,36.7931938,-1.2934657,36.8212737,552,1199,34,1254
4758,18618,53,3,Business,18,1,37011,18,1,37081,18,1,37525,18,1,38108,18,1,39640,11,27.9,-1.2991441,36.7528804,-1.2770708,36.8231093,156,1532,70,1027
4759,27579,1081,3,Business,15,5,41738,15,5,41772,15,5,42144,15,5,42672,15,5,44225,11,26.2,-1.2551895,36.7822034,-1.3034451,36.7523126,250,1553,34,900
4760,4341,3050,3,Business,12,5,45021,12,5,45048,12,5,46011,12,5,46270,12,5,48343,17,24.5,-1.2830989,36.8165739,-1.3398006,36.717935,731,2073,27,1222
4761,13368,2200,3,Business,5,6,43845,5,6,43890,5,6,44386,5,6,44507,5,6,46336,3,22.4,-1.3052491,36.8223899,-1.290894,36.822971,26,1829,45,617
4762,6685,868,3,Business,16,2,41003,16,2,43745,16,2,44872,16,2,45828,16,2,46549,9,23.25888921888938,-1.2296618,36.8438272,-1.265715,36.823815,291,721,2742,2083
4763,5609,393,3,Business,29,1,47869,29,1,47995,29,1,48501,29,1,48967,29,1,49594,4,23.25888921888938,-1.3167113,36.8301563,-1.3004062,36.829741,570,627,126,972
4764,27304,1307,3,Business,29,5,56081,29,5,56132,29,5,56671,29,5,57670,29,5,59908,16,21.3,-1.2994935,36.8908744,-1.2844665,36.7866113,618,2238,51,1538
4765,14375,3420,3,Business,9,2,33713,9,2,33731,9,2,34035,9,2,34177,9,2,35222,6,20.7,-1.3046007,36.8211743,-1.265981,36.7936121,487,1045,18,446
4766,4196,3674,3,Business,21,4,45282,21,4,45386,21,4,45843,21,4,46122,21,4,47617,12,25.4,-1.2551895,36.7822034,-1.3224102,36.8307207,188,1495,104,736
4767,3877,967,3,Personal,26,2,55208,26,2,55248,26,2,56255,26,2,56584,26,2,58207,8,29.5,-1.2795261,36.8260185,-1.3193416,36.7930605,341,1623,40,1336
4768,11622,3331,3,Business,25,5,46394,25,5,46419,25,5,46549,25,5,46718,25,5,47588,9,26.4,-1.2551895,36.7822034,-1.2786703,36.826044,512,870,25,299
4769,16147,19,1,Personal,16,7,38403,16,7,40329,16,7,43943,16,7,45550,16,7,47417,12,25.1,-1.3056547,36.8189009,-1.2975623,36.9025949,101,1867,1926,5221
4770,5386,1271,3,Business,15,2,35104,15,2,35117,15,2,35535,15,2,36311,15,2,38432,25,20.5,-1.3108386,36.7555239,-1.3244885,36.897792,493,2121,13,1194
4771,9057,503,3,Business,7,4,39064,7,4,39435,7,4,40521,7,4,41439,7,4,43667,15,17.1,-1.2859912,36.8756811,-1.2940713,36.7890758,100,2228,371,2004
4772,15785,722,3,Business,5,2,61068,5,2,61356,5,2,61406,5,2,63708,5,2,66492,20,23.25888921888938,-1.32943,36.894243,-1.2492395,36.7986032,404,2784,288,2352
4773,19655,1706,2,Personal,19,3,58302,19,3,58377,19,3,58726,19,3,59556,19,3,60044,2,23.2,-1.3018873,36.7766167,-1.2908158,36.7784546,312,488,75,1179
4774,15213,3186,3,Business,15,2,38957,15,2,39018,15,2,39154,15,2,40144,15,2,41123,7,24.3,-1.2753109,36.8130185,-1.2980229,36.78865,379,979,61,1126
4775,22167,868,3,Business,6,6,46094,6,6,46124,6,6,46398,6,6,46735,6,6,47605,7,26.9,-1.2628473,36.781805,-1.265715,36.823815,690,870,30,611
4776,26001,3222,3,Business,19,2,35841,19,2,35860,19,2,36660,19,2,36886,19,2,38380,4,23.25888921888938,-1.2551895,36.7822034,-1.2695287,36.7981777,259,1494,19,1026
4777,1105,633,3,Business,15,2,49202,15,2,49383,15,2,49928,15,2,50035,15,2,50892,5,24.7,-1.2770708,36.8231093,-1.3004062,36.829741,576,857,181,652
4778,1950,2532,3,Business,12,5,37411,12,5,37444,12,5,37717,12,5,38055,12,5,39552,4,26.3,-1.2551895,36.7822034,-1.273792,36.806401,958,1497,33,611
4779,5442,2069,3,Business,28,4,50151,28,4,50222,28,4,50755,28,4,51380,28,4,52486,12,30.1,-1.2600926,36.8088685,-1.228911,36.881876,101,1106,71,1158
4780,21000,567,3,Business,21,5,42617,21,5,44097,21,5,45786,21,5,47496,21,5,47618,5,22.6,-1.2745551,36.7979797,-1.2795796,36.819062,72,122,1480,3399
4781,15091,567,3,Business,17,1,56173,17,1,56206,17,1,56523,17,1,57431,17,1,57793,2,28.1,-1.2954956,36.7603858,-1.2963097,36.7688221,65,362,33,1225
4782,7067,649,1,Business,22,2,41080,22,2,42536,22,2,42957,22,2,45098,22,2,47637,9,19.2,-1.3034396,36.8329998,-1.2626906,36.7827022,892,2539,1456,2562
4783,1092,2066,3,Business,5,3,44447,5,3,46095,5,3,46637,5,3,47555,5,3,48098,4,22.2,-1.316961,36.820337,-1.2990238,36.7984903,754,543,1648,1460
4784,6528,631,1,Personal,18,5,46527,18,5,46563,18,5,47183,18,5,47396,18,5,49993,20,21.2,-1.2124619,36.8739332,-1.2954745,36.7841149,148,2597,36,833
4785,4767,552,3,Business,28,5,49822,28,5,50753,28,5,52677,28,5,53829,28,5,55774,23,25.4,-1.3472066,36.7692638,-1.335477,36.9308297,764,1945,931,3076
4786,8637,3613,3,Business,25,1,46436,25,1,46509,25,1,46550,25,1,47237,25,1,48135,4,27.0,-1.2733622,36.7704045,-1.287332,36.744498,460,898,73,728
4787,25824,1561,3,Business,29,2,41971,29,2,41979,29,2,43517,29,2,43909,29,2,46747,14,21.4,-1.328259,36.860975,-1.2615584,36.8149506,543,2838,8,1930
4788,2816,3718,3,Business,6,4,41998,6,4,43628,6,4,43928,6,4,45181,6,4,47538,6,24.2,-1.3002801,36.8140096,-1.2650027,36.8126242,19,2357,1630,1553
4789,10864,633,3,Business,9,3,54243,9,3,54266,9,3,54272,9,3,54502,9,3,55354,5,25.2,-1.3004062,36.829741,-1.2770708,36.8231093,555,852,23,236
4790,25053,3283,3,Business,30,6,41157,30,6,42027,30,6,42724,30,6,43331,30,6,44068,6,26.8,-1.272828,36.816608,-1.2628473,36.781805,372,737,870,1304
4791,13172,1280,3,Business,30,2,36722,30,2,36741,30,2,36993,30,2,37313,30,2,38585,8,23.25888921888938,-1.2551895,36.7822034,-1.2949439,36.7604214,291,1272,19,572
4792,28228,2468,3,Business,23,3,32800,23,3,32812,23,3,35855,23,3,36385,23,3,38668,15,23.25888921888938,-1.2519268,36.6953142,-1.2857671,36.7875614,64,2283,12,3573
4793,16650,136,3,Business,12,5,40811,12,5,40840,12,5,47214,12,5,47287,12,5,49695,30,26.7,-1.3094447,36.9107706,-1.3254522,36.7216584,448,2408,29,6447
4794,22452,820,1,Personal,11,5,45208,11,5,45365,11,5,46523,11,5,46990,11,5,47777,5,20.5,-1.2890399,36.8164942,-1.2630828,36.8050538,742,787,157,1625
4795,17143,982,3,Business,1,1,47595,1,1,48581,1,1,50583,1,1,51633,1,1,55432,49,23.25888921888938,-1.2517871,36.6795716,-1.4136642,36.957045,756,3799,986,3052
4796,22989,2956,3,Business,6,4,49720,6,4,49765,6,4,49787,6,4,50571,6,4,51778,10,23.2,-1.2584143,36.8048002,-1.3134514,36.8446293,179,1207,45,806
4797,19157,375,3,Business,6,1,54006,6,1,54049,6,1,54345,6,1,54629,6,1,56150,8,24.6,-1.2551895,36.7822034,-1.2939132,36.8081606,726,1521,43,580
4798,10565,2096,1,Personal,27,4,40810,27,4,40818,27,4,41035,27,4,42046,27,4,44601,20,22.8,-1.2139708,36.882646,-1.2965,36.7721234,704,2555,8,1228
4799,3084,1527,3,Business,10,1,38759,10,1,38817,10,1,39998,10,1,41110,10,1,43266,16,18.5,-1.2991441,36.7528804,-1.3004062,36.829741,643,2156,58,2293
4800,10776,1075,3,Business,9,4,42044,9,4,42147,9,4,42671,9,4,42896,9,4,45898,18,23.25888921888938,-1.2860183,36.8975338,-1.2527958,36.8003131,48,3002,103,749
4801,9308,2271,3,Business,11,1,44249,11,1,44284,11,1,46853,11,1,48490,11,1,50513,20,26.7,-1.2628473,36.781805,-1.293515,36.897607,326,2023,35,4206
4802,17604,2801,3,Business,25,1,50577,25,1,50600,25,1,51180,25,1,51523,25,1,52878,16,27.8,-1.3104506,36.8687235,-1.2595422,36.7871178,466,1355,23,923
4803,5815,1469,3,Business,10,3,59017,10,3,59126,10,3,59131,10,3,61497,10,3,61880,8,27.5,-1.2551895,36.7822034,-1.3004062,36.829741,291,383,109,2371
4804,15784,2330,3,Business,16,3,38939,16,3,38990,16,3,39085,16,3,39498,16,3,40378,6,22.9,-1.2921463,36.8029626,-1.3015197,36.7658456,85,880,51,508
4805,14933,59,3,Business,13,2,41645,13,2,42321,13,2,42490,13,2,43453,13,2,45719,7,22.5,-1.290894,36.822971,-1.2551895,36.7822034,360,2266,676,1132
4806,15128,1724,3,Business,9,2,37510,9,2,37519,9,2,37616,9,2,38129,9,2,40557,15,27.1,-1.2551895,36.7822034,-1.3205111,36.7801016,831,2428,9,610
4807,14155,1502,3,Business,7,7,40767,7,7,40786,7,7,42369,7,7,42490,7,7,43595,5,25.3,-1.2283403,36.8822756,-1.2232123,36.8932547,435,1105,19,1704
4808,10837,1032,1,Personal,17,2,60205,17,2,60229,17,2,60946,17,2,61395,17,2,62446,7,24.2,-1.2914795,36.8248973,-1.2969741,36.7856612,281,1051,24,1166
4809,10372,1500,3,Business,8,5,37244,8,5,37664,8,5,37833,8,5,38034,8,5,39289,9,28.3,-1.2638185,36.7930057,-1.3004062,36.829741,332,1255,420,370
4810,10880,2330,3,Business,12,2,63387,12,2,63484,12,2,65943,12,2,66115,12,2,67430,9,26.5,-1.2326041,36.8009029,-1.2637057,36.80517,755,1315,97,2631
4811,23051,393,3,Business,8,5,50998,8,5,51025,8,5,51112,8,5,53505,8,5,53506,11,27.0,-1.3167113,36.8301563,-1.2638185,36.7930057,619,1,27,2480
4812,7569,496,3,Business,1,1,52874,1,1,52989,1,1,53627,1,1,54087,1,1,54928,7,23.25888921888938,-1.2551895,36.7822034,-1.2802803,36.8271747,903,841,115,1098
4813,15657,1873,3,Business,9,3,54125,9,3,54135,9,3,54150,9,3,54863,9,3,57873,23,25.2,-1.3700383,36.9190174,-1.2571472,36.7950633,456,3010,10,728
4814,51,412,3,Business,31,4,52145,31,4,56660,31,4,56879,31,4,58258,31,4,59542,12,28.9,-1.228911,36.881876,-1.266837,36.799249,75,1284,4515,1598
4815,9546,2523,3,Business,29,1,50390,29,1,50466,29,1,50794,29,1,51040,29,1,52435,7,23.25888921888938,-1.2551895,36.7822034,-1.2972835,36.809687,161,1395,76,574
4816,28173,552,3,Business,12,3,40926,12,3,41346,12,3,41884,12,3,42025,12,3,43591,18,19.2,-1.279395,36.825364,-1.3562374,36.9042954,403,1566,420,679
4817,19637,3432,3,Business,12,6,41181,12,6,41212,12,6,42342,12,6,42836,12,6,45471,13,23.25888921888938,-1.260812,36.807545,-1.308862,36.880646,498,2635,31,1624
4818,2428,1346,3,Business,18,4,49900,18,4,49943,18,4,50948,18,4,51108,18,4,53529,20,23.25888921888938,-1.2917868,36.7872675,-1.3700383,36.9190174,710,2421,43,1165
4819,16187,3264,3,Business,1,1,31796,1,1,31823,1,1,32520,1,1,32660,1,1,34018,9,18.5,-1.2551895,36.7822034,-1.3088824,36.8311983,38,1358,27,837
4820,356,517,3,Business,6,3,36614,6,3,36628,6,3,36638,6,3,37170,6,3,39034,14,23.25888921888938,-1.3167113,36.8301563,-1.2991441,36.7528804,809,1864,14,542
4821,7921,2066,3,Business,8,6,38204,8,6,39375,8,6,41369,8,6,41774,8,6,43492,17,18.2,-1.3210189,36.8410551,-1.2826972,36.9702813,48,1718,1171,2399
4822,24358,2066,3,Business,2,5,61290,2,5,61494,2,5,62051,2,5,62160,2,5,63093,4,24.0,-1.316961,36.820337,-1.297451,36.8210544,932,933,204,666
4823,26982,1329,3,Business,8,5,70970,8,5,71115,8,5,71601,8,5,71949,8,5,72969,3,21.8,-1.273056,36.811298,-1.2766169,36.791816,427,1020,145,834
4824,22740,618,1,Personal,15,1,34016,15,1,34142,15,1,34878,15,1,35058,15,1,35858,5,23.25888921888938,-1.2767423,36.8200767,-1.3008433,36.8036256,88,800,126,916
4825,7500,169,1,Personal,8,1,34936,8,1,35812,8,1,36091,8,1,36296,8,1,36996,7,19.8,-1.3100609,36.8205365,-1.2658315,36.809049,88,700,876,484
4826,5843,3218,3,Business,14,4,37957,14,4,41042,14,4,41461,14,4,41833,14,4,42860,4,19.2,-1.290894,36.822971,-1.2765736,36.8513646,444,1027,3085,791
4827,2562,3669,3,Business,17,4,39159,17,4,39222,17,4,39636,17,4,40821,17,4,40822,3,25.2,-1.25373,36.78793,-1.2615888,36.7928732,903,1,63,1599
4828,11363,1797,3,Personal,4,4,31909,4,4,31995,4,4,33196,4,4,33908,4,4,36142,3,21.6,-1.2933789,36.8087535,-1.2962967,36.8020231,61,2234,86,1913
4829,14125,2200,3,Business,18,4,51042,18,4,53751,18,4,53763,18,4,55386,18,4,58020,11,26.9,-1.3472066,36.7692638,-1.290894,36.822971,669,2634,2709,1635
4830,6212,2605,3,Business,9,3,56343,9,3,56833,9,3,57621,9,3,57772,9,3,60564,22,23.5,-1.255956,36.789867,-1.3562374,36.9042954,742,2792,490,939
4831,25051,393,3,Business,14,5,41243,14,5,42243,14,5,42824,14,5,43602,14,5,45288,10,24.6,-1.3177547,36.8303703,-1.2574219,36.7927073,188,1686,1000,1359
4832,5295,60,3,Business,2,4,34765,2,4,34833,2,4,35107,2,4,36226,2,4,37150,8,23.25888921888938,-1.272828,36.816608,-1.2296618,36.8438272,461,924,68,1393
4833,24858,3674,3,Business,10,3,39475,10,3,39493,10,3,39593,10,3,40158,10,3,41065,8,27.9,-1.2551895,36.7822034,-1.295156,36.8094306,291,907,18,665
4834,11453,2676,3,Business,29,2,41595,29,2,41634,29,2,43075,29,2,45064,29,2,45579,2,21.5,-1.304033,36.7848695,-1.2963097,36.7688221,890,515,39,3430
4835,7612,1281,3,Business,22,4,48870,22,4,49247,22,4,51564,22,4,51769,22,4,52656,8,26.2,-1.2599502,36.79978,-1.2675334,36.7658246,685,887,377,2522
4836,2469,1502,3,Business,3,6,57109,3,6,57392,3,6,58450,3,6,58813,3,6,59534,4,22.1,-1.2283403,36.8822756,-1.2232123,36.8932547,420,721,283,1421
4837,23821,142,3,Business,29,2,48550,29,2,48897,29,2,49423,29,2,49691,29,2,50866,8,26.8,-1.2963097,36.7688221,-1.2570328,36.7869744,56,1175,347,794
4838,10750,2532,3,Business,16,4,34534,16,4,34560,16,4,34601,16,4,35991,16,4,38378,8,23.25888921888938,-1.2551895,36.7822034,-1.3024794,36.8228284,926,2387,26,1431
4839,7026,2200,3,Business,20,3,43633,20,3,43653,20,3,44095,20,3,45192,20,3,46071,7,27.0,-1.290894,36.822971,-1.2612974,36.7993448,785,879,20,1539
4840,10810,3211,3,Personal,22,3,33671,22,3,33695,22,3,34128,22,3,34612,22,3,36245,14,15.3,-1.2783772,36.8201617,-1.2098918,36.7918529,414,1633,24,917
4841,23621,634,1,Personal,30,1,61962,30,1,61977,30,1,62373,30,1,63128,30,1,63156,3,16.0,-1.2861765,36.8209086,-1.2651643,36.8072214,857,28,15,1151
4842,18246,1823,2,Personal,15,2,63444,15,2,63458,15,2,63824,15,2,64533,15,2,65378,3,23.7,-1.2563646,36.793149,-1.2613999,36.7882056,467,845,14,1075
4843,17728,2423,3,Business,26,2,46161,26,2,46177,26,2,46186,26,2,47187,26,2,47711,4,26.0,-1.2571472,36.7950633,-1.2763916,36.8246826,576,524,16,1010
4844,5022,1471,3,Business,21,4,51091,21,4,51355,21,4,52113,21,4,52671,21,4,53602,8,26.1,-1.2551895,36.7822034,-1.3021707,36.8168444,336,931,264,1316
4845,6284,1118,1,Personal,26,2,42642,26,2,42704,26,2,43465,26,2,44606,26,2,46361,9,23.25888921888938,-1.3005044,36.7871991,-1.3226567,36.8221416,101,1755,62,1902
4846,8509,778,3,Business,20,1,35918,20,1,36151,20,1,36939,20,1,37373,20,1,38647,7,14.4,-1.2535486,36.7933541,-1.2655712,36.7685117,882,1274,233,1222
4847,3454,1683,3,Business,27,6,59161,27,6,59211,27,6,59674,27,6,60506,27,6,62623,14,23.25888921888938,-1.2765334,36.8015051,-1.2133243,36.7958543,148,2117,50,1295
4848,17317,1796,3,Business,28,4,32682,28,4,32752,28,4,33896,28,4,34633,28,4,36711,11,19.5,-1.272828,36.816608,-1.331619,36.847976,907,2078,70,1881
4849,8256,3674,3,Business,20,4,39400,20,4,39489,20,4,39852,20,4,40195,20,4,42413,15,22.3,-1.2551895,36.7822034,-1.3323107,36.8692616,205,2218,89,706
4850,11112,2412,3,Business,28,4,63196,28,4,64942,28,4,66089,28,4,66941,28,4,68281,5,23.25888921888938,-1.2156006,36.8916865,-1.2297202,36.8745508,808,1340,1746,1999
4851,10211,3517,3,Business,25,1,42720,25,1,42732,25,1,45015,25,1,45415,25,1,46867,15,27.3,-1.300921,36.828195,-1.3882008,36.7699445,715,1452,12,2683
4852,5855,323,3,Business,8,4,48508,8,4,49540,8,4,51621,8,4,51703,8,4,54008,17,27.2,-1.2869733,36.8220901,-1.3632162,36.9108253,74,2305,1032,2163
4853,1990,478,3,Business,3,5,46767,3,5,46802,3,5,49083,3,5,49849,3,5,53007,8,23.25888921888938,-1.2854174,36.7951152,-1.2551895,36.7822034,92,3158,35,3047
4854,11733,3686,3,Business,2,2,34927,2,2,34969,2,2,35745,2,2,36001,2,2,37536,10,20.5,-1.2551895,36.7822034,-1.3018312,36.7817497,167,1535,42,1032
4855,18533,1469,3,Business,19,4,48896,19,4,48911,19,4,49531,19,4,49726,19,4,52175,7,20.4,-1.2551895,36.7822034,-1.282451,36.8097806,465,2449,15,815
4856,20596,393,3,Business,30,2,53381,30,2,53560,30,2,53577,30,2,54001,30,2,55208,11,23.25888921888938,-1.3167113,36.8301563,-1.2638185,36.7930057,438,1207,179,441
4857,7704,111,3,Business,18,2,35642,18,2,35677,18,2,35891,18,2,35953,18,2,36995,9,16.4,-1.2551895,36.7822034,-1.2785228,36.8274086,85,1042,35,276
4858,26770,3647,3,Business,27,2,50401,27,2,50589,27,2,51404,27,2,51629,27,2,52826,6,25.7,-1.272639,36.794723,-1.2828362,36.8189236,477,1197,188,1040
4859,4246,3283,3,Business,6,3,43025,6,3,43040,6,3,43108,6,3,43598,6,3,44442,7,23.25888921888938,-1.303596,36.778378,-1.2628473,36.781805,156,844,15,558
4860,24064,1874,3,Business,21,5,53842,21,5,53860,21,5,53900,21,5,54370,21,5,55342,3,27.1,-1.2571472,36.7950633,-1.26312,36.78347,167,972,18,510
4861,10736,1012,3,Personal,4,5,40359,4,5,40473,4,5,41901,4,5,42238,4,5,42993,6,17.1,-1.2750975,36.8289032,-1.3108783,36.8392726,72,755,114,1765
4862,17155,3291,3,Business,5,3,43649,5,3,43757,5,3,43993,5,3,44372,5,3,47951,12,22.2,-1.2600926,36.8088685,-1.228911,36.881876,4,3579,108,615
4863,7789,1419,3,Personal,14,4,53115,14,4,55413,14,4,55437,14,4,55891,14,4,60410,5,21.6,-1.2738167,36.8157821,-1.2811395,36.7897609,467,4519,2298,478
4864,6856,3470,3,Business,30,5,54077,30,5,54482,30,5,55088,30,5,55573,30,5,58418,5,24.8,-1.2584143,36.8048002,-1.28878,36.8168312,436,2845,405,1091
4865,7375,3017,3,Business,19,6,59322,19,6,59333,19,6,59974,19,6,60285,19,6,60735,3,21.7,-1.299313,36.7831488,-1.2930931,36.7559267,103,450,11,952
4866,1020,2200,3,Business,29,1,30335,29,1,32260,29,1,33278,29,1,33670,29,1,34780,4,19.2,-1.290894,36.822971,-1.3047026,36.8172033,171,1110,1925,1410
4867,5140,1934,2,Personal,14,2,54416,14,2,54446,14,2,57001,14,2,57123,14,2,59306,9,24.0,-1.304033,36.7848695,-1.3149338,36.7135703,334,2183,30,2677
4868,18980,419,3,Business,29,3,52528,29,3,52682,29,3,53165,29,3,53315,29,3,57580,20,21.3,-1.2571472,36.7950633,-1.3700383,36.9190174,911,4265,154,633
4869,5590,3669,3,Business,7,2,45146,7,2,45166,7,2,45565,7,2,46970,7,2,48479,17,23.25888921888938,-1.2615888,36.7928732,-1.2491258,36.6894253,690,1509,20,1804
4870,10944,3647,3,Business,19,3,34635,19,3,34715,19,3,35113,19,3,35346,19,3,37309,13,19.6,-1.272639,36.794723,-1.3216456,36.7145156,574,1963,80,631
4871,13018,640,3,Business,12,5,59745,12,5,59784,12,5,60612,12,5,60918,12,5,62281,6,25.9,-1.304033,36.7848695,-1.294766,36.8258957,208,1363,39,1134
4872,26275,1724,3,Business,20,3,60067,20,3,60238,20,3,62651,20,3,62969,20,3,65406,12,21.4,-1.2551895,36.7822034,-1.3200587,36.838058,498,2437,171,2731
4873,7365,3434,3,Business,8,5,46091,8,5,46186,8,5,47056,8,5,47151,8,5,52438,17,23.25888921888938,-1.2963097,36.7688221,-1.2482465,36.8889062,844,5287,95,965
4874,22524,1280,3,Business,8,5,39544,8,5,39593,8,5,39599,8,5,40247,8,5,45819,20,28.3,-1.2551895,36.7822034,-1.1914276,36.8954304,373,5572,49,654
4875,20651,3264,3,Business,17,3,59734,17,3,61508,17,3,62581,17,3,62695,17,3,63812,6,23.25888921888938,-1.2551895,36.7822034,-1.2882462,36.8164538,96,1117,1774,1187
4876,19913,2579,3,Business,7,3,43479,7,3,43731,7,3,44762,7,3,45086,7,3,46072,7,25.2,-1.287428,36.7800821,-1.2950041,36.8143583,509,986,252,1355
4877,312,1341,3,Business,9,4,59193,9,4,60780,9,4,61000,9,4,61470,9,4,63147,18,23.25888921888938,-1.228911,36.881876,-1.331619,36.847976,291,1677,1587,690
4878,18216,1138,1,Personal,11,2,53639,11,2,53660,11,2,53946,11,2,54173,11,2,55005,6,25.7,-1.3052672,36.7538539,-1.2925236,36.7795556,64,832,21,513
4879,4388,540,3,Business,3,3,33916,3,3,33946,3,3,34485,3,3,37781,3,3,38792,8,18.3,-1.2945684,36.8154093,-1.2551895,36.7822034,12,1011,30,3835
4880,22429,2370,2,Personal,26,6,41937,26,6,41984,26,6,43111,26,6,43781,26,6,49204,16,22.4,-1.3023387,36.9066847,-1.2840461,36.7934021,618,5423,47,1797
4881,15088,2237,3,Business,17,6,39706,17,6,39923,17,6,41555,17,6,42088,17,6,43541,15,24.0,-1.266571,36.801406,-1.2036664,36.8192622,19,1453,217,2165
4882,28077,59,3,Business,8,5,60917,8,5,61185,8,5,61394,8,5,62602,8,5,65992,6,25.4,-1.290894,36.822971,-1.3230781,36.8353276,513,3390,268,1417
4883,9817,2113,2,Personal,25,5,50874,25,5,51066,25,5,51726,25,5,52635,25,5,54308,8,23.3,-1.2738167,36.8157821,-1.275442,36.7660207,755,1673,192,1569
4884,6723,2423,3,Business,4,4,44159,4,4,44349,4,4,44748,4,4,46683,4,4,48995,7,25.4,-1.2551895,36.7822034,-1.2934657,36.8212737,507,2312,190,2334
4885,8033,2834,3,Business,12,3,40898,12,3,41318,12,3,42239,12,3,42467,12,3,42971,2,19.4,-1.279395,36.825364,-1.290894,36.822971,336,504,420,1149
4886,10998,1688,3,Business,1,4,58114,1,4,58175,1,4,59001,1,4,60030,1,4,63139,15,23.25888921888938,-1.300921,36.828195,-1.369541,36.907455,402,3109,61,1855
4887,18507,2383,3,Business,27,3,53822,27,3,53877,27,3,53943,27,3,54185,27,3,56110,14,28.9,-1.2608993,36.799246,-1.3176268,36.8741735,205,1925,55,308
4888,18140,1304,3,Business,19,3,50176,19,3,50196,19,3,52389,19,3,52496,19,3,54829,14,24.3,-1.2859912,36.8756811,-1.2287282,36.8115304,46,2333,20,2300
4889,23855,2154,3,Business,27,3,44825,27,3,44868,27,3,45641,27,3,46759,27,3,47289,5,26.3,-1.279395,36.825364,-1.2765736,36.8513646,336,530,43,1891
4890,17982,2335,3,Business,13,1,42367,13,1,42390,13,1,42533,13,1,43204,13,1,45223,22,23.25888921888938,-1.2551895,36.7822034,-1.3562374,36.9042954,161,2019,23,814
4891,22298,3222,3,Business,31,4,49786,31,4,49793,31,4,50471,31,4,50854,31,4,51612,1,29.0,-1.2551895,36.7822034,-1.2552271,36.7853553,361,758,7,1061
4892,26344,478,3,Business,22,3,37577,22,3,37670,22,3,38323,22,3,38412,22,3,39085,2,23.3,-1.2707177,36.8009828,-1.2571472,36.7950633,167,673,93,742
4893,1048,1850,3,Business,25,1,54831,25,1,54861,25,1,55377,25,1,56661,25,1,56817,4,28.0,-1.2551895,36.7822034,-1.269534,36.80697,778,156,30,1800
4894,21897,830,3,Business,25,2,47561,25,2,47576,25,2,49290,25,2,49476,25,2,50885,16,27.3,-1.2551895,36.7822034,-1.2156006,36.8916865,19,1409,15,1900
4895,10086,186,3,Business,7,1,53987,7,1,54072,7,1,54724,7,1,55079,7,1,55863,7,26.7,-1.2825816,36.8092346,-1.2571472,36.7950633,404,784,85,1007
4896,14833,393,3,Business,1,1,49305,1,1,49373,1,1,49377,1,1,51330,1,1,52666,10,25.5,-1.3177547,36.8303703,-1.2574219,36.7927073,555,1336,68,1957
4897,4098,2956,3,Business,13,3,37201,13,3,37231,13,3,38760,13,3,39488,13,3,41003,9,23.25888921888938,-1.3014461,36.7661381,-1.2584143,36.8048002,831,1515,30,2257
4898,8890,265,3,Business,18,5,57997,18,5,59668,18,5,60962,18,5,61088,18,5,62067,4,25.6,-1.2897399,36.8270975,-1.300921,36.828195,899,979,1671,1420
4899,12692,2931,3,Business,23,5,47093,23,5,47164,23,5,48013,23,5,48147,23,5,51058,8,24.2,-1.2452664,36.8028541,-1.2939816,36.8118469,829,2911,71,983
4900,21550,2063,3,Business,25,5,52569,25,5,52710,25,5,54517,25,5,57204,25,5,61056,18,29.3,-1.3289016,36.8765964,-1.2551895,36.7822034,697,3852,141,4494
4901,21680,391,3,Business,22,5,38951,22,5,39036,22,5,39080,22,5,41357,22,5,41990,7,28.3,-1.300921,36.828195,-1.2897109,36.8715037,595,633,85,2321
4902,5122,1061,1,Business,11,5,44936,11,5,45024,11,5,45904,11,5,46155,11,5,47128,9,20.9,-1.3001366,36.7678144,-1.255956,36.789867,865,973,88,1131
4903,9174,1402,3,Business,24,5,37889,24,5,41559,24,5,42317,24,5,43505,24,5,47830,16,21.3,-1.3562374,36.9042954,-1.2813012,36.8323962,418,4325,3670,1946
4904,25249,3517,3,Business,20,3,29858,20,3,31394,20,3,31743,20,3,31978,20,3,34119,14,23.25888921888938,-1.3198615,36.7110323,-1.3882008,36.7699445,824,2141,1536,584
4905,17890,2982,3,Business,18,5,58286,18,5,59310,18,5,61299,18,5,62162,18,5,64943,20,25.6,-1.177202,36.8351183,-1.2804349,36.7802593,75,2781,1024,2852
4906,5978,2982,3,Business,14,2,45455,14,2,46502,14,2,47327,14,2,47858,14,2,49722,18,23.25888921888938,-1.177202,36.8351183,-1.300921,36.828195,419,1864,1047,1356
4907,10385,248,3,Business,12,2,47426,12,2,47514,12,2,48028,12,2,48432,12,2,49088,3,24.3,-1.2857117,36.7968296,-1.304735,36.7846054,559,656,88,918
4908,14243,2763,3,Business,16,3,53179,16,3,53370,16,3,53406,16,3,54064,16,3,55053,10,27.2,-1.2571472,36.7950633,-1.3221935,36.8464972,31,989,191,694
4909,1538,393,3,Business,27,4,30148,27,4,30169,27,4,30176,27,4,32234,27,4,34158,14,18.9,-1.3177547,36.8303703,-1.306378,36.7519845,10,1924,21,2065
4910,14600,3496,3,Business,21,5,37188,21,5,37385,21,5,38392,21,5,38514,21,5,40561,7,22.7,-1.2599563,36.7993439,-1.300921,36.828195,728,2047,197,1129
4911,7720,1473,3,Business,11,4,35577,11,4,35603,11,4,36861,11,4,39345,11,4,40260,23,25.4,-1.3700383,36.9190174,-1.2551895,36.7822034,436,915,26,3742
4912,17547,1578,3,Business,8,4,58815,8,4,59494,8,4,60144,8,4,61050,8,4,61960,2,25.5,-1.290894,36.822971,-1.28878,36.8168312,879,910,679,1556
4913,3301,393,3,Business,19,3,32221,19,3,33202,19,3,33659,19,3,34188,19,3,37327,14,19.7,-1.3167113,36.8301563,-1.306378,36.7519845,188,3139,981,986
4914,16347,426,3,Business,5,2,39710,5,2,40791,5,2,41330,5,2,42303,5,2,43013,4,21.4,-1.3323107,36.8692616,-1.3321944,36.8892329,812,710,1081,1512
4915,11417,1363,3,Business,3,4,47363,3,4,47411,3,4,47416,3,4,47983,3,4,49635,12,23.4,-1.3004062,36.829741,-1.238874,36.807889,445,1652,48,572
4916,15222,809,1,Personal,16,4,28323,16,4,28341,16,4,28678,16,4,29313,16,4,29870,4,15.3,-1.2661264,36.8030359,-1.2815072,36.82096,857,557,18,972
4917,18284,3599,3,Business,25,2,47270,25,2,47377,25,2,47386,25,2,49927,25,2,51140,16,27.1,-1.3302996,36.8707935,-1.2706815,36.7646286,813,1213,107,2550
4918,18494,3621,3,Business,14,1,49542,14,1,49560,14,1,50152,14,1,50286,14,1,51602,8,25.8,-1.2836583,36.7886014,-1.2546732,36.7923244,382,1316,18,726
4919,19954,3599,3,Business,29,5,35669,29,5,36126,29,5,37330,29,5,39866,29,5,42121,15,26.6,-1.3302996,36.8707935,-1.2612532,36.7897977,654,2255,457,3740
4920,13182,3647,3,Business,25,1,42080,25,1,42135,25,1,44130,25,1,44395,25,1,45627,5,27.3,-1.272639,36.794723,-1.2935921,36.7876166,652,1232,55,2260
4921,27635,286,3,Business,1,6,38536,1,6,39515,1,6,42172,1,6,42385,1,6,46659,11,22.2,-1.2551895,36.7822034,-1.2827085,36.8495829,362,4274,979,2870
4922,23476,1705,3,Business,18,1,55141,18,1,55150,18,1,55616,18,1,55827,18,1,58987,28,30.6,-1.2551895,36.7822034,-1.1429062,36.9300994,452,3160,9,677
4923,24451,928,3,Business,15,1,45276,15,1,45334,15,1,45474,15,1,45862,15,1,47282,15,23.25888921888938,-1.2551895,36.7822034,-1.3319467,36.7766998,103,1420,58,528
4924,8438,3355,3,Business,8,2,58824,8,2,59380,8,2,60635,8,2,60854,8,2,61900,8,23.4,-1.3052491,36.8223899,-1.2615888,36.7928732,607,1046,556,1474
4925,25316,246,3,Business,26,5,61058,26,5,61076,26,5,61384,26,5,61600,26,5,63368,2,23.25888921888938,-1.2584143,36.8048002,-1.2617028,36.7983849,620,1768,18,524
4926,24584,867,3,Business,7,2,43545,7,2,44265,7,2,45324,7,2,45447,7,2,48547,11,23.25888921888938,-1.2770708,36.8231093,-1.2991441,36.7528804,469,3100,720,1182
4927,15081,2048,3,Personal,21,5,26818,21,5,26825,21,5,27634,21,5,27713,21,5,29816,18,19.8,-1.2850644,36.8343657,-1.2559914,36.689566,235,2103,7,888
4928,11180,1209,3,Business,7,2,60994,7,2,61002,7,2,61007,7,2,61525,7,2,61901,4,23.25888921888938,-1.3228003,36.8306435,-1.3004062,36.829741,411,376,8,523
4929,781,2978,3,Business,2,1,45600,2,1,45624,2,1,45693,2,1,46143,2,1,46526,4,19.2,-1.2551895,36.7822034,-1.2652108,36.8056075,101,383,24,519
4930,17687,1357,1,Personal,14,5,36221,14,5,36335,14,5,37154,14,5,37575,14,5,38441,5,18.2,-1.2663525,36.8128337,-1.2897215,36.7945959,858,866,114,1240
4931,6249,3060,3,Business,24,3,41293,24,3,41395,24,3,42708,24,3,45541,24,3,47695,5,23.25888921888938,-1.3024794,36.8228284,-1.2764099,36.8208451,155,2154,102,4146
4932,24819,1850,3,Business,9,4,32065,9,4,32455,9,4,33544,9,4,33721,9,4,34610,6,16.9,-1.2551895,36.7822034,-1.2802266,36.8164714,882,889,390,1266
4933,15969,2733,3,Business,16,4,39550,16,4,39552,16,4,39931,16,4,41407,16,4,42091,2,23.25888921888938,-1.3014461,36.7661381,-1.2963097,36.7688221,24,684,2,1855
4934,13029,1307,3,Business,3,7,42059,3,7,42067,3,7,42918,3,7,44358,3,7,46703,21,21.8,-1.2844665,36.7866113,-1.3681253,36.9155298,668,2345,8,2291
4935,19803,788,3,Business,20,3,44196,20,3,44284,20,3,45228,20,3,46873,20,3,49107,10,26.5,-1.279395,36.825364,-1.225322,36.80855,436,2234,88,2589
4936,8013,2423,3,Business,8,5,43473,8,5,43786,8,5,46816,8,5,47094,8,5,48518,9,28.6,-1.2551895,36.7822034,-1.294869,36.815327,785,1424,313,3308
4937,16022,2423,3,Business,12,2,33383,12,2,33393,12,2,33456,12,2,34013,12,2,34718,4,17.9,-1.2551895,36.7822034,-1.2753109,36.8130185,958,705,10,620
4938,1815,1161,1,Personal,1,5,65928,1,5,65950,1,5,66377,1,5,67104,1,5,68200,6,22.5,-1.2879041,36.8217926,-1.2705297,36.7987172,103,1096,22,1154
4939,2707,3560,3,Business,12,2,53608,12,2,54112,12,2,54825,12,2,57105,12,2,60565,5,23.25888921888938,-1.2571472,36.7950633,-1.279395,36.825364,763,3460,504,2993
4940,5067,1075,3,Business,7,2,49464,7,2,49503,7,2,49751,7,2,50144,7,2,51033,1,23.25888921888938,-1.2649605,36.7981777,-1.2527958,36.8003131,930,889,39,641
4941,5429,1335,3,Personal,25,5,55456,25,5,55489,25,5,55927,25,5,56188,25,5,57594,5,23.4,-1.2611987,36.8060913,-1.2536855,36.8245276,795,1406,33,699
4942,10371,391,3,Business,14,2,38046,14,2,39315,14,2,40198,14,2,40715,14,2,42120,15,23.25888921888938,-1.300921,36.828195,-1.2154586,36.8830064,411,1405,1269,1400
4943,20566,2230,1,Personal,30,4,37370,30,4,37627,30,4,37747,30,4,39567,30,4,40455,10,20.5,-1.2974472,36.8156997,-1.2450649,36.7869245,179,888,257,1940
4944,17243,2122,3,Business,18,1,37564,18,1,37717,18,1,39380,18,1,40089,18,1,42093,22,27.9,-1.207546,36.7913976,-1.2975066,36.7689423,764,2004,153,2372
4945,8253,1544,3,Business,30,4,52432,30,4,52885,30,4,55220,30,4,55379,30,4,58075,7,23.25888921888938,-1.2813012,36.8323962,-1.3197072,36.8160354,255,2696,453,2494
4946,3635,970,3,Business,24,4,40636,24,4,40666,24,4,41183,24,4,41513,24,4,43604,17,24.7,-1.2551895,36.7822034,-1.2977643,36.8844591,620,2091,30,847
4947,59,633,3,Business,14,4,44459,14,4,45233,14,4,46353,14,4,46580,14,4,47461,5,23.9,-1.2770708,36.8231093,-1.3004062,36.829741,339,881,774,1347
4948,17752,3283,3,Business,10,4,55840,10,4,55875,10,4,56137,10,4,56720,10,4,57528,6,25.4,-1.272828,36.816608,-1.2628473,36.781805,439,808,35,845
4949,734,3630,2,Personal,14,1,45126,14,1,45430,14,1,46523,14,1,47809,14,1,49779,17,22.8,-1.2141875,36.791039,-1.3038156,36.8122733,633,1970,304,2379
4950,9098,3283,3,Business,2,2,38742,2,2,39194,2,2,41088,2,2,41492,2,2,41897,4,26.4,-1.266837,36.799249,-1.2628473,36.781805,103,405,452,2298
4951,10525,3291,3,Business,14,4,48476,14,4,48564,14,4,50706,14,4,51067,14,4,51814,5,28.0,-1.2628473,36.781805,-1.2600926,36.8088685,228,747,88,2503
4952,5966,3295,3,Business,28,4,33145,28,4,33162,28,4,36793,28,4,37120,28,4,40418,20,22.7,-1.2571472,36.7950633,-1.3700383,36.9190174,295,3298,17,3958
4953,5756,830,3,Business,14,4,35589,14,4,35614,14,4,36095,14,4,36491,14,4,37704,7,18.8,-1.2904016,36.8226303,-1.2551895,36.7822034,571,1213,25,877
4954,19865,2174,3,Business,5,5,37686,5,5,37713,5,5,37717,5,5,41340,5,5,41350,16,24.6,-1.2482781,36.884092,-1.1668055,36.8304448,86,10,27,3627
4955,10822,265,3,Business,21,4,51636,21,4,51689,21,4,52736,21,4,57310,21,4,59084,12,26.5,-1.2414003,36.8094718,-1.300921,36.828195,952,1774,53,5621
4956,11362,2200,3,Business,30,4,39407,30,4,39437,30,4,40535,30,4,40826,30,4,43732,16,23.25888921888938,-1.2156006,36.8916865,-1.290894,36.822971,788,2906,30,1389
4957,28201,799,1,Personal,19,2,38514,19,2,39138,19,2,39483,19,2,40213,19,2,43212,6,23.25888921888938,-1.304033,36.7848695,-1.2795261,36.8260185,431,2999,624,1075
4958,551,1075,3,Business,9,4,41604,9,4,41625,9,4,41945,9,4,43691,9,4,45264,15,23.25888921888938,-1.2232123,36.8932547,-1.2527958,36.8003131,484,1573,21,2066
4959,14090,3283,3,Business,12,6,40201,12,6,40232,12,6,40801,12,6,41124,12,6,42471,7,23.25888921888938,-1.2783849,36.8163445,-1.2628473,36.781805,79,1347,31,892
4960,21399,3355,3,Business,16,3,36385,16,3,36413,16,3,36443,16,3,37112,16,3,38347,3,19.8,-1.3052491,36.8223899,-1.291829,36.829358,272,1235,28,699
4961,673,2330,3,Business,29,3,55767,29,3,55968,29,3,58608,29,3,58689,29,3,60605,4,21.2,-1.2642903,36.8002137,-1.2575407,36.7868197,582,1916,201,2721
4962,1377,238,3,Business,24,4,34470,24,4,34480,24,4,34482,24,4,39504,24,4,39977,5,24.7,-1.3004062,36.829741,-1.3077869,36.8443207,450,473,10,5024
4963,18460,3517,3,Business,31,3,53983,31,3,53998,31,3,54508,31,3,55145,31,3,58150,15,26.9,-1.300921,36.828195,-1.3882008,36.7699445,95,3005,15,1147
4964,15043,1500,3,Business,18,4,45479,18,4,45534,18,4,46407,18,4,47637,18,4,49244,11,23.25888921888938,-1.3077869,36.8443207,-1.2638185,36.7930057,349,1607,55,2103
4965,24078,1245,3,Business,6,3,56182,6,3,56222,6,3,57225,6,3,57687,6,3,60463,16,27.4,-1.2599563,36.7993439,-1.3198615,36.7110323,631,2776,40,1465
4966,5314,2216,3,Business,19,2,39056,19,2,39087,19,2,39671,19,2,40611,19,2,41071,1,26.8,-1.2551895,36.7822034,-1.2549259,36.7919494,557,460,31,1524
4967,1989,978,1,Personal,8,1,35729,8,1,35747,8,1,35753,8,1,36562,8,1,38145,13,19.6,-1.3084067,36.8345014,-1.3253106,36.8903296,595,1583,18,815
4968,20687,1260,3,Business,7,2,58258,7,2,58300,7,2,58579,7,2,59725,7,2,60531,6,23.0,-1.2890399,36.8164942,-1.2551895,36.7822034,107,806,42,1425
4969,21484,704,3,Business,14,5,35202,14,5,37881,14,5,38426,14,5,40934,14,5,43707,12,21.3,-1.290894,36.822971,-1.2860183,36.8975338,718,2773,2679,3053
4970,10004,1927,3,Business,30,4,61261,30,4,61724,30,4,62857,30,4,63218,30,4,65178,12,23.25888921888938,-1.2886923,36.8241519,-1.3472066,36.7692638,751,1960,463,1494
4971,22123,1032,1,Personal,24,2,57011,24,2,58226,24,2,59678,24,2,59755,24,2,61120,12,18.9,-1.2287314,36.8367354,-1.250142,36.788155,465,1365,1215,1529
4972,3041,3129,1,Personal,31,4,51879,31,4,51994,31,4,53693,31,4,53939,31,4,55348,8,23.1,-1.2930197,36.7904356,-1.2536042,36.8064895,103,1409,115,1945
4973,9692,633,3,Business,7,3,38342,7,3,38613,7,3,39546,7,3,42195,7,3,42595,4,25.1,-1.3177547,36.8303703,-1.3004062,36.829741,684,400,271,3582
4974,16190,1927,3,Business,17,1,53153,17,1,53976,17,1,54411,17,1,54853,17,1,56593,20,24.6,-1.3472066,36.7692638,-1.2413316,36.8785525,647,1740,823,877
4975,4284,830,3,Business,26,5,43138,26,5,51709,26,5,52987,26,5,53163,26,5,54529,8,23.25888921888938,-1.2551895,36.7822034,-1.2904016,36.8226303,253,1366,8571,1454
4976,6638,393,3,Business,1,1,45186,1,1,45252,1,1,46837,1,1,47031,1,1,49217,14,23.8,-1.3177547,36.8303703,-1.306378,36.7519845,743,2186,66,1779
4977,18176,1363,3,Business,18,4,30931,18,4,31889,18,4,33490,18,4,34240,18,4,35627,7,20.4,-1.2732317,36.7995587,-1.3004062,36.829741,646,1387,958,2351
4978,13894,1927,3,Business,20,3,31248,20,3,31266,20,3,34128,20,3,35742,20,3,36740,15,21.0,-1.3263105,36.8622904,-1.3472066,36.7692638,26,998,18,4476
4979,25275,517,3,Business,27,4,47938,27,4,47944,27,4,48123,27,4,48650,27,4,49472,11,22.9,-1.3167113,36.8301563,-1.2574219,36.7927073,523,822,6,706
4980,4658,1342,3,Business,21,4,48676,21,4,48832,21,4,48842,21,4,50123,21,4,52825,10,22.7,-1.2584143,36.8048002,-1.3025826,36.7670807,354,2702,156,1291
4981,24141,868,3,Business,16,3,46544,16,3,48984,16,3,50010,16,3,51060,16,3,52121,9,25.6,-1.303596,36.778378,-1.265715,36.823815,131,1061,2440,2076
4982,19042,2440,3,Personal,21,1,72271,21,1,73388,21,1,74789,21,1,75006,21,1,76638,12,18.5,-1.22589,36.7822548,-1.267689,36.7673638,144,1632,1117,1618
4983,1235,3704,3,Personal,14,4,33051,14,4,33105,14,4,34105,14,4,34264,14,4,34838,5,18.8,-1.2917868,36.7872675,-1.272704,36.7931279,798,574,54,1159
4984,15746,1972,3,Business,13,4,41702,13,4,41717,13,4,42410,13,4,42957,13,4,44969,8,22.2,-1.3142269,36.839245,-1.2620725,36.8026517,399,2012,15,1240
4985,14805,439,3,Business,22,2,51188,22,2,51226,22,2,52790,22,2,53311,22,2,55489,17,21.2,-1.3323107,36.8692616,-1.2636912,36.788437,661,2178,38,2085
4986,16780,2521,3,Business,1,1,48620,1,1,48686,1,1,49263,1,1,49951,1,1,50361,4,23.25888921888938,-1.3167113,36.8301563,-1.3004062,36.829741,507,410,66,1265
4987,17298,1500,3,Business,12,2,35096,12,2,35142,12,2,35146,12,2,36119,12,2,37176,8,17.8,-1.3004062,36.829741,-1.2638185,36.7930057,576,1057,46,977
4988,5206,490,3,Personal,25,3,39432,25,3,39437,25,3,39936,25,3,40331,25,3,41679,10,23.25888921888938,-1.2607156,36.8145367,-1.2793831,36.7617573,616,1348,5,894
4989,1180,849,1,Personal,9,2,44276,9,2,44420,9,2,47101,9,2,48305,9,2,50608,7,22.0,-1.2869664,36.7945296,-1.2652108,36.8056075,932,2303,144,3885
4990,13469,3435,3,Business,4,4,52786,4,4,53372,4,4,54352,4,4,54586,4,4,55796,7,27.2,-1.3008826,36.8378114,-1.2696341,36.8042045,907,1210,586,1214
4991,9765,2200,3,Business,11,6,46046,11,6,46128,11,6,46182,11,6,46987,11,6,49735,11,23.25888921888938,-1.2852569,36.8976121,-1.290894,36.822971,895,2748,82,859
4992,15460,718,3,Business,29,3,31543,29,3,31571,29,3,32025,29,3,32526,29,3,33565,7,17.8,-1.2551895,36.7822034,-1.2861454,36.8272514,491,1039,28,955
4993,2437,640,3,Business,17,3,37903,17,3,37926,17,3,38391,17,3,38675,17,3,39272,3,23.25888921888938,-1.2969741,36.7856612,-1.2945106,36.7728398,819,597,23,749
4994,17324,3283,3,Business,27,3,39909,27,3,39958,27,3,40073,27,3,40757,27,3,42045,7,25.9,-1.303596,36.778378,-1.2628473,36.781805,328,1288,49,799
4995,11593,533,3,Business,12,1,51515,12,1,55435,12,1,55499,12,1,56561,12,1,57229,6,26.7,-1.2765492,36.7669809,-1.2551895,36.7822034,45,668,3920,1126
4996,11489,1850,3,Business,17,3,55758,17,3,55768,17,3,55779,17,3,56459,17,3,56465,3,23.25888921888938,-1.2551895,36.7822034,-1.259919,36.808244,291,6,10,691
4997,10304,517,3,Business,19,2,28749,19,2,28760,19,2,28766,19,2,31508,19,2,31512,14,20.9,-1.3167113,36.8301563,-1.2991441,36.7528804,39,4,11,2748
4998,3117,3560,3,Business,29,1,47613,29,1,47972,29,1,48359,29,1,51244,29,1,51251,3,24.5,-1.3052491,36.8223899,-1.279395,36.825364,358,7,359,3272
4999,7339,60,3,Business,19,2,45044,19,2,45298,19,2,45402,19,2,48002,19,2,50656,10,26.5,-1.2600926,36.8088685,-1.2296618,36.8438272,206,2654,254,2704
5000,5073,2200,3,Business,25,4,58736,25,4,62173,25,4,62704,25,4,64276,25,4,66137,8,23.25888921888938,-1.3014461,36.7661381,-1.290894,36.822971,436,1861,3437,2103
5001,16569,972,3,Business,3,1,44896,3,1,44951,3,1,45304,3,1,47261,3,1,52477,15,20.7,-1.2862033,36.8152966,-1.3080998,36.6999638,272,5216,55,2310
5002,17965,2587,3,Business,5,5,60648,5,5,60668,5,5,61281,5,5,62789,5,5,64786,22,26.2,-1.28878,36.8168312,-1.3165542,36.700067,456,1997,20,2121
5003,20647,2483,1,Business,16,1,45206,16,1,45257,16,1,45372,16,1,46086,16,1,50035,12,19.4,-1.255956,36.789867,-1.2842685,36.7397756,536,3949,51,829
5004,23907,1502,3,Business,19,1,34397,19,1,34413,19,1,34493,19,1,34688,19,1,36795,13,19.4,-1.2232123,36.8932547,-1.2752846,36.8027022,447,2107,16,275
5005,13619,412,3,Business,20,3,53197,20,3,53249,20,3,53753,20,3,54204,20,3,55169,7,29.6,-1.303596,36.778378,-1.266837,36.799249,71,965,52,955
5006,18033,1246,3,Business,14,2,35976,14,2,35990,14,2,36526,14,2,36832,14,2,38047,8,15.7,-1.2571472,36.7950633,-1.2817557,36.7635561,452,1215,14,842
5007,19629,3517,3,Business,2,2,50827,2,2,50840,2,2,50842,2,2,53762,2,2,55621,15,29.4,-1.300921,36.828195,-1.3882008,36.7699445,595,1859,13,2922
5008,15465,267,3,Personal,11,2,41581,11,2,41591,11,2,41604,11,2,42223,11,2,44331,3,24.3,-1.2833106,36.8240238,-1.2985749,36.8088,338,2108,10,632
5009,24354,1148,3,Business,7,4,56088,7,4,56688,7,4,59129,7,4,60562,7,4,61422,3,29.4,-1.3100586,36.8500329,-1.3120712,36.8567865,787,860,600,3874
5010,24112,1584,3,Business,7,3,50677,7,3,50909,7,3,52312,7,3,55279,7,3,57360,7,28.4,-1.2842021,36.8281144,-1.304033,36.7848695,554,2081,232,4370
5011,14158,1133,3,Business,15,3,52494,15,3,52517,15,3,52872,15,3,52977,15,3,53521,3,25.7,-1.2681262,36.7882341,-1.2571472,36.7950633,520,544,23,460
5012,3853,1527,3,Business,17,5,56720,17,5,56792,17,5,58844,17,5,59138,17,5,60649,5,23.25888921888938,-1.2770708,36.8231093,-1.3004062,36.829741,291,1511,72,2346
5013,443,2857,3,Business,18,1,46395,18,1,46454,18,1,46899,18,1,47755,18,1,49150,7,23.25888921888938,-1.3034072,36.8218035,-1.2683619,36.8065993,949,1395,59,1301
5014,4573,295,3,Business,18,2,41788,18,2,49682,18,2,49688,18,2,50796,18,2,55770,8,25.5,-1.2967108,36.7871135,-1.2622851,36.7893989,942,4974,7894,1114
5015,26404,393,3,Business,24,3,37734,24,3,37779,24,3,37786,24,3,40059,24,3,40061,4,23.25888921888938,-1.3167113,36.8301563,-1.3004062,36.829741,515,2,45,2280
5016,12519,3222,3,Business,13,3,43900,13,3,43969,13,3,44461,13,3,44532,13,3,45741,6,23.25888921888938,-1.2551895,36.7822034,-1.2869955,36.8202749,764,1209,69,563
5017,24290,2008,3,Business,18,5,45307,18,5,45322,18,5,45450,18,5,46393,18,5,48595,17,20.2,-1.2508229,36.7895263,-1.2482377,36.6673782,882,2202,15,1071
5018,3151,3283,3,Business,11,2,48473,11,2,48545,11,2,49713,11,2,50341,11,2,51276,5,22.4,-1.2600926,36.8088685,-1.2628473,36.781805,38,935,72,1796
5019,66,393,3,Business,3,5,50379,3,5,50574,3,5,50577,3,5,53849,3,5,53851,11,23.25888921888938,-1.3167113,36.8301563,-1.2638185,36.7930057,619,2,195,3275
5020,6083,346,3,Business,22,5,42793,22,5,43183,22,5,44541,22,5,44815,22,5,47663,14,23.25888921888938,-1.2860183,36.8975338,-1.28878,36.8168312,569,2848,390,1632
5021,10955,2521,3,Business,26,6,36951,26,6,36960,26,6,36968,26,6,37342,26,6,37753,4,20.6,-1.3167113,36.8301563,-1.3004062,36.829741,523,411,9,382
5022,1408,706,3,Business,14,1,57574,14,1,57607,14,1,57945,14,1,58683,14,1,59104,3,25.6,-1.3077869,36.8443207,-1.3080092,36.8284543,781,421,33,1076
5023,12402,2939,2,Personal,25,5,59378,25,5,59562,25,5,61087,25,5,61561,25,5,63153,8,21.2,-1.2701869,36.7745681,-1.2764786,36.8194788,144,1592,184,1999
5024,2765,265,3,Business,7,2,57037,7,2,57117,7,2,57706,7,2,58748,7,2,59717,7,23.25888921888938,-1.2673786,36.8081593,-1.300921,36.828195,856,969,80,1631
5025,2868,1880,3,Business,26,4,47145,26,4,47157,26,4,47461,26,4,47784,26,4,50300,7,19.1,-1.2571472,36.7950633,-1.2768753,36.8303526,415,2516,12,627
5026,2261,970,3,Business,22,5,46172,22,5,46193,22,5,46506,22,5,47061,22,5,50093,19,23.25888921888938,-1.2571472,36.7950633,-1.3325582,36.7406697,798,3032,21,868
5027,8862,2801,3,Business,23,3,60305,23,3,60356,23,3,60818,23,3,60928,23,3,61617,5,24.3,-1.2637057,36.80517,-1.2595422,36.7871178,902,689,51,572
5028,2148,2613,1,Personal,5,5,32636,5,5,33157,5,5,33655,5,5,34074,5,5,35005,9,18.0,-1.306245,36.8192978,-1.2655306,36.828148,726,931,521,917
5029,4206,867,3,Business,3,3,51616,3,3,51924,3,3,52192,3,3,54647,3,3,56781,10,28.4,-1.3004062,36.829741,-1.2991441,36.7528804,686,2134,308,2723
5030,1045,265,3,Business,7,1,47212,7,1,47266,7,1,48189,7,1,48864,7,1,50824,15,20.4,-1.300921,36.828195,-1.2606477,36.7224694,654,1960,54,1598
5031,5927,1341,3,Business,20,1,48608,20,1,48791,20,1,49793,20,1,50326,20,1,52018,12,23.25888921888938,-1.293515,36.897607,-1.331619,36.847976,158,1692,183,1535
5032,5103,2894,3,Business,26,1,40522,26,1,40750,26,1,42878,26,1,43041,26,1,44588,13,23.0,-1.290641,36.812941,-1.2611078,36.750701,254,1547,228,2291
5033,15631,3635,1,Business,27,4,66580,27,4,66647,27,4,66653,27,4,69226,27,4,72340,23,23.0,-1.2615888,36.7928732,-1.2056712,36.9221784,813,3114,67,2579
5034,2606,1811,2,Personal,2,2,52305,2,2,52331,2,2,52503,2,2,53329,2,2,54252,8,26.3,-1.2854453,36.8188363,-1.2804664,36.7701111,906,923,26,998
5035,1461,704,1,Business,29,7,47630,29,7,47641,29,7,48348,29,7,49738,29,7,52775,17,23.5,-1.2649605,36.7981777,-1.2860183,36.8975338,648,3037,11,2097
5036,1345,1721,3,Business,25,5,50364,25,5,50403,25,5,51004,25,5,51359,25,5,52126,5,29.1,-1.3147074,36.811722,-1.2954581,36.810997,15,767,39,956
5037,12353,3080,3,Business,13,3,54043,13,3,54417,13,3,54526,13,3,54776,13,3,55669,4,27.2,-1.2551895,36.7822034,-1.2668454,36.7940642,436,893,374,359
5038,21542,2634,3,Business,29,1,55202,29,1,55217,29,1,55464,29,1,55777,29,1,57849,21,23.25888921888938,-1.3039411,36.7695316,-1.3160977,36.9131642,854,2072,15,560
5039,13546,1383,1,Personal,21,4,39517,21,4,40073,21,4,40739,21,4,41769,21,4,46787,20,21.5,-1.3015998,36.8764939,-1.2707742,36.7578609,101,5018,556,1696
5040,8791,2150,3,Business,3,5,51911,3,5,53549,3,5,54210,3,5,57614,3,5,58339,12,23.25888921888938,-1.331619,36.847976,-1.344446,36.756597,459,725,1638,4065
5041,24657,3560,3,Business,22,5,39704,22,5,39905,22,5,41002,22,5,41680,22,5,42629,1,28.7,-1.290894,36.822971,-1.279395,36.825364,119,949,201,1775
5042,27026,2442,2,Personal,20,3,47405,20,3,47445,20,3,47516,20,3,47975,20,3,49432,11,20.2,-1.2695287,36.7981777,-1.22589,36.7822548,379,1457,40,530
5043,6862,517,3,Business,28,5,41523,28,5,41542,28,5,41546,28,5,42464,28,5,43858,11,23.6,-1.3167113,36.8301563,-1.2574219,36.7927073,10,1394,19,922
5044,5169,2330,3,Business,11,2,57529,11,2,57950,11,2,58157,11,2,58683,11,2,60211,6,21.5,-1.2915247,36.8055757,-1.3015197,36.7658456,826,1528,421,733
5045,91,478,3,Business,9,2,33492,9,2,33532,9,2,33599,9,2,34304,9,2,37813,8,20.6,-1.2551895,36.7822034,-1.3045333,36.8228072,177,3509,40,772
5046,18875,2330,3,Business,27,1,64749,27,1,64796,27,1,65298,27,1,65526,27,1,66746,8,23.25888921888938,-1.2536275,36.7987932,-1.2336843,36.8007259,96,1220,47,730
5047,7748,3669,3,Business,10,5,54676,10,5,54775,10,5,56399,10,5,56832,10,5,59331,15,23.25888921888938,-1.2615888,36.7928732,-1.2396938,36.8938893,660,2499,99,2057
5048,13554,244,2,Personal,6,4,31751,6,4,32661,6,4,34025,6,4,34604,6,4,38037,28,17.7,-1.3191527,36.6758827,-1.3038645,36.8684596,844,3433,910,1943
5049,25416,3661,3,Business,9,3,34626,9,3,34636,9,3,35295,9,3,35369,9,3,37716,19,20.2,-1.2134646,36.8755266,-1.3208162,36.8451209,685,2347,10,733
5050,25753,1342,3,Business,4,2,64228,4,2,64276,4,2,64697,4,2,65186,4,2,67009,10,20.9,-1.2527958,36.8003131,-1.3025826,36.7670807,105,1823,48,910
5051,14425,552,3,Business,21,3,39731,21,3,39746,21,3,40652,21,3,40869,21,3,45974,22,22.0,-1.3472066,36.7692638,-1.3632162,36.9108253,533,5105,15,1123
5052,24399,1075,3,Business,11,1,40973,11,1,41015,11,1,41416,11,1,42020,11,1,42504,1,24.0,-1.2649605,36.7981777,-1.2527958,36.8003131,439,484,42,1005
5053,17997,2716,3,Business,17,4,31567,17,4,31583,17,4,32097,17,4,32395,17,4,33752,9,23.25888921888938,-1.2865066,36.7327098,-1.2917868,36.7872675,205,1357,16,812
5054,23703,788,3,Business,6,4,54398,6,4,57531,6,4,57833,6,4,58261,6,4,59764,7,23.25888921888938,-1.2527958,36.8003131,-1.225322,36.80855,857,1503,3133,730
5055,449,3192,3,Personal,29,2,56178,29,2,56191,29,2,56873,29,2,58465,29,2,59500,8,23.6,-1.3249978,36.8304773,-1.2658315,36.809049,888,1035,13,2274
5056,26116,3282,3,Personal,1,5,56207,1,5,56222,1,5,56645,1,5,56791,1,5,58452,5,28.4,-1.290059,36.7703475,-1.2925374,36.7995411,588,1661,15,569
5057,7004,2627,3,Business,12,2,48881,12,2,48915,12,2,49042,12,2,50015,12,2,51345,12,23.25888921888938,-1.2571472,36.7950633,-1.2475028,36.8774697,770,1330,34,1100
5058,21099,1551,1,Personal,29,5,45567,29,5,45696,29,5,46430,29,5,46909,29,5,47939,5,19.6,-1.2964348,36.8182757,-1.2833808,36.827198,208,1030,129,1213
5059,27401,2198,1,Personal,1,1,57086,1,1,57553,1,1,58480,1,1,58729,1,1,60374,10,25.4,-1.2248308,36.8012573,-1.2875013,36.8171787,156,1645,467,1176
5060,598,2030,3,Business,7,5,40414,7,5,40630,7,5,41100,7,5,41596,7,5,42724,5,25.2,-1.3100586,36.8500329,-1.29658,36.823699,685,1128,216,966
5061,27176,666,2,Personal,25,5,39854,25,5,40425,25,5,41318,25,5,41545,25,5,42711,4,20.8,-1.2770071,36.832167,-1.2640292,36.8122027,846,1166,571,1120
5062,19235,1299,3,Business,28,1,35030,28,1,35228,28,1,36137,28,1,36650,28,1,37506,7,18.2,-1.282543,36.824618,-1.2575407,36.7868197,88,856,198,1422
5063,16268,286,3,Business,18,4,61939,18,4,62023,18,4,63637,18,4,64056,18,4,65387,7,23.7,-1.2551895,36.7822034,-1.2962967,36.8020231,208,1331,84,2033
5064,6852,3434,3,Business,13,4,40888,13,4,40935,13,4,41517,13,4,41895,13,4,44494,17,23.4,-1.2963097,36.7688221,-1.2482465,36.8889062,548,2599,47,960
5065,3620,1636,3,Business,25,1,46336,25,1,46535,25,1,47333,25,1,50158,25,1,52194,12,30.2,-1.2472011,36.8800307,-1.2991919,36.8368475,8,2036,199,3623
5066,8323,1329,3,Business,29,5,70747,29,5,70759,29,5,70777,29,5,71399,29,5,71994,4,23.25888921888938,-1.273056,36.811298,-1.2686211,36.7898525,119,595,12,640
5067,1533,2803,3,Business,15,4,37635,15,4,37657,15,4,38087,15,4,38272,15,4,39988,16,24.3,-1.2765736,36.8513646,-1.269767,36.7351068,62,1716,22,615
5068,21209,1880,3,Business,5,5,35185,5,5,35392,5,5,35988,5,5,36138,5,5,38135,12,17.7,-1.2571472,36.7950633,-1.31553,36.863732,383,1997,207,746
5069,9431,412,3,Business,2,2,52872,2,2,52934,2,2,53260,2,2,55319,2,2,56993,4,29.6,-1.2628473,36.781805,-1.266837,36.799249,168,1674,62,2385
5070,22612,136,3,Business,20,2,55754,20,2,56048,20,2,57681,20,2,59818,20,2,62101,19,23.7,-1.336582,36.871737,-1.3254522,36.7216584,559,2283,294,3770
5071,28221,1205,3,Business,26,1,42790,26,1,43119,26,1,44638,26,1,45519,26,1,48586,9,23.1,-1.2873232,36.7658572,-1.257309,36.8060084,303,3067,329,2400
5072,4803,2691,3,Business,26,3,51759,26,3,51824,26,3,52788,26,3,53113,26,3,54011,8,27.2,-1.2551895,36.7822034,-1.2857671,36.7875614,726,898,65,1289
5073,17873,136,3,Business,4,2,39922,4,2,39960,4,2,40444,4,2,40907,4,2,42455,4,20.3,-1.2965045,36.7913036,-1.2950408,36.8098172,161,1548,38,947
5074,10396,3450,3,Business,7,5,39593,7,5,39651,7,5,39940,7,5,40507,7,5,41892,10,23.25888921888938,-1.2551895,36.7822034,-1.2942,36.7777614,131,1385,58,856
5075,15871,1570,3,Personal,13,5,50957,13,5,51171,13,5,51515,13,5,52642,13,5,55532,7,19.4,-1.2903842,36.8110684,-1.2793831,36.7617573,431,2890,214,1471
5076,1856,1484,3,Business,9,5,49312,9,5,49363,9,5,49918,9,5,50438,9,5,54927,2,26.0,-1.2571472,36.7950633,-1.25896,36.8016691,467,4489,51,1075
5077,24106,2361,3,Personal,10,1,41566,10,1,42304,10,1,42850,10,1,42976,10,1,45149,7,18.6,-1.2823843,36.7734371,-1.289207,36.8175589,310,2173,738,672
5078,1806,2987,3,Business,10,2,58491,10,2,60127,10,2,60720,10,2,61130,10,2,63199,10,20.4,-1.270212,36.8210877,-1.3014461,36.7661381,217,2069,1636,1003
5079,10305,498,1,Personal,29,2,43247,29,2,43258,29,2,43707,29,2,44989,29,2,46778,17,21.5,-1.3321944,36.8892329,-1.2642903,36.8002137,103,1789,11,1731
5080,1973,2521,3,Business,5,5,48921,5,5,48936,5,5,49022,5,5,49973,5,5,53318,14,27.6,-1.3167113,36.8301563,-1.306378,36.7519845,910,3345,15,1037
5081,8320,3496,3,Business,23,2,39293,23,2,39312,23,2,40027,23,2,44373,23,2,44381,18,17.8,-1.3198615,36.7110323,-1.300921,36.828195,210,8,19,5061
5082,1129,2200,3,Business,1,4,56547,1,4,57373,1,4,57665,1,4,60457,1,4,60825,2,23.25888921888938,-1.28878,36.8168312,-1.290894,36.822971,31,368,826,3084
5083,6570,1471,3,Business,22,5,44505,22,5,44540,22,5,44771,22,5,45896,22,5,49202,7,23.25888921888938,-1.2551895,36.7822034,-1.2885417,36.8100523,404,3306,35,1356
5084,27412,970,3,Business,24,3,34241,24,3,34250,24,3,34406,24,3,34891,24,3,36073,12,23.25888921888938,-1.2551895,36.7822034,-1.3181546,36.8373264,291,1182,9,641
5085,20351,3560,3,Business,17,3,37723,17,3,37794,17,3,38582,17,3,39875,17,3,40808,10,25.2,-1.2297202,36.8819507,-1.279395,36.825364,897,933,71,2081
5086,26917,1363,3,Business,7,5,35474,7,5,36299,7,5,37193,7,5,38710,7,5,38715,3,23.25888921888938,-1.3004062,36.829741,-1.2854089,36.8284874,582,5,825,2411
5087,14220,3291,3,Business,9,6,44496,9,6,44511,9,6,44712,9,6,45504,9,6,49411,9,27.4,-1.2600926,36.8088685,-1.303596,36.778378,607,3907,15,993
5088,24793,1792,3,Business,15,4,42516,15,4,42566,15,4,42875,15,4,43460,15,4,44537,5,24.2,-1.2619756,36.800139,-1.2809121,36.7852524,259,1077,50,894
5089,6804,633,3,Business,5,1,34150,5,1,37053,5,1,39446,5,1,43030,5,1,44106,4,24.5,-1.2770708,36.8231093,-1.3004062,36.829741,593,1076,2903,5977
5090,26813,3565,3,Business,8,5,30792,8,5,31418,8,5,32352,8,5,33289,8,5,34133,8,15.1,-1.2844665,36.7866113,-1.3090663,36.8136865,379,844,626,1871
5091,467,929,2,Personal,8,6,37873,8,6,37888,8,6,38332,8,6,39084,8,6,40232,9,22.5,-1.2563755,36.8215762,-1.2873232,36.7658572,427,1148,15,1196
5092,17805,439,3,Business,15,4,36006,15,4,36021,15,4,36251,15,4,37144,15,4,39944,15,19.6,-1.3323107,36.8692616,-1.2968083,36.7870975,387,2800,15,1123
5093,11414,1329,3,Business,20,2,39406,20,2,39479,20,2,40203,20,2,40499,20,2,42565,12,19.6,-1.273056,36.811298,-1.2019821,36.8054972,937,2066,73,1020
5094,2197,3674,3,Business,23,2,58433,23,2,58751,23,2,59834,23,2,60479,23,2,61636,7,19.3,-1.2551895,36.7822034,-1.2549476,36.8269576,565,1157,318,1728
5095,5260,2523,3,Business,10,1,52391,10,1,52429,10,1,52841,10,1,53258,10,1,55062,5,18.5,-1.2551895,36.7822034,-1.2731645,36.7900343,205,1804,38,829
5096,19616,2801,3,Business,14,4,51014,14,4,51305,14,4,52926,14,4,53230,14,4,54710,7,27.7,-1.2595422,36.7871178,-1.2884231,36.7794566,259,1480,291,1925
5097,19325,1927,3,Business,24,7,35599,24,7,36460,24,7,37698,24,7,39049,24,7,40128,12,23.25888921888938,-1.290894,36.822971,-1.3463042,36.768164,26,1079,861,2589
5098,21258,909,3,Business,4,2,54028,4,2,54888,4,2,55186,4,2,55391,4,2,57399,7,23.9,-1.2584143,36.8048002,-1.225322,36.80855,40,2008,860,503
5099,21060,1066,3,Personal,28,4,46046,28,4,46079,28,4,47227,28,4,47517,28,4,49291,5,27.9,-1.2885029,36.825605,-1.312469,36.815177,863,1774,33,1438
5100,6354,633,3,Business,12,2,55914,12,2,56793,12,2,57990,12,2,61632,12,2,62021,12,28.3,-1.2991441,36.7528804,-1.3004062,36.829741,436,389,879,4839
5101,6365,633,3,Business,4,1,56329,4,1,56343,4,1,56365,4,1,56427,4,1,56429,6,23.25888921888938,-1.3004062,36.829741,-1.3228003,36.8306435,239,2,14,84
5102,17918,1402,3,Business,4,1,39914,4,1,39944,4,1,40291,4,1,40814,4,1,41706,2,26.8,-1.2813012,36.8323962,-1.279395,36.825364,206,892,30,870
5103,21870,37,3,Business,26,5,41766,26,5,41780,26,5,41908,26,5,42848,26,5,44556,21,23.25888921888938,-1.2571472,36.7950633,-1.34364,36.8925345,880,1708,14,1068
5104,4590,3494,3,Personal,21,1,46896,21,1,47176,21,1,47517,21,1,48381,21,1,49310,7,19.8,-1.2856419,36.8260768,-1.2963097,36.7688221,680,929,280,1205
5105,21889,1620,3,Personal,21,5,32458,21,5,32531,21,5,32915,21,5,33949,21,5,34918,11,19.6,-1.261849,36.808254,-1.227132,36.8374277,649,969,73,1418
5106,20888,1246,3,Business,29,3,55524,29,3,56701,29,3,57092,29,3,57200,29,3,58883,14,21.2,-1.3700383,36.9190174,-1.307182,36.850321,938,1683,1177,499
5107,5114,646,2,Personal,18,4,39703,18,4,39819,18,4,40208,18,4,40601,18,4,41675,4,25.3,-1.2661264,36.8030359,-1.2904753,36.8144721,268,1074,116,782
5108,27224,53,3,Business,19,2,32346,19,2,32400,19,2,32963,19,2,33194,19,2,33970,4,21.0,-1.2770708,36.8231093,-1.3004062,36.829741,378,776,54,794
5109,18942,60,3,Business,11,2,55000,11,2,55341,11,2,55460,11,2,56117,11,2,58310,21,21.4,-1.344446,36.756597,-1.22978,36.836215,548,2193,341,776
5110,13745,1646,3,Business,6,1,48263,6,1,48290,6,1,48908,6,1,49300,6,1,50063,6,23.25888921888938,-1.2517448,36.7924971,-1.2264893,36.7584117,484,763,27,1010
5111,5916,1500,3,Business,8,5,55977,8,5,57644,8,5,58677,8,5,59910,8,5,61316,8,27.8,-1.3004062,36.829741,-1.2638185,36.7930057,76,1406,1667,2266
5112,13020,2587,3,Business,21,4,53503,21,4,53886,21,4,54707,21,4,55168,21,4,55171,5,26.4,-1.2584143,36.8048002,-1.28878,36.8168312,70,3,383,1282
5113,18637,1578,3,Business,11,2,31035,11,2,35348,11,2,36026,11,2,36587,11,2,37423,2,16.2,-1.290894,36.822971,-1.28878,36.8168312,819,836,4313,1239
5114,9277,3661,3,Business,27,3,34643,27,3,34652,27,3,36785,27,3,37190,27,3,39712,23,23.25888921888938,-1.2134646,36.8755266,-1.2651574,36.7474347,445,2522,9,2538
5115,25362,186,3,Business,5,5,40137,5,5,40237,5,5,41788,5,5,42068,5,5,44455,4,23.8,-1.2571472,36.7950633,-1.2890399,36.8164942,215,2387,100,1831
5116,13467,2987,3,Business,1,3,49747,1,3,50039,1,3,50358,1,3,50783,1,3,52169,4,23.7,-1.270212,36.8210877,-1.2513591,36.7947674,754,1386,292,744
5117,9856,3599,3,Business,3,5,50582,3,5,52041,3,5,54027,3,5,55134,3,5,57410,14,23.25888921888938,-1.3302996,36.8707935,-1.2886434,36.7709868,519,2276,1459,3093
5118,7985,1759,3,Personal,30,6,36076,30,6,36134,30,6,36685,30,6,37135,30,6,38948,16,23.25888921888938,-1.2251552,36.878727,-1.3011678,36.7914991,8,1813,58,1001
5119,15123,517,3,Business,29,3,35620,29,3,35634,29,3,35641,29,3,36590,29,3,38587,14,18.1,-1.3228003,36.8306435,-1.2991441,36.7528804,349,1997,14,956
5120,6374,3295,3,Business,7,3,45252,7,3,45268,7,3,45341,7,3,45927,7,3,47683,12,25.2,-1.2571472,36.7950633,-1.3270347,36.8667362,470,1756,16,659
5121,2519,393,3,Business,26,1,47005,26,1,49925,26,1,50898,26,1,51395,26,1,53268,10,22.0,-1.3177547,36.8303703,-1.2574219,36.7927073,649,1873,2920,1470
5122,9316,393,3,Business,4,2,52381,4,2,52439,4,2,52723,4,2,53016,4,2,53994,4,22.5,-1.3228003,36.8306435,-1.3004062,36.829741,211,978,58,577
5123,24678,1455,1,Personal,19,4,41476,19,4,42509,19,4,44211,19,4,44357,19,4,45892,6,20.4,-1.2897399,36.8270975,-1.2609721,36.8480813,752,1535,1033,1848
5124,8841,2330,3,Business,9,4,45677,9,4,46855,9,4,47685,9,4,48255,9,4,49849,12,23.25888921888938,-1.2284323,36.8757058,-1.2925641,36.8976449,856,1594,1178,1400
5125,8006,2987,3,Business,31,5,55507,31,5,57247,31,5,57570,31,5,58224,31,5,58786,3,20.2,-1.270212,36.8210877,-1.2649605,36.7981777,179,562,1740,977
5126,5205,2789,3,Business,3,3,42735,3,3,43834,3,3,44486,3,3,45202,3,3,45602,1,27.4,-1.3019925,36.7833825,-1.304735,36.7846054,468,400,1099,1368
5127,26444,3718,3,Business,5,3,61280,5,3,61323,5,3,61809,5,3,62358,5,3,62669,1,22.5,-1.2650027,36.8126242,-1.2690013,36.8092872,881,311,43,1035
5128,15399,2336,1,Personal,6,3,39554,6,3,40404,6,3,40510,6,3,41755,6,3,42985,10,20.0,-1.2248308,36.8012573,-1.263099,36.7879186,116,1230,850,1351
5129,24978,2587,3,Business,13,3,41015,13,3,41805,13,3,43164,13,3,43584,13,3,45533,11,24.8,-1.2859912,36.8756811,-1.28878,36.8168312,311,1949,790,1779
5130,12492,2803,3,Business,18,4,52732,18,4,52742,18,4,53865,18,4,53960,18,4,56031,14,23.25888921888938,-1.2765736,36.8513646,-1.2707623,36.7581285,910,2071,10,1218
5131,12986,186,3,Business,21,4,44100,21,4,44152,21,4,44301,21,4,45097,21,4,45598,5,25.3,-1.2825816,36.8092346,-1.2571472,36.7950633,205,501,52,945
5132,22547,1927,3,Business,28,5,36576,28,5,36580,28,5,36622,28,5,36707,28,5,40826,20,20.7,-1.3472066,36.7692638,-1.2413316,36.8785525,179,4119,4,127
5133,759,2346,1,Personal,25,1,53256,25,1,53941,25,1,54244,25,1,54392,25,1,58393,8,23.25888921888938,-1.3054537,36.8284768,-1.2813742,36.8558927,890,4001,685,451
5134,12368,718,3,Business,7,5,34977,7,5,35551,7,5,36579,7,5,36841,7,5,38885,8,20.5,-1.2551895,36.7822034,-1.2987976,36.829477,725,2044,574,1290
5135,3851,1304,3,Business,31,3,49061,31,3,49116,31,3,50035,31,3,50144,31,3,53403,17,27.1,-1.3332749,36.8708147,-1.2805699,36.7730714,30,3259,55,1028
5136,20179,2981,1,Personal,23,4,39252,23,4,39309,23,4,40362,23,4,40427,23,4,41857,7,18.7,-1.2872996,36.8310969,-1.2609186,36.7938342,849,1430,57,1118
5137,12001,1469,3,Business,5,2,55853,5,2,55879,5,2,56984,5,2,57764,5,2,59994,2,27.6,-1.2571472,36.7950633,-1.2567464,36.7915273,547,2230,26,1885
5138,4295,2150,3,Business,4,1,46168,4,1,46972,4,1,48363,4,1,48459,4,1,51306,15,26.7,-1.344446,36.756597,-1.265715,36.823815,605,2847,804,1487
5139,4683,2691,3,Business,20,3,36316,20,3,36352,20,3,38146,20,3,38521,20,3,40220,8,27.4,-1.2857671,36.7875614,-1.2551895,36.7822034,647,1699,36,2169
5140,25125,3244,3,Personal,16,4,38280,16,4,38299,16,4,39192,16,4,39465,16,4,40967,9,23.25888921888938,-1.3103512,36.814996,-1.2549476,36.8269576,591,1502,19,1166
5141,6335,2523,3,Business,14,4,54824,14,4,55170,14,4,57337,14,4,57551,14,4,58291,6,27.9,-1.2551895,36.7822034,-1.2357748,36.7900524,337,740,346,2381
5142,4884,1410,3,Business,9,2,29950,9,2,29960,9,2,30012,9,2,35238,9,2,35616,19,17.6,-1.300921,36.828195,-1.2847613,36.967084,70,378,10,5278
5143,26900,302,3,Business,5,1,57220,5,1,58859,5,1,59384,5,1,60049,5,1,60834,7,24.5,-1.2649605,36.7981777,-1.2916738,36.7901057,315,785,1639,1190
5144,11106,3674,3,Business,15,2,55882,15,2,55899,15,2,55922,15,2,56112,15,2,57258,5,24.4,-1.2551895,36.7822034,-1.2711982,36.8240199,518,1146,17,213
5145,18409,2279,3,Business,18,1,49592,18,1,52266,18,1,52713,18,1,53369,18,1,54917,4,30.9,-1.2897368,36.8226783,-1.2980155,36.7973064,539,1548,2674,1103
5146,19418,1252,1,Personal,17,1,48011,17,1,48398,17,1,49746,17,1,50038,17,1,51998,14,28.4,-1.2343087,36.84749,-1.319977,36.8138663,328,1960,387,1640
5147,9469,2627,3,Business,14,2,53584,14,2,53611,14,2,54512,14,2,54977,14,2,55013,1,23.25888921888938,-1.2571472,36.7950633,-1.2584143,36.8048002,131,36,27,1366
5148,738,847,3,Business,18,4,44134,18,4,44155,18,4,45566,18,4,46068,18,4,48104,13,23.25888921888938,-1.3290949,36.8767589,-1.287353,36.826992,341,2036,21,1913
5149,10628,540,3,Business,20,3,33965,20,3,34051,20,3,34822,20,3,40523,20,3,42897,8,27.0,-1.2551895,36.7822034,-1.3027475,36.8178196,868,2374,86,6472
5150,4693,1809,3,Business,19,3,41719,19,3,41859,19,3,41935,19,3,42563,19,3,43618,8,22.4,-1.2571472,36.7950633,-1.3025667,36.7803495,56,1055,140,704
5151,21989,146,3,Personal,24,4,41468,24,4,41489,24,4,42113,24,4,42410,24,4,43246,4,24.4,-1.3073664,36.8158394,-1.2985153,36.7876043,758,836,21,921
5152,2479,633,3,Business,26,2,42033,26,2,42054,26,2,42643,26,2,43806,26,2,45049,9,27.4,-1.2638185,36.7930057,-1.3004062,36.829741,349,1243,21,1752
5153,822,633,3,Business,23,6,31526,23,6,31632,23,6,31639,23,6,32536,23,6,33338,9,18.8,-1.2638185,36.7930057,-1.3004062,36.829741,576,802,106,904
5154,5100,111,3,Business,18,4,53951,18,4,53962,18,4,54110,18,4,54419,18,4,58277,8,26.8,-1.2551895,36.7822034,-1.298094,36.803149,805,3858,11,457
5155,14452,1976,3,Business,11,4,46657,11,4,46736,11,4,47544,11,4,47783,11,4,49558,12,23.8,-1.257028,36.7810435,-1.2738136,36.8232881,219,1775,79,1047
5156,22595,393,3,Business,10,5,31482,10,5,31514,10,5,31675,10,5,32660,10,5,33365,4,23.25888921888938,-1.3167113,36.8301563,-1.3004062,36.829741,211,705,32,1146
5157,14839,391,3,Business,26,5,28663,26,5,28759,26,5,28765,26,5,30239,26,5,30246,5,23.25888921888938,-1.2867454,36.8259017,-1.2602337,36.7990548,61,7,96,1480
5158,7923,53,3,Business,14,4,42347,14,4,51435,14,4,51458,14,4,51532,14,4,52326,5,28.1,-1.2770708,36.8231093,-1.3004062,36.829741,518,794,9088,97
5159,10587,633,3,Business,15,5,57245,15,5,57284,15,5,58067,15,5,58145,15,5,58849,4,17.6,-1.3077869,36.8443207,-1.3004062,36.829741,349,704,39,861
5160,22863,496,3,Business,30,2,52340,30,2,55051,30,2,58475,30,2,61411,30,2,61413,7,23.25888921888938,-1.2904753,36.8144721,-1.2551895,36.7822034,613,2,2711,6360
5161,1660,2587,3,Business,19,6,49412,19,6,49491,19,6,49992,19,6,50591,19,6,51542,5,27.8,-1.2584143,36.8048002,-1.28878,36.8168312,899,951,79,1100
5162,26059,3517,3,Business,30,2,46755,30,2,46993,30,2,47477,30,2,51807,30,2,52298,1,23.25888921888938,-1.2546732,36.8086796,-1.2599563,36.7993439,855,491,238,4814
5163,21436,1469,3,Business,5,2,55515,5,2,55610,5,2,56879,5,2,57782,5,2,58443,4,27.7,-1.2551895,36.7822034,-1.2738522,36.7992818,72,661,95,2172
5164,1898,1589,3,Business,5,3,46692,5,3,46710,5,3,50117,5,3,50487,5,3,52366,7,19.2,-1.207546,36.7887089,-1.225322,36.80855,689,1879,18,3777
5165,26531,2195,1,Business,6,5,36291,6,5,36432,6,5,36991,6,5,37670,6,5,40838,11,15.2,-1.265715,36.823815,-1.331619,36.847976,88,3168,141,1238
5166,27029,1578,3,Business,25,5,54174,25,5,54242,25,5,55820,25,5,56131,25,5,59758,15,29.3,-1.28878,36.8168312,-1.216682,36.9085778,553,3627,68,1889
5167,4686,788,3,Business,13,3,60218,13,3,62347,13,3,62394,13,3,62958,13,3,64893,15,26.1,-1.2156006,36.8916865,-1.225322,36.80855,131,1935,2129,611
5168,26014,1683,3,Business,17,1,47403,17,1,48855,17,1,49392,17,1,49818,17,1,49828,6,24.7,-1.2535486,36.7933541,-1.2765334,36.8015051,501,10,1452,963
5169,21121,2801,3,Business,15,3,58527,15,3,58626,15,3,59291,15,3,60070,15,3,60990,6,25.0,-1.2566586,36.7929682,-1.289081,36.8300409,378,920,99,1444
5170,24618,823,3,Personal,23,6,55659,23,6,55864,23,6,56805,23,6,57136,23,6,58480,10,28.1,-1.3025826,36.7670807,-1.2495129,36.7886876,545,1344,205,1272
5171,6925,2174,3,Business,12,3,37796,12,3,38079,12,3,38271,12,3,39414,12,3,42033,27,19.5,-1.2489964,36.8771594,-1.3339943,36.7263409,854,2619,283,1335
5172,24815,1209,3,Business,3,5,36387,3,5,36446,3,5,36743,3,5,37464,3,5,38253,5,23.25888921888938,-1.3004062,36.829741,-1.3228003,36.8306435,709,789,59,1018
5173,12801,393,3,Business,19,3,41964,19,3,41982,19,3,41990,19,3,42848,19,3,44865,14,22.2,-1.3167113,36.8301563,-1.306378,36.7519845,515,2017,18,866
5174,27880,2298,3,Personal,4,4,29702,4,4,29762,4,4,31004,4,4,31298,4,4,33176,14,21.8,-1.3234104,36.7989459,-1.2665433,36.7611081,99,1878,60,1536
5175,13751,2330,3,Business,3,5,47925,3,5,48563,3,5,49072,3,5,49208,3,5,50104,8,23.25888921888938,-1.3192789,36.7112991,-1.3015197,36.7658456,326,896,638,645
5176,25390,1687,3,Business,19,2,58682,19,2,59065,19,2,60446,19,2,62025,19,2,63470,4,28.1,-1.2871938,36.8195031,-1.3030659,36.8135093,448,1445,383,2960
5177,17301,2987,3,Business,30,4,37898,30,4,37933,30,4,38343,30,4,38610,30,4,39446,11,20.4,-1.270212,36.8210877,-1.2156006,36.8916865,116,836,35,677
5178,17998,2330,3,Business,10,1,35234,10,1,35317,10,1,36032,10,1,37790,10,1,39625,16,16.6,-1.2921463,36.8029626,-1.2925641,36.8976449,92,1835,83,2473
5179,22760,2200,3,Business,6,1,34068,6,1,34154,6,1,34362,6,1,35010,6,1,35997,5,23.25888921888938,-1.273488,36.804158,-1.290894,36.822971,119,987,86,856
5180,16352,2236,1,Personal,13,3,50205,13,3,50551,13,3,51156,13,3,51266,13,3,52343,6,23.6,-1.2901262,36.7951047,-1.3263415,36.7722827,312,1077,346,715
5181,28056,3689,3,Business,14,3,47359,14,3,47368,14,3,47794,14,3,47985,14,3,49217,5,24.4,-1.279395,36.825364,-1.2527958,36.8003131,237,1232,9,617
5182,26024,111,3,Business,12,5,50681,12,5,50695,12,5,50696,12,5,50899,12,5,51207,2,23.25888921888938,-1.2551895,36.7822034,-1.2575555,36.7987053,576,308,14,204
5183,3491,2663,1,Personal,15,6,37579,15,6,37604,15,6,38163,15,6,38542,15,6,38988,4,23.25888921888938,-1.2971379,36.8019794,-1.2817331,36.818384,622,446,25,938
5184,15334,346,3,Business,5,5,42586,5,5,42612,5,5,43974,5,5,44598,5,5,45066,1,24.7,-1.279395,36.825364,-1.28878,36.8168312,448,468,26,1986
5185,19310,3283,3,Business,8,2,34441,8,2,34480,8,2,37303,8,2,38988,8,2,40931,19,23.5,-1.293515,36.897607,-1.2628473,36.781805,237,1943,39,4508
5186,4401,1400,2,Personal,13,6,49109,13,6,49802,13,6,51183,13,6,51978,13,6,53397,11,28.1,-1.2696795,36.8640088,-1.3194988,36.7966681,248,1419,693,2176
5187,23382,1001,1,Personal,10,3,51919,10,3,51933,10,3,52650,10,3,53448,10,3,56942,19,24.7,-1.2801648,36.8241697,-1.3386942,36.7105213,844,3494,14,1515
5188,25982,359,2,Personal,7,4,55063,7,4,55112,7,4,55440,7,4,55866,7,4,56779,4,20.1,-1.2924173,36.7797814,-1.3043728,36.8044157,101,913,49,754
5189,28023,261,2,Personal,17,5,36386,17,5,36422,17,5,36730,17,5,37793,17,5,38925,8,14.2,-1.2675332,36.808561,-1.296797,36.7764525,882,1132,36,1371
5190,12089,1690,3,Business,28,1,63048,28,1,63099,28,1,64159,28,1,64318,28,1,66665,7,22.5,-1.2717851,36.8105363,-1.304033,36.7848695,752,2347,51,1219
5191,353,2694,1,Personal,3,4,44023,3,4,44909,3,4,45309,3,4,47698,3,4,49088,6,21.8,-1.3154433,36.806386,-1.2801649,36.8315686,929,1390,886,2789
5192,13873,517,3,Business,2,3,29988,2,3,30086,2,3,30259,2,3,30768,2,3,31192,4,20.0,-1.3167113,36.8301563,-1.3004062,36.829741,523,424,98,682
5193,9457,478,3,Business,30,2,51439,30,2,51559,30,2,52395,30,2,53761,30,2,55373,6,23.25888921888938,-1.2551895,36.7822034,-1.280753,36.8191175,291,1612,120,2202
5194,27661,795,3,Personal,21,1,40020,21,1,40068,21,1,40521,21,1,40804,21,1,42797,4,19.9,-1.3104734,36.7363698,-1.2966729,36.7490784,844,1993,48,736
5195,7609,718,3,Business,26,1,55985,26,1,56022,26,1,60336,26,1,60406,26,1,65013,23,20.1,-1.2551895,36.7822034,-1.3447079,36.91105,401,4607,37,4384
5196,19453,633,3,Business,25,5,35083,25,5,35162,25,5,35728,25,5,37037,25,5,37603,5,20.8,-1.3004062,36.829741,-1.3228003,36.8306435,580,566,79,1875
5197,14838,1110,1,Personal,30,1,39850,30,1,39864,30,1,40472,30,1,40852,30,1,42032,9,22.8,-1.274165,36.814577,-1.2833608,36.7577466,754,1180,14,988
5198,5540,3674,3,Business,30,2,34639,30,2,34701,30,2,35288,30,2,35425,30,2,36571,8,17.3,-1.2551895,36.7822034,-1.2976788,36.8027916,167,1146,62,724
5199,10844,635,3,Business,8,4,34525,8,4,37723,8,4,38378,8,4,38836,8,4,40169,6,26.1,-1.2904695,36.8243257,-1.2599563,36.7993439,276,1333,3198,1113
5200,6764,2982,3,Business,4,1,44295,4,1,45761,4,1,47131,4,1,48306,4,1,51702,23,21.1,-1.177202,36.8351183,-1.296279,36.760463,852,3396,1466,2545
5201,8341,3584,2,Personal,19,5,52769,19,5,54345,19,5,55246,19,5,55697,19,5,57012,9,27.5,-1.3172395,36.839269,-1.2517571,36.8170267,622,1315,1576,1352
5202,702,478,3,Business,8,5,41535,8,5,41611,8,5,41963,8,5,42315,8,5,43264,3,28.2,-1.2551895,36.7822034,-1.2671001,36.7977185,200,949,76,704
5203,11266,1130,3,Personal,27,5,44188,27,5,44195,27,5,45288,27,5,45802,27,5,46780,12,22.6,-1.259488,36.800101,-1.2482465,36.8889062,857,978,7,1607
5204,18221,1856,3,Business,13,2,47255,13,2,47523,13,2,50657,13,2,51311,13,2,53725,2,26.3,-1.273009,36.802807,-1.263987,36.798891,875,2414,268,3788
5205,8697,1363,3,Business,28,3,53402,28,3,53783,28,3,53788,28,3,54695,28,3,54697,5,23.25888921888938,-1.3004062,36.829741,-1.3177547,36.8303703,515,2,381,912
5206,22722,1880,3,Business,30,2,44677,30,2,51179,30,2,52565,30,2,53169,30,2,55348,1,23.25888921888938,-1.2571472,36.7950633,-1.2568411,36.8012533,653,2179,6502,1990
5207,9079,238,3,Business,18,1,47262,18,1,47322,18,1,47890,18,1,49173,18,1,52064,15,29.6,-1.2991441,36.7528804,-1.3077869,36.8443207,831,2891,60,1851
5208,12377,186,3,Business,10,1,59368,10,1,59486,10,1,59931,10,1,60478,10,1,61199,5,18.8,-1.2825816,36.8092346,-1.2571472,36.7950633,576,721,118,992
5209,13499,1170,2,Personal,13,1,29446,13,1,29460,13,1,29609,13,1,30897,13,1,32069,7,15.0,-1.255956,36.772901,-1.2732412,36.8117677,720,1172,14,1437
5210,5220,1329,3,Business,30,3,49700,30,3,49731,30,3,50157,30,3,50241,30,3,50960,3,28.8,-1.273056,36.811298,-1.2657054,36.7930278,259,719,31,510
5211,26458,1397,3,Business,9,6,35523,9,6,35560,9,6,35793,9,6,36307,9,6,37487,11,21.0,-1.2648363,36.8023754,-1.2351541,36.8748505,828,1180,37,747
5212,24180,2216,3,Business,10,1,52736,10,1,52764,10,1,53885,10,1,54703,10,1,55182,9,18.4,-1.2551895,36.7822034,-1.305791,36.8111627,921,479,28,1939
5213,12623,1302,2,Personal,28,1,32849,28,1,32954,28,1,34603,28,1,35366,28,1,36251,7,17.9,-1.2702333,36.80065,-1.2970034,36.8333214,808,885,105,2412
5214,24977,3560,3,Business,24,1,53943,24,1,53987,24,1,54348,24,1,55836,24,1,55839,2,24.7,-1.279395,36.825364,-1.281754,36.8324229,86,3,44,1849
5215,8261,61,1,Personal,26,3,44498,26,3,44563,26,3,45486,26,3,46711,26,3,48295,13,24.0,-1.3357319,36.8621006,-1.2560455,36.7800867,54,1584,65,2148
5216,8811,2271,3,Business,14,5,51564,14,5,51587,14,5,51635,14,5,52741,14,5,54151,11,23.1,-1.307143,36.825009,-1.293515,36.897607,686,1410,23,1154
5217,11353,1551,1,Personal,19,4,31865,19,4,31908,19,4,31954,19,4,32882,19,4,34123,11,14.7,-1.2863371,36.8200261,-1.3349663,36.8580085,89,1241,43,974
5218,17482,2457,3,Business,12,2,53638,12,2,55414,12,2,56233,12,2,56403,12,2,58469,8,23.1,-1.2551895,36.7822034,-1.3016151,36.8117354,726,2066,1776,989
5219,9649,3647,3,Business,5,5,58280,5,5,58945,5,5,59267,5,5,59389,5,5,60389,5,26.4,-1.272639,36.794723,-1.2807268,36.7866659,795,1000,665,444
5220,6931,1820,3,Personal,3,5,42724,3,5,42751,3,5,42981,3,5,43822,3,5,45214,6,21.2,-1.302088,36.831162,-1.2753109,36.8130185,89,1392,27,1071
5221,11164,3295,3,Business,14,4,51955,14,4,52133,14,4,52486,14,4,52997,14,4,54618,12,28.1,-1.2571472,36.7950633,-1.3236648,36.846181,870,1621,178,864
5222,25024,2866,3,Business,11,5,45151,11,5,45164,11,5,45622,11,5,46550,11,5,48319,22,21.1,-1.2571472,36.7950633,-1.3448483,36.9004081,845,1769,13,1386
5223,14613,3222,3,Business,17,4,54119,17,4,54131,17,4,54689,17,4,55337,17,4,57635,2,27.9,-1.2551895,36.7822034,-1.2580991,36.7941519,399,2298,12,1206
5224,24675,2044,1,Personal,15,2,34082,15,2,34707,15,2,36639,15,2,37994,15,2,39508,7,22.8,-1.2517392,36.8249608,-1.297512,36.821511,676,1514,625,3287
5225,13754,393,3,Business,28,1,44739,28,1,44809,28,1,45129,28,1,45415,28,1,46920,14,22.7,-1.3177547,36.8303703,-1.306378,36.7519845,543,1505,70,606
5226,15516,3599,3,Business,21,2,37332,21,2,39313,21,2,41210,21,2,41794,21,2,43715,8,22.7,-1.3302996,36.8707935,-1.3116855,36.8233653,332,1921,1981,2481
5227,19208,635,3,Business,13,1,34755,13,1,34986,13,1,35324,13,1,37092,13,1,38748,8,23.25888921888938,-1.300921,36.828195,-1.291055,36.786744,591,1656,231,2106
5228,7136,2869,3,Business,3,3,33057,3,3,33347,3,3,33729,3,3,33926,3,3,36032,10,21.5,-1.2584143,36.8048002,-1.3025826,36.7670807,682,2106,290,579
5229,3344,2582,3,Business,6,3,32697,6,3,32707,6,3,32946,6,3,33873,6,3,36027,13,16.7,-1.2551895,36.7822034,-1.2470959,36.8729823,876,2154,10,1166
5230,7400,1075,3,Business,6,3,49836,6,3,49858,6,3,50839,6,3,51231,6,3,51639,1,27.3,-1.2649605,36.7981777,-1.2527958,36.8003131,205,408,22,1373
5231,6480,2112,3,Business,20,7,54700,20,7,56099,20,7,56728,20,7,56879,20,7,59421,16,20.3,-1.3052491,36.8223899,-1.2156006,36.8916865,581,2542,1399,780
5232,19893,3669,3,Business,16,3,32702,16,3,32709,16,3,34727,16,3,36419,16,3,37872,19,19.8,-1.2504436,36.8897292,-1.2615888,36.7928732,456,1453,7,3710
5233,22590,1141,3,Business,20,2,51714,20,2,53906,20,2,54885,20,2,55367,20,2,57842,8,24.2,-1.2877645,36.8378535,-1.2979147,36.7857814,263,2475,2192,1461
5234,9,868,3,Business,17,1,47556,17,1,47580,17,1,47606,17,1,50293,17,1,51073,10,24.8,-1.228911,36.881876,-1.265715,36.823815,260,780,24,2713
5235,10147,2521,3,Business,25,5,35084,25,5,35100,25,5,35115,25,5,36455,25,5,37961,11,20.7,-1.3167113,36.8301563,-1.2574219,36.7927073,623,1506,16,1355
5236,1187,3647,3,Business,18,2,57867,18,2,58210,18,2,58598,18,2,58763,18,2,60010,5,25.6,-1.272639,36.794723,-1.2712521,36.818089,660,1247,343,553
5237,12281,2763,3,Business,8,5,47347,8,5,53923,8,5,54645,8,5,54718,8,5,56843,6,30.2,-1.2551895,36.7822034,-1.2870705,36.8256017,522,2125,6576,795
5238,103,2457,1,Business,21,5,27414,21,5,27460,21,5,29048,21,5,29999,21,5,30495,4,19.8,-1.255956,36.789867,-1.269534,36.80697,116,496,46,2539
5239,11716,2154,3,Business,30,2,57383,30,2,57423,30,2,58313,30,2,59052,30,2,59890,5,27.6,-1.290894,36.822971,-1.2765736,36.8513646,865,838,40,1629
5240,21287,1280,3,Business,14,5,53467,14,5,54849,14,5,55295,14,5,55806,14,5,57369,15,23.8,-1.2551895,36.7822034,-1.3323107,36.8692616,300,1563,1382,957
5241,1920,3689,3,Business,6,6,37888,6,6,37959,6,6,39239,6,6,39611,6,6,41484,7,24.5,-1.2527958,36.8003131,-1.2521881,36.7537237,268,1873,71,1652
5242,22487,209,1,Personal,15,1,40882,15,1,40892,15,1,41382,15,1,41575,15,1,42176,3,23.25888921888938,-1.2528485,36.7953722,-1.2674274,36.7870827,720,601,10,683
5243,20496,3647,3,Business,2,3,61825,2,3,61931,2,3,62445,2,3,62777,2,3,63376,6,25.0,-1.272639,36.794723,-1.2739249,36.8191151,427,599,106,846
5244,24595,1719,3,Business,6,2,36222,6,2,36952,6,2,37353,6,2,37556,6,2,39213,8,19.8,-1.2768687,36.8209066,-1.296797,36.7764525,858,1657,730,604
5245,14719,624,3,Business,5,5,42519,5,5,43165,5,5,44187,5,5,45670,5,5,46542,6,23.7,-1.228911,36.881876,-1.22978,36.836215,900,872,646,2505
5246,3064,516,3,Business,30,5,39334,30,5,39345,30,5,39546,30,5,40581,30,5,41478,2,23.9,-1.2571472,36.7950633,-1.2668071,36.8068157,274,897,11,1236
5247,16184,868,3,Business,18,4,55347,18,4,56411,18,4,57180,18,4,57755,18,4,59650,9,23.25888921888938,-1.331619,36.847976,-1.265715,36.823815,523,1895,1064,1344
5248,4687,868,3,Business,18,2,39051,18,2,39057,18,2,39105,18,2,39779,18,2,40824,6,23.25888921888938,-1.307143,36.825009,-1.265715,36.823815,45,1045,6,722
5249,19961,909,3,Business,12,3,47364,12,3,47457,12,3,48775,12,3,48891,12,3,50480,9,26.3,-1.225322,36.80855,-1.2551895,36.7822034,933,1589,93,1434
5250,7402,1882,3,Business,5,5,71064,5,5,71144,5,5,71914,5,5,72424,5,5,74710,14,22.7,-1.2156006,36.8916865,-1.2268871,36.8073946,649,2286,80,1280
5251,19688,1280,3,Business,5,3,40398,5,3,40464,5,3,40914,5,3,41160,5,3,41540,3,22.0,-1.2551895,36.7822034,-1.2654348,36.8022464,116,380,66,696
5252,3366,540,3,Business,30,4,54571,30,4,54591,30,4,55919,30,4,56495,30,4,57449,5,23.25888921888938,-1.2551895,36.7822034,-1.270054,36.815164,659,954,20,1904
5253,19815,2523,3,Business,10,5,35003,10,5,35012,10,5,35142,10,5,35510,10,5,36007,8,23.25888921888938,-1.2551895,36.7822034,-1.2829828,36.7972062,438,497,9,498
5254,547,3688,3,Business,4,1,44384,4,1,44437,4,1,44616,4,1,44864,4,1,46274,8,25.8,-1.2551895,36.7822034,-1.3038156,36.8122733,291,1410,53,427
5255,23788,3291,3,Business,11,2,48784,11,2,51251,11,2,51736,11,2,55615,11,2,56566,11,22.5,-1.303596,36.778378,-1.2600926,36.8088685,382,951,2467,4364
5256,2944,2956,3,Business,22,5,48605,22,5,48628,22,5,48707,22,5,49132,22,5,49846,3,27.3,-1.2584143,36.8048002,-1.2551895,36.7822034,778,714,23,504
5257,21995,3329,3,Business,24,5,42467,24,5,42690,24,5,44455,24,5,44694,24,5,46402,6,21.0,-1.2859576,36.8197604,-1.3123271,36.8147383,85,1708,223,2004
5258,19183,2457,3,Business,8,3,38253,8,3,38276,8,3,38285,8,3,39360,8,3,43482,8,22.4,-1.2551895,36.7822034,-1.3016151,36.8117354,101,4122,23,1084
5259,23559,1342,3,Business,12,3,30765,12,3,30779,12,3,30816,12,3,33624,12,3,35240,12,16.6,-1.295324,36.839629,-1.3025826,36.7670807,179,1616,14,2845
5260,6390,1469,3,Business,6,4,53618,6,4,53624,6,4,54060,6,4,54528,6,4,54529,3,23.25888921888938,-1.2551895,36.7822034,-1.2640571,36.7883547,647,1,6,904
5261,10851,633,3,Business,27,3,29729,27,3,29822,27,3,30166,27,3,31247,27,3,31249,5,21.2,-1.3004062,36.829741,-1.2770708,36.8231093,472,2,93,1425
5262,13977,2216,3,Business,10,3,42088,10,3,45784,10,3,45935,10,3,46936,10,3,46978,4,27.6,-1.2551895,36.7822034,-1.2519787,36.7806491,258,42,3696,1152
5263,11279,111,3,Business,11,2,46668,11,2,46683,11,2,47082,11,2,47198,11,2,48601,12,24.4,-1.2551895,36.7822034,-1.3104734,36.7363698,279,1403,15,515
5264,27142,136,3,Business,29,2,34422,29,2,34455,29,2,34550,29,2,34891,29,2,36188,11,18.4,-1.2965045,36.7913036,-1.3254522,36.7216584,449,1297,33,436
5265,17592,3300,3,Business,2,3,35570,2,3,36961,2,3,37869,2,3,38777,2,3,40241,11,22.1,-1.331619,36.847976,-1.303596,36.778378,753,1464,1391,1816
5266,15318,2804,3,Business,2,4,39282,2,4,39330,2,4,39945,2,4,40360,2,4,41863,7,23.25888921888938,-1.2571472,36.7950633,-1.2981352,36.8213822,138,1503,48,1030
5267,16699,3355,3,Business,14,3,34110,14,3,34400,14,3,34810,14,3,35357,14,3,36439,7,18.4,-1.2584143,36.8048002,-1.3052491,36.8223899,383,1082,290,957
5268,12158,3291,3,Business,17,5,38944,17,5,39009,17,5,39902,17,5,40766,17,5,40768,5,23.25888921888938,-1.2783849,36.8163445,-1.2600926,36.8088685,76,2,65,1757
5269,4959,627,3,Business,22,5,50396,22,5,50504,22,5,51031,22,5,54219,22,5,54235,18,30.8,-1.2571472,36.7950633,-1.3339943,36.7263409,318,16,108,3715
5270,23505,2069,3,Business,25,6,59395,25,6,59409,25,6,59424,25,6,59962,25,6,61273,12,23.25888921888938,-1.259478,36.8017813,-1.228911,36.881876,178,1311,14,553
5271,11977,3080,3,Business,2,1,36209,2,1,36333,2,1,36877,2,1,37575,2,1,38140,6,16.6,-1.2551895,36.7822034,-1.2833106,36.8240238,714,565,124,1242
5272,6072,3578,3,Business,25,4,52428,25,4,52442,25,4,53081,25,4,55725,25,4,58055,15,23.25888921888938,-1.2615888,36.7928732,-1.2232123,36.8932547,690,2330,14,3283
5273,20316,2976,3,Business,28,4,37212,28,4,37257,28,4,38148,28,4,38347,28,4,39686,6,28.1,-1.2992482,36.7865618,-1.2696819,36.8028694,801,1339,45,1090
5274,7931,2041,1,Business,14,5,41437,14,5,41548,14,5,43336,14,5,43787,14,5,45046,6,24.2,-1.2527958,36.8003131,-1.290894,36.822971,726,1259,111,2239
5275,22973,3108,3,Business,7,4,40283,7,4,41655,7,4,43508,7,4,44091,7,4,45118,8,16.8,-1.2551895,36.7822034,-1.2894795,36.7818534,900,1027,1372,2436
5276,4314,2956,3,Business,10,5,34544,10,5,34552,10,5,34650,10,5,35023,10,5,35320,3,13.6,-1.2584143,36.8048002,-1.2551895,36.7822034,865,297,8,471
5277,2464,868,3,Business,18,4,55836,18,4,56017,18,4,56792,18,4,57822,18,4,58410,5,23.25888921888938,-1.2600926,36.8088685,-1.265715,36.823815,126,588,181,1805
5278,19613,393,3,Business,22,3,38206,22,3,38643,22,3,38680,22,3,43005,22,3,43235,11,23.3,-1.3228003,36.8306435,-1.2638185,36.7930057,436,230,437,4362
5279,25713,1195,3,Business,4,2,42911,4,2,45701,4,2,45758,4,2,46217,4,2,48503,15,19.4,-1.2991441,36.7528804,-1.3177547,36.8303703,523,2286,2790,516
5280,19900,635,3,Business,29,1,46014,29,1,46070,29,1,47430,29,1,51969,29,1,53421,10,23.25888921888938,-1.3081376,36.8329772,-1.2602337,36.7990548,85,1452,56,5899
5281,12754,432,3,Business,2,4,56567,2,4,56595,2,4,57036,2,4,57255,2,4,59536,9,23.25888921888938,-1.2551895,36.7822034,-1.3012008,36.764868,177,2281,28,660
5282,998,1482,3,Business,31,3,54899,31,3,54927,31,3,55514,31,3,55991,31,3,57433,13,27.1,-1.2971701,36.8288201,-1.2310607,36.8035776,31,1442,28,1064
5283,22678,3486,3,Business,19,3,56052,19,3,56085,19,3,56264,19,3,56761,19,3,57428,4,24.4,-1.2551895,36.7822034,-1.2739743,36.8139238,107,667,33,676
5284,6253,904,3,Business,7,4,48754,7,4,48767,7,4,50803,7,4,50957,7,4,52403,12,27.7,-1.304192,36.739457,-1.2593049,36.8029373,205,1446,13,2190
5285,6497,1482,3,Business,23,5,44503,23,5,44711,23,5,45014,23,5,45209,23,5,47529,19,24.1,-1.338579,36.8963038,-1.263736,36.780353,882,2320,208,498
5286,25974,590,3,Business,13,2,38155,13,2,39542,13,2,42012,13,2,42387,13,2,43387,3,22.2,-1.2479362,36.772759,-1.257773,36.795486,866,1000,1387,2845
5287,16905,700,3,Business,30,5,36461,30,5,36568,30,5,40836,30,5,41316,30,5,43915,7,23.5,-1.276466,36.828239,-1.3205164,36.8098882,79,2599,107,4748
5288,19593,3015,1,Personal,1,2,62092,1,2,62107,1,2,64883,1,2,65794,1,2,66559,13,20.0,-1.3026355,36.8012981,-1.3264635,36.8883889,95,765,15,3687
5289,21890,2835,1,Personal,25,2,45712,25,2,45751,25,2,46741,25,2,47095,25,2,49057,15,23.9,-1.2810157,36.8027578,-1.2100797,36.811189,848,1962,39,1344
5290,1218,3621,3,Business,12,2,46655,12,2,47783,12,2,48763,12,2,48912,12,2,50928,5,23.25888921888938,-1.2836583,36.7886014,-1.2810889,36.8247135,709,2016,1128,1129
5291,16439,909,3,Business,2,6,45986,2,6,48160,2,6,48182,2,6,49166,2,6,50571,10,30.8,-1.2765736,36.8513646,-1.225322,36.80855,143,1405,2174,1006
5292,12250,3664,1,Personal,19,6,58227,19,6,58803,19,6,59097,19,6,59542,19,6,60243,3,21.6,-1.3040487,36.8211935,-1.307774,36.8407541,196,701,576,739
5293,28082,1578,3,Business,30,3,38876,30,3,38923,30,3,39901,30,3,41903,30,3,43091,8,22.7,-1.3147074,36.811722,-1.2765736,36.8513646,808,1188,47,2980
5294,3480,3486,3,Business,21,5,46184,21,5,48082,21,5,48089,21,5,48212,21,5,49580,7,22.8,-1.2551895,36.7822034,-1.2849035,36.8103615,725,1368,1898,130
5295,19196,1514,3,Personal,6,3,37929,6,3,37959,6,3,38046,6,3,38685,6,3,39210,6,23.25888921888938,-1.3044313,36.818504,-1.3189407,36.8381862,829,525,30,726
5296,11878,2330,3,Business,28,1,63403,28,1,63661,28,1,65584,28,1,65855,28,1,66916,4,25.3,-1.293082,36.8278578,-1.2915247,36.8055757,206,1061,258,2194
5297,18874,3479,1,Personal,11,5,43351,11,5,43649,11,5,44564,11,5,44891,11,5,46943,9,20.7,-1.2962603,36.7766164,-1.2696012,36.8208656,101,2052,298,1242
5298,13567,868,3,Business,7,2,33167,7,2,33183,7,2,33343,7,2,33995,7,2,35502,9,23.25888921888938,-1.331619,36.847976,-1.265715,36.823815,709,1507,16,812
5299,26614,2804,3,Business,23,2,46274,23,2,46312,23,2,46749,23,2,47280,23,2,47717,6,23.25888921888938,-1.281613,36.8084651,-1.2571472,36.7950633,291,437,38,968
5300,13935,2619,2,Personal,26,3,38509,26,3,38554,26,3,38915,26,3,39156,26,3,39875,5,24.2,-1.2649605,36.7981777,-1.2795796,36.819062,726,719,45,602
5301,14450,2150,3,Business,12,3,54331,12,3,54496,12,3,57193,12,3,58906,12,3,58914,12,21.0,-1.331619,36.847976,-1.344446,36.756597,376,8,165,4410
5302,15159,391,3,Business,30,3,37668,30,3,37781,30,3,39133,30,3,39599,30,3,41656,5,22.6,-1.2777924,36.8231577,-1.3016417,36.8271679,844,2057,113,1818
5303,9840,213,1,Personal,6,1,30333,6,1,31067,6,1,31990,6,1,32350,6,1,34981,25,14.9,-1.3724141,36.926992,-1.3009477,36.7686733,932,2631,734,1283
5304,3231,3250,3,Business,9,5,42611,9,5,43570,9,5,45512,9,5,45804,9,5,48681,28,25.6,-1.3827933,36.7626219,-1.3433181,36.9138018,858,2877,959,2234
5305,26941,2933,2,Personal,1,3,50274,1,3,50328,1,3,51618,1,3,52386,1,3,53231,6,23.7,-1.311208,36.778743,-1.3052672,36.7538539,140,845,54,2058
5306,1272,1329,3,Business,28,5,35469,28,5,35485,28,5,36688,28,5,36820,28,5,37921,14,19.6,-1.273056,36.811298,-1.222849,36.8973875,698,1101,16,1335
5307,10665,944,1,Personal,17,3,35176,17,3,35209,17,3,35360,17,3,35952,17,3,37152,7,21.0,-1.255597,36.830024,-1.2964348,36.8182757,338,1200,33,743
5308,16373,3194,3,Business,29,3,39842,29,3,40089,29,3,40802,29,3,41462,29,3,43859,9,23.25888921888938,-1.3014461,36.7661381,-1.2551895,36.7822034,42,2397,247,1373
5309,2258,393,3,Business,26,2,35942,26,2,36006,26,2,36589,26,2,37582,26,2,39633,14,21.9,-1.3167113,36.8301563,-1.2991441,36.7528804,126,2051,64,1576
5310,15346,402,3,Business,7,5,55789,7,5,56073,7,5,56609,7,5,56835,7,5,61235,10,23.25888921888938,-1.2527958,36.7976244,-1.3038543,36.8381051,309,4400,284,762
5311,14672,1740,3,Personal,14,5,38205,14,5,38212,14,5,38782,14,5,39550,14,5,42706,16,24.3,-1.338579,36.8963038,-1.301953,36.788458,932,3156,7,1338
5312,6627,1402,3,Business,18,4,29707,18,4,29728,18,4,29758,18,4,31737,18,4,32109,2,23.25888921888938,-1.28878,36.8168312,-1.2813012,36.8323962,61,372,21,2009
5313,20736,548,3,Business,6,6,41245,6,6,42638,6,6,44155,6,6,44320,6,6,45655,15,24.3,-1.338484,36.883377,-1.2686413,36.8126976,179,1335,1393,1682
5314,6878,3035,3,Business,20,4,32776,20,4,32820,20,4,33118,20,4,33229,20,4,35336,11,18.3,-1.2963097,36.7688221,-1.257309,36.8060084,571,2107,44,409
5315,17425,738,3,Business,19,3,50198,19,3,50280,19,3,51633,19,3,52745,19,3,54858,10,25.5,-1.288148,36.7850276,-1.2601219,36.71530511,612,2113,82,2465
5316,27485,1104,2,Business,19,5,30373,19,5,30385,19,5,32431,19,5,32500,19,5,34441,29,20.4,-1.1874211,36.9286449,-1.2917989,36.7910266,704,1941,12,2115
5317,24838,265,3,Business,14,3,35403,14,3,37172,14,3,38245,14,3,39135,14,3,40290,16,24.6,-1.3429554,36.7262559,-1.300921,36.828195,555,1155,1769,1963
5318,8741,1568,3,Business,7,4,55798,7,4,55832,7,4,56366,7,4,56699,7,4,57898,8,20.3,-1.2972916,36.7880497,-1.2579304,36.8019667,663,1199,34,867
5319,2144,124,3,Personal,15,2,43985,15,2,44001,15,2,44640,15,2,45235,15,2,47819,21,22.9,-1.3192846,36.9205168,-1.271402,36.8238135,543,2584,16,1234
5320,15945,2330,3,Business,20,3,46821,20,3,46904,20,3,47260,20,3,47424,20,3,49579,9,20.4,-1.2671943,36.8062533,-1.2243841,36.8024757,268,2155,83,520
5321,13738,1410,3,Business,11,2,41167,11,2,41188,11,2,41191,11,2,43679,11,2,45423,20,19.3,-1.300921,36.828195,-1.2847613,36.967084,871,1744,21,2491
5322,22533,3404,3,Business,31,4,59474,31,4,59504,31,4,60293,31,4,61683,31,4,64244,15,27.6,-1.225322,36.80855,-1.2232123,36.8932547,895,2561,30,2179
5323,23500,393,3,Business,10,4,41598,10,4,42069,10,4,43315,10,4,43415,10,4,46234,14,24.8,-1.3167113,36.8301563,-1.306378,36.7519845,725,2819,471,1346
5324,24559,1335,3,Personal,10,1,40496,10,1,40540,10,1,41084,10,1,41228,10,1,42362,5,23.25888921888938,-1.2611987,36.8060913,-1.2549476,36.8269576,622,1134,44,688
5325,14261,3291,3,Business,15,6,35579,15,6,35650,15,6,36381,15,6,36986,15,6,38878,11,16.9,-1.2296618,36.8438272,-1.2600926,36.8088685,158,1892,71,1336
5326,2598,733,3,Business,2,4,50309,2,4,50400,2,4,50446,2,4,50930,2,4,52456,8,23.25888921888938,-1.2551895,36.7822034,-1.2962832,36.7849683,361,1526,91,530
5327,17266,1927,3,Business,7,2,52028,7,2,52076,7,2,52136,7,2,52762,7,2,57371,23,23.25888921888938,-1.2285835,36.8826468,-1.3472066,36.7692638,519,4609,48,686
5328,24125,3201,3,Business,14,1,55109,14,1,55534,14,1,56038,14,1,57566,14,1,58480,5,25.6,-1.2793686,36.8259233,-1.2584143,36.8048002,733,914,425,2032
5329,18186,111,3,Business,30,2,41873,30,2,41932,30,2,42369,30,2,42620,30,2,50007,13,22.3,-1.2551895,36.7822034,-1.3270347,36.8667362,937,7387,59,688
5330,26389,2828,3,Business,28,4,39696,28,4,39729,28,4,40058,28,4,40322,28,4,43079,13,23.25888921888938,-1.2615888,36.7928732,-1.3332749,36.8708147,326,2757,33,593
5331,20697,1796,3,Business,28,4,41748,28,4,41763,28,4,42195,28,4,42369,28,4,43070,7,23.7,-1.307143,36.825009,-1.331619,36.847976,127,701,15,606
5332,14078,909,3,Business,6,3,56083,6,3,56097,6,3,56960,6,3,57074,6,3,61535,7,27.6,-1.225322,36.80855,-1.2527958,36.8003131,428,4461,14,977
5333,24176,3667,3,Personal,22,5,41522,22,5,41638,22,5,44009,22,5,44225,22,5,45505,11,28.6,-1.2612574,36.7879622,-1.2295205,36.8120426,452,1280,116,2587
5334,22108,1953,3,Personal,4,4,55445,4,4,57463,4,4,58249,4,4,58719,4,4,60845,12,24.7,-1.2810889,36.8247135,-1.3050206,36.8997049,865,2126,2018,1256
5335,22051,1280,3,Business,4,1,57327,4,1,57339,4,1,57561,4,1,57859,4,1,57862,4,23.25888921888938,-1.2551895,36.7822034,-1.2617028,36.7983849,523,3,12,520
5336,12139,2718,3,Business,1,1,52148,1,1,52275,1,1,53006,1,1,53148,1,1,54283,11,23.25888921888938,-1.2668815,36.8017244,-1.2467429,36.7479091,955,1135,127,873
5337,28196,3355,3,Business,12,1,56034,12,1,56682,12,1,57907,12,1,57994,12,1,59414,9,26.8,-1.2859912,36.8756811,-1.3052491,36.8223899,31,1420,648,1312
5338,11758,3689,3,Business,23,4,54447,23,4,55449,23,4,55854,23,4,56393,23,4,57543,15,20.9,-1.2156006,36.8916865,-1.2527958,36.8003131,857,1150,1002,944
5339,24320,811,3,Personal,9,2,56702,9,2,56759,9,2,57555,9,2,57900,9,2,58464,6,30.7,-1.311706,36.802841,-1.2963097,36.7688221,61,564,57,1141
5340,3618,283,3,Business,1,3,53484,1,3,53489,1,3,53941,1,3,54409,1,3,56814,8,23.7,-1.2804227,36.8250375,-1.3025667,36.7803495,462,2405,5,920
5341,19573,517,3,Business,4,3,48559,4,3,48585,4,3,48982,4,3,50343,4,3,50358,8,18.3,-1.3177547,36.8303703,-1.2770708,36.8231093,656,15,26,1758
5342,22534,2982,3,Business,14,3,33213,14,3,33768,14,3,34483,14,3,36590,14,3,38690,18,18.3,-1.300921,36.828195,-1.177202,36.8351183,715,2100,555,2822
5343,20480,788,3,Business,27,4,42841,27,4,43222,27,4,44617,27,4,44765,27,4,46179,7,22.9,-1.225322,36.80855,-1.2605938,36.8073235,477,1414,381,1543
5344,14065,286,3,Business,6,4,35252,6,4,38501,6,4,42059,6,4,42899,6,4,45573,11,24.2,-1.3206929,36.8621776,-1.2962967,36.8020231,677,2674,3249,4398
5345,23236,1148,3,Business,12,2,36361,12,2,37351,12,2,39042,12,2,40930,12,2,42840,14,21.0,-1.3100586,36.8500329,-1.2294985,36.8775495,549,1910,990,3579
5346,14935,3080,3,Business,8,1,46824,8,1,46830,8,1,46873,8,1,47263,8,1,48108,8,24.3,-1.2551895,36.7822034,-1.2886166,36.7836803,731,845,6,433
5347,22028,264,1,Personal,26,6,58986,26,6,59073,26,6,60720,26,6,61083,26,6,62495,8,21.9,-1.2824079,36.8171287,-1.3203917,36.8334751,480,1412,87,2010
5348,26192,136,3,Business,3,1,53962,3,1,53978,3,1,55838,3,1,56234,3,1,60059,23,23.2,-1.2248308,36.8012573,-1.3169591,36.7000029,882,3825,16,2256
5349,24212,640,3,Business,27,1,38881,27,1,38998,27,1,39753,27,1,40213,27,1,41345,8,20.8,-1.2709035,36.8168523,-1.304033,36.7848695,341,1132,117,1215
5350,16306,1142,1,Personal,8,3,61693,8,3,61780,8,3,62341,8,3,62732,8,3,63500,4,23.9,-1.2652108,36.8056075,-1.2463211,36.789487,726,768,87,952
5351,11418,1620,1,Personal,9,6,36819,9,6,36898,9,6,37215,9,6,38822,9,6,40105,10,17.4,-1.2871215,36.822053,-1.227132,36.8374277,379,1283,79,1924
5352,19153,248,3,Business,30,5,32233,30,5,32273,30,5,32518,30,5,32814,30,5,34276,10,19.1,-1.304735,36.7846054,-1.3297531,36.7063699,356,1462,40,541
5353,13113,391,3,Business,29,5,59931,29,5,60430,29,5,62100,29,5,62344,29,5,63884,2,27.8,-1.2784063,36.8222933,-1.2870774,36.8259832,291,1540,499,1914
5354,4876,3239,3,Personal,11,1,40616,11,1,41304,11,1,43098,11,1,43219,11,1,44439,6,18.0,-1.2839322,36.8292426,-1.312469,36.815177,752,1220,688,1915
5355,5781,1271,3,Business,23,5,58881,23,5,59050,23,5,59880,23,5,60007,23,5,60785,8,24.7,-1.3244885,36.897792,-1.3332749,36.8708147,268,778,169,957
5356,8051,567,3,Business,31,4,32050,31,4,32153,31,4,32761,31,4,32986,31,4,33825,8,17.7,-1.296797,36.7764525,-1.2658335,36.8042867,735,839,103,833
5357,1967,2982,3,Business,25,5,39840,25,5,39900,25,5,41397,25,5,41790,25,5,43792,18,26.5,-1.300921,36.828195,-1.177202,36.8351183,263,2002,60,1890
5358,18485,3496,3,Business,21,5,40642,21,5,41598,21,5,42227,21,5,43250,21,5,46228,13,22.9,-1.356907,36.906808,-1.300921,36.828195,19,2978,956,1652
5359,28061,510,3,Business,19,3,58458,19,3,62766,19,3,63969,19,3,64126,19,3,66228,5,22.3,-1.2860183,36.8975338,-1.3142011,36.8993879,532,2102,4308,1360
5360,26605,3647,3,Business,4,4,57179,4,4,57190,4,4,58810,4,4,60450,4,4,60460,18,23.25888921888938,-1.272639,36.794723,-1.3390024,36.8746657,818,10,11,3260
5361,7835,391,3,Business,7,5,54235,7,5,55520,7,5,55525,7,5,58710,7,5,58713,4,23.25888921888938,-1.2867454,36.8259017,-1.300921,36.828195,855,3,1285,3190
5362,13631,3404,3,Business,12,2,41090,12,2,41841,12,2,43342,12,2,43836,12,2,45581,5,28.2,-1.2527958,36.8003131,-1.279395,36.825364,831,1745,751,1995
5363,9658,718,3,Business,28,4,56010,28,4,56110,28,4,56689,28,4,56766,28,4,57571,4,30.0,-1.2551895,36.7822034,-1.2753109,36.8130185,830,805,100,656
5364,17239,2523,3,Business,13,3,62216,13,3,62250,13,3,62587,13,3,62989,13,3,63661,8,26.0,-1.2551895,36.7822034,-1.2832259,36.7958373,205,672,34,739
5365,11684,3175,3,Business,5,1,49744,5,1,49841,5,1,51476,5,1,52644,5,1,52677,3,26.2,-1.2628638,36.8070399,-1.2681004,36.7952081,108,33,97,2803
5366,27024,3118,1,Personal,26,3,55827,26,3,56312,26,3,56771,26,3,57366,26,3,58374,5,27.2,-1.2861765,36.8209086,-1.307241,36.8302368,698,1008,485,1054
5367,10773,3194,3,Business,29,3,44871,29,3,44939,29,3,44974,29,3,45334,29,3,47531,9,23.25888921888938,-1.2551895,36.7822034,-1.249541,36.8329772,709,2197,68,395
5368,18712,1754,3,Business,15,5,34057,15,5,34071,15,5,35124,15,5,35521,15,5,36667,12,19.2,-1.2283403,36.8822756,-1.2860183,36.8975338,8,1146,14,1450
5369,9278,1410,3,Business,6,2,36787,6,2,36827,6,2,36834,6,2,39769,6,2,42352,20,24.8,-1.300921,36.828195,-1.2847613,36.967084,69,2583,40,2942
5370,20128,1271,3,Business,25,1,41081,25,1,41138,25,1,41526,25,1,42199,25,1,43258,9,25.4,-1.3244885,36.897792,-1.3223621,36.8459855,675,1059,57,1061
5371,2065,2342,2,Personal,12,3,48637,12,3,50014,12,3,51219,12,3,51487,12,3,52781,6,26.3,-1.3233991,36.8421894,-1.2872899,36.820434,698,1294,1377,1473
5372,18662,3631,3,Personal,10,5,44267,10,5,44304,10,5,44732,10,5,44827,10,5,45282,2,23.25888921888938,-1.2990817,36.7654866,-1.2963097,36.7688221,327,455,37,523
5373,4822,2436,3,Business,22,5,52262,22,5,52307,22,5,52378,22,5,53029,22,5,53031,2,27.5,-1.2551895,36.7822034,-1.2567464,36.7915273,56,2,45,722
5374,15109,2174,3,Business,12,2,35069,12,2,35079,12,2,35129,12,2,38266,12,2,39464,12,24.5,-1.2482781,36.884092,-1.2981239,36.8367977,510,1198,10,3187
5375,3248,1482,3,Business,27,3,49912,27,3,49920,27,3,49934,27,3,50846,27,3,52972,19,29.3,-1.1612629,36.8268239,-1.2649605,36.7981777,576,2126,8,926
5376,15830,2858,3,Business,7,5,46756,7,5,46769,7,5,47580,7,5,47659,7,5,50349,18,24.9,-1.3164106,36.6952197,-1.2534301,36.8000983,167,2690,13,890
5377,13675,2701,3,Business,22,3,35274,22,3,35289,22,3,36251,22,3,36397,22,3,38454,7,15.3,-1.279395,36.825364,-1.2551895,36.7822034,932,2057,15,1108
5378,23013,1731,1,Personal,15,5,43161,15,5,43277,15,5,45925,15,5,46078,15,5,47571,10,19.9,-1.302982,36.79458,-1.3228367,36.8543666,444,1493,116,2801
5379,121,3686,3,Business,15,5,39424,15,5,39435,15,5,39564,15,5,39886,15,5,40447,3,25.8,-1.2551895,36.7822034,-1.2575407,36.7868197,709,561,11,451
5380,1394,1927,3,Business,10,1,53132,10,1,53157,10,1,53297,10,1,53875,10,1,55428,10,18.4,-1.3165542,36.700067,-1.3472066,36.7692638,864,1553,25,718
5381,19273,2330,3,Business,12,5,69242,12,5,70296,12,5,70862,12,5,70926,12,5,72171,8,23.1,-1.2324923,36.8363775,-1.233018,36.8004477,484,1245,1054,630
5382,6845,2956,3,Business,8,3,57909,8,3,58026,8,3,59776,8,3,60333,8,3,61605,9,24.1,-1.3014461,36.7661381,-1.2584143,36.8048002,147,1272,117,2307
5383,11582,1195,3,Business,19,2,29590,19,2,29622,19,2,29760,19,2,30873,19,2,32015,4,20.9,-1.3228003,36.8306435,-1.2983042,36.8261141,901,1142,32,1251
5384,10949,2989,3,Business,31,3,40076,31,3,41518,31,3,41537,31,3,42908,31,3,44158,10,24.6,-1.3169591,36.7000029,-1.3463042,36.768164,631,1250,1442,1390
5385,3183,393,3,Business,15,2,36638,15,2,36643,15,2,36898,15,2,37681,15,2,39540,14,20.3,-1.3167113,36.8301563,-1.306378,36.7519845,523,1859,5,1038
5386,15201,1019,1,Personal,10,4,33789,10,4,33880,10,4,34828,10,4,35555,10,4,37349,9,18.4,-1.29387,36.7907813,-1.2515637,36.8119508,486,1794,91,1675
5387,6661,3426,3,Business,9,3,44560,9,3,44736,9,3,45343,9,3,45449,9,3,46755,9,25.1,-1.3165542,36.700067,-1.3012008,36.764868,544,1306,176,713
5388,13136,1497,3,Personal,12,4,45790,12,4,45845,12,4,46624,12,4,46730,12,4,47827,3,19.0,-1.299813,36.7871392,-1.2913246,36.8019522,898,1097,55,885
5389,25345,649,3,Business,24,5,35283,24,5,35356,24,5,35420,24,5,36604,24,5,38764,7,18.0,-1.2551895,36.7822034,-1.2854089,36.8284874,438,2160,73,1248
5390,14366,970,3,Business,30,3,47015,30,3,47096,30,3,47549,30,3,47969,30,3,48973,6,25.0,-1.2551895,36.7822034,-1.249526,36.7711579,925,1004,81,873
5391,19251,1850,3,Business,29,1,54981,29,1,56464,29,1,57202,29,1,58032,29,1,59531,6,24.2,-1.2551895,36.7822034,-1.2854989,36.8218183,56,1499,1483,1568
5392,26916,3718,3,Business,29,4,40365,29,4,40504,29,4,40808,29,4,41010,29,4,45777,5,21.3,-1.2650027,36.8126242,-1.2906618,36.8131222,268,4767,139,506
5393,8827,1329,3,Business,20,2,52369,20,2,52661,20,2,53770,20,2,53912,20,2,54938,5,23.8,-1.273056,36.811298,-1.2950408,36.8098172,247,1026,292,1251
5394,10289,1124,1,Business,15,1,28401,15,1,28462,15,1,30874,15,1,31495,15,1,32970,11,23.25888921888938,-1.269018,36.796803,-1.2812601,36.7340272,232,1475,61,3033
5395,12781,1329,3,Business,11,4,56560,11,4,56809,11,4,57966,11,4,58457,11,4,59321,8,27.0,-1.273056,36.811298,-1.321737,36.8179788,61,864,249,1648
5396,7665,1443,1,Personal,9,2,37274,9,2,37305,9,2,38369,9,2,39010,9,2,39696,6,22.0,-1.3056005,36.7567122,-1.2946818,36.7576745,46,686,31,1705
5397,12124,916,3,Business,18,6,32026,18,6,32037,18,6,32435,18,6,33912,18,6,35088,10,15.6,-1.301259,36.842244,-1.3321944,36.8892329,857,1176,11,1875
5398,17537,393,3,Business,7,5,34697,7,5,34743,7,5,34810,7,5,35231,7,5,35839,4,23.25888921888938,-1.3228003,36.8306435,-1.3004062,36.829741,35,608,46,488
5399,14919,2064,2,Personal,13,3,51739,13,3,51866,13,3,52205,13,3,56714,13,3,57277,2,23.5,-1.2689559,36.8097614,-1.2664882,36.8033374,116,563,127,4848
5400,20195,246,3,Business,1,7,49892,1,7,49907,1,7,51489,1,7,52046,1,7,52808,15,23.2,-1.2297202,36.8745508,-1.2584143,36.8048002,265,762,15,2139
5401,7039,867,3,Business,18,1,52292,18,1,52360,18,1,52368,18,1,52494,18,1,54391,14,29.4,-1.3077869,36.8443207,-1.2991441,36.7528804,831,1897,68,134
5402,23076,1471,3,Business,15,5,52458,15,5,52630,15,5,53182,15,5,53794,15,5,55089,8,28.1,-1.2551895,36.7822034,-1.2972916,36.7880497,669,1295,172,1164
5403,22206,393,3,Business,5,2,44189,5,2,44199,5,2,44207,5,2,45791,5,2,46327,4,23.8,-1.3167113,36.8301563,-1.3004062,36.829741,523,536,10,1592
5404,16009,3560,3,Business,18,3,39034,18,3,39105,18,3,39630,18,3,40580,18,3,42514,8,20.0,-1.3014461,36.7661381,-1.279395,36.825364,234,1934,71,1475
5405,27365,1102,3,Business,28,2,46732,28,2,46759,28,2,48587,28,2,48860,28,2,50501,15,19.6,-1.3004062,36.829741,-1.2630429,36.7518974,207,1641,27,2101
5406,25464,1071,1,Personal,12,4,55757,12,4,55776,12,4,55787,12,4,55929,12,4,56551,2,21.5,-1.2695287,36.7981777,-1.2728425,36.791039,338,622,19,153
5407,7336,3149,3,Business,20,1,38152,20,1,38197,20,1,38888,20,1,39359,20,1,42914,12,23.25888921888938,-1.3167113,36.8301563,-1.276954,36.765926,223,3555,45,1162
5408,10323,2174,3,Business,9,2,41987,9,2,42093,9,2,42454,9,2,46193,9,2,48702,16,26.8,-1.2482781,36.884092,-1.2979242,36.7902416,216,2509,106,4100
5409,26145,1402,3,Business,11,2,52070,11,2,53334,11,2,54305,11,2,56143,11,2,57508,6,21.4,-1.2571472,36.7950633,-1.2813012,36.8323962,109,1365,1264,2809
5410,13883,3149,3,Business,28,3,51682,28,3,51709,28,3,51715,28,3,53211,28,3,53215,5,23.25888921888938,-1.3004062,36.829741,-1.3177547,36.8303703,619,4,27,1502
5411,8998,1250,1,Personal,31,2,59998,31,2,60053,31,2,61202,31,2,62583,31,2,64900,12,19.8,-1.2620741,36.8158147,-1.3014461,36.7661381,882,2317,55,2530
5412,18493,3674,3,Business,4,2,52041,4,2,52319,4,2,52324,4,2,55627,4,2,55642,7,22.5,-1.2551895,36.7822034,-1.2867809,36.8218665,855,15,278,3308
5413,18582,2523,3,Business,8,3,36355,8,3,36421,8,3,36975,8,3,37084,8,3,38988,15,17.5,-1.2551895,36.7822034,-1.218673,36.8888713,415,1904,66,663
5414,20754,2344,3,Business,31,4,42375,31,4,42404,31,4,43319,31,4,43405,31,4,44241,8,26.3,-1.2551895,36.7822034,-1.2985749,36.8088,862,836,29,1001
5415,3065,3283,3,Business,21,3,32693,21,3,32713,21,3,34930,21,3,37506,21,3,39003,14,17.1,-1.228911,36.881876,-1.2628473,36.781805,237,1497,20,4793
5416,12838,186,3,Business,8,5,32405,8,5,32493,8,5,33409,8,5,34237,8,5,35072,7,22.8,-1.2825816,36.8092346,-1.2571472,36.7950633,259,835,88,1744
5417,17485,296,3,Business,28,4,33774,28,4,33809,28,4,34203,28,4,34987,28,4,36124,5,19.4,-1.2571472,36.7950633,-1.279395,36.825364,24,1137,35,1178
5418,15580,2091,1,Personal,23,6,50379,23,6,50410,23,6,51236,23,6,51731,23,6,54090,14,23.25888921888938,-1.2731645,36.7902246,-1.3371926,36.7250933,858,2359,31,1321
5419,1249,1162,2,Business,28,5,31759,28,5,31835,28,5,32853,28,5,33284,28,5,33969,4,20.8,-1.312261,36.794658,-1.2883346,36.8148489,208,685,76,1449
5420,17699,3283,3,Business,10,1,38459,10,1,40770,10,1,41580,10,1,44316,10,1,44573,7,18.6,-1.303596,36.778378,-1.2628473,36.781805,864,257,2311,3546
5421,1565,2801,3,Business,30,5,38409,30,5,38543,30,5,39155,30,5,39434,30,5,40800,11,23.6,-1.2595422,36.7871178,-1.307726,36.839117,623,1366,134,891
5422,14686,372,1,Business,6,3,39561,6,3,42563,6,3,43649,6,3,43913,6,3,45916,8,19.8,-1.2765736,36.8513646,-1.324462,36.867212,616,2003,3002,1350
5423,20274,393,3,Business,1,4,36772,1,4,36823,1,4,36831,1,4,37370,1,4,38145,8,23.25888921888938,-1.3177547,36.8303703,-1.2770708,36.8231093,128,775,51,547
5424,889,2984,1,Personal,13,3,31761,13,3,32116,13,3,33994,13,3,34523,13,3,35530,6,16.1,-1.2623805,36.7805404,-1.2772403,36.8196193,752,1007,355,2407
5425,1764,867,3,Business,10,3,52416,10,3,52431,10,3,52435,10,3,52720,10,3,55434,16,30.4,-1.2991441,36.7528804,-1.2996533,36.8292629,394,2714,15,289
5426,630,2150,3,Business,29,5,34045,29,5,34633,29,5,35699,29,5,36228,29,5,37425,12,20.8,-1.331619,36.847976,-1.344446,36.756597,459,1197,588,1595
5427,3296,868,3,Business,18,4,39299,18,4,39314,18,4,39320,18,4,39661,18,4,40451,9,23.25888921888938,-1.2296618,36.8438272,-1.265715,36.823815,7,790,15,347
5428,3412,123,3,Business,29,1,42623,29,1,42637,29,1,44313,29,1,45183,29,1,47501,12,23.25888921888938,-1.2404912,36.8847788,-1.2731645,36.7900343,612,2318,14,2546
5429,17342,868,3,Business,15,3,46507,15,3,46588,15,3,46960,15,3,47523,15,3,49211,8,23.25888921888938,-1.303596,36.778378,-1.265715,36.823815,675,1688,81,935
5430,4672,2801,3,Business,7,5,56420,7,5,56797,7,5,58988,7,5,59178,7,5,60697,9,24.7,-1.2595422,36.7871178,-1.297694,36.749788,517,1519,377,2381
5431,6274,635,3,Business,7,2,39720,7,2,39745,7,2,40606,7,2,42367,7,2,43826,8,23.3,-1.3016417,36.8271679,-1.2599563,36.7993439,519,1459,25,2622
5432,18382,3686,3,Business,12,2,39345,12,2,39405,12,2,39414,12,2,39903,12,2,41296,9,28.1,-1.2551895,36.7822034,-1.3090727,36.8315262,518,1393,60,498
5433,12191,53,3,Business,1,5,52367,1,5,52675,1,5,54072,1,5,54447,1,5,56681,5,32.1,-1.3004062,36.829741,-1.2770708,36.8231093,17,2234,308,1772
5434,18598,2415,1,Personal,23,6,32064,23,6,32347,23,6,32925,23,6,33029,23,6,34015,9,23.25888921888938,-1.2864025,36.8175763,-1.3272104,36.8528418,752,986,283,682
5435,8417,2174,3,Business,12,5,35113,12,5,35118,12,5,35600,12,5,35979,12,5,38052,21,18.6,-1.2482781,36.884092,-1.1456993,36.9499598,12,2073,5,861
5436,5149,2982,3,Business,27,3,37013,27,3,37019,27,3,37060,27,3,39465,27,3,40636,10,23.25888921888938,-1.300921,36.828195,-1.2797184,36.7811448,771,1171,6,2446
5437,2509,3403,3,Business,6,3,34796,6,3,34900,6,3,35239,6,3,35512,6,3,36681,8,16.2,-1.2553615,36.7895376,-1.2866816,36.7871863,727,1169,104,612
5438,11545,2229,3,Business,14,5,48361,14,5,48389,14,5,48594,14,5,49029,14,5,50908,20,22.8,-1.3247683,36.85803,-1.2355327,36.8822975,364,1879,28,640
5439,2291,1245,3,Business,15,3,50706,15,3,50762,15,3,51504,15,3,53203,15,3,54844,17,26.0,-1.300921,36.828195,-1.3198615,36.7110323,211,1641,56,2441
5440,18881,1246,3,Business,14,3,38342,14,3,38358,14,3,38768,14,3,39033,14,3,39928,2,24.5,-1.2571472,36.7950633,-1.2682478,36.8072852,566,895,16,675
5441,1242,393,3,Business,8,5,43794,8,5,43835,8,5,44369,8,5,44969,8,5,44972,4,24.3,-1.3167113,36.8301563,-1.3004062,36.829741,903,3,41,1134
5442,7903,2074,2,Personal,13,5,35834,13,5,36034,13,5,36574,13,5,36721,13,5,37792,5,15.4,-1.2741728,36.7969108,-1.2949474,36.8270407,722,1071,200,687
5443,2041,963,2,Personal,11,1,44771,11,1,44938,11,1,45559,11,1,45976,11,1,47376,9,18.2,-1.2874127,36.8247663,-1.3332749,36.8708147,820,1400,167,1038
5444,895,2271,3,Business,31,4,61478,31,4,61537,31,4,63743,31,4,64626,31,4,66739,15,27.3,-1.2296618,36.8438272,-1.293515,36.897607,775,2113,59,3089
5445,10314,2931,3,Business,1,5,53902,1,5,54148,1,5,55868,1,5,57013,1,5,59590,29,28.5,-1.3433181,36.9138018,-1.3169591,36.7000029,548,2577,246,2865
5446,26870,914,3,Business,22,5,41962,22,5,42210,22,5,43573,22,5,43878,22,5,43916,6,23.25888921888938,-1.2670213,36.7994482,-1.2989287,36.8163082,19,38,248,1668
5447,10555,2154,3,Business,4,4,53976,4,4,54011,4,4,54988,4,4,55919,4,4,57812,20,27.1,-1.3705766,36.9120742,-1.2765736,36.8513646,877,1893,35,1908
5448,3266,1249,3,Business,15,5,59557,15,5,60331,15,5,61805,15,5,61981,15,5,64372,18,27.8,-1.3189252,36.8617269,-1.3516579,36.7298363,856,2391,774,1650
5449,19884,665,1,Business,5,5,47739,5,5,47852,5,5,49166,5,5,49746,5,5,52014,18,26.6,-1.2859912,36.8756811,-1.279767,36.7695313,900,2268,113,1894
5450,10579,3521,3,Business,29,5,48726,29,5,48844,29,5,50423,29,5,50764,29,5,51173,1,29.1,-1.2723298,36.8037146,-1.2696908,36.81519,547,409,118,1920
5451,26138,444,2,Business,27,5,49968,27,5,49978,27,5,51637,27,5,51753,27,5,53745,6,24.1,-1.2763548,36.8218713,-1.2672426,36.7884223,229,1992,10,1775
5452,16723,2200,3,Business,10,1,54130,10,1,54823,10,1,56196,10,1,57049,10,1,60361,10,23.25888921888938,-1.290894,36.822971,-1.2413316,36.8785525,537,3312,693,2226
5453,15740,1961,3,Business,30,4,42110,30,4,42433,30,4,42713,30,4,43702,30,4,45778,25,23.25888921888938,-1.3393547,36.8910035,-1.3188359,36.7038526,675,2076,323,1269
5454,26639,1880,3,Business,8,2,44749,8,2,44771,8,2,45866,8,2,46221,8,2,47066,3,23.5,-1.2571472,36.7950633,-1.2663778,36.8076024,425,845,22,1450
5455,3715,1471,3,Business,26,1,46979,26,1,47636,26,1,47807,26,1,47876,26,1,50422,10,23.1,-1.2551895,36.7822034,-1.2967108,36.7871135,674,2546,657,240
5456,2427,2344,3,Business,11,1,44494,11,1,44683,11,1,44753,11,1,45686,11,1,49059,23,18.1,-1.2551895,36.7822034,-1.3447079,36.91105,379,3373,189,1003
5457,15248,928,3,Business,22,3,56684,22,3,56748,22,3,57420,22,3,57845,22,3,58944,8,24.3,-1.2551895,36.7822034,-1.2944702,36.8009707,138,1099,64,1097
5458,26926,2271,3,Business,30,2,50365,30,2,50583,30,2,53001,30,2,53327,30,2,56040,17,23.25888921888938,-1.293515,36.897607,-1.2600926,36.8088685,883,2713,218,2744
5459,18157,391,3,Business,3,1,49399,3,1,49464,3,1,50485,3,1,50592,3,1,51918,5,23.0,-1.300921,36.828195,-1.2867454,36.8259017,158,1326,65,1128
5460,965,649,3,Business,12,2,34963,12,2,34983,12,2,35295,12,2,37158,12,2,39761,22,21.0,-1.2551895,36.7822034,-1.3562374,36.9042954,177,2603,20,2175
5461,15878,1976,3,Business,29,1,40128,29,1,40147,29,1,40801,29,1,41235,29,1,43463,15,23.25888921888938,-1.257028,36.7810435,-1.3274779,36.7814225,731,2228,19,1088
5462,8567,2,1,Personal,15,3,35725,15,3,35789,15,3,36377,15,3,36800,15,3,38570,6,16.3,-1.280467,36.7859296,-1.2916556,36.8262516,592,1770,64,1011
5463,26687,852,2,Personal,5,4,45736,5,4,46048,5,4,46562,5,4,47039,5,4,48383,8,23.25888921888938,-1.298066,36.7767095,-1.264788,36.7883897,24,1344,312,991
5464,14093,517,3,Business,14,6,38158,14,6,38228,14,6,38620,14,6,39204,14,6,39537,7,17.8,-1.3177547,36.8303703,-1.3012842,36.8561033,687,333,70,976
5465,501,357,3,Business,26,5,55718,26,5,56307,26,5,56921,26,5,57217,26,5,58112,3,23.25888921888938,-1.2945179,36.7685349,-1.2955334,36.7742857,770,895,589,910
5466,15770,3627,1,Personal,30,1,51732,30,1,51849,30,1,57290,30,1,58084,30,1,59939,6,20.5,-1.2395181,36.765513,-1.2655332,36.8094648,519,1855,117,6235
5467,23194,3300,3,Business,2,4,35423,2,4,35477,2,4,36187,2,4,36458,2,4,38090,16,23.25888921888938,-1.2296618,36.8438272,-1.303596,36.778378,8,1632,54,981
5468,9097,2102,3,Business,11,5,54227,11,5,54235,11,5,54838,11,5,55040,11,5,56616,15,26.4,-1.3323107,36.8692616,-1.2613768,36.8019418,622,1576,8,805
5469,20646,3091,3,Business,9,2,60601,9,2,60633,9,2,61062,9,2,61709,9,2,63237,6,27.9,-1.2584143,36.8048002,-1.290894,36.822971,394,1528,32,1076
5470,7990,2159,3,Business,14,2,54324,14,2,54337,14,2,54565,14,2,56444,14,2,57635,12,24.1,-1.3354923,36.8598156,-1.304735,36.7846054,882,1191,13,2107
5471,22116,515,3,Business,2,4,55096,2,4,55132,2,4,55667,2,4,56013,2,4,58653,7,26.0,-1.2901131,36.7923153,-1.2574088,36.799712,100,2640,36,881
5472,27553,3647,3,Business,16,2,50150,16,2,50189,16,2,50746,16,2,50956,16,2,51881,8,27.4,-1.272639,36.794723,-1.2653185,36.8358841,22,925,39,767
5473,9806,3687,1,Personal,28,5,32076,28,5,32091,28,5,33068,28,5,34536,28,5,37643,24,20.5,-1.207546,36.7913976,-1.3074581,36.7434,101,3107,15,2445
5474,1010,1754,3,Business,6,2,35417,6,2,35441,6,2,35679,6,2,36099,6,2,37722,13,20.0,-1.2283403,36.8822756,-1.2860183,36.8975338,803,1623,24,658
5475,23143,3698,3,Business,11,4,55822,11,4,58921,11,4,60107,11,4,60504,11,4,61995,10,26.4,-1.3107918,36.761794,-1.2863907,36.8194287,205,1491,3099,1583
5476,2119,1271,3,Business,25,5,47094,25,5,47128,25,5,47991,25,5,51142,25,5,53384,11,29.0,-1.3107918,36.761794,-1.30393,36.826136,540,2242,34,4014
5477,520,1341,3,Business,10,5,50306,10,5,50347,10,5,52538,10,5,52684,10,5,54480,13,23.25888921888938,-1.303596,36.778378,-1.331619,36.847976,907,1796,41,2337
5478,496,3738,3,Business,1,3,64678,1,3,64692,1,3,64763,1,3,65700,1,3,66710,7,23.4,-1.2584143,36.8048002,-1.2857671,36.7875614,648,1010,14,1008
5479,13420,2102,3,Business,31,5,41620,31,5,41765,31,5,41971,31,5,42657,31,5,44648,11,21.5,-1.3323107,36.8692616,-1.296965,36.8065678,856,1991,145,892
5480,11643,2302,1,Personal,1,3,60628,1,3,60660,1,3,61258,1,3,61602,1,3,62229,2,23.3,-1.2913382,36.8018508,-1.287429,36.786357,263,627,32,942
5481,7178,2535,2,Personal,5,3,49008,5,3,49052,5,3,50369,5,3,50530,5,3,52594,5,23.9,-1.294221,36.7719395,-1.3095597,36.797295,88,2064,44,1478
5482,10465,795,3,Personal,5,2,39467,5,2,39590,5,2,41488,5,2,41800,5,2,42776,6,21.3,-1.34338,36.711834,-1.3104734,36.7363698,116,976,123,2210
5483,747,635,3,Business,13,4,56067,13,4,58912,13,4,59075,13,4,59244,13,4,60291,8,26.3,-1.2599563,36.7993439,-1.2633397,36.7454238,216,1047,2845,332
5484,5226,2154,3,Business,16,3,59620,16,3,59655,16,3,60278,16,3,60715,16,3,61903,6,23.2,-1.279395,36.825364,-1.2765736,36.8513646,31,1188,35,1060
5485,7607,2118,1,Personal,4,4,71049,4,4,71072,4,4,71905,4,4,72319,4,4,73091,5,23.25888921888938,-1.2952098,36.7825532,-1.265432,36.795034,578,772,23,1247
5486,9326,3710,3,Business,5,3,49730,5,3,50745,5,3,51156,5,3,51367,5,3,52126,4,24.8,-1.2551895,36.7822034,-1.2689924,36.798157,167,759,1015,622
5487,856,1245,3,Business,27,6,36742,27,6,36763,27,6,36772,27,6,38192,27,6,40229,16,23.25888921888938,-1.2602337,36.7990548,-1.3198615,36.7110323,61,2037,21,1429
5488,2822,346,3,Business,19,2,49346,19,2,50623,19,2,52660,19,2,53718,19,2,55916,14,30.1,-1.2232123,36.8932547,-1.28878,36.8168312,377,2198,1277,3095
5489,10598,136,3,Business,11,5,48200,11,5,48254,11,5,48527,11,5,49340,11,5,52191,18,22.7,-1.2914795,36.8248973,-1.3326173,36.7146233,805,2851,54,1086
5490,2502,2216,3,Business,17,5,57320,17,5,57439,17,5,57502,17,5,59182,17,5,60782,8,23.25888921888938,-1.2551895,36.7822034,-1.2824577,36.7967953,709,1600,119,1743
5491,10648,1209,3,Business,10,5,37468,10,5,37511,10,5,37521,10,5,38703,10,5,40819,9,23.25888921888938,-1.2638185,36.7930057,-1.3004062,36.829741,79,2116,43,1192
5492,28054,2700,3,Business,22,4,48649,22,4,49456,22,4,49861,22,4,52681,22,4,53765,7,26.5,-1.301809,36.75643,-1.2845835,36.8079121,237,1084,807,3225
5493,1161,3517,3,Business,14,2,54566,14,2,54962,14,2,56845,14,2,58542,14,2,59904,6,23.25888921888938,-1.300921,36.828195,-1.3015998,36.8764939,20,1362,396,3580
5494,26590,2789,3,Business,20,3,44507,20,3,44567,20,3,44953,20,3,45216,20,3,47742,7,26.3,-1.304735,36.7846054,-1.2668815,36.8017244,24,2526,60,649
5495,23736,2344,3,Business,6,2,44926,6,2,45320,6,2,45360,6,2,46207,6,2,47390,10,25.2,-1.2551895,36.7822034,-1.2999305,36.843617,38,1183,394,887
5496,5075,3647,3,Business,10,4,58506,10,4,58562,10,4,59063,10,4,59130,10,4,60297,3,25.0,-1.272639,36.794723,-1.2729843,36.8105717,569,1167,56,568
5497,21757,778,3,Business,21,5,29462,21,5,29797,21,5,31114,21,5,31697,21,5,32821,6,19.3,-1.2771155,36.82668,-1.2535486,36.7933541,26,1124,335,1900
5498,14974,3689,3,Business,27,1,52005,27,1,52030,27,1,53196,27,1,54324,27,1,55209,6,23.25888921888938,-1.2904016,36.8226303,-1.2527958,36.8003131,88,885,25,2294
5499,11185,1363,3,Business,8,2,43757,8,2,43792,8,2,44124,8,2,45586,8,2,46388,5,23.2,-1.3004062,36.829741,-1.3228003,36.8306435,576,802,35,1794
5500,17211,867,3,Business,26,2,50567,26,2,50589,26,2,50607,26,2,51274,26,2,53293,15,29.8,-1.2991441,36.7528804,-1.3228003,36.8306435,154,2019,22,685
5501,13334,1882,3,Business,19,2,57191,19,2,57262,19,2,57349,19,2,57874,19,2,62282,6,29.3,-1.2956882,36.7861845,-1.2591019,36.800577,436,4408,71,612
5502,2470,3291,3,Business,22,4,39156,22,4,39199,22,4,39432,22,4,39506,22,4,39899,2,22.7,-1.2673935,36.8030328,-1.2600926,36.8088685,727,393,43,307
5503,27626,1500,3,Business,28,5,57506,28,5,57511,28,5,57618,28,5,57895,28,5,58710,13,25.6,-1.2574219,36.7927073,-1.3228003,36.8306435,619,815,5,384
5504,18099,2330,3,Business,5,2,59044,5,2,60783,5,2,61500,5,2,61709,5,2,63524,8,24.8,-1.3015197,36.7658456,-1.293082,36.8278578,75,1815,1739,926
5505,12713,592,1,Personal,18,3,51034,18,3,51057,18,3,51463,18,3,51910,18,3,53563,14,20.6,-1.2884354,36.7606766,-1.3239488,36.8316835,726,1653,23,853
5506,13856,1927,3,Business,6,1,56686,6,1,56706,6,1,56904,6,1,57987,6,1,59576,19,23.25888921888938,-1.3562374,36.9042954,-1.3472066,36.7692638,484,1589,20,1281
5507,5547,2181,2,Personal,30,1,30738,30,1,36080,30,1,37108,30,1,37352,30,1,38269,8,16.5,-1.2665974,36.7921181,-1.293278,36.827789,648,917,5342,1272
5508,4441,1590,2,Personal,21,5,54716,21,5,54761,21,5,54780,21,5,55231,21,5,55722,3,27.3,-1.2854453,36.8188363,-1.2861874,36.8128448,320,491,45,470
5509,23849,432,3,Business,13,1,47979,13,1,48189,13,1,49178,13,1,50069,13,1,52196,9,23.25888921888938,-1.279395,36.825364,-1.3012008,36.764868,155,2127,210,1880
5510,1694,1831,3,Business,15,5,61416,15,5,61715,15,5,61937,15,5,62520,15,5,65899,17,27.7,-1.279448,36.823568,-1.3632162,36.9108253,953,3379,299,805
5511,24118,1271,3,Business,8,1,45225,8,1,45448,8,1,46083,8,1,47016,8,1,49670,28,24.7,-1.3244885,36.897792,-1.3921859,36.740959,86,2654,223,1568
5512,14732,1500,3,Business,25,4,55588,25,4,59063,25,4,60496,25,4,60609,25,4,62622,9,23.25888921888938,-1.2574219,36.7927073,-1.3004062,36.829741,219,2013,3475,1546
5513,13849,1500,3,Business,22,3,45043,22,3,45086,22,3,45607,22,3,45726,22,3,46743,9,23.3,-1.2638185,36.7930057,-1.3004062,36.829741,161,1017,43,640
5514,7857,928,3,Business,30,4,57752,30,4,57845,30,4,58262,30,4,58723,30,4,59815,8,23.25888921888938,-1.2551895,36.7822034,-1.2937193,36.8236214,491,1092,93,878
5515,8132,2982,3,Business,19,2,58314,19,2,58327,19,2,59067,19,2,59148,19,2,61855,13,30.0,-1.307164,36.8347807,-1.2210156,36.855674,448,2707,13,821
5516,24004,1552,1,Personal,28,5,40450,28,5,40482,28,5,42042,28,5,42386,28,5,43583,3,25.3,-1.2755029,36.813658,-1.2610283,36.7936286,844,1197,32,1904
5517,7169,3560,3,Business,4,1,56712,4,1,57232,4,1,57845,4,1,58492,4,1,59693,11,23.25888921888938,-1.2283403,36.8822756,-1.279395,36.825364,942,1201,520,1260
5518,13530,3560,3,Business,9,3,46913,9,3,47066,9,3,48756,9,3,48923,9,3,51335,9,25.5,-1.279395,36.825364,-1.2413316,36.8785525,436,2412,153,1857
5519,13098,636,1,Personal,7,4,54570,7,4,54881,7,4,56260,7,4,57283,7,4,59755,15,20.0,-1.2245407,36.7583778,-1.3034735,36.7986213,808,2472,311,2402
5520,15485,20,3,Business,5,5,30344,5,5,30374,5,5,31148,5,5,31529,5,5,33389,14,19.9,-1.2629666,36.8068369,-1.3278522,36.8711134,99,1860,30,1155
5521,23352,2666,3,Personal,28,4,35751,28,4,35792,28,4,37506,28,4,37887,28,4,40741,16,23.25888921888938,-1.2859912,36.8756811,-1.2615888,36.7928732,906,2854,41,2095
5522,9802,635,3,Business,12,5,57333,12,5,57481,12,5,58039,12,5,59464,12,5,60935,10,23.25888921888938,-1.3081376,36.8329772,-1.2602337,36.7990548,25,1471,148,1983
5523,3272,1051,3,Business,29,1,40833,29,1,40877,29,1,40885,29,1,41318,29,1,43223,21,23.25888921888938,-1.2963097,36.7688221,-1.3160977,36.9131642,397,1905,44,441
5524,7909,3125,1,Personal,29,3,54450,29,3,54542,29,3,55098,29,3,55376,29,3,56521,8,19.0,-1.2672213,36.8275035,-1.3068448,36.8348641,423,1145,92,834
5525,16406,646,3,Personal,15,1,50330,15,1,50352,15,1,50520,15,1,50811,15,1,52950,6,23.25888921888938,-1.2951264,36.798382,-1.2665327,36.8108799,195,2139,22,459
5526,2496,3283,3,Business,8,6,45386,8,6,45450,8,6,46573,8,6,47073,8,6,48166,14,20.0,-1.228911,36.881876,-1.2628473,36.781805,8,1093,64,1623
5527,25082,635,3,Business,2,4,44924,2,4,47595,2,4,49067,2,4,49188,2,4,50837,7,23.25888921888938,-1.3081376,36.8329772,-1.2705336,36.7943509,106,1649,2671,1593
5528,16653,2956,3,Business,4,3,38033,4,3,38058,4,3,38531,4,3,39639,4,3,41990,17,17.1,-1.3165542,36.700067,-1.2584143,36.8048002,636,2351,25,1581
5529,5921,3291,3,Business,16,4,54702,16,4,54737,16,4,55517,16,4,56038,16,4,56764,6,23.25888921888938,-1.318062,36.849326,-1.331619,36.847976,910,726,35,1301
5530,6333,2174,3,Business,27,3,36322,27,3,36353,27,3,36359,27,3,39986,27,3,40953,14,26.2,-1.2482781,36.884092,-1.263736,36.780353,86,967,31,3633
5531,4805,2150,3,Business,10,3,39080,10,3,39112,10,3,39148,10,3,41045,10,3,41515,12,27.9,-1.331619,36.847976,-1.344446,36.756597,459,470,32,1933
5532,20786,142,3,Business,28,2,50662,28,2,50662,28,2,50880,28,2,53153,28,2,59731,11,23.3,-1.2963097,36.7688221,-1.2568865,36.7945489,71,6578,0,2491
5533,21584,12,3,Business,9,3,39754,9,3,40770,9,3,42848,9,3,42910,9,3,44915,9,25.1,-1.240021,36.84999,-1.2864963,36.8252086,48,2005,1016,2140
5534,12049,393,3,Business,26,2,45212,26,2,45299,26,2,45303,26,2,45601,26,2,46623,3,26.3,-1.3167113,36.8301563,-1.3210541,36.8169608,901,1022,87,302
5535,18021,2457,3,Business,30,2,43106,30,2,43257,30,2,43754,30,2,43939,30,2,46654,8,22.5,-1.2551895,36.7822034,-1.3025131,36.817387,290,2715,151,682
5536,4617,3051,3,Personal,27,3,43173,27,3,43245,27,3,43714,27,3,44098,27,3,44781,3,26.2,-1.2702333,36.80065,-1.2736498,36.8061911,228,683,72,853
5537,21300,2595,1,Personal,29,5,64598,29,5,64700,29,5,65990,29,5,66100,29,5,68799,12,20.7,-1.2851603,36.8249667,-1.2777824,36.8977804,549,2699,102,1400
5538,18230,635,3,Business,17,4,46082,17,4,46102,17,4,46482,17,4,49055,17,4,50893,11,28.1,-1.3081376,36.8329772,-1.2771412,36.766146,936,1838,20,2953
5539,1663,1245,3,Business,26,2,45119,26,2,45131,26,2,45293,26,2,50649,26,2,54263,17,31.2,-1.300921,36.828195,-1.3198615,36.7110323,459,3614,12,5518
5540,17085,393,3,Business,4,6,30570,4,6,31506,4,6,32195,4,6,32852,4,6,34586,14,15.6,-1.3177547,36.8303703,-1.306378,36.7519845,345,1734,936,1346
5541,24104,1059,1,Personal,11,2,36343,11,2,36437,11,2,37132,11,2,37425,11,2,38940,11,18.4,-1.3303649,36.7260187,-1.296567,36.7813901,263,1515,94,988
5542,12957,393,3,Business,8,1,44881,8,1,44916,8,1,45557,8,1,45943,8,1,47618,14,28.1,-1.3167113,36.8301563,-1.2991441,36.7528804,728,1675,35,1027
5543,15344,2167,3,Personal,16,2,31707,16,2,31770,16,2,33265,16,2,33361,16,2,34688,10,23.25888921888938,-1.3187647,36.8004283,-1.2625087,36.8263725,933,1327,63,1591
5544,2985,3711,3,Business,25,5,37967,25,5,38279,25,5,38753,25,5,39304,25,5,42801,9,26.4,-1.3025826,36.7670807,-1.291768,36.8297208,210,3497,312,1025
5545,6918,754,3,Business,10,3,46908,10,3,46930,10,3,47292,10,3,52233,10,3,52698,5,30.4,-1.3173869,36.8112044,-1.2977387,36.8031447,438,465,22,5303
5546,6752,893,3,Business,19,1,59284,19,1,59301,19,1,59983,19,1,60275,19,1,62018,11,23.7,-1.2146739,36.8560568,-1.2641579,36.8216792,685,1743,17,974
5547,19857,265,3,Business,26,5,28470,26,5,28498,26,5,28534,26,5,31010,26,5,31455,5,23.25888921888938,-1.327371,36.840591,-1.300921,36.828195,69,445,28,2512
5548,21697,1340,3,Business,1,1,30943,1,1,31039,1,1,31441,1,1,31796,1,1,32517,4,21.3,-1.2707179,36.7979713,-1.2734594,36.8170558,99,721,96,757
5549,24995,1927,3,Business,2,6,40852,2,6,40913,2,6,43144,2,6,43729,2,6,45974,19,27.4,-1.2927792,36.9053492,-1.3472066,36.7692638,237,2245,61,2816
5550,27717,2314,2,Personal,4,1,39519,4,1,41067,4,1,42354,4,1,44453,4,1,46140,10,21.1,-1.3406072,36.887746,-1.310796,36.86283,844,1687,1548,3386
5551,13097,2801,3,Business,4,3,56075,4,3,56209,4,3,57331,4,3,58384,4,3,59493,6,18.3,-1.2765492,36.7669809,-1.2885417,36.8100523,101,1109,134,2175
5552,17438,432,3,Business,28,2,48399,28,2,48515,28,2,51875,28,2,53033,28,2,54761,12,23.6,-1.2765736,36.8513646,-1.3012008,36.764868,855,1728,116,4518
5553,15507,2330,3,Business,29,1,45814,29,1,45833,29,1,45851,29,1,46896,29,1,48468,13,23.25888921888938,-1.2890715,36.8157588,-1.2124582,36.802894,812,1572,19,1063
5554,21238,2587,3,Business,12,5,54244,12,5,54988,12,5,57120,12,5,57794,12,5,58624,2,27.3,-1.290894,36.822971,-1.28878,36.8168312,656,830,744,2806
5555,6897,635,3,Business,5,5,47077,5,5,48797,5,5,50455,5,5,50875,5,5,51513,3,26.4,-1.2534952,36.7825215,-1.2602337,36.7990548,770,638,1720,2078
5556,4711,3540,3,Personal,31,4,33446,31,4,33457,31,4,33631,31,4,34000,31,4,34599,6,20.4,-1.2724792,36.7807386,-1.2950707,36.7917289,379,599,11,543
5557,17614,2528,3,Business,18,1,58781,18,1,58879,18,1,59334,18,1,59776,18,1,60578,3,28.9,-1.2584143,36.8048002,-1.2551895,36.7822034,763,802,98,897
5558,26432,393,3,Business,15,1,42029,15,1,42051,15,1,42071,15,1,44671,15,1,46038,11,23.25888921888938,-1.3167113,36.8301563,-1.2638185,36.7930057,935,1367,22,2620
5559,10074,2828,3,Business,13,5,48596,13,5,48635,13,5,48735,13,5,49191,13,5,49896,3,19.2,-1.2584143,36.8048002,-1.2615888,36.7928732,791,705,39,556
5560,15224,3291,3,Business,7,5,43385,7,5,43443,7,5,43973,7,5,44251,7,5,45600,4,23.25888921888938,-1.2663631,36.8163329,-1.2600926,36.8088685,27,1349,58,808
5561,10326,2027,1,Personal,25,1,30079,25,1,30129,25,1,30452,25,1,30569,25,1,31304,8,15.2,-1.2551895,36.7822034,-1.2962832,36.7849683,379,735,50,440
5562,2996,393,3,Business,26,3,37328,26,3,37360,26,3,38453,26,3,39330,26,3,39984,4,24.0,-1.3177547,36.8303703,-1.3004062,36.829741,731,654,32,1970
5563,19816,1113,1,Personal,24,5,65950,24,5,65957,24,5,66440,24,5,66652,24,5,68196,13,23.25888921888938,-1.2156006,36.8916865,-1.2669292,36.8118911,384,1544,7,695
5564,9191,265,3,Business,15,5,55202,15,5,55806,15,5,58292,15,5,59260,15,5,62017,24,18.0,-1.2903933,36.6988935,-1.300921,36.828195,831,2757,604,3454
5565,18840,2154,3,Business,31,1,51490,31,1,51776,31,1,52707,31,1,52809,31,1,53514,4,23.7,-1.2765736,36.8513646,-1.2911905,36.8226543,26,705,286,1033
5566,26227,2412,3,Business,13,3,53604,13,3,56469,13,3,58361,13,3,60411,13,3,61624,14,26.2,-1.2615888,36.7928732,-1.2285835,36.8826468,411,1213,2865,3942
5567,13577,246,3,Business,29,1,54146,29,1,54151,29,1,54656,29,1,54853,29,1,55314,1,24.6,-1.2584143,36.8048002,-1.2597529,36.806629,620,461,5,702
5568,1165,3201,3,Business,6,2,50523,6,2,50612,6,2,50620,6,2,51059,6,2,51250,2,27.6,-1.2527958,36.8003131,-1.2584143,36.8048002,579,191,89,447
5569,21229,432,3,Business,24,5,50659,24,5,51050,24,5,52242,24,5,53375,24,5,55580,8,22.9,-1.2615888,36.7928732,-1.3012008,36.764868,567,2205,391,2325
5570,21517,2474,1,Personal,4,4,49928,4,4,49958,4,4,50690,4,4,51126,4,4,52304,14,24.9,-1.2780878,36.8469436,-1.2614838,36.7530984,207,1178,30,1168
5571,7920,1245,3,Business,5,2,53200,5,2,53250,5,2,56345,5,2,58773,5,2,60878,17,23.25888921888938,-1.300921,36.828195,-1.3198615,36.7110323,654,2105,50,5523
5572,9868,1469,3,Business,15,3,34275,15,3,34285,15,3,34289,15,3,35067,15,3,35809,6,23.25888921888938,-1.2551895,36.7822034,-1.265432,36.795034,576,742,10,782
5573,4260,2528,3,Business,9,2,34670,9,2,36994,9,2,37475,9,2,37963,9,2,39626,7,26.8,-1.2551895,36.7822034,-1.293278,36.827789,709,1663,2324,969
5574,9152,20,3,Business,14,5,44582,14,5,44643,14,5,48686,14,5,48755,14,5,50027,8,23.0,-1.3008826,36.8378114,-1.2680478,36.8013518,567,1272,61,4112
5575,26251,3599,3,Business,25,6,40161,25,6,40228,25,6,42267,25,6,42445,25,6,46197,13,23.25888921888938,-1.3302996,36.8707935,-1.271337,36.786712,459,3752,67,2217
5576,22493,3283,3,Business,18,1,40808,18,1,40828,18,1,41154,18,1,42202,18,1,42208,7,26.8,-1.303596,36.778378,-1.2628473,36.781805,919,6,20,1374
5577,6826,2350,1,Personal,18,1,45526,18,1,46907,18,1,48128,18,1,48652,18,1,49948,10,23.25888921888938,-1.2946287,36.7585367,-1.3114711,36.8088708,898,1296,1381,1745
5578,21837,105,1,Personal,27,1,55602,27,1,55618,27,1,56596,27,1,56935,27,1,61659,22,23.25888921888938,-1.2202661,36.7650838,-1.3291124,36.8701589,361,4724,16,1317
5579,7644,2627,3,Business,24,5,56216,24,5,56254,24,5,56853,24,5,57576,24,5,57850,1,22.8,-1.2571472,36.7950633,-1.2584143,36.8048002,341,274,38,1322
5580,16629,2112,3,Business,24,6,53334,24,6,53897,24,6,55955,24,6,56083,24,6,58360,14,27.1,-1.207546,36.7913976,-1.2156006,36.8916865,626,2277,563,2186
5581,19422,635,3,Business,12,5,37814,12,5,37852,12,5,37918,12,5,42434,12,5,43490,10,26.5,-1.3081376,36.8329772,-1.2602337,36.7990548,595,1056,38,4582
5582,878,3291,3,Business,19,2,45047,19,2,45096,19,2,45378,19,2,46205,19,2,46624,5,27.6,-1.2628473,36.781805,-1.2600926,36.8088685,147,419,49,1109
5583,15023,393,3,Business,26,2,52282,26,2,52304,26,2,52476,26,2,53035,26,2,53779,4,31.2,-1.3167113,36.8301563,-1.3004062,36.829741,519,744,22,731
5584,12841,2066,3,Business,24,5,57290,24,5,57308,24,5,57415,24,5,57537,24,5,60506,9,23.0,-1.3210189,36.8410551,-1.2846195,36.7958316,233,2969,18,229
5585,17117,2511,1,Personal,14,5,45417,14,5,45485,14,5,46396,14,5,46529,14,5,47799,5,24.6,-1.2622055,36.7763428,-1.266164,36.8004608,453,1270,68,1044
5586,17637,2989,3,Business,7,3,37238,7,3,37297,7,3,38123,7,3,38741,7,3,40490,9,25.1,-1.303031,36.758577,-1.3472066,36.7692638,548,1749,59,1444
5587,6265,2271,3,Business,2,4,56151,2,4,56212,2,4,58921,2,4,59832,2,4,61519,12,23.6,-1.331619,36.847976,-1.293515,36.897607,549,1687,61,3620
5588,8900,2829,3,Business,8,2,34916,8,2,34924,8,2,35289,8,2,35583,8,2,39432,21,19.1,-1.2571472,36.7950633,-1.3562374,36.9042954,379,3849,8,659
5589,4318,2701,3,Business,17,4,62022,17,4,62040,17,4,62324,17,4,62445,17,4,64731,14,22.2,-1.279395,36.825364,-1.2600745,36.7226768,207,2286,18,405
5590,20203,1988,1,Personal,17,1,38787,17,1,38793,17,1,39141,17,1,39793,17,1,41516,12,25.1,-1.2839763,36.7603106,-1.2725144,36.8272178,45,1723,6,1000
5591,24992,3283,3,Business,14,4,44335,14,4,44886,14,4,45544,14,4,45917,14,4,46985,7,23.7,-1.303596,36.778378,-1.2628473,36.781805,290,1068,551,1031
5592,16799,2147,3,Personal,20,1,48419,20,1,48491,20,1,50566,20,1,50987,20,1,55043,21,23.25888921888938,-1.257569,36.842164,-1.3334681,36.7116093,155,4056,72,2496
5593,3797,2982,3,Business,4,2,52075,4,2,53056,4,2,53384,4,2,56219,4,2,59943,8,22.5,-1.300921,36.828195,-1.2587114,36.8349398,310,3724,981,3163
5594,2147,1148,3,Business,18,4,41085,18,4,41601,18,4,42289,18,4,43877,18,4,44648,3,25.7,-1.3100586,36.8500329,-1.311818,36.8638544,69,771,516,2276
5595,15079,393,3,Business,25,6,40420,25,6,40432,25,6,40439,25,6,41218,25,6,43235,14,23.25888921888938,-1.3228003,36.8306435,-1.2991441,36.7528804,349,2017,12,786
5596,4505,1809,3,Business,6,3,48193,6,3,48216,6,3,49521,6,3,50106,6,3,51854,17,23.25888921888938,-1.2156006,36.8916865,-1.2571472,36.7950633,75,1748,23,1890
5597,22002,2727,3,Personal,14,4,41339,14,4,41674,14,4,42646,14,4,42811,14,4,44046,7,23.8,-1.2925556,36.7903149,-1.2632247,36.777536,428,1235,335,1137
5598,27502,3355,3,Business,7,5,60483,7,5,60787,7,5,63858,7,5,64243,7,5,65047,4,23.0,-1.290894,36.822971,-1.3052491,36.8223899,267,804,304,3456
5599,436,136,3,Business,13,4,48035,13,4,48264,13,4,50128,13,4,50222,13,4,52011,16,23.0,-1.3254522,36.7216584,-1.3233496,36.8139159,572,1789,229,1958
5600,25563,1307,3,Business,29,5,31526,29,5,31683,29,5,32518,29,5,33471,29,5,35542,14,23.25888921888938,-1.2844665,36.7866113,-1.2296416,36.8422602,247,2071,157,1788
5601,27053,111,3,Business,17,3,37295,17,3,37326,17,3,37371,17,3,37896,17,3,39658,6,23.25888921888938,-1.2551895,36.7822034,-1.2793804,36.7924183,708,1762,31,570
5602,7434,970,3,Business,28,4,35008,28,4,35027,28,4,35042,28,4,35351,28,4,35801,6,22.4,-1.2551895,36.7822034,-1.266533,36.7658382,801,450,19,324
5603,13557,1527,3,Business,29,3,36943,29,3,36956,29,3,37608,29,3,37892,29,3,39756,6,18.0,-1.3004062,36.829741,-1.3267168,36.8050359,255,1864,13,936
5604,18852,1231,3,Business,14,2,49936,14,2,49972,14,2,50308,14,2,50465,14,2,51796,8,24.0,-1.2821422,36.8161565,-1.3014461,36.7661381,726,1331,36,493
5605,15189,1469,3,Business,30,2,47380,30,2,47598,30,2,50405,30,2,50583,30,2,54032,12,23.25888921888938,-1.2551895,36.7822034,-1.3127877,36.8481987,938,3449,218,2985
5606,26002,892,2,Personal,26,3,58005,26,3,58256,26,3,58987,26,3,59309,26,3,59614,2,27.2,-1.306735,36.8256226,-1.312475,36.8225778,85,305,251,1053
5607,17517,640,3,Business,21,4,32789,21,4,35494,21,4,35991,21,4,37927,21,4,42293,23,21.7,-1.3724413,36.9284922,-1.304033,36.7848695,478,4366,2705,2433
5608,15319,3398,3,Business,2,2,53606,2,2,53615,2,2,54069,2,2,55392,2,2,58916,26,26.4,-1.2297202,36.8819507,-1.3169591,36.7000029,449,3524,9,1777
5609,16173,393,3,Business,2,2,31389,2,2,31422,2,2,31776,2,2,32478,2,2,33071,4,20.6,-1.3167113,36.8301563,-1.3004062,36.829741,263,593,33,1056
5610,10352,2454,3,Business,21,1,49411,21,1,49428,21,1,49826,21,1,50094,21,1,51164,7,27.6,-1.2670714,36.8010274,-1.2993231,36.7753372,531,1070,17,666
5611,17715,2216,3,Business,8,1,38218,8,1,38246,8,1,38318,8,1,40650,8,1,40778,4,28.1,-1.2551895,36.7822034,-1.2519787,36.7806491,507,128,28,2404
5612,17152,265,3,Business,15,4,38118,15,4,38883,15,4,39794,15,4,41670,15,4,42826,5,24.4,-1.300921,36.828195,-1.2824367,36.8353831,607,1156,765,2787
5613,18941,1075,3,Business,4,1,47744,4,1,47803,4,1,48021,4,1,48153,4,1,49189,3,25.5,-1.2527958,36.8003131,-1.2551895,36.7822034,377,1036,59,350
5614,13570,2509,3,Business,1,4,40007,1,4,40068,1,4,40075,1,4,40594,1,4,41783,6,23.25888921888938,-1.2571472,36.7950633,-1.2925919,36.8170577,731,1189,61,526
5615,19566,3496,3,Business,9,3,59646,9,3,59659,9,3,60542,9,3,60692,9,3,61435,5,24.3,-1.300921,36.828195,-1.3052838,36.8545538,95,743,13,1033
5616,22513,867,3,Business,31,5,44956,31,5,45370,31,5,47377,31,5,47653,31,5,49683,14,21.5,-1.3077869,36.8443207,-1.2991441,36.7528804,676,2030,414,2283
5617,26720,496,3,Business,30,2,43420,30,2,43707,30,2,44174,30,2,45226,30,2,45236,5,23.25888921888938,-1.2551895,36.7822034,-1.2592947,36.7698085,660,10,287,1519
5618,5780,3599,3,Business,2,2,41256,2,2,42992,2,2,45327,2,2,45752,2,2,48718,12,20.9,-1.3302996,36.8707935,-1.2874367,36.8804447,810,2966,1736,2760
5619,21962,393,3,Business,28,2,43129,28,2,43156,28,2,43331,28,2,44097,28,2,44612,4,21.1,-1.3228003,36.8306435,-1.3004062,36.829741,211,515,27,941
5620,22421,1724,3,Business,29,2,58402,29,2,58474,29,2,59172,29,2,59245,29,2,60373,7,23.8,-1.2553615,36.7895376,-1.2729644,36.7938653,937,1128,72,771
5621,18728,393,3,Business,30,2,42473,30,2,42933,30,2,43637,30,2,45880,30,2,47459,11,23.25888921888938,-1.3167113,36.8301563,-1.2638185,36.7930057,245,1579,460,2947
5622,14937,1244,3,Business,3,4,47655,3,4,47674,3,4,47686,3,4,48465,3,4,49664,8,23.3,-1.307143,36.825009,-1.303596,36.778378,462,1199,19,791
5623,9081,635,3,Business,12,5,52542,12,5,53325,12,5,54851,12,5,56137,12,5,58402,7,23.25888921888938,-1.300921,36.828195,-1.2692689,36.8055169,315,2265,783,2812
5624,23707,1882,3,Business,13,2,35873,13,2,36551,13,2,37175,13,2,37322,13,2,38016,5,19.9,-1.287781,36.817866,-1.2591019,36.800577,612,694,678,771
5625,27665,3432,3,Business,28,1,44434,28,1,44483,28,1,44610,28,1,45186,28,1,47337,12,23.7,-1.2672588,36.8000252,-1.3299358,36.8524971,275,2151,49,703
5626,6796,2330,3,Business,25,6,65521,25,6,65554,25,6,66481,25,6,67075,25,6,69099,6,23.25888921888938,-1.2915247,36.8055757,-1.3015197,36.7658456,826,2024,33,1521
5627,9601,2190,3,Business,8,1,52571,8,1,52672,8,1,54762,8,1,55320,8,1,56420,8,29.8,-1.301953,36.788458,-1.2649605,36.7981777,686,1100,101,2648
5628,5907,2828,3,Business,27,3,57174,27,3,57244,27,3,57716,27,3,58116,27,3,60737,12,29.5,-1.2615888,36.7928732,-1.3193822,36.7949906,168,2621,70,872
5629,4303,3283,3,Business,7,1,41263,7,1,41273,7,1,41275,7,1,42838,7,1,44312,13,24.6,-1.331619,36.847976,-1.2628473,36.781805,111,1474,10,1565
5630,9337,3080,1,Business,12,2,59097,12,2,60267,12,2,60709,12,2,61215,12,2,64025,12,21.2,-1.2861765,36.8209086,-1.2388687,36.7529026,616,2810,1170,948
5631,8411,1721,3,Business,16,4,50907,16,4,50962,16,4,52237,16,4,52805,16,4,53146,3,23.25888921888938,-1.2551895,36.7822034,-1.2638132,36.7849775,155,341,55,1843
5632,7614,1500,3,Business,6,3,42962,6,3,43010,6,3,45238,6,3,45417,6,3,46799,11,23.25888921888938,-1.3077869,36.8443207,-1.2638185,36.7930057,123,1382,48,2407
5633,10838,3699,1,Personal,18,3,51310,18,3,51372,18,3,52381,18,3,52695,18,3,54772,12,20.5,-1.2921233,36.806386,-1.2963418,36.8855114,427,2077,62,1323
5634,25913,2200,3,Business,30,6,49292,30,6,49376,30,6,49928,30,6,50140,30,6,51387,6,28.4,-1.2649605,36.7981777,-1.290894,36.822971,660,1247,84,764
5635,25916,3326,3,Business,23,5,55040,23,5,55893,23,5,56616,23,5,56900,23,5,58075,8,26.2,-1.2551895,36.7822034,-1.2812624,36.7714609,675,1175,853,1007
5636,9189,635,3,Business,25,1,53511,25,1,53558,25,1,54489,25,1,55525,25,1,56572,9,29.9,-1.3081376,36.8329772,-1.2602337,36.7990548,126,1047,47,1967
5637,12906,2344,3,Business,8,2,39061,8,2,40093,8,2,40707,8,2,41036,8,2,42129,10,21.3,-1.255956,36.789867,-1.2456401,36.8096727,589,1093,1032,943
5638,16500,868,3,Business,15,3,43185,15,3,46292,15,3,48402,15,3,50326,15,3,51401,6,26.1,-1.307143,36.825009,-1.265715,36.823815,787,1075,3107,4034
5639,21445,2763,3,Business,6,3,33473,6,3,33540,6,3,33546,6,3,33843,6,3,34562,6,23.25888921888938,-1.2551895,36.7822034,-1.2843046,36.7746132,523,719,67,303
5640,22190,2801,3,Business,26,2,48833,26,2,48902,26,2,49682,26,2,50018,26,2,51031,7,29.6,-1.2674274,36.7870827,-1.2827545,36.7936129,720,1013,69,1116
5641,9349,1648,3,Personal,6,3,51888,6,3,52902,6,3,55820,6,3,55892,6,3,59913,32,27.7,-1.3976138,36.782966,-1.2096572,36.8049574,883,4021,1014,2990
5642,17460,970,3,Business,15,5,47467,15,5,47627,15,5,47764,15,5,48620,15,5,48904,3,26.2,-1.2551895,36.7822034,-1.2629594,36.8077626,446,284,160,993
5643,11331,2956,3,Business,2,2,63664,2,2,63702,2,2,63996,2,2,64706,2,2,66292,14,28.4,-1.207546,36.7913976,-1.2584143,36.8048002,7,1586,38,1004
5644,17550,867,3,Business,6,1,36598,6,1,36675,6,1,37784,6,1,39145,6,1,43110,10,23.25888921888938,-1.2996533,36.8292629,-1.2991441,36.7528804,216,3965,77,2470
5645,6811,3252,1,Personal,12,2,34512,12,2,34736,12,2,35549,12,2,36018,12,2,38693,11,16.1,-1.30435,36.86001,-1.2639198,36.8069299,498,2675,224,1282
5646,6164,1724,3,Business,2,4,34844,2,4,34946,2,4,35965,2,4,36483,2,4,37802,10,23.25888921888938,-1.3044458,36.8233667,-1.2551895,36.7822034,92,1319,102,1537
5647,4361,146,3,Personal,3,4,41395,3,4,41412,3,4,42363,3,4,42609,3,4,45070,14,23.5,-1.2985153,36.7876043,-1.3389279,36.7092201,846,2461,17,1197
5648,5965,2102,3,Business,14,1,54032,14,1,54045,14,1,54837,14,1,55040,14,1,58113,15,25.8,-1.3323107,36.8692616,-1.2613768,36.8019418,75,3073,13,995
5649,15226,186,3,Business,14,4,30228,14,4,30927,14,4,33539,14,4,34590,14,4,39718,6,15.3,-1.2902869,36.8085396,-1.2579304,36.8019667,159,5128,699,3663
5650,7366,2982,3,Business,21,1,48781,21,1,48843,21,1,49132,21,1,50144,21,1,51346,7,27.4,-1.300921,36.828195,-1.325469,36.862403,340,1202,62,1301
5651,14560,2763,3,Business,22,5,42610,22,5,42719,22,5,43295,22,5,43598,22,5,44717,8,28.6,-1.2551895,36.7822034,-1.2934638,36.7668028,937,1119,109,879
5652,2778,2964,3,Business,3,3,42675,3,3,42841,3,3,43455,3,3,45175,3,3,47345,22,27.5,-1.3124537,36.925365,-1.2551895,36.7822034,126,2170,166,2334
5653,15778,279,1,Personal,17,5,59063,17,5,59183,17,5,59295,17,5,60396,17,5,61499,6,19.1,-1.2824911,36.8218042,-1.2611642,36.7949932,45,1103,120,1213
5654,1256,1502,3,Business,16,2,43071,16,2,43711,16,2,44219,16,2,44492,16,2,45755,14,23.25888921888938,-1.2571472,36.7950633,-1.2232123,36.8932547,96,1263,640,781
5655,9772,811,3,Personal,4,3,38261,4,3,38277,4,3,38721,4,3,39007,4,3,39765,2,17.2,-1.3014461,36.7661381,-1.2963097,36.7688221,74,758,16,730
5656,27272,3291,3,Business,18,1,38896,18,1,39422,18,1,39628,18,1,40613,18,1,42405,8,27.9,-1.303596,36.778378,-1.2600926,36.8088685,210,1792,526,1191
5657,6449,1642,3,Business,9,6,37381,9,6,37425,9,6,37777,9,6,38428,9,6,39174,4,24.8,-1.2642903,36.8002137,-1.2726506,36.7960153,547,746,44,1003
5658,5716,893,3,Business,9,4,50275,9,4,50301,9,4,50797,9,4,51096,9,4,51976,5,23.25888921888938,-1.2732604,36.823046,-1.2663194,36.809901,709,880,26,795
5659,14532,2436,3,Business,27,4,48050,27,4,48078,27,4,48257,27,4,52707,27,4,52720,20,25.0,-1.2551895,36.7822034,-1.3023387,36.9066847,49,13,28,4629
5660,20100,2112,3,Business,25,1,60029,25,1,60038,25,1,60068,25,1,61574,25,1,63409,5,27.7,-1.2285835,36.8826468,-1.2156006,36.8916865,649,1835,9,1536
5661,23356,400,3,Business,3,4,51141,3,4,51166,3,4,51511,3,4,51770,3,4,52925,4,25.9,-1.275442,36.7660207,-1.255956,36.772901,846,1155,25,604
5662,27092,700,3,Business,10,1,56223,10,1,58042,10,1,59586,10,1,60006,10,1,62395,10,18.8,-1.3205164,36.8098882,-1.2640571,36.7883547,447,2389,1819,1964
5663,10409,868,3,Business,31,2,41395,31,2,41505,31,2,42402,31,2,42582,31,2,43678,8,18.7,-1.303596,36.778378,-1.265715,36.823815,726,1096,110,1077
5664,17585,128,1,Personal,5,4,42499,5,4,42690,5,4,45413,5,4,45775,5,4,46634,8,23.25888921888938,-1.3098463,36.8054139,-1.3246123,36.7902267,101,859,191,3085
5665,10510,1555,3,Business,10,2,32219,10,2,32383,10,2,33204,10,2,38146,10,2,38159,10,20.5,-1.3052491,36.8223899,-1.3404187,36.7614685,927,13,164,5763
5666,16706,517,3,Business,28,5,42892,28,5,43263,28,5,43952,28,5,44300,28,5,45923,14,23.7,-1.3167113,36.8301563,-1.306378,36.7519845,523,1623,371,1037
5667,1845,2461,3,Business,9,3,54647,9,3,54672,9,3,55448,9,3,56736,9,3,60193,14,23.5,-1.237705,36.7663283,-1.310627,36.819216,949,3457,25,2064
5668,1959,3149,3,Business,10,1,40683,10,1,40733,10,1,40837,10,1,40901,10,1,41325,5,18.3,-1.3004062,36.829741,-1.3167113,36.8301563,161,424,50,168
5669,2901,2587,3,Business,26,6,38954,26,6,39008,26,6,39919,26,6,40430,26,6,42360,8,25.8,-1.3014461,36.7661381,-1.28878,36.8168312,800,1930,54,1422
5670,17909,868,3,Business,20,3,47444,20,3,47454,20,3,48079,20,3,49021,20,3,50118,9,29.5,-1.331619,36.847976,-1.265715,36.823815,291,1097,10,1567
5671,11107,1431,3,Personal,6,5,39211,6,5,39348,6,5,40444,6,5,40775,6,5,42683,10,20.5,-1.3187067,36.8288886,-1.2779711,36.7822345,131,1908,137,1427
5672,28059,2869,3,Business,4,2,32746,4,2,33739,4,2,35271,4,2,36145,4,2,38404,14,16.4,-1.3025826,36.7670807,-1.3083777,36.8590077,429,2259,993,2406
5673,24412,1020,1,Personal,15,1,55465,15,1,56187,15,1,56807,15,1,56936,15,1,57989,7,23.25888921888938,-1.2764786,36.8194788,-1.255956,36.772901,208,1053,722,749
5674,5399,1724,3,Business,3,3,49718,3,3,49761,3,3,50138,3,3,50318,3,3,56311,26,28.1,-1.303031,36.758577,-1.1848195,36.915472,599,5993,43,557
5675,14501,2112,3,Business,27,6,37903,27,6,37917,27,6,39743,27,6,40203,27,6,42914,14,23.25888921888938,-1.2927792,36.9053492,-1.2156006,36.8916865,248,2711,14,2286
5676,20023,2789,3,Business,2,2,37700,2,2,37724,2,2,38077,2,2,38167,2,2,38768,3,26.0,-1.304735,36.7846054,-1.2945179,36.7685349,259,601,24,443
5677,9250,2412,3,Business,28,5,43284,28,5,43331,28,5,43858,28,5,44017,28,5,44030,3,23.9,-1.2156006,36.8916865,-1.2285835,36.8826468,803,13,47,686
5678,14423,286,3,Business,24,6,34442,24,6,34864,24,6,35892,24,6,35966,24,6,37602,19,18.6,-1.2414003,36.8094718,-1.3206929,36.8621776,878,1636,422,1102
5679,22922,1058,1,Business,27,1,47221,27,1,47418,27,1,48603,27,1,49468,27,1,50847,16,23.25888921888938,-1.2251703,36.8904714,-1.2571472,36.7950633,520,1379,197,2050
5680,3350,3599,3,Business,27,6,34545,27,6,40140,27,6,43225,27,6,44585,27,6,46818,14,23.25888921888938,-1.3302996,36.8707935,-1.3374736,36.9207076,461,2233,5595,4445
5681,3691,3698,3,Business,15,1,54213,15,1,55946,15,1,56826,15,1,57626,15,1,59774,11,23.25888921888938,-1.3107918,36.761794,-1.2864733,36.8239937,855,2148,1733,1680
5682,14122,489,1,Personal,21,7,41696,21,7,41777,21,7,42050,21,7,42528,21,7,43736,9,24.9,-1.2852584,36.8043641,-1.319536,36.7793289,282,1208,81,751
5683,12646,2789,3,Business,7,5,41651,7,5,41769,7,5,42212,7,5,42421,7,5,43451,6,23.25888921888938,-1.304735,36.7846054,-1.2611728,36.7753701,709,1030,118,652
5684,6566,286,3,Business,24,6,31621,24,6,31665,24,6,32605,24,6,32883,24,6,34356,12,18.6,-1.2414003,36.8094718,-1.2970034,36.8333214,276,1473,44,1218
5685,25782,3194,3,Business,7,4,48353,7,4,48427,7,4,48855,7,4,49565,7,4,50432,7,31.0,-1.2571472,36.7950633,-1.3025453,36.8320497,205,867,74,1138
5686,17586,1658,2,Personal,28,5,50707,28,5,54125,28,5,54159,28,5,55398,28,5,58338,9,25.5,-1.2561104,36.7497052,-1.2769868,36.7859858,268,2940,3418,1273
5687,6600,2200,3,Business,27,1,45984,27,1,46068,27,1,47310,27,1,48559,27,1,51126,7,20.9,-1.290894,36.822971,-1.2571472,36.7950633,673,2567,84,2491
5688,3472,314,2,Personal,13,6,63451,13,6,63641,13,6,64296,13,6,64493,13,6,66459,20,26.3,-1.2270789,36.8412311,-1.3209614,36.7808827,383,1966,190,852
5689,28163,2701,3,Business,22,2,55102,22,2,55279,22,2,56591,22,2,57086,22,2,57938,10,21.3,-1.279395,36.825364,-1.2478187,36.8844611,687,852,177,1807
5690,19351,1620,1,Personal,14,2,59047,14,2,59426,14,2,61929,14,2,62234,14,2,64070,18,23.4,-1.227132,36.8374277,-1.290059,36.7703475,541,1836,379,2808
5691,2033,65,1,Personal,6,1,45882,6,1,45940,6,1,46445,6,1,47241,6,1,49868,13,20.3,-1.2662524,36.8244795,-1.3299358,36.8524971,320,2627,58,1301
5692,17513,324,3,Personal,6,3,37717,6,3,38896,6,3,40471,6,3,42224,6,3,45128,16,19.9,-1.332942,36.714065,-1.2653676,36.7911012,618,2904,1179,3328
5693,24954,1869,3,Personal,27,1,42583,27,1,42641,27,1,43006,27,1,44432,27,1,45443,7,23.9,-1.3039695,36.7838267,-1.3291184,36.7892374,749,1011,58,1791
5694,7854,3339,3,Business,21,4,39239,21,4,39281,21,4,39989,21,4,40084,21,4,41929,9,25.3,-1.2551895,36.7822034,-1.2962618,36.7929334,436,1845,42,803
5695,11221,3355,3,Business,24,3,54498,24,3,54588,24,3,54615,24,3,55031,24,3,55643,4,18.5,-1.3052491,36.8223899,-1.2909536,36.8407162,848,612,90,443
5696,19122,2801,3,Business,8,1,45030,8,1,45085,8,1,46041,8,1,46666,8,1,49085,16,24.4,-1.3301235,36.7070434,-1.2595422,36.7871178,565,2419,55,1581
5697,16351,1280,3,Business,5,1,31019,5,1,31087,5,1,32600,5,1,33028,5,1,34922,13,18.8,-1.3221141,36.8636835,-1.2654348,36.8022464,956,1894,68,1941
5698,26728,228,3,Business,22,5,32807,22,5,32833,22,5,33099,22,5,33245,22,5,35685,5,22.2,-1.2842665,36.7967626,-1.273488,36.804158,933,2440,26,412
5699,15956,2987,3,Business,24,1,56494,24,1,56536,24,1,56816,24,1,57070,24,1,57646,3,23.25888921888938,-1.2805757,36.8223948,-1.270212,36.8210877,857,576,42,534
5700,18341,1471,3,Business,1,4,27196,1,4,27209,1,4,30461,1,4,32544,1,4,33761,21,23.25888921888938,-1.3562374,36.9042954,-1.2551895,36.7822034,656,1217,13,5335
5701,20454,2605,3,Business,4,3,55685,4,3,55701,4,3,56644,4,3,57063,4,3,58872,22,18.2,-1.2551895,36.7822034,-1.3562374,36.9042954,116,1809,16,1362
5702,8966,1721,3,Business,8,1,55640,8,1,55647,8,1,55835,8,1,56153,8,1,57092,3,29.7,-1.2551895,36.7822034,-1.2562797,36.8075858,649,939,7,506
5703,919,1770,3,Personal,10,4,45268,10,4,45272,10,4,46218,10,4,47335,10,4,49328,14,23.25888921888938,-1.3223335,36.8708169,-1.2603714,36.7893387,543,1993,4,2063
5704,23850,1148,3,Business,11,2,43307,11,2,43379,11,2,43921,11,2,44348,11,2,45543,5,19.6,-1.3099295,36.8436807,-1.3074264,36.8226123,943,1195,72,969
5705,14190,3339,3,Business,27,4,36542,27,4,36583,27,4,36660,27,4,36849,27,4,38796,9,18.9,-1.2551895,36.7822034,-1.3084469,36.8263054,62,1947,41,266
5706,4990,794,2,Personal,15,1,28374,15,1,28863,15,1,29863,15,1,30037,15,1,30791,6,23.25888921888938,-1.2627203,36.7929743,-1.2902247,36.7922037,726,754,489,1174
5707,13081,3365,2,Personal,17,3,52667,17,3,52679,17,3,52755,17,3,53644,17,3,54975,6,28.4,-1.2795796,36.819062,-1.307774,36.8407541,365,1331,12,965
5708,27157,1500,3,Business,9,4,46671,9,4,46725,9,4,46762,9,4,47560,9,4,48696,8,23.25888921888938,-1.3004062,36.829741,-1.2638185,36.7930057,168,1136,54,835
5709,24482,868,3,Business,9,3,41631,9,3,41733,9,3,42789,9,3,43900,9,3,44449,6,25.3,-1.265715,36.823815,-1.2628473,36.781805,878,549,102,2167
5710,23880,2344,3,Business,30,3,45536,30,3,45982,30,3,46781,30,3,47092,30,3,48550,7,25.1,-1.2551895,36.7822034,-1.286937,36.8246742,276,1458,446,1110
5711,3929,868,3,Business,24,3,42749,24,3,43351,24,3,43503,24,3,44650,24,3,45217,6,23.25888921888938,-1.3033561,36.8163631,-1.265715,36.823815,19,567,602,1299
5712,10114,1500,3,Business,3,3,35093,3,3,35130,3,3,36480,3,3,37145,3,3,38307,6,21.4,-1.2770708,36.8231093,-1.2638185,36.7930057,436,1162,37,2015
5713,16633,2801,3,Business,27,2,59516,27,2,59648,27,2,61207,27,2,61416,27,2,62530,4,22.3,-1.2595422,36.7871178,-1.2664428,36.809453,875,1114,132,1768
5714,10739,517,3,Business,27,6,36891,27,6,37626,27,6,38038,27,6,38747,27,6,39177,4,23.25888921888938,-1.3167113,36.8301563,-1.3004062,36.829741,205,430,735,1121
5715,13287,1402,3,Business,30,5,38973,30,5,40381,30,5,41517,30,5,42325,30,5,43369,2,23.5,-1.290894,36.822971,-1.2891922,36.825189,362,1044,1408,1944
5716,11293,2112,3,Business,12,3,47075,12,3,47089,12,3,49362,12,3,49838,12,3,50826,6,26.7,-1.2156006,36.8916865,-1.2389425,36.8775718,384,988,14,2749
5717,27373,3517,3,Business,8,2,47292,8,2,47306,8,2,47312,8,2,51322,8,2,52987,15,25.3,-1.300921,36.828195,-1.3882008,36.7699445,871,1665,14,4016
5718,11512,2066,3,Business,29,2,49864,29,2,50399,29,2,51683,29,2,52103,29,2,53587,8,27.0,-1.3210189,36.8410551,-1.2856902,36.8306163,336,1484,535,1704
5719,17447,2528,3,Business,8,3,47160,8,3,47190,8,3,47373,8,3,49580,8,3,50265,4,23.25888921888938,-1.2584143,36.8048002,-1.2551895,36.7822034,427,685,30,2390
5720,20231,2801,3,Business,15,1,51053,15,1,53261,15,1,54606,15,1,56290,15,1,57394,13,23.25888921888938,-1.3546228,36.9013783,-1.307726,36.839117,126,1104,2208,3029
5721,24347,3291,3,Business,19,2,55246,19,2,55274,19,2,55876,19,2,56174,19,2,57311,8,29.3,-1.303596,36.778378,-1.2600926,36.8088685,291,1137,28,900
5722,25500,265,3,Business,22,5,37847,22,5,37855,22,5,38157,22,5,38470,22,5,41442,11,23.25888921888938,-1.300921,36.828195,-1.3459625,36.9073925,127,2972,8,615
5723,17772,3283,3,Business,5,3,33005,5,3,33061,5,3,33733,5,3,34258,5,3,35370,7,17.8,-1.2628473,36.781805,-1.265715,36.823815,829,1112,56,1197
5724,13772,830,3,Business,6,4,45796,6,4,45878,6,4,46372,6,4,46484,6,4,47687,9,19.8,-1.2551895,36.7822034,-1.225322,36.80855,770,1203,82,606
5725,26539,1075,3,Business,28,4,56631,28,4,56644,28,4,56992,28,4,57476,28,4,59487,10,27.6,-1.3014461,36.7661381,-1.2527958,36.8003131,831,2011,13,832
5726,3113,2801,3,Business,25,2,35340,25,2,35346,25,2,35797,25,2,36211,25,2,37368,7,17.7,-1.2879652,36.8203441,-1.2595422,36.7871178,622,1157,6,865
5727,13882,136,3,Business,2,5,40259,2,5,40291,2,5,41488,2,5,41740,2,5,43262,11,23.3,-1.2962832,36.7849683,-1.3254522,36.7216584,232,1522,32,1449
5728,23485,1245,3,Business,3,1,49997,3,1,53359,3,1,57663,3,1,60207,3,1,62613,16,22.6,-1.300921,36.828195,-1.3558865,36.7156689,581,2406,3362,6848
5729,11616,2718,3,Business,25,2,45900,25,2,45926,25,2,46450,25,2,47426,25,2,51067,23,23.8,-1.2668815,36.8017244,-1.3592118,36.6717545,520,3641,26,1500
5730,5557,3434,3,Business,2,5,52934,2,5,53294,2,5,53385,2,5,54540,2,5,55604,4,25.2,-1.3253826,36.8822315,-1.3123562,36.9157558,925,1064,360,1246
5731,26045,1280,3,Business,10,5,55487,10,5,55872,10,5,57021,10,5,57099,10,5,58111,5,23.25888921888938,-1.2551895,36.7822034,-1.2701385,36.8235208,687,1012,385,1227
5732,5738,265,3,Business,8,5,42700,8,5,42774,8,5,43125,8,5,43265,8,5,45622,8,24.0,-1.300921,36.828195,-1.3319467,36.7766998,147,2357,74,491
5733,9879,1882,3,Business,27,6,34557,27,6,34578,27,6,37717,27,6,38746,27,6,40011,14,23.25888921888938,-1.2156006,36.8916865,-1.2591019,36.800577,19,1265,21,4168
5734,11915,3222,3,Business,8,5,51823,8,5,51854,8,5,52324,8,5,52575,8,5,53262,3,30.5,-1.2551895,36.7822034,-1.2546732,36.8086796,658,687,31,721
5735,14191,1787,3,Business,13,6,42033,13,6,42087,13,6,43268,13,6,46762,13,6,48393,9,26.0,-1.2859912,36.8756811,-1.2283403,36.8822756,435,1631,54,4675
5736,10296,1700,1,Personal,18,1,55392,18,1,55488,18,1,55713,18,1,55873,18,1,56916,9,17.0,-1.2935303,36.7988142,-1.2557779,36.7879648,322,1043,96,385
5737,14351,306,1,Personal,9,6,47107,9,6,47149,9,6,48093,9,6,48905,9,6,50507,9,19.0,-1.3157973,36.815148,-1.258321,36.795453,549,1602,42,1756
5738,5365,14,3,Personal,19,3,55053,19,3,56239,19,3,56707,19,3,56984,19,3,58413,10,24.6,-1.279228,36.7746478,-1.3070122,36.8287218,685,1429,1186,745
5739,10950,3177,3,Business,8,4,44110,8,4,44218,8,4,44310,8,4,46186,8,4,47674,18,26.1,-1.3253106,36.8903296,-1.301953,36.788458,886,1488,108,1968
5740,2458,2681,1,Personal,7,1,55214,7,1,56217,7,1,56705,7,1,56885,7,1,57499,4,20.5,-1.2854453,36.8188363,-1.2720542,36.7910241,100,614,1003,668
5741,18879,97,3,Business,20,3,63547,20,3,63605,20,3,64089,20,3,65317,20,3,66366,4,27.8,-1.2751745,36.7657676,-1.2969741,36.7856612,129,1049,58,1712
5742,22837,1996,3,Business,4,4,52863,4,4,53116,4,4,54481,4,4,55322,4,4,56631,7,27.4,-1.2946359,36.8352718,-1.2640573,36.8085528,686,1309,253,2206
5743,15481,136,3,Business,17,3,39870,17,3,39940,17,3,40180,17,3,40354,17,3,41096,6,23.25888921888938,-1.3254522,36.7216584,-1.3287648,36.7445732,327,742,70,414
5744,2006,1597,1,Personal,16,4,48088,16,4,48102,16,4,48996,16,4,49889,16,4,52864,14,18.8,-1.232287,36.801636,-1.3159617,36.8117934,208,2975,14,1787
5745,4481,2271,3,Business,24,4,51942,24,4,53058,24,4,53410,24,4,53821,24,4,55906,19,28.5,-1.303596,36.778378,-1.293515,36.897607,556,2085,1116,763
5746,25904,3557,3,Business,30,2,55424,30,2,55442,30,2,56071,30,2,56657,30,2,56659,4,27.3,-1.2581837,36.8017056,-1.2622145,36.8087391,380,2,18,1215
5747,3697,3247,3,Business,24,3,42978,24,3,43054,24,3,43337,24,3,43804,24,3,45697,12,19.8,-1.2571472,36.7950633,-1.318524,36.8553767,614,1893,76,750
5748,15259,1329,3,Business,30,6,49224,30,6,49264,30,6,49301,30,6,49645,30,6,50509,7,28.4,-1.273056,36.811298,-1.309638,36.805289,119,864,40,381
5749,12228,3674,3,Business,30,2,49127,30,2,49258,30,2,49814,30,2,50098,30,2,52204,14,23.25888921888938,-1.2551895,36.7822034,-1.2493719,36.8780276,96,2106,131,840
5750,19586,2627,3,Business,5,2,51587,5,2,51602,5,2,51818,5,2,53029,5,2,53224,2,23.25888921888938,-1.2571472,36.7950633,-1.2591019,36.800577,937,195,15,1427
5751,11110,1473,3,Business,14,1,30967,14,1,37191,14,1,37851,14,1,38434,14,1,39764,16,23.3,-1.3044458,36.8233667,-1.3700383,36.9190174,31,1330,6224,1243
5752,18282,3647,3,Business,12,3,34779,12,3,34831,12,3,35360,12,3,35481,12,3,36126,6,23.25888921888938,-1.264316,36.8160676,-1.272639,36.794723,207,645,52,650
5753,5351,1927,3,Business,20,3,53084,20,3,53382,20,3,55076,20,3,55368,20,3,57768,20,28.6,-1.3472066,36.7692638,-1.2413316,36.8785525,649,2400,298,1986
5754,12775,2041,3,Business,12,3,49147,12,3,50041,12,3,50047,12,3,52024,12,3,54765,1,26.3,-1.290894,36.822971,-1.293278,36.827789,692,2741,894,1983
5755,27686,2064,2,Personal,12,2,35327,12,2,35586,12,2,37454,12,2,37660,12,2,40757,8,15.9,-1.2959613,36.7684114,-1.2664882,36.8033374,441,3097,259,2074
5756,15680,3203,3,Business,9,6,39210,9,6,39306,9,6,39919,9,6,41774,9,6,42585,13,17.0,-1.307143,36.825009,-1.228911,36.881876,900,811,96,2468
5757,10906,2989,3,Business,1,4,53739,1,4,53748,1,4,54371,1,4,55607,1,4,57516,18,23.25888921888938,-1.2859912,36.8756811,-1.3463042,36.768164,699,1909,9,1859
5758,18007,633,3,Business,8,5,40224,8,5,40289,8,5,42274,8,5,42502,8,5,43328,4,28.3,-1.3077869,36.8443207,-1.3004062,36.829741,349,826,65,2213
5759,18758,2200,3,Business,8,4,47803,8,4,47823,8,4,50166,8,4,50533,8,4,52019,2,27.5,-1.279395,36.825364,-1.290894,36.822971,569,1486,20,2710
5760,20393,323,3,Business,14,3,57296,14,3,57589,14,3,58965,14,3,59583,14,3,60805,14,23.4,-1.307241,36.8302368,-1.3632162,36.9108253,219,1222,293,1994
5761,14664,1355,2,Personal,23,7,67960,23,7,67978,23,7,69374,23,7,69701,23,7,71867,18,23.8,-1.2125712,36.7964151,-1.2939882,36.7591199,103,2166,18,1723
5762,22640,393,3,Business,10,5,52977,10,5,53068,10,5,53073,10,5,54773,10,5,54775,4,23.25888921888938,-1.3167113,36.8301563,-1.3004062,36.829741,10,2,91,1705
5763,7872,3686,3,Business,6,3,55983,6,3,56174,6,3,56841,6,3,57122,6,3,58468,8,27.6,-1.2551895,36.7822034,-1.3004062,36.829741,958,1346,191,948
5764,26988,393,3,Business,26,2,32517,26,2,32552,26,2,32567,26,2,36317,26,2,36351,11,23.25888921888938,-1.3167113,36.8301563,-1.2638185,36.7930057,239,34,35,3765
5765,22022,248,3,Business,19,3,43590,19,3,43730,19,3,44350,19,3,45888,19,3,46825,6,22.2,-1.2971877,36.8270159,-1.304735,36.7846054,518,937,140,2158
5766,16016,2436,3,Business,26,1,50117,26,1,50198,26,1,50445,26,1,51665,26,1,52610,6,22.3,-1.2551895,36.7822034,-1.2479362,36.772759,770,945,81,1467
5767,1141,646,3,Personal,3,3,37867,3,3,37876,3,3,38578,3,3,38963,3,3,41729,27,23.9,-1.2469508,36.8244485,-1.1846355,36.9485728,31,2766,9,1087
5768,16718,3689,3,Business,28,3,57599,28,3,57949,28,3,58632,28,3,59024,28,3,61048,13,23.25888921888938,-1.207546,36.7913976,-1.2527958,36.8003131,626,2024,350,1075
5769,1760,2216,3,Business,24,3,52879,24,3,52915,24,3,53602,24,3,53968,24,3,56133,19,23.25888921888938,-1.2551895,36.7822034,-1.3239618,36.899082,177,2165,36,1053
5770,2591,38,1,Personal,22,3,49321,22,3,49350,22,3,49356,22,3,49715,22,3,50895,14,25.7,-1.2962832,36.7849683,-1.3207708,36.8685919,726,1180,29,365
5771,7160,1471,3,Business,13,3,47231,13,3,47411,13,3,47764,13,3,48435,13,3,50586,9,24.9,-1.2551895,36.7822034,-1.2864747,36.7973884,379,2151,180,1024
5772,24997,517,3,Business,3,4,41045,3,4,41247,3,4,41373,3,4,41839,3,4,42315,4,23.3,-1.3167113,36.8301563,-1.3004062,36.829741,523,476,202,592
5773,3610,391,3,Business,10,5,54185,10,5,54803,10,5,57010,10,5,58194,10,5,63680,3,23.25888921888938,-1.2784063,36.8222933,-1.270766,36.810988,76,5486,618,3391
5774,5790,478,3,Business,27,1,32989,27,1,33021,27,1,33314,27,1,33612,27,1,33671,3,18.0,-1.2551895,36.7822034,-1.2640571,36.7883547,708,59,32,591
5775,12455,1229,2,Personal,2,3,76370,2,3,77188,2,3,77476,2,3,77971,2,3,78343,3,16.9,-1.3016513,36.7649321,-1.2947685,36.7785834,312,372,818,783
5776,6823,3086,3,Business,11,6,53567,11,6,53674,11,6,54586,11,6,55825,11,6,55876,6,23.25888921888938,-1.2889914,36.8209443,-1.2512895,36.8446173,921,51,107,2151
5777,27589,1642,3,Business,11,2,37271,11,2,39416,11,2,40074,11,2,40253,11,2,41084,8,19.2,-1.2726506,36.7960153,-1.2970034,36.8333214,404,831,2145,837
5778,19774,2330,3,Business,11,2,54054,11,2,54171,11,2,54479,11,2,54697,11,2,56150,12,21.2,-1.2284323,36.8757058,-1.2642903,36.8002137,709,1453,117,526
5779,20709,2883,2,Personal,28,2,58234,28,2,58336,28,2,59536,28,2,59620,28,2,62016,8,18.2,-1.2847099,36.7722345,-1.2472601,36.7859285,447,2396,102,1284
5780,22916,3560,3,Business,8,4,55204,8,4,56802,8,4,57364,8,4,57599,8,4,59239,5,27.4,-1.2656193,36.8034589,-1.279395,36.825364,353,1640,1598,797
5781,4699,1,3,Business,5,5,56566,5,5,56695,5,5,57243,5,5,57532,5,5,58375,3,26.7,-1.2584143,36.8048002,-1.2551895,36.7822034,208,843,129,837
5782,18080,3491,3,Business,21,1,39743,21,1,39776,21,1,40337,21,1,40614,21,1,41046,5,20.2,-1.2156006,36.8916865,-1.2297202,36.8745508,735,432,33,838
5783,16499,378,2,Personal,1,6,55697,1,6,55987,1,6,56934,1,6,57278,1,6,58354,5,19.6,-1.2862718,36.824329,-1.2543164,36.831861,400,1076,290,1291
5784,13342,136,3,Business,28,4,35197,28,4,35228,28,4,35844,28,4,36065,28,4,38317,22,22.5,-1.3254522,36.7216584,-1.2261501,36.7600434,647,2252,31,837
5785,6206,248,3,Business,12,3,32567,12,3,32607,12,3,33781,12,3,34042,12,3,35555,6,23.25888921888938,-1.304735,36.7846054,-1.3071226,36.8075525,831,1513,40,1435
5786,5563,1402,3,Business,30,2,58319,30,2,58837,30,2,59861,30,2,61970,30,2,61981,1,23.25888921888938,-1.2803414,36.8265456,-1.2813012,36.8323962,845,11,518,3133
5787,774,2174,3,Business,16,3,45746,16,3,45751,16,3,45763,16,3,47417,16,3,48192,10,22.9,-1.2482781,36.884092,-1.261795,36.822333,216,775,5,1666
5788,19411,1808,1,Personal,30,6,33318,30,6,33684,30,6,35305,30,6,35573,30,6,36796,12,17.6,-1.3312488,36.8801409,-1.3092484,36.8228639,212,1223,366,1889
5789,8140,2676,3,Business,3,4,43394,3,4,43422,3,4,43436,3,4,43916,3,4,45311,7,22.0,-1.2963097,36.7688221,-1.2865096,36.8169364,101,1395,28,494
5790,20716,2549,2,Personal,14,1,51097,14,1,51121,14,1,51145,14,1,52157,14,1,53244,6,25.7,-1.2864298,36.8224345,-1.2941024,36.79578,747,1087,24,1036
5791,24417,2330,3,Business,15,1,57664,15,1,62099,15,1,62888,15,1,63365,15,1,63910,8,23.25888921888938,-1.185943,36.9276394,-1.2284323,36.8757058,291,545,4435,1266
5792,22399,2216,3,Business,10,3,51294,10,3,51329,10,3,51553,10,3,55416,10,3,58657,6,30.6,-1.2551895,36.7822034,-1.2843046,36.7746132,451,3241,35,4087
5793,14354,3283,3,Business,6,6,38204,6,6,38217,6,6,38264,6,6,38639,6,6,39940,7,26.6,-1.303596,36.778378,-1.2628473,36.781805,166,1301,13,422
5794,24208,391,3,Business,23,6,42352,23,6,42415,23,6,42851,23,6,43936,23,6,44800,5,26.1,-1.300921,36.828195,-1.2867454,36.8259017,378,864,63,1521
5795,15282,552,3,Business,11,1,39770,11,1,40264,11,1,41841,11,1,43334,11,1,46491,21,26.4,-1.2571472,36.7950633,-1.335477,36.9308297,935,3157,494,3070
5796,12363,3647,3,Business,23,2,56713,23,2,56984,23,2,57943,23,2,58212,23,2,59210,6,23.25888921888938,-1.272639,36.794723,-1.3020831,36.7573386,161,998,271,1228
5797,19425,635,3,Business,2,3,54085,2,3,54184,2,3,54452,2,3,56455,2,3,59846,7,26.1,-1.2599563,36.7993439,-1.3016417,36.8271679,557,3391,99,2271
5798,27238,1687,3,Business,8,3,36732,8,3,36881,8,3,37391,8,3,38185,8,3,39075,6,23.25888921888938,-1.2626574,36.8014034,-1.2384517,36.7711438,956,890,149,1304
5799,2960,2767,3,Business,4,2,58910,4,2,59097,4,2,59626,4,2,61309,4,2,62180,5,22.4,-1.257773,36.795486,-1.273854,36.8003368,646,871,187,2212
5800,22951,633,3,Business,21,3,42651,21,3,42721,21,3,42961,21,3,43372,21,3,43802,4,21.9,-1.3077869,36.8443207,-1.3004062,36.829741,619,430,70,651
5801,9916,3326,3,Business,12,2,52653,12,2,52786,12,2,53906,12,2,54015,12,2,55616,7,26.8,-1.2551895,36.7822034,-1.2862637,36.781301,953,1601,133,1229
5802,15140,2200,3,Business,15,3,57229,15,3,57309,15,3,58293,15,3,58896,15,3,61305,11,21.6,-1.2927792,36.9053492,-1.290894,36.822971,234,2409,80,1587
5803,16989,1959,3,Business,10,5,36377,10,5,36400,10,5,37070,10,5,37193,10,5,38416,6,23.25888921888938,-1.2551895,36.7822034,-1.28878,36.8168312,868,1223,23,793
5804,7191,478,3,Business,29,1,46960,29,1,46968,29,1,47066,29,1,47227,29,1,49277,9,23.25888921888938,-1.2551895,36.7822034,-1.2985549,36.7882087,815,2050,8,259
5805,15769,868,3,Business,1,1,31722,1,1,31738,1,1,32153,1,1,33182,1,1,33675,4,21.3,-1.266837,36.799249,-1.265715,36.823815,427,493,16,1444
5806,1595,948,3,Business,13,1,34452,13,1,34516,13,1,35296,13,1,36229,13,1,37487,9,23.25888921888938,-1.297532,36.784932,-1.2696908,36.81519,624,1258,64,1713
5807,16890,948,3,Business,29,3,48435,29,3,48753,29,3,49856,29,3,51430,29,3,54958,11,21.0,-1.3151858,36.854623,-1.2594474,36.8089122,883,3528,318,2677
5808,12279,1787,3,Business,25,4,62209,25,4,62522,25,4,62656,25,4,62947,25,4,63970,5,23.25888921888938,-1.2156006,36.8916865,-1.2297202,36.8819507,79,1023,313,425
5809,15191,3291,3,Business,24,4,46355,24,4,46367,24,4,46503,24,4,46801,24,4,46803,2,24.4,-1.266837,36.799249,-1.2600926,36.8088685,40,2,12,434
5810,2875,316,1,Personal,21,1,43347,21,1,43379,21,1,43932,21,1,44295,21,1,46071,20,20.0,-1.3339943,36.7263409,-1.3231725,36.8640177,893,1776,32,916
5811,27997,1329,3,Business,11,2,37623,11,2,38065,11,2,38348,11,2,38454,11,2,40737,3,19.5,-1.273056,36.811298,-1.263194,36.797624,881,2283,442,389
5812,5020,3091,3,Business,14,1,53780,14,1,53803,14,1,54139,14,1,54447,14,1,55443,5,25.6,-1.2846195,36.7958316,-1.3012008,36.764868,516,996,23,644
5813,13845,496,3,Business,30,2,44379,30,2,45125,30,2,46893,30,2,47128,30,2,48214,15,23.25888921888938,-1.2551895,36.7822034,-1.2283403,36.8822756,247,1086,746,2003
5814,23145,540,3,Business,3,3,51166,3,3,51176,3,3,51414,3,3,51760,3,3,52830,8,28.3,-1.2551895,36.7822034,-1.2862436,36.791017,250,1070,10,584
5815,12985,393,3,Business,11,5,43097,11,5,43116,11,5,43122,11,5,44072,11,5,45806,14,21.2,-1.3167113,36.8301563,-1.306378,36.7519845,555,1734,19,956
5816,12860,3525,3,Business,12,3,38087,12,3,38848,12,3,39388,12,3,44975,12,3,46893,15,19.4,-1.3700383,36.9190174,-1.2981102,36.8293513,436,1918,761,6127
5817,22478,3017,3,Business,1,3,46518,1,3,46548,1,3,47948,1,3,48182,1,3,48585,2,20.1,-1.299313,36.7831488,-1.2963097,36.7688221,519,403,30,1634
5818,7331,3149,3,Business,13,4,52465,13,4,56961,13,4,57690,13,4,58964,13,4,60128,5,22.3,-1.3004062,36.829741,-1.3228003,36.8306435,362,1164,4496,2003
5819,4262,635,3,Business,15,5,42973,15,5,44981,15,5,47863,15,5,48782,15,5,50185,8,17.6,-1.2780878,36.8469436,-1.2602337,36.7990548,459,1403,2008,3801
5820,16963,867,3,Business,11,2,46034,11,2,46213,11,2,46400,11,2,48135,11,2,49874,10,19.5,-1.2996533,36.8292629,-1.2991441,36.7528804,36,1739,179,1922
5821,21999,1075,3,Business,14,4,48202,14,4,56276,14,4,58037,14,4,58259,14,4,60313,6,28.0,-1.2904016,36.8226303,-1.2527958,36.8003131,590,2054,8074,1983
5822,2199,498,1,Personal,2,1,58023,2,1,58220,2,1,59100,2,1,59286,2,1,60535,9,20.2,-1.3046965,36.8016456,-1.2642903,36.8002137,726,1249,197,1066
5823,17926,2154,3,Business,25,4,45113,25,4,48319,25,4,49446,25,4,49777,25,4,53401,9,23.25888921888938,-1.2765736,36.8513646,-1.2413316,36.8785525,204,3624,3206,1458
5824,190,2383,3,Business,21,4,56872,21,4,56907,21,4,57450,21,4,58363,21,4,59861,11,31.1,-1.2608993,36.799246,-1.2987697,36.746851,318,1498,35,1456
5825,16088,2454,3,Business,20,1,58425,20,1,58508,20,1,60681,20,1,61273,20,1,63123,12,23.25888921888938,-1.3264333,36.71071,-1.2942023,36.7958179,855,1850,83,2765
5826,27936,2587,3,Business,28,5,38217,28,5,38236,28,5,39231,28,5,39757,28,5,40178,1,23.7,-1.279395,36.825364,-1.28878,36.8168312,456,421,19,1521
5827,10547,2931,3,Business,21,1,43716,21,1,45871,21,1,47099,21,1,49098,21,1,52517,23,27.6,-1.3433181,36.9138018,-1.2452664,36.8028541,14,3419,2155,3227
5828,1151,1280,3,Business,11,1,55038,11,1,55201,11,1,55565,11,1,55878,11,1,55885,3,29.0,-1.2551895,36.7822034,-1.2638132,36.7849775,430,7,163,677
5829,2383,393,3,Business,27,3,31577,27,3,31589,27,3,31865,27,3,32577,27,3,34644,11,23.25888921888938,-1.3167113,36.8301563,-1.2638185,36.7930057,858,2067,12,988
5830,11525,2330,3,Business,12,5,54737,12,5,54812,12,5,55631,12,5,55715,12,5,57866,16,23.25888921888938,-1.233018,36.8004477,-1.3015197,36.7658456,7,2151,75,903
5831,20282,3464,3,Business,23,6,38614,23,6,38690,23,6,39041,23,6,39669,23,6,41436,9,26.2,-1.3014461,36.7661381,-1.2885029,36.825605,800,1767,76,979
5832,9779,868,3,Business,28,6,44641,28,6,44648,28,6,45456,28,6,46106,28,6,47895,14,24.1,-1.265715,36.823815,-1.293515,36.897607,670,1789,7,1458
5833,25047,3633,3,Personal,9,3,26384,9,3,29548,9,3,31655,9,3,31827,9,3,33201,7,17.7,-1.2963097,36.7688221,-1.3050868,36.8191906,571,1374,3164,2279
5834,4243,868,3,Business,15,1,57966,15,1,58245,15,1,59078,15,1,59581,15,1,60494,6,23.25888921888938,-1.3033561,36.8163631,-1.265715,36.823815,126,913,279,1336
5835,17224,1983,3,Personal,2,6,35246,2,6,35266,2,6,35413,2,6,35938,2,6,36514,4,20.1,-1.2827946,36.7689449,-1.2952109,36.7757064,735,576,20,672
5836,4112,517,3,Business,3,1,38895,3,1,38909,3,1,38935,3,1,39291,3,1,40394,11,21.7,-1.3228003,36.8306435,-1.2638185,36.7930057,168,1103,14,382
5837,429,426,3,Business,25,2,33372,25,2,33393,25,2,34322,25,2,35536,25,2,40114,14,17.8,-1.3323107,36.8692616,-1.2684319,36.8165853,612,4578,21,2143
5838,17389,2582,3,Business,19,2,44693,19,2,44785,19,2,45413,19,2,46010,19,2,47871,11,26.6,-1.2571472,36.7950633,-1.3322618,36.8045412,411,1861,92,1225
5839,15561,868,3,Business,21,4,43271,21,4,43314,21,4,44869,21,4,45619,21,4,47540,14,25.3,-1.293515,36.897607,-1.265715,36.823815,377,1921,43,2305
5840,6686,1742,1,Personal,15,6,66016,15,6,66048,15,6,67310,15,6,67530,15,6,68379,4,24.8,-1.2966785,36.7896469,-1.280467,36.7859296,465,849,32,1482
5841,15859,2066,3,Business,14,2,46450,14,2,46486,14,2,47134,14,2,47491,14,2,48875,8,21.5,-1.316961,36.820337,-1.2654199,36.8008276,213,1384,36,1005
5842,12448,393,3,Business,23,3,41922,23,3,41998,23,3,43105,23,3,43563,23,3,45897,14,23.25888921888938,-1.3167113,36.8301563,-1.306378,36.7519845,876,2334,76,1565
5843,3991,2989,3,Business,24,1,53973,24,1,54596,24,1,57385,24,1,57931,24,1,59237,15,24.8,-1.3472066,36.7692638,-1.2591019,36.800577,925,1306,623,3335
5844,20502,1402,3,Business,15,1,52092,15,1,52890,15,1,53617,15,1,54278,15,1,57215,17,23.25888921888938,-1.3263903,36.7179885,-1.2813012,36.8323962,448,2937,798,1388
5845,28158,84,3,Business,3,3,41632,3,3,41640,3,3,41948,3,3,42156,3,3,44846,22,27.3,-1.2551895,36.7822034,-1.3562374,36.9042954,865,2690,8,516
5846,15906,346,3,Business,9,2,49838,9,2,49904,9,2,52119,9,2,52621,9,2,56819,16,30.5,-1.207546,36.7913976,-1.28878,36.8168312,7,4198,66,2717
5847,15216,896,3,Personal,4,1,44692,4,1,44857,4,1,45983,4,1,46722,4,1,48716,20,25.5,-1.3247683,36.85803,-1.2163547,36.8862404,856,1994,165,1865
5848,18832,2676,3,Business,17,4,51389,17,4,51567,17,4,54386,17,4,54639,17,4,55689,8,28.0,-1.2650042,36.7903927,-1.2963097,36.7688221,764,1050,178,3072
5849,24169,2200,3,Business,5,1,52028,5,1,52868,5,1,53720,5,1,54050,5,1,54147,2,26.2,-1.2897368,36.8226783,-1.290894,36.822971,31,97,840,1182
5850,8814,475,3,Business,13,1,54220,13,1,54242,13,1,54351,13,1,55170,13,1,55883,7,23.25888921888938,-1.2571472,36.7950633,-1.3024794,36.8228284,438,713,22,928
5851,7949,2271,3,Business,18,1,45720,18,1,45876,18,1,46121,18,1,46903,18,1,49035,19,26.8,-1.303596,36.778378,-1.293515,36.897607,327,2132,156,1027
5852,539,635,3,Business,18,5,46080,18,5,46116,18,5,47513,18,5,47996,18,5,48855,2,20.1,-1.2599563,36.7993439,-1.2649247,36.8085655,611,859,36,1880
5853,4076,2853,3,Business,18,5,56491,18,5,57147,18,5,58226,18,5,58728,18,5,61413,22,24.3,-1.3700383,36.9190174,-1.2576006,36.815763,900,2685,656,1581
5854,10659,1245,3,Business,17,5,47084,17,5,47101,17,5,47724,17,5,48156,17,5,50519,11,23.25888921888938,-1.3198615,36.7110323,-1.2929937,36.7815349,204,2363,17,1055
5855,16725,2423,3,Business,30,2,39326,30,2,39514,30,2,39784,30,2,40705,30,2,42613,4,23.25888921888938,-1.2551895,36.7822034,-1.2684437,36.810097,291,1908,188,1191
5856,25196,1500,3,Business,14,3,33025,14,3,35118,14,3,37545,14,3,39120,14,3,40496,8,24.5,-1.3004062,36.829741,-1.2574219,36.7927073,436,1376,2093,4002
5857,26313,496,3,Business,17,3,33853,17,3,33872,17,3,33968,17,3,35361,17,3,35778,2,23.25888921888938,-1.2551895,36.7822034,-1.2517846,36.7938086,177,417,19,1489
5858,20211,2212,3,Business,19,5,32644,19,5,34920,19,5,36450,19,5,36786,19,5,39626,5,20.0,-1.2646084,36.8028645,-1.2841726,36.8179589,829,2840,2276,1866
5859,16837,3091,3,Business,18,2,46475,18,2,47047,18,2,47939,18,2,48106,18,2,49083,3,23.25888921888938,-1.3012008,36.764868,-1.2765492,36.7669809,548,977,572,1059
5860,6186,533,3,Business,15,4,53347,15,4,53652,15,4,54104,15,4,55022,15,4,55754,7,27.6,-1.2571472,36.7950633,-1.2765492,36.7669809,131,732,305,1370
5861,8185,3222,3,Business,29,1,53820,29,1,54256,29,1,55253,29,1,57922,29,1,58762,8,24.2,-1.2551895,36.7822034,-1.2939132,36.8081606,606,840,436,3666
5862,8592,2686,1,Personal,14,2,56550,14,2,57579,14,2,57805,14,2,58003,14,2,59590,12,24.1,-1.3465623,36.7677838,-1.2791224,36.8306878,249,1587,1029,424
5863,20983,442,3,Personal,18,1,55698,18,1,55834,18,1,56677,18,1,57219,18,1,58151,6,30.7,-1.2885417,36.8100523,-1.2609745,36.7886626,405,932,136,1385
5864,17328,2767,3,Business,14,5,36360,14,5,36371,14,5,36978,14,5,37223,14,5,38717,11,18.1,-1.257773,36.795486,-1.2248308,36.8012573,131,1494,11,852
5865,14639,635,3,Business,23,4,39207,23,4,39499,23,4,40139,23,4,40737,23,4,41450,4,18.5,-1.2599563,36.7993439,-1.2833335,36.8260084,179,713,292,1238
5866,3499,221,1,Personal,14,5,54921,14,5,55349,14,5,55906,14,5,56357,14,5,59554,7,27.2,-1.2853338,36.8194475,-1.2887613,36.7730538,365,3197,428,1008
5867,16652,3669,3,Business,1,4,39172,1,4,39187,1,4,39272,1,4,40595,1,4,41102,3,23.25888921888938,-1.2584143,36.8048002,-1.2615888,36.7928732,648,507,15,1408
5868,22395,867,3,Business,28,3,53261,28,3,53449,28,3,53526,28,3,54652,28,3,56199,10,23.25888921888938,-1.2996533,36.8292629,-1.306378,36.7519845,708,1547,188,1203
5869,2607,393,3,Business,17,3,31574,17,3,31681,17,3,32115,17,3,32671,17,3,33376,4,23.25888921888938,-1.3167113,36.8301563,-1.3004062,36.829741,728,705,107,990
5870,19032,1244,3,Business,2,4,35171,2,4,35223,2,4,35396,2,4,37285,2,4,38296,9,13.3,-1.2600926,36.8088685,-1.303596,36.778378,101,1011,52,2062
5871,17705,3149,3,Business,20,3,56645,20,3,56673,20,3,56678,20,3,59401,20,3,59916,5,28.5,-1.3004062,36.829741,-1.3167113,36.8301563,809,515,28,2728
5872,17757,2200,3,Business,4,2,52672,4,2,54125,4,2,55503,4,2,55574,4,2,59582,12,23.9,-1.225322,36.80855,-1.290894,36.822971,928,4008,1453,1449
5873,25942,3578,3,Business,29,1,45710,29,1,45758,29,1,47403,29,1,47989,29,1,49112,6,23.25888921888938,-1.2936941,36.8156795,-1.2527958,36.8003131,19,1123,48,2231
5874,18500,1034,1,Personal,25,2,43969,25,2,44224,25,2,45397,25,2,46477,25,2,47181,4,23.6,-1.2715686,36.8023526,-1.2946764,36.8184646,338,704,255,2253
5875,26888,3686,3,Business,14,4,40510,14,4,42252,14,4,43166,14,4,43379,14,4,44619,8,23.6,-1.2551895,36.7822034,-1.299911,36.818856,339,1240,1742,1127
5876,10737,2691,3,Business,24,4,33588,24,4,33748,24,4,36482,24,4,38545,24,4,39699,9,21.1,-1.26097,36.787286,-1.2677415,36.8348418,844,1154,160,4797
5877,16330,788,3,Business,7,3,47955,7,3,47980,7,3,49580,7,3,51452,7,3,52183,7,28.1,-1.207546,36.7913976,-1.225322,36.80855,257,731,25,3472
5878,22287,0,1,Personal,3,7,40779,3,7,40993,3,7,42261,3,7,43098,3,7,46156,17,22.1,-1.3093096,36.9060479,-1.2699958,36.795639,890,3058,214,2105
5879,6616,391,3,Business,24,3,41594,24,3,42636,24,3,42690,24,3,44749,24,3,44753,4,23.25888921888938,-1.2839729,36.8115146,-1.300921,36.828195,86,4,1042,2113
5880,11870,2330,3,Business,15,5,44197,15,5,44218,15,5,44832,15,5,44965,15,5,45305,3,26.3,-1.3040812,36.7924217,-1.2915247,36.8055757,862,340,21,747
5881,20347,3341,1,Personal,29,5,42495,29,5,43964,29,5,43975,29,5,44211,29,5,46887,4,19.8,-1.2863177,36.8237972,-1.2994217,36.8009779,756,2676,1469,247
5882,11523,1102,3,Business,29,5,59753,29,5,59789,29,5,60342,29,5,60439,29,5,61832,4,28.2,-1.3004062,36.829741,-1.2980085,36.8044778,787,1393,36,650
5883,13736,972,3,Business,25,4,34262,25,4,34471,25,4,34612,25,4,34776,25,4,35454,5,16.4,-1.2862033,36.8152966,-1.3019137,36.7925105,726,678,209,305
5884,3860,393,3,Business,23,4,36055,23,4,36073,23,4,36168,23,4,37021,23,4,37636,5,23.25888921888938,-1.3228003,36.8306435,-1.3077869,36.8443207,709,615,18,948
5885,14781,1293,3,Personal,28,2,46078,28,2,46095,28,2,47884,28,2,48624,28,2,50932,18,17.7,-1.3152336,36.7116401,-1.2543164,36.831861,393,2308,17,2529
5886,22138,3283,3,Business,15,4,47156,15,4,48939,15,4,49677,15,4,50443,15,4,52746,18,27.5,-1.293515,36.897607,-1.2628473,36.781805,702,2303,1783,1504
5887,13477,3149,3,Business,26,5,55228,26,5,55278,26,5,55334,26,5,56785,26,5,57350,5,23.25888921888938,-1.3004062,36.829741,-1.3167113,36.8301563,211,565,50,1507
5888,2539,3189,3,Personal,10,1,39488,10,1,39515,10,1,39882,10,1,40787,10,1,43226,15,18.6,-1.3087304,36.8312988,-1.2513529,36.752172,211,2439,27,1272
5889,12096,3760,2,Personal,1,1,55203,1,1,55214,1,1,55468,1,1,56015,1,1,56517,2,25.8,-1.2752846,36.8027022,-1.2747111,36.8083983,622,502,11,801
5890,9884,3560,3,Business,22,3,46912,22,3,47069,22,3,48637,22,3,49065,22,3,51212,12,24.5,-1.2860183,36.8975338,-1.279395,36.825364,99,2147,157,1996
5891,19241,3064,3,Business,26,4,52316,26,4,56828,26,4,57352,26,4,57612,26,4,59055,5,22.2,-1.2571472,36.7950633,-1.2549476,36.8269576,131,1443,4512,784
5892,23374,3264,3,Business,24,3,32709,24,3,32840,24,3,34011,24,3,34144,24,3,35138,7,23.25888921888938,-1.2551895,36.7822034,-1.2889914,36.8209443,953,994,131,1304
5893,24373,1059,1,Personal,17,3,53642,17,3,53651,17,3,54125,17,3,54309,17,3,55605,11,28.5,-1.3303649,36.7260187,-1.296567,36.7813901,832,1296,9,658
5894,24775,657,1,Personal,20,3,62178,20,3,64172,20,3,65207,20,3,65597,20,3,67201,12,21.7,-1.2873119,36.8251255,-1.309538,36.7353407,744,1604,1994,1425
5895,3047,3621,3,Business,8,1,64201,8,1,64218,8,1,65133,8,1,65214,8,1,66588,5,29.2,-1.2836583,36.7886014,-1.2811503,36.8235884,344,1374,17,996
5896,13594,2469,3,Business,26,1,58641,26,1,58875,26,1,61094,26,1,61634,26,1,62976,7,20.2,-1.2907843,36.8298908,-1.303924,36.8758792,916,1342,234,2759
5897,15179,2763,3,Business,29,2,34896,29,2,34921,29,2,35074,29,2,35590,29,2,37505,13,18.3,-1.2551895,36.7822034,-1.307504,36.8598127,576,1915,25,669
5898,5629,3518,3,Business,28,5,33662,28,5,33669,28,5,33769,28,5,34020,28,5,35399,14,20.7,-1.2551895,36.7822034,-1.3332749,36.8708147,449,1379,7,351
5899,20784,868,3,Business,10,1,44985,10,1,45116,10,1,45256,10,1,45996,10,1,47234,7,18.5,-1.2628473,36.781805,-1.2663631,36.8163329,864,1238,131,880
5900,15115,1482,3,Business,4,2,45976,4,2,46079,4,2,47896,4,2,48230,4,2,49386,8,19.6,-1.338579,36.8963038,-1.3319425,36.8944709,113,1156,103,2151
5901,17322,2175,3,Business,15,5,34212,15,5,34269,15,5,34279,15,5,35127,15,5,36439,8,19.1,-1.2551895,36.7822034,-1.290894,36.822971,828,1312,57,858
5902,21585,391,3,Business,7,2,38238,7,2,38790,7,2,39050,7,2,41021,7,2,42587,5,23.25888921888938,-1.300921,36.828195,-1.2867454,36.8259017,298,1566,552,2231
5903,2120,1340,3,Business,1,3,55779,1,3,55842,1,3,56418,1,3,56828,1,3,58123,6,23.8,-1.2945798,36.7737755,-1.2707179,36.7979713,140,1295,63,986
5904,15704,1500,3,Business,2,3,54582,2,3,54664,2,3,54958,2,3,56655,2,3,56658,13,26.2,-1.2574219,36.7927073,-1.3228003,36.8306435,725,3,82,1991
5905,1627,1280,3,Business,10,1,41018,10,1,41040,10,1,41394,10,1,41666,10,1,42070,3,23.4,-1.2551895,36.7822034,-1.265338,36.8088155,446,404,22,626
5906,2499,1768,1,Personal,3,3,32692,3,3,32769,3,3,34312,3,3,34691,3,3,35824,10,18.7,-1.2750257,36.8157165,-1.301809,36.75643,754,1133,77,1922
5907,14858,510,3,Business,29,2,52359,29,2,52371,29,2,52377,29,2,52668,29,2,53842,14,23.6,-1.2860183,36.8975338,-1.3562374,36.9042954,589,1174,12,297
5908,27909,2603,2,Personal,16,2,43031,16,2,43417,16,2,43885,16,2,44078,16,2,47619,19,23.6,-1.3632162,36.9108253,-1.2852584,36.8043641,770,3541,386,661
5909,19326,2611,3,Personal,16,2,58239,16,2,58447,16,2,58526,16,2,59118,16,2,60022,6,27.3,-1.3012475,36.8295592,-1.3035984,36.8035843,89,904,208,671
5910,13891,81,3,Business,30,3,40102,30,3,40215,30,3,40568,30,3,41866,30,3,43817,16,24.9,-1.2156006,36.8916865,-1.2641496,36.7914139,869,1951,113,1651
5911,18714,1721,3,Business,26,2,59892,26,2,59977,26,2,59986,26,2,60241,26,2,61354,8,28.5,-1.2551895,36.7822034,-1.289379,36.792949,523,1113,85,264
5912,11592,1243,1,Business,1,1,41476,1,1,41528,1,1,41857,1,1,42091,1,1,43929,10,24.2,-1.2615888,36.7928732,-1.304524,36.775371,228,1838,52,563
5913,8506,1304,3,Business,6,2,52200,6,2,54580,6,2,54691,6,2,55483,6,2,58245,13,27.5,-1.3332749,36.8708147,-1.2684319,36.8165853,315,2762,2380,903
5914,16431,1882,1,Business,6,6,34182,6,6,34250,6,6,37170,6,6,37637,6,6,38911,8,19.1,-1.2268871,36.8073946,-1.2591019,36.800577,257,1274,68,3387
5915,7249,527,2,Personal,8,5,47250,8,5,47338,8,5,49820,8,5,52088,8,5,55230,13,21.4,-1.2861765,36.8209086,-1.3302565,36.8986392,216,3142,88,4750
5916,27838,3647,3,Business,12,3,53081,12,3,53247,12,3,54462,12,3,54757,12,3,56466,5,20.8,-1.272639,36.794723,-1.2628638,36.8070399,158,1709,166,1510
5917,8062,1792,3,Business,30,3,54554,30,3,54653,30,3,55227,30,3,55319,30,3,56662,10,25.2,-1.288159,36.7925275,-1.243307,36.7969579,898,1343,99,666
5918,24048,2901,3,Business,16,2,33356,16,2,33391,16,2,36222,16,2,36407,16,2,37087,3,23.25888921888938,-1.2946918,36.8011541,-1.2839993,36.791851,468,680,35,3016
5919,17553,1705,3,Business,7,5,43572,7,5,43774,7,5,43857,7,5,44434,7,5,46901,30,25.3,-1.2551895,36.7822034,-1.1427273,36.9371213,574,2467,202,660
5920,25489,1363,3,Business,10,5,54577,10,5,55092,10,5,55211,10,5,55703,10,5,58487,10,23.25888921888938,-1.3004062,36.829741,-1.2991441,36.7528804,68,2784,515,611
5921,10576,1425,3,Business,31,5,51369,31,5,51484,31,5,51759,31,5,53614,31,5,55578,10,24.9,-1.338283,36.8871775,-1.3004062,36.829741,383,1964,115,2130
5922,23375,2383,3,Business,4,2,56631,4,2,57384,4,2,58272,4,2,58375,4,2,58944,2,22.6,-1.2608993,36.799246,-1.2516391,36.8114886,138,569,753,991
5923,13076,1928,1,Business,9,1,44138,9,1,44182,9,1,44867,9,1,45071,9,1,47270,16,20.5,-1.2571191,36.8019652,-1.2808685,36.8906944,74,2199,44,889
5924,8345,3194,3,Business,10,3,56376,10,3,56389,10,3,56444,10,3,56876,10,3,60140,29,30.5,-1.2551895,36.7822034,-1.1270934,36.648316,858,3264,13,487
5925,21534,1307,3,Business,3,7,52720,3,7,52787,3,7,54538,3,7,54899,3,7,57785,19,22.8,-1.2844665,36.7866113,-1.267146,36.9065104,919,2886,67,2112
5926,15684,393,3,Business,2,5,46060,2,5,48430,2,5,49729,2,5,50150,2,5,52005,14,25.2,-1.3177547,36.8303703,-1.306378,36.7519845,623,1855,2370,1720
5927,14856,3115,3,Business,1,3,42841,1,3,42853,1,3,43112,1,3,43747,1,3,45548,10,19.9,-1.2615584,36.8149506,-1.2963097,36.7688221,329,1801,12,894
5928,10978,3647,3,Business,14,2,47751,14,2,47844,14,2,48474,14,2,48658,14,2,49411,4,23.25888921888938,-1.272639,36.794723,-1.2674482,36.8076994,959,753,93,814
5929,5083,2330,3,Business,12,2,32848,12,2,32871,12,2,33255,12,2,33320,12,2,34617,11,17.9,-1.3015197,36.7658456,-1.2687407,36.7373043,847,1297,23,449
5930,8089,136,3,Business,13,2,53809,13,2,55671,13,2,55684,13,2,56063,13,2,56128,3,26.2,-1.3326173,36.7146233,-1.3169591,36.7000029,928,65,1862,392
5931,2329,393,3,Business,25,1,35968,25,1,35987,25,1,36431,25,1,37460,25,1,38932,14,23.25888921888938,-1.3167113,36.8301563,-1.306378,36.7519845,411,1472,19,1473
5932,20522,1787,3,Business,4,1,63244,4,1,63279,4,1,63485,4,1,64315,4,1,65666,12,27.8,-1.2603403,36.7998848,-1.2285835,36.8826468,178,1351,35,1036
5933,25117,2956,3,Business,9,4,45867,9,4,46060,9,4,49200,9,4,49956,9,4,50769,2,23.25888921888938,-1.2527958,36.8003131,-1.2584143,36.8048002,435,813,193,3896
5934,24186,517,3,Business,27,6,39907,27,6,40048,27,6,40057,27,6,40660,27,6,41042,4,23.25888921888938,-1.3167113,36.8301563,-1.3004062,36.829741,161,382,141,612
5935,25798,2532,3,Business,6,1,58763,6,1,58786,6,1,59002,6,1,61020,6,1,61378,3,22.5,-1.2571472,36.7950633,-1.2745107,36.7974503,116,358,23,2234
5936,1689,2956,3,Business,10,2,53064,10,2,60378,10,2,61063,10,2,61612,10,2,63944,7,20.8,-1.225322,36.80855,-1.2584143,36.8048002,467,2332,7314,1234
5937,8487,868,3,Business,22,3,55014,22,3,55950,22,3,58020,22,3,58208,22,3,58209,5,24.1,-1.2600926,36.8088685,-1.265715,36.823815,849,1,936,2258
5938,12718,2344,3,Business,24,3,59454,24,3,59571,24,3,60011,24,3,60284,24,3,60287,4,18.4,-1.2619756,36.800139,-1.2551895,36.7822034,647,3,117,713
5939,6987,633,3,Business,15,5,41902,15,5,42083,15,5,42357,15,5,42865,15,5,44083,9,26.1,-1.2638185,36.7930057,-1.3004062,36.829741,764,1218,181,782
5940,16261,3017,3,Business,20,4,62086,20,4,62110,20,4,62952,20,4,63186,20,4,65686,15,25.1,-1.2993231,36.7753372,-1.244847,36.6830249,465,2500,24,1076
5941,22126,136,3,Business,19,2,45538,19,2,45581,19,2,45798,19,2,45893,19,2,48760,17,27.4,-1.3254522,36.7216584,-1.2629838,36.8086926,655,2867,43,312
5942,2097,2804,3,Business,18,4,30484,18,4,30504,18,4,32794,18,4,33695,18,4,35219,12,23.25888921888938,-1.3270716,36.8406371,-1.2571472,36.7950633,68,1524,20,3191
5943,2448,265,3,Business,14,4,45475,14,4,45510,14,4,45608,14,4,46465,14,4,47622,8,25.0,-1.2948835,36.7830474,-1.300921,36.828195,519,1157,35,955
5944,23140,1508,2,Personal,6,1,32180,6,1,32190,6,1,32498,6,1,32675,6,1,33872,11,15.2,-1.2874215,36.7767292,-1.257984,36.745016,636,1197,10,485
5945,777,730,3,Personal,30,3,52193,30,3,52203,30,3,52240,30,3,52517,30,3,53457,2,24.9,-1.2963097,36.7688221,-1.3043821,36.7840586,618,940,10,314
5946,25585,1513,1,Personal,27,4,43918,27,4,44206,27,4,44934,27,4,45171,27,4,46916,7,22.9,-1.2574219,36.7927073,-1.2929432,36.8215068,844,1745,288,965
5947,2629,248,3,Business,12,4,60875,12,4,60906,12,4,61198,12,4,62966,12,4,64570,10,20.6,-1.304735,36.7846054,-1.254191,36.8099132,919,1604,31,2060
5948,13126,53,3,Business,3,3,42772,3,3,43074,3,3,44648,3,3,45165,3,3,46545,5,27.5,-1.3004062,36.829741,-1.2770708,36.8231093,306,1380,302,2091
5949,22448,2866,3,Business,6,1,57898,6,1,57918,6,1,58088,6,1,58228,6,1,60207,8,24.5,-1.2551895,36.7822034,-1.2994217,36.8009779,857,1979,20,310
5950,27873,3718,3,Business,23,2,43968,23,2,44045,23,2,44171,23,2,44918,23,2,45749,6,18.0,-1.2635744,36.781677,-1.2650027,36.8126242,536,831,77,873
5951,10850,1499,2,Personal,14,6,36004,14,6,36014,14,6,36905,14,6,37255,14,6,39171,5,15.2,-1.2873232,36.7658572,-1.2835228,36.7437619,465,1916,10,1241
5952,11444,478,3,Business,7,3,56155,7,3,56354,7,3,58919,7,3,59135,7,3,60141,11,28.2,-1.2701354,36.8072167,-1.331619,36.847976,343,1006,199,2781
5953,3336,3127,3,Business,21,3,38390,21,3,38399,21,3,40820,21,3,41363,21,3,44050,14,22.1,-1.2388499,36.8727268,-1.2918246,36.801585,199,2687,9,2964
5954,2488,3491,3,Business,5,5,62326,5,5,62334,5,5,62847,5,5,63152,5,5,63758,3,26.3,-1.2232123,36.8932547,-1.2283403,36.8822756,484,606,8,818
5955,15655,3647,3,Business,3,1,47033,3,1,47067,3,1,48928,3,1,49117,3,1,49963,5,23.2,-1.272639,36.794723,-1.2655477,36.8001682,79,846,34,2050
5956,16217,3222,3,Business,3,1,56985,3,1,57049,3,1,57526,3,1,57919,3,1,58558,4,23.0,-1.2551895,36.7822034,-1.2754343,36.8127158,827,639,64,870
5957,25302,3300,3,Business,29,3,31858,29,3,31880,29,3,31907,29,3,32736,29,3,33722,9,17.9,-1.259478,36.8017813,-1.303596,36.778378,178,986,22,856
5958,20002,3647,3,Business,25,4,32972,25,4,32998,25,4,33528,25,4,33871,25,4,34741,4,23.25888921888938,-1.272639,36.794723,-1.2674482,36.8076994,306,870,26,873
5959,9164,3194,3,Business,22,5,47146,22,5,47199,22,5,47453,22,5,47958,22,5,48664,7,23.25888921888938,-1.2551895,36.7822034,-1.2737396,36.8365642,156,706,53,759
5960,4431,3222,3,Business,8,5,51477,8,5,51517,8,5,51625,8,5,52799,8,5,55101,8,30.5,-1.2551895,36.7822034,-1.3012619,36.8213697,630,2302,40,1282
5961,2817,3727,3,Business,8,5,36680,8,5,36697,8,5,37248,8,5,37445,8,5,38878,9,20.3,-1.2963097,36.7688221,-1.252433,36.7919418,755,1433,17,748
5962,14380,1724,3,Business,18,1,51280,18,1,51482,18,1,51906,18,1,52090,18,1,52719,4,29.3,-1.2672588,36.8000252,-1.2551895,36.7822034,877,629,202,608
5963,24955,3214,3,Business,20,1,54192,20,1,54255,20,1,55988,20,1,56467,20,1,58354,21,23.25888921888938,-1.289795,36.7957132,-1.3190102,36.9230693,845,1887,63,2212
5964,23417,1484,3,Business,11,1,35477,11,1,35680,11,1,36170,11,1,37064,11,1,38166,14,18.0,-1.2551895,36.7822034,-1.2464947,36.8802085,497,1102,203,1384
5965,16437,393,3,Business,8,1,50981,8,1,50986,8,1,50992,8,1,51860,8,1,53470,14,29.8,-1.3167113,36.8301563,-1.2991441,36.7528804,349,1610,5,874
5966,23207,1687,3,Business,7,4,36766,7,4,37396,7,4,40589,7,4,41550,7,4,41575,2,16.8,-1.2816617,36.81634443,-1.2874648,36.8271985,159,25,630,4154
5967,8104,2523,3,Business,25,1,41983,25,1,41998,25,1,42452,25,1,42522,25,1,43708,7,27.3,-1.2551895,36.7822034,-1.2545163,36.8243717,933,1186,15,524
5968,5340,71,3,Business,28,1,46805,28,1,46877,28,1,47570,28,1,48086,28,1,48407,1,23.9,-1.2813012,36.8323962,-1.290894,36.822971,21,321,72,1209
5969,19390,1148,3,Business,8,1,42104,8,1,42205,8,1,42520,8,1,43460,8,1,44933,9,24.3,-1.3100586,36.8500329,-1.2710687,36.8142839,848,1473,101,1255
5970,8795,880,3,Personal,21,5,43326,21,5,43388,21,5,44127,21,5,44546,21,5,45903,4,19.9,-1.2995135,36.7933633,-1.2892529,36.7740575,312,1357,62,1158
5971,4193,1245,3,Business,25,1,48514,25,1,48525,25,1,48671,25,1,50694,25,1,52313,16,27.8,-1.300921,36.828195,-1.3882008,36.7699445,267,1619,11,2169
5972,6573,3147,3,Business,21,5,40230,21,5,40235,21,5,40250,21,5,42564,21,5,44522,31,19.8,-1.3472066,36.7692638,-1.1923911,36.9447333,345,1958,5,2329
5973,13147,3599,3,Business,28,2,42055,28,2,42055,28,2,42088,28,2,44035,28,2,46381,14,21.5,-1.3302996,36.8707935,-1.2748221,36.7817865,772,2346,0,1980
5974,15644,136,3,Business,2,2,32608,2,2,32639,2,2,33478,2,2,33772,2,2,38823,18,20.7,-1.2633232,36.8305068,-1.3254522,36.7216584,530,5051,31,1133
5975,4438,1500,3,Business,11,5,56247,11,5,57831,11,5,59331,11,5,59617,11,5,60597,6,24.3,-1.2770708,36.8231093,-1.2574219,36.7927073,436,980,1584,1786
5976,8384,1926,3,Business,2,5,48567,2,5,48625,2,5,48932,2,5,49076,2,5,52082,14,25.0,-1.3332749,36.8708147,-1.2959018,36.7948256,807,3006,58,451
5977,23057,391,3,Business,10,5,40148,10,5,40679,10,5,41369,10,5,44011,10,5,44132,5,23.25888921888938,-1.300921,36.828195,-1.2784063,36.8222933,436,121,531,3332
5978,4021,2330,3,Business,16,3,41822,16,3,41828,16,3,41842,16,3,41944,16,3,43166,9,22.6,-1.3040812,36.7924217,-1.2642903,36.8002137,253,1222,6,116
5979,11802,635,3,Business,25,6,33947,25,6,33993,25,6,35723,25,6,36946,25,6,38246,10,23.25888921888938,-1.3081376,36.8329772,-1.2602337,36.7990548,448,1300,46,2953
5980,21847,2212,3,Business,9,4,46763,9,4,47314,9,4,48103,9,4,48362,9,4,50251,11,23.25888921888938,-1.2571472,36.7950633,-1.3151162,36.8569981,96,1889,551,1048
5981,17182,1482,3,Business,18,2,55596,18,2,55680,18,2,55700,18,2,59190,18,2,62378,16,25.7,-1.2534301,36.8000983,-1.338579,36.8963038,31,3188,84,3510
5982,16409,346,3,Business,25,6,44030,25,6,44082,25,6,44599,25,6,46503,25,6,47949,12,23.25888921888938,-1.2283403,36.8822756,-1.28878,36.8168312,291,1446,52,2421
5983,2704,1927,3,Business,9,3,54718,9,3,54733,9,3,56238,9,3,56897,9,3,59733,17,25.3,-1.3467389,36.7690312,-1.2551895,36.7822034,246,2836,15,2164
5984,16017,3253,1,Personal,6,5,36140,6,5,36148,6,5,36800,6,5,37629,6,5,39816,14,14.8,-1.2238486,36.8566907,-1.2615888,36.7928732,224,2187,8,1481
5985,10381,3701,3,Business,23,4,50624,23,4,50656,23,4,51521,23,4,52428,23,4,53707,8,24.6,-1.2975098,36.8397842,-1.2612574,36.7879622,448,1279,32,1772
5986,18999,1527,3,Business,2,4,44528,2,4,44833,2,4,46115,2,4,46214,2,4,46656,5,23.25888921888938,-1.3004062,36.829741,-1.3228003,36.8306435,910,442,305,1381
5987,3601,2767,3,Business,12,1,49148,12,1,52318,12,1,53363,12,1,54091,12,1,54968,8,27.0,-1.257773,36.795486,-1.2230813,36.8014169,147,877,3170,1773
5988,16291,3589,1,Personal,29,2,46190,29,2,46290,29,2,46823,29,2,46897,29,2,49720,6,21.3,-1.2579304,36.8019667,-1.3051608,36.8288914,88,2823,100,607
5989,4624,411,3,Business,19,3,56676,19,3,56754,19,3,58286,19,3,58546,19,3,60944,11,24.5,-1.3008601,36.8542593,-1.2768326,36.8073804,779,2398,78,1792
5990,21676,635,3,Business,26,1,44868,26,1,45466,26,1,46018,26,1,47489,26,1,48370,6,23.0,-1.300921,36.828195,-1.3229345,36.8566974,406,881,598,2023
5991,18401,53,3,Business,11,4,40569,11,4,40671,11,4,41193,11,4,42981,11,4,44133,5,25.8,-1.3004062,36.829741,-1.2770708,36.8231093,99,1152,102,2310
5992,16744,1584,3,Business,27,1,41873,27,1,41892,27,1,41963,27,1,42425,27,1,43569,4,23.9,-1.304033,36.7848695,-1.2885417,36.8100523,890,1144,19,533
5993,222,136,3,Business,30,5,42753,30,5,42771,30,5,43172,30,5,43374,30,5,44879,3,23.7,-1.3326173,36.7146233,-1.3169591,36.7000029,917,1505,18,603
5994,17898,3746,1,Personal,25,5,64960,25,5,65108,25,5,66124,25,5,66679,25,5,67778,5,21.1,-1.2646579,36.8253211,-1.2750247,36.7981039,755,1099,148,1571
5995,26668,186,3,Business,11,2,54008,11,2,57487,11,2,57534,11,2,57805,11,2,59773,16,21.4,-1.3700383,36.9190174,-1.2852569,36.8976121,937,1968,3479,318
5996,26309,3698,3,Business,30,2,46989,30,2,47200,30,2,47838,30,2,48215,30,2,49673,7,23.25888921888938,-1.3244885,36.897792,-1.34364,36.8925345,164,1458,211,1015
5997,3854,3222,3,Business,27,1,43401,27,1,43587,27,1,44452,27,1,46255,27,1,47541,14,20.7,-1.3261879,36.8601793,-1.2551895,36.7822034,856,1286,186,2668
5998,24440,91,3,Personal,26,2,44598,26,2,44625,26,2,46901,26,2,48008,26,2,49365,9,26.2,-1.2990731,36.8488058,-1.2775276,36.8140021,569,1357,27,3383
5999,2181,1208,1,Personal,29,5,54402,29,5,55089,29,5,57945,29,5,58071,29,5,60085,22,21.0,-1.3003196,36.8171416,-1.2100103,36.797424,265,2014,687,2982
6000,3659,1500,3,Business,21,4,47554,21,4,47642,21,4,48015,21,4,50120,21,4,51126,11,26.3,-1.3077869,36.8443207,-1.2638185,36.7930057,828,1006,88,2478
6001,1931,1500,3,Business,23,2,37480,23,2,37490,23,2,37503,23,2,38830,23,2,40031,8,23.25888921888938,-1.3004062,36.829741,-1.2638185,36.7930057,843,1201,10,1340
6002,27472,1075,3,Business,2,6,52129,2,6,53603,2,6,55010,2,6,55550,2,6,57262,7,30.9,-1.2325706,36.8083923,-1.2527958,36.8003131,318,1712,1474,1947
6003,5530,393,3,Business,13,3,38312,13,3,38323,13,3,38327,13,3,39223,13,3,40874,11,23.25888921888938,-1.3167113,36.8301563,-1.2638185,36.7930057,901,1651,11,900
6004,22146,3487,3,Business,29,1,44515,29,1,44608,29,1,45032,29,1,45434,29,1,46149,6,23.25888921888938,-1.279395,36.825364,-1.2615888,36.7928732,205,715,93,826
6005,24114,3560,3,Business,6,1,35060,6,1,35148,6,1,36883,6,1,37355,6,1,38722,13,14.8,-1.2156006,36.8916865,-1.279395,36.825364,19,1367,88,2207
6006,19040,1954,3,Business,18,5,30747,18,5,31664,18,5,32311,18,5,32689,18,5,34914,9,17.8,-1.289498,36.818878,-1.329568,36.8520825,531,2225,917,1025
6007,8219,2523,3,Business,31,4,45799,31,4,45821,31,4,46200,31,4,47016,31,4,47019,4,26.3,-1.2551895,36.7822034,-1.2689015,36.7986106,916,3,22,1195
6008,3693,2987,3,Business,29,1,59738,29,1,60549,29,1,61102,29,1,61189,29,1,63763,7,23.6,-1.270212,36.8210877,-1.3043821,36.7840586,143,2574,811,640
6009,19740,1724,3,Business,4,4,51726,4,4,51772,4,4,52513,4,4,54768,4,4,56390,11,24.7,-1.2892959,36.8378671,-1.2551895,36.7822034,845,1622,46,2996
6010,21942,3291,3,Business,25,6,34197,25,6,35321,25,6,36156,25,6,36725,25,6,37794,4,23.25888921888938,-1.265715,36.823815,-1.2600926,36.8088685,27,1069,1124,1404
6011,21105,2454,3,Business,14,3,45570,14,3,51622,14,3,51907,14,3,57859,14,3,59951,21,25.6,-1.3510811,36.894806,-1.2993231,36.7753372,510,2092,6052,6237
6012,13491,1500,3,Business,8,2,57493,8,2,57511,8,2,57516,8,2,59384,8,2,60251,8,25.4,-1.3004062,36.829741,-1.2574219,36.7927073,925,867,18,1873
6013,7243,2801,3,Business,4,4,33905,4,4,33946,4,4,34700,4,4,35221,4,4,37069,9,18.4,-1.283905,36.8249272,-1.2595422,36.7871178,532,1848,41,1275
6014,18300,450,1,Personal,11,4,39189,11,4,39200,11,4,39704,11,4,40286,11,4,41701,9,23.8,-1.2740396,36.7993518,-1.3205164,36.8098882,148,1415,11,1086
6015,13907,1329,3,Business,18,1,47611,18,1,47636,18,1,48192,18,1,48284,18,1,49476,9,26.8,-1.273056,36.811298,-1.2486689,36.8748969,206,1192,25,648
6016,3157,3647,3,Business,23,3,38626,23,3,38649,23,3,39251,23,3,39524,23,3,41479,20,23.25888921888938,-1.272639,36.794723,-1.2162985,36.9065105,627,1955,23,875
6017,2799,3404,3,Business,10,6,41252,10,6,41548,10,6,42105,10,6,42196,10,6,43445,10,24.1,-1.2413316,36.8785525,-1.279395,36.825364,504,1249,296,648
6018,8999,1605,1,Business,22,3,50845,22,3,50862,22,3,51880,22,3,52415,22,3,54536,17,25.5,-1.2853266,36.8224188,-1.3310215,36.7067229,45,2121,17,1553
6019,14443,3218,3,Business,7,1,35246,7,1,35277,7,1,35363,7,1,36220,7,1,36985,5,18.5,-1.279395,36.825364,-1.2765736,36.8513646,408,765,31,943
6020,2290,393,3,Business,7,3,37823,7,3,37833,7,3,37837,7,3,38840,7,3,40575,14,25.0,-1.3177547,36.8303703,-1.306378,36.7519845,62,1735,10,1007
6021,23041,3354,3,Business,19,1,53271,19,1,53445,19,1,53918,19,1,54067,19,1,55276,10,25.0,-1.3700383,36.9190174,-1.3179244,36.9031396,504,1209,174,622
6022,5645,2771,1,Personal,12,2,43939,12,2,43976,12,2,44194,12,2,44721,12,2,45911,13,20.8,-1.2811975,36.8109382,-1.276312,36.882742,345,1190,37,745
6023,24863,990,1,Business,15,3,37315,15,3,37324,15,3,38219,15,3,39220,15,3,41075,20,18.3,-1.3164339,36.8578882,-1.3548775,36.7211683,213,1855,9,1896
6024,15745,3291,3,Business,21,2,35980,21,2,36005,21,2,38286,21,2,42455,21,2,43161,22,22.7,-1.335477,36.9308297,-1.2600926,36.8088685,404,706,25,6450
6025,10272,1205,3,Business,17,4,40641,17,4,40992,17,4,41870,17,4,42098,17,4,42883,3,22.3,-1.2814178,36.8154096,-1.300073,36.8082423,544,785,351,1106
6026,11092,136,3,Business,14,4,47394,14,4,47868,14,4,48538,14,4,48611,14,4,51681,13,25.2,-1.3254522,36.7216584,-1.25537,36.7756,831,3070,474,743
6027,25014,71,3,Business,12,1,35785,12,1,36007,12,1,36533,12,1,36793,12,1,37521,9,19.6,-1.2891922,36.825189,-1.2551895,36.7822034,88,728,222,786
6028,17776,1195,3,Business,19,3,37503,19,3,38289,19,3,38851,19,3,39386,19,3,42267,15,22.4,-1.2991441,36.7528804,-1.3228003,36.8306435,404,2881,786,1097
6029,7531,1075,3,Business,27,3,55824,27,3,55888,27,3,56489,27,3,56750,27,3,58223,7,29.4,-1.2878913,36.8089253,-1.2527958,36.8003131,50,1473,64,862
6030,28004,1304,3,Business,15,4,63506,15,4,64553,15,4,65705,15,4,65871,15,4,66940,5,25.2,-1.298141,36.891382,-1.2702844,36.8803209,622,1069,1047,1318
6031,20770,3338,3,Business,30,4,53784,30,4,53802,30,4,54046,30,4,54297,30,4,55934,5,23.25888921888938,-1.2551895,36.7822034,-1.2788889,36.8100058,161,1637,18,495
6032,3543,3661,3,Business,7,4,37072,7,4,37222,7,4,38370,7,4,38514,7,4,41325,19,24.5,-1.2134646,36.8755266,-1.3208162,36.8451209,691,2811,150,1292
6033,13993,1522,3,Business,11,2,34725,11,2,34985,11,2,35936,11,2,37650,11,2,39544,17,16.8,-1.215909,36.886056,-1.2584143,36.8048002,60,1894,260,2665
6034,22710,187,3,Business,12,2,51852,12,2,51874,12,2,52219,12,2,55796,12,2,59856,28,27.2,-1.2285835,36.8826468,-1.3169591,36.7000029,75,4060,22,3922
6035,5093,2956,3,Business,5,5,43892,5,5,44185,5,5,45733,5,5,46934,5,5,48630,6,24.7,-1.28878,36.8168312,-1.2584143,36.8048002,695,1696,293,2749
6036,5168,2528,3,Business,11,1,34396,11,1,34410,11,1,34447,11,1,34911,11,1,35371,3,20.7,-1.2584143,36.8048002,-1.2551895,36.7822034,26,460,14,501
6037,22745,633,3,Business,23,3,34374,23,3,34401,23,3,34407,23,3,35236,23,3,35819,4,23.25888921888938,-1.3077869,36.8443207,-1.3004062,36.829741,188,583,27,835
6038,1987,2330,3,Business,15,3,36657,15,3,36863,15,3,37172,15,3,37557,15,3,38082,3,23.25888921888938,-1.2921463,36.8029626,-1.2890715,36.8157588,119,525,206,694
6039,21574,3283,3,Business,16,6,45387,16,6,45431,16,6,46375,16,6,47113,16,6,47759,6,25.5,-1.272828,36.816608,-1.2628473,36.781805,855,646,44,1682
6040,5911,2154,3,Business,2,5,45620,2,5,45729,2,5,47499,2,5,48840,2,5,49891,9,25.2,-1.2860183,36.8975338,-1.2765736,36.8513646,900,1051,109,3111
6041,6020,323,3,Business,7,4,58521,7,4,58530,7,4,58544,7,4,59392,7,4,62751,22,31.2,-1.2551895,36.7822034,-1.3562374,36.9042954,584,3359,9,862
6042,18669,1687,3,Business,30,3,39265,30,3,39302,30,3,40233,30,3,40599,30,3,41635,3,24.8,-1.2649605,36.7981777,-1.2729802,36.793734,611,1036,37,1297
6043,14713,2457,3,Business,13,5,48288,13,5,48566,13,5,49482,13,5,49954,13,5,51990,18,19.2,-1.3165542,36.700067,-1.269534,36.80697,116,2036,278,1388
6044,7038,1304,3,Business,15,4,38492,15,4,38554,15,4,40133,15,4,40957,15,4,42877,9,24.6,-1.2551895,36.7822034,-1.2874243,36.7504414,470,1920,62,2403
6045,20430,2803,3,Business,14,4,35656,14,4,35812,14,4,37182,14,4,37375,14,4,38432,6,17.7,-1.2765736,36.8513646,-1.2568264,36.8653129,448,1057,156,1563
6046,18263,510,3,Business,17,1,58201,17,1,59302,17,1,61997,17,1,62595,17,1,66369,12,22.8,-1.3226302,36.8719901,-1.2860183,36.8975338,436,3774,1101,3293
6047,24274,2528,3,Business,3,1,47412,3,1,47701,3,1,48465,3,1,48775,3,1,49906,6,23.3,-1.2551895,36.7822034,-1.281223,36.8239,790,1131,289,1074
6048,23639,245,2,Personal,11,4,62768,11,4,62779,11,4,63022,11,4,63619,11,4,64773,6,24.1,-1.2861765,36.8209086,-1.324328,36.8383843,156,1154,11,840
6049,5552,625,3,Business,18,6,46870,18,6,46892,18,6,47282,18,6,48057,18,6,48870,5,18.8,-1.2600926,36.8088685,-1.265715,36.823815,882,813,22,1165
6050,3657,2801,3,Business,25,1,55021,25,1,55066,25,1,56350,25,1,59358,25,1,60829,9,27.9,-1.307726,36.839117,-1.2595422,36.7871178,267,1471,45,4292
6051,27021,3635,1,Business,28,2,34409,28,2,34479,28,2,35028,28,2,35393,28,2,37471,12,16.2,-1.2615888,36.7928732,-1.2108499,36.7819362,116,2078,70,914
6052,25348,3147,3,Business,6,1,30954,6,1,30993,6,1,31585,6,1,32655,6,1,33079,17,23.25888921888938,-1.2551895,36.7822034,-1.3472066,36.7692638,96,424,39,1662
6053,16687,3115,3,Business,16,4,30235,16,4,30264,16,4,31154,16,4,31288,16,4,31814,2,23.25888921888938,-1.2963097,36.7688221,-1.2969741,36.7856612,468,526,29,1024
6054,427,1961,3,Business,6,1,34661,6,1,34681,6,1,35351,6,1,37257,6,1,38829,22,23.25888921888938,-1.318062,36.849326,-1.3181159,36.7101559,819,1572,20,2576
6055,14317,286,3,Business,14,2,64826,14,2,64934,14,2,65773,14,2,65994,14,2,67404,7,23.25888921888938,-1.2551895,36.7822034,-1.2876092,36.8027422,953,1410,108,1060
6056,12288,53,3,Business,14,2,46666,14,2,46779,14,2,48222,14,2,49515,14,2,52148,8,23.25888921888938,-1.2770708,36.8231093,-1.276954,36.765926,436,2633,113,2736
6057,27279,2789,3,Business,26,2,43785,26,2,43853,26,2,44506,26,2,45152,26,2,46299,5,27.4,-1.2981625,36.8130142,-1.304735,36.7846054,177,1147,68,1299
6058,14133,3283,3,Business,9,1,45538,9,1,45589,9,1,45600,9,1,47078,9,1,47589,5,20.3,-1.2600926,36.8088685,-1.2628473,36.781805,51,511,51,1489
6059,20677,393,3,Business,13,2,42311,13,2,43203,13,2,44201,13,2,45127,13,2,47034,14,22.2,-1.3177547,36.8303703,-1.306378,36.7519845,626,1907,892,1924
6060,21945,2216,3,Business,10,1,64040,10,1,64109,10,1,65048,10,1,66805,10,1,67664,7,18.8,-1.2551895,36.7822034,-1.2890847,36.8048724,139,859,69,2696
6061,26697,2069,3,Business,2,2,61728,2,2,61803,2,2,62167,2,2,62389,2,2,65070,16,28.6,-1.303596,36.778378,-1.228911,36.881876,682,2681,75,586
6062,25531,2423,3,Business,12,3,52703,12,3,52844,12,3,52851,12,3,54193,12,3,57911,7,21.1,-1.2571472,36.7950633,-1.3038156,36.8122733,338,3718,141,1349
6063,17366,172,1,Personal,15,3,58212,15,3,58257,15,3,58464,15,3,58756,15,3,59563,3,21.8,-1.286149,36.8161572,-1.2796633,36.8261627,88,807,45,499
6064,8907,2335,3,Business,4,4,43651,4,4,43694,4,4,44956,4,4,45508,4,4,47365,10,25.4,-1.2551895,36.7822034,-1.3128307,36.8251543,576,1857,43,1814
6065,13854,393,3,Business,28,4,60273,28,4,60358,28,4,60363,28,4,60953,28,4,61471,6,28.0,-1.3004062,36.829741,-1.3167113,36.8301563,523,518,85,595
6066,27185,1046,1,Personal,8,6,49819,8,6,50096,8,6,51072,8,6,51178,8,6,52432,7,24.8,-1.3054537,36.8284768,-1.290881,36.8559893,208,1254,277,1082
6067,25705,2651,3,Business,3,3,60611,3,3,62508,3,3,63995,3,3,64117,3,3,66576,8,27.6,-1.3402212,36.7696184,-1.2974015,36.7772406,843,2459,1897,1609
6068,3744,3647,3,Business,29,5,44490,29,5,44557,29,5,45632,29,5,46569,29,5,49613,16,26.7,-1.272639,36.794723,-1.3502295,36.7242597,576,3044,67,2012
6069,19313,970,3,Business,29,3,45537,29,3,45583,29,3,45971,29,3,46106,29,3,46496,1,23.25888921888938,-1.2571472,36.7950633,-1.2629594,36.8077626,90,390,46,523
6070,12589,111,3,Business,29,3,33779,29,3,34180,29,3,35242,29,3,36178,29,3,38652,8,17.7,-1.2551895,36.7822034,-1.3047132,36.8089553,245,2474,401,1998
6071,1460,2733,3,Business,12,1,38324,12,1,40080,12,1,40589,12,1,41467,12,1,41706,2,23.6,-1.3047482,36.7849672,-1.2963097,36.7688221,19,239,1756,1387
6072,3846,3517,3,Business,5,2,34759,5,2,34784,5,2,34816,5,2,37440,5,2,39854,16,21.1,-1.300921,36.828195,-1.3882008,36.7699445,332,2414,25,2656
6073,24972,3194,3,Business,10,2,44727,10,2,44764,10,2,45155,10,2,45554,10,2,48108,8,20.3,-1.2551895,36.7822034,-1.2854174,36.7951152,799,2554,37,790
6074,8153,173,3,Business,17,6,63101,17,6,64942,17,6,65561,17,6,65695,17,6,66046,3,19.8,-1.2993231,36.7753372,-1.3089298,36.7761994,952,351,1841,753
6075,23258,2509,3,Business,29,5,41797,29,5,41846,29,5,41999,29,5,42335,29,5,44370,14,26.7,-1.2571472,36.7950633,-1.206696,36.847709,770,2035,49,489
6076,27902,1304,3,Business,12,5,52583,12,5,52790,12,5,52970,12,5,54611,12,5,55642,8,23.25888921888938,-1.2551895,36.7822034,-1.3038408,36.818713,291,1031,207,1821
6077,25003,3689,3,Business,6,4,57672,6,4,57721,6,4,57741,6,4,58478,6,4,59668,2,23.25888921888938,-1.2527958,36.8003131,-1.2610837,36.8021315,829,1190,49,757
6078,6246,1231,3,Business,29,1,37421,29,1,37507,29,1,37922,29,1,38205,29,1,40289,13,23.25888921888938,-1.2821422,36.8161565,-1.2156006,36.8916865,612,2084,86,698
6079,17400,3688,3,Business,6,4,57564,6,4,57652,6,4,58466,6,4,58539,6,4,60215,10,21.4,-1.2551895,36.7822034,-1.3071891,36.8462027,490,1676,88,887
6080,23206,391,3,Business,14,2,42997,14,2,43995,14,2,44747,14,2,45497,14,2,46886,7,23.25888921888938,-1.2784063,36.8222933,-1.3082842,36.8434194,204,1389,998,1502
6081,7241,2767,3,Business,9,4,46736,9,4,46822,9,4,47775,9,4,47836,9,4,49291,9,23.9,-1.257773,36.795486,-1.2885713,36.7649818,263,1455,86,1014
6082,1893,640,3,Business,20,1,57647,20,1,57746,20,1,58338,20,1,58510,20,1,59282,5,23.25888921888938,-1.2969741,36.7856612,-1.3047132,36.8089553,576,772,99,764
6083,19924,2271,3,Business,27,1,38637,27,1,38656,27,1,38916,27,1,39401,27,1,41046,12,24.1,-1.228911,36.881876,-1.293515,36.897607,805,1645,19,745
6084,22407,1176,3,Business,6,4,53052,6,4,53138,6,4,55442,6,4,55636,6,4,57146,22,23.25888921888938,-1.2812015,36.8261246,-1.1682729,36.9536167,622,1510,86,2498
6085,8443,2465,1,Personal,3,1,58070,3,1,58118,3,1,59302,3,1,61535,3,1,62876,16,22.4,-1.3214137,36.8569475,-1.3398265,36.7399824,669,1341,48,3417
6086,936,2454,3,Business,6,3,61870,6,3,61883,6,3,62413,6,3,62786,6,3,63343,4,26.1,-1.2993231,36.7753372,-1.296098,36.798225,246,557,13,903
6087,26494,1217,3,Personal,5,2,45064,5,2,46011,5,2,46968,5,2,47332,5,2,51015,14,23.5,-1.2175583,36.884343,-1.2880883,36.8227336,589,3683,947,1321
6088,11637,1955,3,Business,17,3,57178,17,3,57231,17,3,57497,17,3,58252,17,3,60392,15,28.4,-1.3332749,36.8708147,-1.2955334,36.7742857,69,2140,53,1021
6089,25597,2387,1,Personal,19,5,32235,19,5,32270,19,5,32550,19,5,32615,19,5,33142,5,20.4,-1.2535486,36.7933541,-1.2633494,36.7959696,453,527,35,345
6090,7677,2920,3,Personal,23,3,35437,23,3,35483,23,3,35751,23,3,36256,23,3,38937,36,23.25888921888938,-1.2969741,36.7856612,-1.11377,37.002043,40,2681,46,773
6091,26020,503,1,Business,13,5,56066,13,5,56105,13,5,56185,13,5,56917,13,5,57977,8,19.0,-1.2859912,36.8756811,-1.3024388,36.859699,890,1060,39,812
6092,4164,3404,3,Business,1,5,37518,1,5,37565,1,5,38025,1,5,39025,1,5,39532,1,26.3,-1.290894,36.822971,-1.279395,36.825364,206,507,47,1460
6093,6510,2982,3,Business,30,2,32195,30,2,32265,30,2,33199,30,2,36100,30,2,38311,18,23.25888921888938,-1.300921,36.828195,-1.177202,36.8351183,61,2211,70,3835
6094,9670,3698,3,Business,18,4,49306,18,4,49617,18,4,51520,18,4,51815,18,4,54017,11,23.25888921888938,-1.263279,36.909609,-1.3244885,36.897792,697,2202,311,2198
6095,1425,2090,3,Personal,14,2,32036,14,2,32082,14,2,33463,14,2,34445,14,2,34848,2,15.5,-1.2671296,36.8125772,-1.2597034,36.8003065,592,403,46,2363
6096,24392,2593,3,Business,7,2,39441,7,2,39461,7,2,39655,7,2,39897,7,2,40286,1,23.3,-1.2615888,36.7928732,-1.2551895,36.7822034,449,389,20,436
6097,20773,478,1,Business,2,1,31228,2,1,31244,2,1,31487,2,1,31751,2,1,33378,15,16.6,-1.2551895,36.7822034,-1.3216456,36.7145156,379,1627,16,507
6098,19193,635,3,Business,3,3,51429,3,3,51487,3,3,51697,3,3,54479,3,3,55397,7,28.3,-1.300921,36.828195,-1.2675613,36.8133001,205,918,58,2992
6099,8332,1882,3,Business,10,4,33290,10,4,33300,10,4,33392,10,4,35651,10,4,37191,18,19.3,-1.2628638,36.8070399,-1.3499321,36.9047554,247,1540,10,2351
6100,12847,1802,2,Personal,15,5,39219,15,5,39347,15,5,40009,15,5,40976,15,5,42094,6,20.0,-1.272704,36.7931279,-1.2949855,36.7830349,56,1118,128,1629
6101,18927,3496,3,Business,30,2,51810,30,2,51877,30,2,52229,30,2,53537,30,2,54787,12,23.25888921888938,-1.300921,36.828195,-1.2799576,36.7630239,856,1250,67,1660
6102,12154,2763,3,Business,16,2,51879,16,2,51890,16,2,52329,16,2,52400,16,2,53124,7,23.25888921888938,-1.2551895,36.7822034,-1.2653185,36.8358841,349,724,11,510
6103,18384,1363,3,Business,23,4,53151,23,4,53420,23,4,53690,23,4,53756,23,4,54601,3,24.5,-1.3004062,36.829741,-1.2883164,36.8146724,158,845,269,336
6104,23103,1850,3,Business,2,4,48826,2,4,48862,2,4,50425,2,4,50548,2,4,51888,7,23.25888921888938,-1.2571472,36.7950633,-1.3047132,36.8089553,138,1340,36,1686
6105,23453,311,3,Business,5,3,52147,5,3,52156,5,3,52527,5,3,53050,5,3,55525,21,23.7,-1.3700383,36.9190174,-1.2917868,36.7872675,74,2475,9,894
6106,3548,1882,1,Business,24,2,36542,24,2,36550,24,2,37492,24,2,38907,24,2,40331,8,17.3,-1.2268871,36.8073946,-1.2591019,36.800577,144,1424,8,2357
6107,3687,1432,1,Personal,15,3,34018,15,3,34029,15,3,36365,15,3,36582,15,3,38465,11,16.4,-1.2912419,36.8775284,-1.2950408,36.8098172,84,1883,11,2553
6108,1682,1850,3,Business,8,5,47637,8,5,52679,8,5,53343,8,5,54480,8,5,59157,9,30.2,-1.2551895,36.7822034,-1.3074264,36.8226123,547,4677,5042,1801
6109,1608,142,3,Business,29,1,55095,29,1,55129,29,1,56521,29,1,56749,29,1,58074,8,23.25888921888938,-1.2570328,36.7869744,-1.2963097,36.7688221,710,1325,34,1620
6110,1484,1927,3,Business,18,1,35367,18,1,35388,18,1,36617,18,1,39810,18,1,41250,19,27.9,-1.3562374,36.9042954,-1.3472066,36.7692638,952,1440,21,4422
6111,12449,387,1,Personal,11,4,52055,11,4,52381,11,4,52402,11,4,53260,11,4,54146,12,26.9,-1.3246455,36.8754415,-1.3802928,36.9364493,179,886,326,879
6112,4360,2731,1,Personal,14,5,34988,14,5,35471,14,5,37202,14,5,37304,14,5,38014,5,18.2,-1.2855799,36.8176209,-1.2859202,36.7894121,726,710,483,1833
6113,8420,3469,3,Personal,21,1,39952,21,1,40167,21,1,42148,21,1,42885,21,1,45264,13,19.8,-1.2583393,36.7464632,-1.2900075,36.8032564,334,2379,215,2718
6114,11127,614,1,Personal,26,2,40363,26,2,41377,26,2,41946,26,2,43569,26,2,44863,9,23.25888921888938,-1.3299358,36.8524971,-1.2885364,36.7995016,379,1294,1014,2192
6115,8605,1895,1,Personal,27,3,64387,27,3,64471,27,3,65877,27,3,69580,27,3,71616,15,23.25888921888938,-1.2887938,36.8285832,-1.2419155,36.7321257,581,2036,84,5109
6116,23686,867,3,Business,10,1,49488,10,1,49538,10,1,49547,10,1,52635,10,1,52637,13,18.3,-1.3228003,36.8306435,-1.2991441,36.7528804,39,2,50,3097
6117,23629,478,3,Business,31,5,28771,31,5,29214,31,5,31177,31,5,33889,31,5,35796,8,23.25888921888938,-1.3045333,36.8228072,-1.2603403,36.7998848,55,1907,443,4675
6118,11741,3560,3,Business,20,3,47675,20,3,48589,20,3,48669,20,3,48904,20,3,50897,5,28.4,-1.279395,36.825364,-1.307241,36.8302368,448,1993,914,315
6119,13202,635,3,Business,3,3,40311,3,3,40369,3,3,41125,3,3,41693,3,3,43266,8,27.4,-1.3081376,36.8329772,-1.2602337,36.7990548,504,1573,58,1324
6120,19599,2143,3,Business,26,1,48370,26,1,48394,26,1,48455,26,1,48702,26,1,49871,5,22.9,-1.2975066,36.7689423,-1.2945684,36.8154093,829,1169,24,308
6121,24812,402,3,Business,15,3,55410,15,3,55784,15,3,57952,15,3,58541,15,3,62013,6,25.7,-1.290894,36.822971,-1.2527958,36.8003131,868,3472,374,2757
6122,3933,2091,1,Personal,14,4,40680,14,4,40789,14,4,42439,14,4,43178,14,4,45561,14,18.8,-1.2733223,36.7951005,-1.3371926,36.7250933,449,2383,109,2389
6123,16658,3149,3,Business,6,3,41840,6,3,42204,6,3,43324,6,3,43814,6,3,45377,9,23.25888921888938,-1.2770708,36.8231093,-1.3167113,36.8301563,763,1563,364,1610
6124,11055,2803,3,Business,13,3,47654,13,3,47680,13,3,47953,13,3,48035,13,3,50130,16,24.6,-1.2765736,36.8513646,-1.269767,36.7351068,411,2095,26,355
6125,24243,3283,3,Business,27,4,45942,27,4,45963,27,4,47635,27,4,48610,27,4,49670,13,22.9,-1.2296618,36.8438272,-1.2628473,36.781805,86,1060,21,2647
6126,19403,2112,3,Business,18,2,38376,18,2,39397,18,2,39772,18,2,41868,18,2,43017,14,23.25888921888938,-1.2571472,36.7950633,-1.2156006,36.8916865,453,1149,1021,2471
6127,25440,1502,3,Business,1,1,36068,1,1,36079,1,1,36490,1,1,37422,1,1,38701,13,18.3,-1.260232,36.807334,-1.2156006,36.8916865,882,1279,11,1343
6128,25224,478,3,Business,5,2,51831,5,2,53904,5,2,55793,5,2,59185,5,2,60548,4,23.25888921888938,-1.2844516,36.8245932,-1.2571472,36.7950633,660,1363,2073,5281
6129,2302,2763,3,Business,14,5,52672,14,5,53110,14,5,53618,14,5,54275,14,5,55694,11,22.8,-1.2551895,36.7822034,-1.3250103,36.8388817,896,1419,438,1165
6130,23929,1329,3,Business,8,5,39229,8,5,39283,8,5,40106,8,5,40556,8,5,41472,5,28.2,-1.273056,36.811298,-1.3010059,36.8216816,119,916,54,1273
6131,17086,3355,3,Business,7,3,36966,7,3,36984,7,3,36996,7,3,37694,7,3,38947,12,23.25888921888938,-1.3052491,36.8223899,-1.2413316,36.8785525,120,1253,18,710
6132,23317,1244,3,Business,19,6,44774,19,6,44987,19,6,45630,19,6,46494,19,6,47752,9,21.5,-1.307143,36.825009,-1.303596,36.778378,327,1258,213,1507
6133,14189,2271,3,Business,15,1,49216,15,1,49914,15,1,50032,15,1,51312,15,1,52376,11,23.25888921888938,-1.228911,36.881876,-1.293515,36.897607,75,1064,698,1398
6134,15602,517,3,Business,3,4,41296,3,4,42069,3,4,42077,3,4,42364,3,4,43800,11,23.7,-1.3167113,36.8301563,-1.2574219,36.7927073,555,1436,773,295
6135,5491,393,3,Business,21,5,28371,21,5,31097,21,5,31100,21,5,31657,21,5,33447,11,19.3,-1.3167113,36.8301563,-1.2574219,36.7927073,10,1790,2726,560
6136,11291,375,3,Business,12,2,53859,12,2,54027,12,2,54698,12,2,55109,12,2,56944,9,23.25888921888938,-1.2551895,36.7822034,-1.2346243,36.8109003,281,1835,168,1082
6137,24666,1809,3,Business,5,3,57989,5,3,58039,5,3,58091,5,3,58510,5,3,59960,5,24.9,-1.2571472,36.7950633,-1.2886366,36.8245436,379,1450,50,471
6138,27967,3201,3,Business,19,3,68780,19,3,69593,19,3,70391,19,3,70527,19,3,71003,3,20.1,-1.2584143,36.8048002,-1.2752846,36.8027022,383,476,813,934
6139,17305,1724,3,Business,26,2,47077,26,2,47214,26,2,49096,26,2,49335,26,2,50760,8,29.9,-1.2907854,36.7774108,-1.2551895,36.7822034,459,1425,137,2121
6140,7698,1885,1,Personal,4,1,36188,4,1,40664,4,1,41071,4,1,41285,4,1,43316,19,21.1,-1.2862033,36.8152966,-1.2475223,36.937088,539,2031,4476,621
6141,13044,1329,3,Business,13,2,57710,13,2,57764,13,2,58415,13,2,58507,13,2,58934,1,26.4,-1.273056,36.811298,-1.2697893,36.8124106,56,427,54,743
6142,14113,246,3,Business,18,4,33424,18,4,33587,18,4,35654,18,4,36486,18,4,38200,6,20.4,-1.290894,36.822971,-1.2584143,36.8048002,736,1714,163,2899
6143,160,1899,3,Business,9,4,47659,9,4,47782,9,4,49218,9,4,50183,9,4,51163,6,25.8,-1.318062,36.849326,-1.331619,36.847976,882,980,123,2401
6144,2420,3460,3,Personal,18,4,55675,18,4,55686,18,4,55760,18,4,56246,18,4,58420,16,23.25888921888938,-1.298598,36.7953396,-1.2145575,36.8898511,801,2174,11,560
6145,22374,2982,3,Business,16,5,47846,16,5,47913,16,5,48571,16,5,49562,16,5,50989,7,23.25888921888938,-1.300921,36.828195,-1.325469,36.862403,581,1427,67,1649
6146,4356,60,3,Business,28,4,34283,28,4,34312,28,4,34335,28,4,35956,28,4,36493,8,19.3,-1.272828,36.816608,-1.2296618,36.8438272,900,537,29,1644
6147,14009,1389,3,Business,29,6,47563,29,6,47571,29,6,48362,29,6,49615,29,6,51269,14,27.8,-1.2857919,36.8191749,-1.207546,36.7913976,74,1654,8,2044
6148,5219,1482,3,Business,1,5,50615,1,5,50685,1,5,51628,1,5,54456,1,5,56368,16,28.7,-1.2534301,36.8000983,-1.338579,36.8963038,741,1912,70,3771
6149,25184,2330,3,Business,1,5,48568,1,5,49706,1,5,51043,1,5,51438,1,5,54039,17,28.5,-1.3340505,36.7119038,-1.2642903,36.8002137,433,2601,1138,1732
6150,20074,111,3,Business,15,3,55034,15,3,55134,15,3,55878,15,3,56304,15,3,58444,12,21.8,-1.2551895,36.7822034,-1.318049,36.8556554,882,2140,100,1170
6151,23768,393,3,Business,1,1,40875,1,1,40965,1,1,41545,1,1,41756,1,1,42596,6,23.25888921888938,-1.3167113,36.8301563,-1.3077869,36.8443207,507,840,90,791
6152,21919,1021,1,Personal,9,4,67070,9,4,67983,9,4,70016,9,4,71020,9,4,72498,19,18.9,-1.2540928,36.69782,-1.2624632,36.8405321,116,1478,913,3037
6153,18228,1578,3,Business,2,2,40720,2,2,42944,2,2,43683,2,2,44820,2,2,46097,6,21.0,-1.2765736,36.8513646,-1.28878,36.8168312,532,1277,2224,1876
6154,19419,3432,3,Business,19,6,39665,19,6,39692,19,6,40225,19,6,41012,19,6,42444,3,25.4,-1.2672588,36.8000252,-1.2527469,36.7904333,190,1432,27,1320
6155,7346,3621,3,Business,13,4,33372,13,4,33412,13,4,34562,13,4,34715,13,4,36427,11,18.5,-1.2836583,36.7886014,-1.323186,36.8319281,427,1712,40,1303
6156,22439,3201,3,Business,12,3,32763,12,3,32848,12,3,32851,12,3,33665,12,3,34433,5,23.25888921888938,-1.279395,36.825364,-1.2584143,36.8048002,698,768,85,817
6157,10904,3283,3,Business,6,4,40939,6,4,41017,6,4,41622,6,4,41878,6,4,42502,5,19.6,-1.2600926,36.8088685,-1.2628473,36.781805,279,624,78,861
6158,13895,53,3,Business,16,2,46197,16,2,46263,16,2,46911,16,2,48954,16,2,50009,7,23.25888921888938,-1.2638185,36.7930057,-1.2770708,36.8231093,855,1055,66,2691
6159,27166,778,3,Business,20,3,33891,20,3,34011,20,3,34991,20,3,35386,20,3,37238,10,21.1,-1.275931,36.8516227,-1.2535486,36.7933541,76,1852,120,1375
6160,7042,3355,3,Business,15,2,54680,15,2,54703,15,2,55311,15,2,55425,15,2,58008,10,24.4,-1.3052491,36.8223899,-1.325086,36.887894,436,2583,23,722
6161,724,2330,3,Business,11,1,53622,11,1,53706,11,1,54215,11,1,54536,11,1,55567,8,28.1,-1.3015197,36.7658456,-1.3270197,36.7037303,178,1031,84,830
6162,11155,1502,3,Business,19,2,49505,19,2,49553,19,2,50728,19,2,51445,19,2,52856,11,29.8,-1.2859912,36.8756811,-1.2232123,36.8932547,339,1411,48,1892
6163,18734,2587,3,Business,13,3,46686,13,3,46717,13,3,47207,13,3,48120,13,3,48604,3,24.8,-1.277055,36.813027,-1.28878,36.8168312,785,484,31,1403
6164,26644,346,3,Business,7,4,51921,7,4,51932,7,4,52009,7,4,52330,7,4,53893,8,31.0,-1.3014461,36.7661381,-1.28878,36.8168312,520,1563,11,398
6165,903,868,3,Business,5,2,50221,5,2,50953,5,2,51432,5,2,52491,5,2,53668,7,22.5,-1.307143,36.825009,-1.265715,36.823815,265,1177,732,1538
6166,18722,2069,3,Business,1,1,48291,1,1,48430,1,1,49214,1,1,49816,1,1,51117,12,23.25888921888938,-1.2600926,36.8088685,-1.228911,36.881876,691,1301,139,1386
6167,25084,3080,3,Business,26,5,39567,26,5,43824,26,5,44196,26,5,44273,26,5,48872,7,23.25888921888938,-1.2551895,36.7822034,-1.2879618,36.8200863,903,4599,4257,449
6168,21531,3486,3,Business,20,4,46477,20,4,46500,20,4,46536,20,4,46966,20,4,48874,18,22.2,-1.2551895,36.7822034,-1.2320538,36.6769615,43,1908,23,466
6169,16906,393,3,Business,17,1,42153,17,1,43600,17,1,44536,17,1,45047,17,1,46784,14,25.1,-1.3177547,36.8303703,-1.306378,36.7519845,200,1737,1447,1447
6170,26320,2823,3,Business,6,5,46010,6,5,46762,6,5,47039,6,5,47802,6,5,48666,8,20.2,-1.2585521,36.7945765,-1.3014461,36.7661381,103,864,752,1040
6171,27535,3647,3,Business,17,3,37225,17,3,37239,17,3,37781,17,3,38131,17,3,40316,21,23.25888921888938,-1.272639,36.794723,-1.3319686,36.9115553,829,2185,14,892
6172,7765,1004,3,Business,11,2,51894,11,2,52164,11,2,52860,11,2,53338,11,2,54690,9,21.5,-1.3250048,36.8697188,-1.333148,36.922453,495,1352,270,1174
6173,15709,2031,1,Personal,25,6,60417,25,6,60432,25,6,61264,25,6,61456,25,6,64748,23,23.25888921888938,-1.2317292,36.79682,-1.3317192,36.7537532,881,3292,15,1024
6174,12213,2828,3,Business,8,1,39141,8,1,39153,8,1,40799,8,1,43758,8,1,44573,4,27.8,-1.272798,36.8124195,-1.2615888,36.7928732,161,815,12,4605
6175,9317,2335,3,Business,18,5,34489,18,5,34496,18,5,34761,18,5,35014,18,5,37272,22,20.0,-1.2551895,36.7822034,-1.3562374,36.9042954,932,2258,7,518
6176,27384,2227,3,Personal,5,2,45359,5,2,45405,5,2,46171,5,2,46250,5,2,47572,10,23.5,-1.2541275,36.8263055,-1.2441236,36.8812807,622,1322,46,845
6177,2175,868,3,Business,18,2,47402,18,2,47436,18,2,47441,18,2,48348,18,2,49558,8,23.25888921888938,-1.303596,36.778378,-1.265715,36.823815,40,1210,34,912
6178,12112,552,3,Business,30,3,42669,30,3,42697,30,3,43163,30,3,43501,30,3,46318,18,25.1,-1.2793686,36.8259233,-1.3562374,36.9042954,237,2817,28,804
6179,20508,2330,3,Business,26,2,34201,26,2,34225,26,2,35498,26,2,35993,26,2,37248,14,23.25888921888938,-1.2854537,36.9051024,-1.3800951,36.9297274,466,1255,24,1768
6180,12397,2763,3,Business,8,4,54712,8,4,57170,8,4,57661,8,4,57810,8,4,61999,16,27.5,-1.2551895,36.7822034,-1.3321944,36.8892329,85,4189,2458,640
6181,7494,633,3,Business,21,4,31422,21,4,31475,21,4,32921,21,4,33938,21,4,34616,4,21.9,-1.2770708,36.8231093,-1.3004062,36.829741,728,678,53,2463
6182,19477,248,3,Business,30,2,41764,30,2,42533,30,2,45039,30,2,47418,30,2,48106,5,23.25888921888938,-1.304735,36.7846054,-1.280511,36.7889896,132,688,769,4885
6183,23147,393,3,Business,10,4,56369,10,4,56387,10,4,56837,10,4,57330,10,4,59723,13,25.4,-1.3231001,36.8283559,-1.306378,36.7519845,523,2393,18,943
6184,10769,635,3,Business,18,5,33599,18,5,33611,18,5,33865,18,5,38353,18,5,39397,8,20.2,-1.3081376,36.8329772,-1.2602337,36.7990548,111,1044,12,4742
6185,567,635,3,Business,4,6,34211,4,6,34239,4,6,34945,4,6,38711,4,6,40076,8,23.25888921888938,-1.3081376,36.8329772,-1.2602337,36.7990548,712,1365,28,4472
6186,1811,1471,3,Business,28,2,44864,28,2,44959,28,2,45690,28,2,46054,28,2,46790,4,21.3,-1.2551895,36.7822034,-1.2642978,36.819261,541,736,95,1095
6187,4236,3404,3,Business,14,5,51122,14,5,51328,14,5,51869,14,5,52031,14,5,52817,1,23.6,-1.2793686,36.8259233,-1.2857548,36.819062,660,786,206,703
6188,23755,2030,3,Business,13,4,51496,13,4,51561,13,4,52180,13,4,52583,13,4,53724,5,22.4,-1.3379799,36.8835453,-1.3226302,36.8719901,276,1141,65,1022
6189,17930,2038,1,Personal,15,3,42186,15,3,42197,15,3,42730,15,3,42955,15,3,44475,13,18.0,-1.26559,36.8027,-1.2136206,36.8912603,882,1520,11,758
6190,6079,2523,3,Business,4,5,52269,4,5,52305,4,5,52425,4,5,52530,4,5,55753,14,23.25888921888938,-1.3204931,36.7043102,-1.3781602,36.7562761,457,3223,36,225
6191,11179,1162,3,Business,3,5,34281,3,5,34348,3,5,35656,3,5,36929,3,5,38173,8,23.25888921888938,-1.312261,36.794658,-1.2665327,36.8108799,328,1244,67,2581
6192,232,3291,3,Business,11,2,40516,11,2,40569,11,2,40689,11,2,42242,11,2,43597,8,24.2,-1.2600926,36.8088685,-1.2999309,36.8307998,895,1355,53,1673
6193,10222,1972,3,Business,14,4,53245,14,4,53339,14,4,55660,14,4,55746,14,4,58696,8,27.5,-1.3142269,36.839245,-1.2649114,36.8134191,127,2950,94,2407
6194,27952,3108,3,Business,8,3,33133,8,3,33152,8,3,33698,8,3,33853,8,3,35907,10,17.1,-1.2551895,36.7822034,-1.3069587,36.8378732,452,2054,19,701
6195,15699,895,1,Personal,10,2,38556,10,2,38571,10,2,39321,10,2,39906,10,2,41609,17,20.1,-1.2917729,36.8097997,-1.2022306,36.7893305,103,1703,15,1335
6196,24622,3674,3,Business,7,1,36219,7,1,36279,7,1,37240,7,1,38463,7,1,39909,8,24.8,-1.2551895,36.7822034,-1.2987976,36.829477,607,1446,60,2184
6197,5221,3339,3,Business,27,3,42179,27,3,42217,27,3,42679,27,3,42999,27,3,45073,11,26.0,-1.3139386,36.8121806,-1.2551895,36.7822034,206,2074,38,782
6198,13548,552,3,Business,27,2,60569,27,2,60613,27,2,61042,27,2,62879,27,2,66066,20,22.2,-1.2527958,36.8003131,-1.3632162,36.9108253,946,3187,44,2266
6199,25806,1271,3,Business,8,2,36450,8,2,36466,8,2,36477,8,2,39075,8,2,39193,4,21.4,-1.3244885,36.897792,-1.3266624,36.8820352,546,118,16,2609
6200,28073,1927,3,Business,8,1,38775,8,1,38796,8,1,40002,8,1,40948,8,1,42768,18,24.6,-1.2859912,36.8756811,-1.3472066,36.7692638,100,1820,21,2152
6201,27927,1553,1,Personal,11,6,56895,11,6,56931,11,6,58231,11,6,58345,11,6,59598,11,21.9,-1.307774,36.8407541,-1.2343087,36.84749,674,1253,36,1414
6202,13313,2008,3,Business,22,5,53479,22,5,53561,22,5,54795,22,5,55824,22,5,58300,17,27.5,-1.2508229,36.7895263,-1.2482377,36.6673782,52,2476,82,2263
6203,3803,393,3,Business,8,1,30917,8,1,30955,8,1,31651,8,1,32655,8,1,34035,11,22.0,-1.3167113,36.8301563,-1.2638185,36.7930057,690,1380,38,1700
6204,10897,3650,3,Business,14,2,34142,14,2,34168,14,2,34822,14,2,35101,14,2,35600,4,15.6,-1.2848376,36.8027622,-1.303306,36.7899884,249,499,26,933
6205,21150,2866,3,Business,9,3,34940,9,3,35002,9,3,35239,9,3,35458,9,3,36144,6,20.1,-1.2551895,36.7822034,-1.265715,36.823815,536,686,62,456
6206,22155,2587,3,Business,18,1,40724,18,1,40756,18,1,40776,18,1,41442,18,1,42467,2,27.1,-1.290894,36.822971,-1.28878,36.8168312,931,1025,32,686
6207,19298,2533,1,Personal,17,3,39210,17,3,39232,17,3,40505,17,3,40720,17,3,42091,9,25.3,-1.2727624,36.7674062,-1.3047026,36.8172033,116,1371,22,1488
6208,2626,3674,3,Business,11,4,52556,11,4,52607,11,4,53524,11,4,55207,11,4,56002,9,26.9,-1.2551895,36.7822034,-1.3080696,36.8237191,291,795,51,2600
6209,12268,814,3,Business,31,2,48961,31,2,49058,31,2,49887,31,2,50227,31,2,53050,21,22.1,-1.3562374,36.9042954,-1.2551895,36.7822034,329,2823,97,1169
6210,8991,136,3,Business,25,4,39050,25,4,43595,25,4,45723,25,4,46046,25,4,47581,17,23.25888921888938,-1.3254522,36.7216584,-1.3233496,36.8139159,427,1535,4545,2451
6211,18144,3521,3,Business,22,5,56784,22,5,57329,22,5,57351,22,5,61702,22,5,61712,2,23.25888921888938,-1.2652809,36.8080659,-1.2768326,36.8073804,51,10,545,4373
6212,26194,1081,3,Business,14,4,57114,14,4,59794,14,4,60496,14,4,61011,14,4,62914,14,26.2,-1.2551895,36.7822034,-1.3213918,36.7915399,336,1903,2680,1217
6213,8226,635,3,Business,3,4,40457,3,4,40474,3,4,41667,3,4,42782,3,4,43477,8,23.5,-1.3016417,36.8271679,-1.2599563,36.7993439,809,695,17,2308
6214,3233,3599,3,Business,10,3,33687,10,3,34085,10,3,37006,10,3,37617,10,3,41212,14,21.9,-1.3302996,36.8707935,-1.2850523,36.7859591,448,3595,398,3532
6215,13072,3300,3,Business,4,2,36320,4,2,39546,4,2,41581,4,2,42273,4,2,45032,18,20.3,-1.293515,36.897607,-1.303596,36.778378,864,2759,3226,2727
6216,4939,633,3,Business,19,2,43289,19,2,43330,19,2,43724,19,2,44865,19,2,45357,5,27.7,-1.3004062,36.829741,-1.3228003,36.8306435,111,492,41,1535
6217,3741,2112,3,Business,24,4,66291,24,4,66325,24,4,66336,24,4,67259,24,4,67851,5,25.8,-1.2285835,36.8826468,-1.2156006,36.8916865,86,592,34,934
6218,6550,1363,3,Business,25,1,52383,25,1,52404,25,1,52703,25,1,52767,25,1,54206,13,29.9,-1.3004062,36.829741,-1.242902,36.870334,181,1439,21,363
6219,20401,432,3,Business,22,3,57840,22,3,57866,22,3,57875,22,3,58414,22,3,59229,3,24.5,-1.3012008,36.764868,-1.3002865,36.7491504,161,815,26,548
6220,16936,3264,3,Business,30,5,34209,30,5,34342,30,5,34721,30,5,35118,30,5,39204,8,19.2,-1.2551895,36.7822034,-1.2995101,36.8185828,322,4086,133,776
6221,23773,633,3,Business,27,2,49982,27,2,49996,27,2,50698,27,2,50941,27,2,52369,4,25.4,-1.3177547,36.8303703,-1.3004062,36.829741,942,1428,14,945
6222,22270,3647,3,Business,4,4,33356,4,4,33371,4,4,33379,4,4,34977,4,4,37100,12,21.7,-1.272639,36.794723,-1.3178263,36.7141818,828,2123,15,1606
6223,16824,1389,3,Business,6,1,49133,6,1,49518,6,1,50950,6,1,51268,6,1,53070,16,23.25888921888938,-1.207546,36.7913976,-1.2551895,36.7822034,96,1802,385,1750
6224,13801,1280,3,Business,4,1,54498,4,1,54619,4,1,55368,4,1,55598,4,1,57686,13,23.25888921888938,-1.2551895,36.7822034,-1.3208221,36.8295735,647,2088,121,979
6225,11607,834,2,Personal,28,4,35412,28,4,35476,28,4,36133,28,4,36425,28,4,38179,7,23.25888921888938,-1.2935318,36.7784567,-1.2714267,36.8110553,474,1754,64,949
6226,23030,2196,3,Personal,4,1,45982,4,1,46046,4,1,48866,4,1,50016,4,1,50917,9,22.6,-1.2553615,36.7895376,-1.2945179,36.7685349,248,901,64,3970
6227,4587,2384,3,Personal,16,3,48010,16,3,48260,16,3,49411,16,3,49676,16,3,51320,13,26.8,-1.2295205,36.8120426,-1.2857671,36.7875614,932,1644,250,1416
6228,23023,53,3,Business,27,6,39215,27,6,39348,27,6,39985,27,6,40480,27,6,41591,8,23.25888921888938,-1.3167113,36.8301563,-1.2770708,36.8231093,843,1111,133,1132
6229,20381,3017,3,Business,14,6,54258,14,6,54314,14,6,54597,14,6,55247,14,6,57283,16,18.9,-1.299313,36.7831488,-1.3263285,36.8926624,45,2036,56,933
6230,18054,1271,3,Business,5,2,55830,5,2,57368,5,2,58655,5,2,59771,5,2,60535,9,25.1,-1.3244885,36.897792,-1.3323107,36.8692616,377,764,1538,2403
6231,10489,2360,3,Business,7,4,45107,7,4,45134,7,4,45585,7,4,45718,7,4,48020,3,24.4,-1.2584143,36.8048002,-1.2615888,36.7928732,660,2302,27,584
6232,5987,2415,1,Personal,7,6,52407,7,6,52496,7,6,53191,7,6,53339,7,6,55787,8,21.6,-1.2766474,36.8155764,-1.292188,36.764855,208,2448,89,843
6233,12317,868,3,Business,28,2,53031,28,2,53042,28,2,53053,28,2,54344,28,2,55138,5,23.7,-1.259478,36.8017813,-1.265715,36.823815,72,794,11,1302
6234,1515,2097,2,Personal,21,5,34369,21,5,34417,21,5,35000,21,5,35865,21,5,38225,8,19.9,-1.2874711,36.7646208,-1.2854089,36.8284874,785,2360,48,1448
6235,21505,1075,3,Business,13,1,35872,13,1,35893,13,1,37799,13,1,37997,13,1,38910,3,23.25888921888938,-1.2527958,36.8003131,-1.2551895,36.7822034,361,913,21,2104
6236,20960,2330,3,Business,26,5,46349,26,5,46373,26,5,46646,26,5,47068,26,5,48265,9,23.25888921888938,-1.2642903,36.8002137,-1.3015197,36.7658456,484,1197,24,695
6237,18581,3222,3,Business,15,1,53496,15,1,53677,15,1,54316,15,1,54986,15,1,56139,13,23.25888921888938,-1.2551895,36.7822034,-1.2045978,36.7595611,449,1153,181,1309
6238,18530,72,1,Personal,10,2,35708,10,2,35792,10,2,36137,10,2,36377,10,2,37188,5,16.1,-1.3227037,36.8470872,-1.3038645,36.8684596,791,811,84,585
6239,12823,2069,3,Business,11,1,45009,11,1,45048,11,1,45801,11,1,45974,11,1,48020,16,26.7,-1.303596,36.778378,-1.228911,36.881876,463,2046,39,926
6240,13442,3599,3,Business,1,1,43290,1,1,43446,1,1,44050,1,1,45489,1,1,48492,13,23.8,-1.3302996,36.8707935,-1.2735236,36.7992196,519,3003,156,2043
6241,5918,478,3,Business,2,4,37538,2,4,40662,2,4,41413,2,4,42126,2,4,45366,15,22.5,-1.2551895,36.7822034,-1.3216456,36.7145156,101,3240,3124,1464
6242,21012,3487,3,Business,3,5,48271,3,5,48523,3,5,48862,3,5,50161,3,5,51318,5,23.25888921888938,-1.2584143,36.8048002,-1.279395,36.825364,953,1157,252,1638
6243,26579,2677,3,Business,8,4,53709,8,4,53743,8,4,54684,8,4,55231,8,4,59339,30,27.4,-1.306378,36.7519845,-1.3440557,36.9099653,30,4108,34,1488
6244,24635,265,3,Business,10,4,54560,10,4,54564,10,4,54769,10,4,56464,10,4,60377,24,21.7,-1.300921,36.828195,-1.2491258,36.6894253,105,3913,4,1900
6245,22636,1803,1,Personal,30,3,26358,30,3,26491,30,3,27358,30,3,27645,30,3,29459,5,17.3,-1.2673271,36.8064451,-1.2875183,36.8022344,103,1814,133,1154
6246,14137,2123,1,Personal,2,1,48432,2,1,48609,2,1,50435,2,1,50806,2,1,52257,14,20.2,-1.2846475,36.8275903,-1.3382857,36.8870715,752,1451,177,2197
6247,2050,927,3,Personal,2,2,56441,2,2,56672,2,2,57992,2,2,58885,2,2,59644,3,26.2,-1.2985749,36.8088,-1.2917868,36.7872675,328,759,231,2213
6248,6491,1500,3,Business,14,3,51253,14,3,51292,14,3,52143,14,3,52210,14,3,53340,10,25.6,-1.2991441,36.7528804,-1.2574219,36.7927073,257,1130,39,918
6249,27424,640,3,Business,9,4,56703,9,4,59351,9,4,60020,9,4,60230,9,4,61158,3,23.25888921888938,-1.2969741,36.7856612,-1.2878914,36.7728222,92,928,2648,879
6250,19149,1927,3,Business,1,1,53075,1,1,53088,1,1,53959,1,1,55481,1,1,57580,15,25.6,-1.264272,36.7978791,-1.3472066,36.7692638,857,2099,13,2393
6251,18352,2680,3,Business,1,4,36421,1,4,36527,1,4,38042,1,4,38442,1,4,40421,8,23.25888921888938,-1.2857521,36.8277457,-1.3039706,36.7688174,554,1979,106,1915
6252,25119,2464,3,Business,14,5,58220,14,5,58489,14,5,60113,14,5,60196,14,5,62366,5,21.5,-1.2765736,36.8513646,-1.279395,36.825364,673,2170,269,1707
6253,14176,2562,1,Personal,26,6,35372,26,6,38363,26,6,39015,26,6,39200,26,6,42532,7,22.7,-1.2830603,36.8298283,-1.2894957,36.8709153,351,3332,2991,837
6254,12802,516,3,Business,16,4,51634,16,4,51684,16,4,51733,16,4,53049,16,4,53634,4,23.25888921888938,-1.2571472,36.7950633,-1.265432,36.795034,147,585,50,1365
6255,19466,1911,2,Personal,20,4,40251,20,4,40352,20,4,41081,20,4,42172,20,4,43696,12,24.2,-1.2662257,36.7981813,-1.2049707,36.7858957,536,1524,101,1820
6256,5266,776,1,Personal,1,5,60094,1,5,60281,1,5,60970,1,5,61739,1,5,62489,6,22.8,-1.278967,36.8236745,-1.3027038,36.7814225,103,750,187,1458
6257,25449,2828,3,Business,27,3,57352,27,3,58240,27,3,58328,27,3,59637,27,3,61985,20,27.7,-1.2615888,36.7928732,-1.3681253,36.9155298,926,2348,888,1397
6258,2165,1500,3,Business,30,3,45981,30,3,47207,30,3,47228,30,3,50052,30,3,51079,8,28.8,-1.3004062,36.829741,-1.2636051,36.7850995,111,1027,1226,2845
6259,26806,288,1,Personal,20,3,38710,20,3,38859,20,3,39671,20,3,40273,20,3,44507,7,20.4,-1.2876365,36.816096,-1.296797,36.7764525,431,4234,149,1414
6260,23324,3689,3,Business,6,4,48584,6,4,48597,6,4,49224,6,4,51360,6,4,52476,6,23.4,-1.281754,36.8324229,-1.2527958,36.8003131,882,1116,13,2763
6261,12955,2150,3,Business,30,4,37708,30,4,37731,30,4,37745,30,4,38319,30,4,39649,14,23.25888921888938,-1.303596,36.778378,-1.344446,36.756597,855,1330,23,588
6262,22148,3326,3,Business,7,3,58726,7,3,58820,7,3,60608,7,3,60916,7,3,65309,13,25.0,-1.2551895,36.7822034,-1.3133713,36.8541174,287,4393,94,2096
6263,4795,1245,3,Business,27,4,33369,27,4,33394,27,4,34805,27,4,36150,27,4,38652,20,17.9,-1.300921,36.828195,-1.3340618,36.7108942,654,2502,25,2756
6264,7150,412,3,Business,2,2,51867,2,2,51943,2,2,52910,2,2,53904,2,2,53917,4,29.4,-1.2628473,36.781805,-1.266837,36.799249,850,13,76,1961
6265,19955,1211,2,Personal,11,4,38554,11,4,38597,11,4,38970,11,4,39223,11,4,40093,6,23.7,-1.2595422,36.7871178,-1.2795549,36.7627011,434,870,43,626
6266,10490,2829,3,Business,26,5,41368,26,5,41435,26,5,42070,26,5,42419,26,5,43538,6,23.25888921888938,-1.2571472,36.7950633,-1.2981625,36.8130142,96,1119,67,984
6267,25409,3224,2,Personal,19,4,49949,19,4,49986,19,4,50301,19,4,50560,19,4,53425,4,20.3,-1.269277,36.8068993,-1.2551895,36.7822034,100,2865,37,574
6268,23631,2195,1,Business,6,4,37536,6,4,37563,6,4,38436,6,4,38828,6,4,41513,10,22.2,-1.2667076,36.8054353,-1.3313643,36.8577422,216,2685,27,1265
6269,5606,475,3,Business,20,4,41824,20,4,41872,20,4,42241,20,4,42742,20,4,43174,2,22.3,-1.2551895,36.7822034,-1.2573514,36.7946418,937,432,48,870
6270,9192,2112,3,Business,4,2,42045,4,2,42138,4,2,43382,4,2,44261,4,2,45506,14,19.0,-1.2956951,36.8129242,-1.2156006,36.8916865,248,1245,93,2123
6271,8481,3291,3,Business,8,6,52006,8,6,52026,8,6,53335,8,6,55140,8,6,55143,4,23.25888921888938,-1.265715,36.823815,-1.2600926,36.8088685,309,3,20,3114
6272,4879,1033,3,Personal,15,5,53986,15,5,56482,15,5,57518,15,5,58056,15,5,60182,11,28.1,-1.2326041,36.8009029,-1.2902539,36.8211322,839,2126,2496,1574
6273,1236,1244,3,Business,11,1,49832,11,1,50512,11,1,51011,11,1,52317,11,1,53553,11,27.8,-1.331619,36.847976,-1.303596,36.778378,178,1236,680,1805
6274,3708,2739,1,Personal,20,5,51296,20,5,51304,20,5,51804,20,5,52087,20,5,53374,7,20.6,-1.2595422,36.7871178,-1.2962832,36.7849683,550,1287,8,783
6275,7546,186,3,Business,22,4,59315,22,4,59478,22,4,59520,22,4,60176,22,4,61233,4,24.3,-1.2571472,36.7950633,-1.2890399,36.8164942,447,1057,163,698
6276,13721,676,2,Personal,3,2,53393,3,2,53761,3,2,56298,3,2,58671,3,2,61239,20,20.1,-1.3381926,36.9205612,-1.2753109,36.8130185,238,2568,368,4910
6277,2172,2850,1,Personal,8,5,64157,8,5,64351,8,5,65861,8,5,66255,8,5,68189,12,19.8,-1.2813445,36.8356397,-1.2257343,36.8933543,852,1934,194,1904
6278,20447,1363,3,Business,7,5,39396,7,5,39442,7,5,39590,7,5,39668,7,5,41489,13,23.25888921888938,-1.3004062,36.829741,-1.242902,36.870334,740,1821,46,226
6279,14867,848,3,Personal,13,1,36997,13,1,37015,13,1,38134,13,1,38448,13,1,42138,22,17.4,-1.2449128,36.76975679,-1.3287648,36.7445732,116,3690,18,1433
6280,5232,3647,3,Business,5,5,52343,5,5,52352,5,5,53461,5,5,53727,5,5,56020,16,27.7,-1.272639,36.794723,-1.296266,36.8882943,843,2293,9,1375
6281,24920,3517,3,Business,6,6,33534,6,6,33557,6,6,33982,6,6,35790,6,6,37288,15,19.8,-1.300921,36.828195,-1.3882008,36.7699445,843,1498,23,2233
6282,9717,2238,1,Personal,30,4,38014,30,4,38037,30,4,38065,30,4,38865,30,4,40297,14,20.2,-1.349133,36.7599586,-1.3006208,36.7727444,881,1432,23,828
6283,5443,1502,3,Business,22,6,54263,22,6,54270,22,6,54285,22,6,54646,22,6,56225,13,26.0,-1.2527958,36.8003131,-1.2232123,36.8932547,685,1579,7,376
6284,10532,1280,3,Business,9,2,34839,9,2,34851,9,2,34950,9,2,35251,9,2,35867,3,20.7,-1.2551895,36.7822034,-1.2575407,36.7868197,411,616,12,400
6285,4468,918,1,Personal,3,1,53962,3,1,53967,3,1,55402,3,1,56473,3,1,60375,23,23.0,-1.3415373,36.7295377,-1.2344774,36.7553163,248,3902,5,2506
6286,5721,3404,3,Business,2,2,47893,2,2,47912,2,2,48350,2,2,48562,2,2,49960,8,21.0,-1.3014461,36.7661381,-1.2793686,36.8259233,88,1398,19,650
6287,16729,1687,3,Business,8,3,39030,8,3,39106,8,3,39562,8,3,40195,8,3,41586,11,23.25888921888938,-1.2626574,36.8014034,-1.281531,36.740864,96,1391,76,1089
6288,6440,2565,3,Personal,25,5,40934,25,5,40949,25,5,41270,25,5,42684,25,5,44171,11,26.6,-1.3135847,36.8505456,-1.257309,36.8060084,647,1487,15,1735
6289,4682,1363,3,Business,7,5,38788,7,5,39237,7,5,40034,7,5,40273,7,5,41372,3,25.6,-1.3004062,36.829741,-1.291768,36.8297208,447,1099,449,1036
6290,24961,1245,3,Business,14,4,38981,14,4,38989,14,4,38998,14,4,39777,14,4,41434,19,24.9,-1.300921,36.828195,-1.3198615,36.7110323,728,1657,8,788
6291,13122,1329,3,Business,19,6,38378,19,6,38388,19,6,38765,19,6,38834,19,6,39482,5,25.2,-1.273056,36.811298,-1.2855921,36.7788349,902,648,10,446
6292,5809,868,3,Business,2,4,44913,2,4,44967,2,4,45740,2,4,46427,2,4,48152,8,23.25888921888938,-1.303596,36.778378,-1.265715,36.823815,269,1725,54,1460
6293,14691,1271,3,Business,5,5,52941,5,5,53009,5,5,53478,5,5,54533,5,5,57317,23,27.8,-1.3244885,36.897792,-1.2784722,36.7556652,96,2784,68,1524
6294,218,808,2,Business,25,5,58260,25,5,58301,25,5,59971,25,5,60599,25,5,62479,7,21.4,-1.310518,36.837305,-1.2651643,36.8072214,858,1880,41,2298
6295,18756,3669,3,Business,30,2,40555,30,2,40856,30,2,42151,30,2,43202,30,2,44591,15,23.25888921888938,-1.2615888,36.7928732,-1.2156006,36.8916865,8,1389,301,2346
6296,10072,22,2,Personal,8,3,32931,8,3,33022,8,3,34322,8,3,34792,8,3,36576,7,17.4,-1.3112325,36.8146321,-1.2764887,36.8180775,700,1784,91,1770
6297,1980,194,1,Personal,2,3,46238,2,3,46277,2,3,46761,2,3,46958,2,3,47479,2,21.9,-1.27267,36.8124492,-1.2658373,36.8018598,650,521,39,681
6298,1389,2789,3,Business,5,5,30450,5,5,30556,5,5,32196,5,5,32377,5,5,33628,7,19.8,-1.304735,36.7846054,-1.2603996,36.7972272,576,1251,106,1821
6299,26063,579,3,Business,23,2,52677,23,2,53660,23,2,56001,23,2,56277,23,2,59634,20,19.2,-1.3204931,36.7043102,-1.277473,36.8311978,844,3357,983,2617
6300,10116,3599,3,Business,24,5,51539,24,5,51561,24,5,52961,24,5,55984,24,5,56523,5,22.8,-1.3302996,36.8707935,-1.3184779,36.8373109,675,539,22,4423
6301,8673,2041,1,Business,30,6,42559,30,6,43468,30,6,43879,30,6,44602,30,6,45830,2,21.8,-1.290894,36.822971,-1.2848174,36.826163,21,1228,909,1134
6302,3368,1804,3,Personal,19,3,40208,19,3,40233,19,3,40973,19,3,41315,19,3,41534,1,23.25888921888938,-1.2839993,36.791851,-1.2859206,36.7888272,612,219,25,1082
6303,20220,186,3,Business,17,3,45059,17,3,45092,17,3,45301,17,3,46082,17,3,47827,5,23.25888921888938,-1.2825816,36.8092346,-1.2571472,36.7950633,843,1745,33,990
6304,18805,1335,3,Personal,14,4,60610,14,4,60844,14,4,60872,14,4,61252,14,4,61897,4,26.2,-1.2611987,36.8060913,-1.2604408,36.8206328,409,645,234,408
6305,22929,2651,3,Business,20,1,46510,20,1,46594,20,1,47057,20,1,48332,20,1,51005,12,23.25888921888938,-1.3247683,36.85803,-1.2652611,36.8062739,430,2673,84,1738
6306,10174,3242,1,Personal,16,2,49614,16,2,49634,16,2,50552,16,2,52795,16,2,54507,14,27.3,-1.3255316,36.711542,-1.2939816,36.8118469,847,1712,20,3161
6307,20084,3283,3,Business,2,6,35129,2,6,35139,2,6,35551,2,6,35986,2,6,36486,4,21.1,-1.266837,36.799249,-1.2628473,36.781805,427,500,10,847
6308,16667,2763,3,Business,8,3,56019,8,3,56091,8,3,56773,8,3,56930,8,3,60240,8,23.25888921888938,-1.2551895,36.7822034,-1.2934638,36.7668028,337,3310,72,839
6309,24569,635,3,Business,19,1,48192,19,1,48829,19,1,49295,19,1,49457,19,1,51502,6,25.1,-1.2599563,36.7993439,-1.2951243,36.8281344,447,2045,637,628
6310,10026,2989,3,Business,13,5,35753,13,5,35938,13,5,36039,13,5,36407,13,5,37940,18,15.4,-1.3392837,36.76282898,-1.2551895,36.7822034,103,1533,185,469
6311,17826,3503,2,Personal,3,5,48588,3,5,48612,3,5,48885,3,5,50124,3,5,52677,14,25.4,-1.3299841,36.8466903,-1.2828204,36.7842621,101,2553,24,1512
6312,20517,2283,2,Personal,18,3,44581,18,3,44590,18,3,45837,18,3,46475,18,3,47168,4,19.9,-1.2595422,36.7871178,-1.2562797,36.8075858,951,693,9,1885
6313,3935,393,3,Business,29,1,39071,29,1,39085,29,1,39203,29,1,41336,29,1,42588,11,23.25888921888938,-1.3167113,36.8301563,-1.2638185,36.7930057,168,1252,14,2251
6314,6002,2200,3,Business,15,6,50474,15,6,52404,15,6,52961,15,6,54292,15,6,55222,6,23.6,-1.2527958,36.8003131,-1.290894,36.822971,266,930,1930,1888
6315,15347,1148,3,Business,29,2,51281,29,2,51316,29,2,53275,29,2,53345,29,2,55701,12,26.8,-1.3100586,36.8500329,-1.255956,36.772901,206,2356,35,2029
6316,11682,3635,1,Business,20,1,58445,20,1,58667,20,1,58699,20,1,61447,20,1,64105,7,20.5,-1.2615888,36.7928732,-1.2772389,36.7855864,179,2658,222,2780
6317,10678,3517,3,Business,20,1,33313,20,1,33339,20,1,34590,20,1,36519,20,1,38140,7,14.2,-1.2696795,36.8640088,-1.300921,36.828195,467,1621,26,3180
6318,19579,755,1,Personal,26,3,42384,26,3,42417,26,3,42821,26,3,43687,26,3,47078,15,24.1,-1.3297531,36.7063699,-1.2640571,36.7883547,125,3391,33,1270
6319,14457,1033,3,Personal,23,6,42254,23,6,42303,23,6,43432,23,6,44400,23,6,45209,2,23.25888921888938,-1.260232,36.807334,-1.2606419,36.8055244,407,809,49,2097
6320,21582,3651,3,Business,18,2,32355,18,2,32509,18,2,33043,18,2,33489,18,2,34614,6,16.5,-1.2876324,36.8186574,-1.2571472,36.7950633,857,1125,154,980
6321,2564,1419,3,Personal,24,5,51775,24,5,51886,24,5,52636,24,5,52914,24,5,56242,21,23.2,-1.2737903,36.789124,-1.314193,36.916132,468,3328,111,1028
6322,18571,1584,3,Business,20,5,36805,20,5,36893,20,5,38000,20,5,38269,20,5,39626,8,18.6,-1.26559,36.8027,-1.2969741,36.7856612,379,1357,88,1376
6323,23780,2435,2,Personal,28,5,48627,28,5,48684,28,5,50132,28,5,51026,28,5,52164,7,25.5,-1.2962893,36.7708484,-1.2646847,36.7906823,597,1138,57,2342
6324,20356,2279,3,Business,27,1,37018,27,1,37047,27,1,38489,27,1,38929,27,1,38937,3,20.6,-1.2980085,36.8044778,-1.2897368,36.8226783,19,8,29,1882
6325,7259,391,3,Business,20,3,49116,20,3,49218,20,3,50918,20,3,52146,20,3,53475,5,29.4,-1.300921,36.828195,-1.2867454,36.8259017,223,1329,102,2928
6326,17741,3084,3,Business,5,2,57022,5,2,59798,5,2,60914,5,2,61338,5,2,63293,17,23.25888921888938,-1.215326,36.8919938,-1.2767257,36.787393,8,1955,2776,1540
6327,2280,3291,3,Business,3,5,34646,3,5,34660,3,5,35786,3,5,36644,3,5,37277,4,23.25888921888938,-1.272828,36.816608,-1.2600926,36.8088685,89,633,14,1984
6328,1816,3331,3,Business,5,3,51043,5,3,51474,5,3,51837,5,3,51996,5,3,53050,10,25.0,-1.2551895,36.7822034,-1.3025667,36.7803495,878,1054,431,522
6329,25055,3701,3,Business,26,2,41333,26,2,41367,26,2,43075,26,2,43276,26,2,44568,6,27.6,-1.2612574,36.7879622,-1.2611818,36.8271669,448,1292,34,1909
6330,11448,3326,3,Business,16,4,33780,16,4,33886,16,4,35566,16,4,36121,16,4,37038,7,23.25888921888938,-1.2571472,36.7950633,-1.304344,36.812274,205,917,106,2235
6331,18478,914,3,Business,16,2,55382,16,2,55395,16,2,56090,16,2,56590,16,2,58309,11,23.25888921888938,-1.2670213,36.7994482,-1.3083777,36.8590077,99,1719,13,1195
6332,18008,1500,3,Business,2,4,50476,2,4,50880,2,4,54669,2,4,55306,2,4,58468,8,23.25888921888938,-1.3004062,36.829741,-1.2638185,36.7930057,778,3162,404,4426
6333,8018,2801,3,Business,12,4,55413,12,4,55432,12,4,55909,12,4,56085,12,4,57660,14,21.5,-1.2595422,36.7871178,-1.298227,36.8530125,71,1575,19,653
6334,9367,1687,3,Business,15,2,47251,15,2,47258,15,2,47544,15,2,48492,15,2,50630,21,22.8,-1.3098453,36.8392995,-1.1853633,36.9350604,188,2138,7,1234
6335,19633,3689,3,Business,8,4,64834,8,4,64865,8,4,65362,8,4,65475,8,4,66194,1,25.8,-1.2584143,36.8048002,-1.2527958,36.8003131,578,719,31,610
6336,18069,1341,3,Business,17,3,41572,17,3,41636,17,3,41904,17,3,42779,17,3,43991,15,23.25888921888938,-1.344446,36.756597,-1.331619,36.847976,327,1212,64,1143
6337,27955,635,3,Business,14,4,48984,14,4,49050,14,4,50112,14,4,51530,14,4,52720,7,28.1,-1.3081376,36.8329772,-1.2602337,36.7990548,715,1190,66,2480
6338,6014,1075,3,Business,18,1,44949,18,1,45019,18,1,47306,18,1,47854,18,1,50248,18,28.2,-1.2852569,36.8976121,-1.2527958,36.8003131,697,2394,70,2835
6339,25278,391,3,Business,7,5,44012,7,5,47095,7,5,48043,7,5,49087,7,5,50631,5,23.25888921888938,-1.300921,36.828195,-1.2867454,36.8259017,158,1544,3083,1992
6340,15842,2987,3,Business,21,3,58755,21,3,59069,21,3,59636,21,3,59744,21,3,61208,4,23.25888921888938,-1.270212,36.8210877,-1.2534301,36.8000983,727,1464,314,675
6341,9002,3635,1,Business,20,4,40137,20,4,40145,20,4,40161,20,4,40558,20,4,40577,3,24.6,-1.2584143,36.8048002,-1.2615888,36.7928732,51,19,8,413
6342,28235,393,3,Business,31,3,50875,31,3,51173,31,3,51181,31,3,51902,31,3,53848,14,27.0,-1.3177547,36.8303703,-1.306378,36.7519845,239,1946,298,729
6343,14096,3326,3,Business,6,5,52119,6,5,55700,6,5,56670,6,5,58795,6,5,60686,21,22.6,-1.2579304,36.8019667,-1.3427269,36.9194847,116,1891,3581,3095
6344,10471,3718,3,Business,30,2,37615,30,2,37895,30,2,38450,30,2,38920,30,2,40829,4,22.2,-1.2650027,36.8126242,-1.2921233,36.806386,519,1909,280,1025
6345,23469,1051,3,Business,11,1,52201,11,1,52240,11,1,54856,11,1,55172,11,1,57510,22,27.9,-1.3564685,36.9049642,-1.2963097,36.7688221,488,2338,39,2932
6346,6129,970,3,Business,26,2,30096,26,2,30497,26,2,31930,26,2,32171,26,2,33312,6,23.25888921888938,-1.2551895,36.7822034,-1.2904753,36.8144721,953,1141,401,1674
6347,16197,1805,2,Personal,7,5,66479,7,5,66716,7,5,67540,7,5,67957,7,5,69477,6,22.2,-1.2979147,36.7857814,-1.2855688,36.824538,312,1520,237,1241
6348,6944,2163,3,Personal,7,5,52343,7,5,52494,7,5,54637,7,5,54760,7,5,56975,8,23.25888921888938,-1.2429898,36.7851062,-1.2778241,36.8139525,204,2215,151,2266
6349,8901,2326,1,Personal,7,2,50938,7,2,51001,7,2,51659,7,2,52082,7,2,53371,4,24.6,-1.2746076,36.8325519,-1.2750393,36.8151527,174,1289,63,1081
6350,117,186,3,Business,25,4,59214,25,4,59244,25,4,59594,25,4,59816,25,4,60830,4,23.25888921888938,-1.2571472,36.7950633,-1.2890399,36.8164942,935,1014,30,572
6351,27526,1179,3,Business,7,5,42516,7,5,43153,7,5,44046,7,5,45192,7,5,47912,21,25.2,-1.3700383,36.9190174,-1.2917868,36.7872675,807,2720,637,2039
6352,1289,1329,3,Business,3,4,41023,3,4,41049,3,4,41409,3,4,41764,3,4,43034,4,23.4,-1.273056,36.811298,-1.2580565,36.8084825,407,1270,26,715
6353,23429,1329,3,Business,3,5,35724,3,5,35736,3,5,36425,3,5,36583,3,5,37304,5,23.25888921888938,-1.273056,36.811298,-1.2844858,36.7955884,195,721,12,847
6354,498,3370,3,Business,31,2,37991,31,2,38010,31,2,38460,31,2,39427,31,2,41792,9,18.7,-1.3038156,36.8122733,-1.2615888,36.7928732,580,2365,19,1417
6355,15765,3295,3,Business,6,4,33533,6,4,33582,6,4,33625,6,4,34519,6,4,38209,20,18.9,-1.2571472,36.7950633,-1.3700383,36.9190174,926,3690,49,937
6356,23734,246,3,Business,14,5,36955,14,5,36973,14,5,37669,14,5,40013,14,5,42455,8,24.5,-1.290894,36.822971,-1.2584143,36.8048002,698,2442,18,3040
6357,7733,372,1,Business,13,1,44871,13,1,44887,13,1,44919,13,1,46737,13,1,48204,11,17.0,-1.2765736,36.8513646,-1.255956,36.789867,179,1467,16,1850
6358,14446,1402,3,Business,13,1,41676,13,1,41694,13,1,43120,13,1,43576,13,1,46410,13,17.4,-1.2156006,36.8916865,-1.2891922,36.825189,633,2834,18,1882
6359,15544,1245,3,Business,8,2,45714,8,2,45722,8,2,46300,8,2,48150,8,2,50497,17,23.5,-1.300921,36.828195,-1.3198615,36.7110323,580,2347,8,2428
6360,9109,627,3,Business,3,3,57226,3,3,59470,3,3,59793,3,3,60497,3,3,62038,18,23.6,-1.2748998,36.886482,-1.2551895,36.7822034,589,1541,2244,1027
6361,22811,2216,3,Business,30,3,67051,30,3,67057,30,3,67256,30,3,67842,30,3,69593,18,23.25888921888938,-1.2553615,36.7895376,-1.3491868,36.7111673,116,1751,6,785
6362,215,1245,3,Business,19,6,37319,19,6,37352,19,6,37865,19,6,39188,19,6,40864,19,25.2,-1.300921,36.828195,-1.3198615,36.7110323,130,1676,33,1836
6363,17911,3669,3,Business,2,4,55973,2,4,56567,2,4,57598,2,4,59230,2,4,63908,11,23.25888921888938,-1.2615888,36.7928732,-1.3251584,36.8199384,292,4678,594,2663
6364,16589,868,3,Business,26,5,35406,26,5,35458,26,5,37303,26,5,37694,26,5,38844,8,23.25888921888938,-1.303596,36.778378,-1.265715,36.823815,435,1150,52,2236
6365,11764,3647,3,Business,9,5,59695,9,5,61131,9,5,62425,9,5,62919,9,5,65266,11,25.2,-1.272639,36.794723,-1.3094179,36.7185918,304,2347,1436,1788
6366,20913,3560,3,Business,24,3,40464,24,3,41566,24,3,41986,24,3,43000,24,3,43751,5,20.0,-1.2765736,36.8513646,-1.279395,36.825364,358,751,1102,1434
6367,763,3283,3,Business,3,1,43518,3,1,43551,3,1,44043,3,1,44372,3,1,44947,5,21.6,-1.2600926,36.8088685,-1.2628473,36.781805,8,575,33,821
6368,3481,632,1,Personal,10,3,58955,10,3,58999,10,3,59796,10,3,60576,10,3,61861,12,23.0,-1.295141,36.769918,-1.2688502,36.8357356,612,1285,44,1577
6369,22854,1244,3,Business,9,6,46043,9,6,46058,9,6,47360,9,6,47809,9,6,49187,8,24.9,-1.272828,36.816608,-1.303596,36.778378,427,1378,15,1751
6370,21689,2956,3,Business,9,4,59641,9,4,59735,9,4,60286,9,4,61041,9,4,63225,10,23.25888921888938,-1.2584143,36.8048002,-1.2413316,36.8785525,930,2184,94,1306
6371,1777,142,3,Business,4,4,40637,4,4,40697,4,4,41344,4,4,41502,4,4,44179,17,25.6,-1.2963097,36.7688221,-1.2871375,36.8898931,411,2677,60,805
6372,19948,1033,3,Personal,1,5,47704,1,5,47795,1,5,48937,1,5,49252,1,5,50449,7,28.7,-1.2326041,36.8009029,-1.26071,36.8206332,253,1197,91,1457
6373,2230,475,3,Business,11,1,44754,11,1,45162,11,1,45526,11,1,45806,11,1,46733,3,17.9,-1.2551895,36.7822034,-1.2576857,36.7799199,322,927,408,644
6374,6694,2828,3,Business,23,6,51386,23,6,51400,23,6,51826,23,6,55363,23,6,56466,25,28.1,-1.2615888,36.7928732,-1.3593378,36.9433184,863,1103,14,3963
6375,23308,3283,3,Business,5,3,32803,5,3,33018,5,3,33570,5,3,33956,5,3,37716,13,18.2,-1.2296618,36.8438272,-1.2628473,36.781805,677,3760,215,938
6376,22125,909,3,Business,22,3,53348,22,3,54811,22,3,55808,22,3,56253,22,3,57508,7,24.4,-1.207546,36.7913976,-1.225322,36.80855,7,1255,1463,1442
6377,2775,2686,3,Personal,21,6,38527,21,6,38546,21,6,38744,21,6,39514,21,6,40806,12,16.3,-1.3404187,36.7614685,-1.316065,36.840398,670,1292,19,968
6378,16717,3115,3,Business,25,4,39185,25,4,39204,25,4,39757,25,4,40107,25,4,42664,21,20.2,-1.2963097,36.7688221,-1.3160977,36.9131642,247,2557,19,903
6379,14278,2150,3,Business,6,6,42762,6,6,42776,6,6,43215,6,6,43379,6,6,45069,18,26.8,-1.2628473,36.781805,-1.344446,36.756597,952,1690,14,603
6380,4362,2174,3,Business,13,6,42400,13,6,42425,13,6,43264,13,6,43948,13,6,48537,27,26.1,-1.2482781,36.884092,-1.324878,36.7070285,387,4589,25,1523
6381,1968,3669,3,Business,16,5,60653,16,5,60692,16,5,61278,16,5,61657,16,5,62823,17,26.1,-1.2615888,36.7928732,-1.2491258,36.6894253,640,1166,39,965
6382,10800,3291,3,Business,6,3,38942,6,3,39022,6,3,40009,6,3,41173,6,3,42044,5,23.25888921888938,-1.2783849,36.8163445,-1.2600926,36.8088685,763,871,80,2151
6383,26685,2587,3,Business,9,6,35522,9,6,35623,9,6,36261,9,6,36795,9,6,37609,5,20.2,-1.2584143,36.8048002,-1.28878,36.8168312,579,814,101,1172
6384,14539,868,3,Business,10,5,52928,10,5,52969,10,5,54122,10,5,55428,10,5,56770,9,21.9,-1.331619,36.847976,-1.265715,36.823815,882,1342,41,2459
6385,13848,2777,3,Business,7,4,60464,7,4,60514,7,4,60865,7,4,63354,7,4,64551,3,29.4,-1.2584143,36.8048002,-1.2551895,36.7822034,925,1197,50,2840
6386,1093,1500,3,Business,21,5,42688,21,5,45854,21,5,45914,21,5,46295,21,5,48727,7,20.0,-1.3004062,36.829741,-1.2696795,36.8640088,532,2432,3166,441
6387,27455,242,3,Business,8,5,44019,8,5,50267,8,5,51804,8,5,52177,8,5,54600,8,21.3,-1.2551895,36.7822034,-1.2965924,36.8179314,312,2423,6248,1910
6388,11851,633,3,Business,1,4,41229,1,4,41249,1,4,41499,1,4,41826,1,4,43616,10,23.25888921888938,-1.3004062,36.829741,-1.2991441,36.7528804,518,1790,20,577
6389,8670,2423,3,Business,30,2,57339,30,2,57972,30,2,58255,30,2,58772,30,2,59257,3,23.25888921888938,-1.2551895,36.7822034,-1.2655477,36.8001682,8,485,633,800
6390,579,302,3,Business,16,5,50601,16,5,50670,16,5,50905,16,5,51651,16,5,53413,2,23.25888921888938,-1.2649605,36.7981777,-1.25896,36.8016691,125,1762,69,981
6391,13602,1544,3,Business,24,5,59043,24,5,62422,24,5,64422,24,5,65386,24,5,67012,13,20.1,-1.2794301,36.816247,-1.3123977,36.902807,411,1626,3379,2964
6392,19786,3222,3,Business,8,5,40285,8,5,40344,8,5,41020,8,5,41213,8,5,42793,6,28.3,-1.2551895,36.7822034,-1.2803414,36.8265456,278,1580,59,869
6393,15075,2333,2,Personal,18,2,57874,18,2,57981,18,2,58577,18,2,58762,18,2,59138,2,27.2,-1.2903421,36.7885282,-1.28467,36.794438,409,376,107,781
6394,2523,246,3,Business,12,4,52505,12,4,52520,12,4,52968,12,4,54095,12,4,55521,2,21.6,-1.2615888,36.7928732,-1.2584143,36.8048002,951,1426,15,1575
6395,9517,2066,3,Business,15,3,63930,15,3,64343,15,3,65234,15,3,65384,15,3,66379,7,21.0,-1.316961,36.820337,-1.2747143,36.8068888,857,995,413,1041
6396,5466,3470,3,Business,21,1,38955,21,1,39058,21,1,40332,21,1,40969,21,1,42165,8,20.0,-1.2765736,36.8513646,-1.2601709,36.8002238,900,1196,103,1911
6397,10885,2801,3,Business,30,2,37982,30,2,38022,30,2,38527,30,2,38609,30,2,39306,3,22.1,-1.2595422,36.7871178,-1.2566586,36.7929682,228,697,40,587
6398,12523,935,1,Personal,18,3,34365,18,3,34393,18,3,37483,18,3,37921,18,3,38644,6,20.0,-1.2762384,36.7929522,-1.2551895,36.7822034,334,723,28,3528
6399,26135,3599,3,Business,14,3,47785,14,3,48210,14,3,48878,14,3,50897,14,3,53164,11,25.7,-1.3302996,36.8707935,-1.3329032,36.7888802,62,2267,425,2687
6400,19308,1482,3,Business,17,6,45554,17,6,45662,17,6,46506,17,6,46569,17,6,49222,24,23.9,-1.338579,36.8963038,-1.3981712,36.7673241,751,2653,108,907
6401,12120,346,3,Business,11,4,54951,11,4,56256,11,4,56931,11,4,57175,11,4,57847,5,27.0,-1.28878,36.8168312,-1.2922364,36.7895538,438,672,1305,919
6402,9373,1673,2,Personal,22,6,49739,22,6,49745,22,6,50009,22,6,51153,22,6,52442,11,23.25888921888938,-1.2222199,36.8209432,-1.2583017,36.8023526,6,1289,6,1408
6403,26960,1578,3,Business,20,2,45569,20,2,45698,20,2,46790,20,2,46939,20,2,47832,4,19.6,-1.28878,36.8168312,-1.303711,36.8154933,456,893,129,1241
6404,25075,2514,3,Business,27,3,57199,27,3,57247,27,3,58103,27,3,58489,27,3,60443,4,29.5,-1.288086,36.821116,-1.266294,36.8057971,448,1954,48,1242
6405,4296,12,3,Business,9,1,31053,9,1,31185,9,1,33381,9,1,33844,9,1,35459,9,15.3,-1.240021,36.84999,-1.2864963,36.8252086,808,1615,132,2659
6406,10713,391,3,Business,18,1,39945,18,1,39975,18,1,40587,18,1,41214,18,1,41919,5,27.9,-1.2602337,36.7990548,-1.2867454,36.8259017,855,705,30,1239
6407,3552,3283,3,Business,8,1,34955,8,1,34989,8,1,35399,8,1,36085,8,1,36550,6,22.1,-1.272828,36.816608,-1.2628473,36.781805,812,465,34,1096
6408,16710,1797,2,Personal,21,1,51171,21,1,53933,21,1,55806,21,1,56497,21,1,58354,7,21.5,-1.2871938,36.8195031,-1.2827576,36.7830241,216,1857,2762,2564
6409,21741,3222,3,Business,22,2,50285,22,2,50357,22,2,51194,22,2,51602,22,2,53175,8,25.8,-1.2551895,36.7822034,-1.295156,36.8094306,607,1573,72,1245
6410,27487,3239,3,Personal,24,1,38306,24,1,38373,24,1,38705,24,1,39209,24,1,40094,14,22.9,-1.2836832,36.8306719,-1.2124619,36.8739332,237,885,67,836
6411,15324,2523,3,Business,24,5,35307,24,5,35325,24,5,35416,24,5,36611,24,5,37310,5,18.3,-1.2551895,36.7822034,-1.2731645,36.7900343,438,699,18,1286
6412,16510,3530,1,Personal,5,4,37891,5,4,43647,5,4,43875,5,4,45379,5,4,48178,28,23.25888921888938,-1.2143842,36.8122348,-1.3169591,36.7000029,103,2799,5756,1732
6413,27483,496,3,Business,2,4,42619,2,4,42647,2,4,42713,2,4,43130,2,4,45327,23,23.25888921888938,-1.2551895,36.7822034,-1.374163,36.913444,695,2197,28,483
6414,1462,1544,3,Business,13,4,46886,13,4,47286,13,4,48425,13,4,48665,13,4,50431,8,22.0,-1.2851603,36.8249667,-1.284382,36.7746045,491,1766,400,1379
6415,25859,1500,3,Business,29,3,36128,29,3,36206,29,3,36218,29,3,39400,29,3,39455,10,23.25888921888938,-1.2991441,36.7528804,-1.2638185,36.7930057,855,55,78,3194
6416,10444,1799,1,Personal,29,2,54962,29,2,54983,29,2,55826,29,2,56378,29,2,57106,7,23.6,-1.2566078,36.7832089,-1.2658315,36.809049,259,728,21,1395
6417,25158,631,1,Personal,27,3,36756,27,3,37909,27,3,39616,27,3,39831,27,3,42791,19,23.25888921888938,-1.2247704,36.878967,-1.3225157,36.8262411,812,2960,1153,1922
6418,807,393,3,Business,22,5,49367,22,5,49378,22,5,49502,22,5,49919,22,5,50518,4,27.5,-1.3167113,36.8301563,-1.3004062,36.829741,842,599,11,541
6419,4714,3283,3,Business,30,6,43403,30,6,43447,30,6,44157,30,6,46659,30,6,48002,10,26.4,-1.307143,36.825009,-1.2628473,36.781805,349,1343,44,3212
6420,20382,29,3,Personal,25,6,39619,25,6,39619,25,6,40081,25,6,40609,25,6,42932,24,23.25888921888938,-1.2852951,36.8133853,-1.2636813,36.6690254,206,2323,0,990
6421,10476,3625,1,Personal,27,3,41326,27,3,41458,27,3,42905,27,3,43493,27,3,47250,16,23.25888921888938,-1.2725144,36.8272178,-1.356804,36.746196,159,3757,132,2035
6422,2373,393,3,Business,20,3,50712,20,3,57742,20,3,58301,20,3,59297,20,3,60478,7,23.4,-1.3122474,36.8728544,-1.3177547,36.8303703,445,1181,7030,1555
6423,12070,2718,3,Business,27,5,36523,27,5,36579,27,5,36890,27,5,38130,27,5,38431,5,22.4,-1.2601,36.796528,-1.272962,36.80882,116,301,56,1551
6424,18313,2330,3,Business,29,3,53727,29,3,56104,29,3,57153,29,3,58586,29,3,59929,10,20.9,-1.2524916,36.8656196,-1.2642903,36.8002137,576,1343,2377,2482
6425,4455,2873,1,Personal,26,6,73121,26,6,73137,26,6,73391,26,6,74973,26,6,76137,9,18.4,-1.2808006,36.8327169,-1.2872411,36.7745778,654,1164,16,1836
6426,14542,1899,3,Business,25,3,48894,25,3,48920,25,3,49097,25,3,50261,25,3,51626,13,17.6,-1.303596,36.778378,-1.331619,36.847976,937,1365,26,1341
6427,4367,1966,3,Business,20,1,42104,20,1,42216,20,1,44376,20,1,46342,20,1,48196,21,23.25888921888938,-1.3700383,36.9190174,-1.2917868,36.7872675,863,1854,112,4126
6428,4427,475,3,Business,21,1,53535,21,1,53686,21,1,54695,21,1,54787,21,1,56363,9,21.8,-1.2626906,36.7827022,-1.2983462,36.8139996,761,1576,151,1101
6429,8297,391,3,Business,3,3,41881,3,3,41933,3,3,43417,3,3,43778,3,3,47033,2,27.3,-1.2784063,36.8222933,-1.2870774,36.8259832,204,3255,52,1845
6430,8713,2313,2,Personal,28,5,59366,28,5,59392,28,5,59984,28,5,60169,28,5,61313,12,23.25888921888938,-1.2736442,36.8149232,-1.2238103,36.8772588,754,1144,26,777
6431,20367,3294,1,Personal,3,2,38137,3,2,39102,3,2,39574,3,2,39790,3,2,41475,7,18.3,-1.265432,36.795034,-1.2985749,36.8088,912,1685,965,688
6432,9640,1146,3,Business,28,4,49614,28,4,49714,28,4,50142,28,4,51798,28,4,52652,5,29.9,-1.3004062,36.829741,-1.3083266,36.8494756,85,854,100,2084
6433,11133,3506,1,Personal,29,5,55509,29,5,56170,29,5,57102,29,5,57207,29,5,58551,16,21.2,-1.3052672,36.7538539,-1.329568,36.8520825,312,1344,661,1037
6434,22088,181,2,Personal,12,5,28360,12,5,28401,12,5,29101,12,5,29175,12,5,30353,9,18.8,-1.2564152,36.7792803,-1.2392628,36.7661643,453,1178,41,774
6435,8547,1315,1,Personal,18,4,43516,18,4,43974,18,4,45213,18,4,45396,18,4,47415,18,25.6,-1.3138208,36.91437,-1.2802618,36.8191684,213,2019,458,1422
6436,7195,1245,3,Business,9,3,47039,9,3,47089,9,3,47811,9,3,50679,9,3,52380,19,25.4,-1.300921,36.828195,-1.3198615,36.7110323,622,1701,50,3590
6437,1240,655,1,Personal,17,3,46166,17,3,46206,17,3,46327,17,3,46654,17,3,47465,4,25.2,-1.2860785,36.8107713,-1.2836827,36.7988758,754,811,40,448
6438,7025,3203,3,Business,16,1,39380,16,1,39397,16,1,40591,16,1,41094,16,1,42284,12,19.2,-1.2600926,36.8088685,-1.228911,36.881876,116,1190,17,1697
6439,2178,2649,3,Business,3,1,43034,3,1,43096,3,1,43748,3,1,43942,3,1,45562,13,21.5,-1.2752846,36.8027022,-1.2030691,36.8394744,706,1620,62,846
6440,3946,3420,3,Business,8,2,53519,8,2,53711,8,2,54188,8,2,54431,8,2,55283,6,25.3,-1.3046007,36.8211743,-1.265981,36.7936121,848,852,192,720
6441,22447,1502,3,Business,15,5,48626,15,5,48658,15,5,49423,15,5,50176,15,5,51875,12,27.9,-1.2765736,36.8513646,-1.2232123,36.8932547,339,1699,32,1518
6442,22536,1384,3,Business,9,2,60746,9,2,60756,9,2,61609,9,2,61955,9,2,63557,13,28.0,-1.2517448,36.7924971,-1.2518265,36.8697426,89,1602,10,1199
6443,20452,1850,3,Business,10,1,51719,10,1,52117,10,1,52522,10,1,55280,10,1,56082,7,18.5,-1.2571472,36.7950633,-1.3047132,36.8089553,24,802,398,3163
6444,21304,1724,3,Business,28,4,61006,28,4,61099,28,4,61657,28,4,61802,28,4,63111,8,23.25888921888938,-1.2915307,36.7905865,-1.2551895,36.7822034,449,1309,93,703
6445,3965,186,3,Business,1,5,56798,1,5,56904,1,5,56935,1,5,57808,1,5,58394,4,28.6,-1.2571472,36.7950633,-1.2825816,36.8092346,81,586,106,904
6446,15193,3186,3,Business,15,3,58268,15,3,58305,15,3,58942,15,3,59045,15,3,61734,14,26.0,-1.2980229,36.78865,-1.3250048,36.8697188,158,2689,37,740
6447,4266,2801,3,Business,8,3,46400,8,3,46413,8,3,46864,8,3,47318,8,3,48033,3,23.25888921888938,-1.2674274,36.7870827,-1.2566586,36.7929682,815,715,13,905
6448,11226,171,3,Business,31,5,48700,31,5,48741,31,5,49427,31,5,49866,31,5,51866,2,19.9,-1.296797,36.7764525,-1.297365,36.785936,812,2000,41,1125
6449,21766,2183,3,Business,9,3,37149,9,3,37221,9,3,38206,9,3,38400,9,3,41111,20,25.1,-1.3138692,36.9096906,-1.2584143,36.8048002,418,2711,72,1179
6450,15529,2200,3,Business,2,5,36642,2,5,38763,2,5,38784,2,5,43371,2,5,44609,6,23.5,-1.260232,36.807334,-1.290894,36.822971,785,1238,2121,4608
6451,20619,1484,3,Business,7,4,49137,7,4,49301,7,4,49602,7,4,51413,7,4,51890,6,27.9,-1.2571472,36.7950633,-1.2824911,36.8218042,26,477,164,2112
6452,24778,3283,3,Business,20,3,34623,20,3,34658,20,3,34876,20,3,35031,20,3,35768,4,20.8,-1.266837,36.799249,-1.2628473,36.781805,216,737,35,373
6453,3830,246,3,Business,4,1,30585,4,1,30727,4,1,33695,4,1,34242,4,1,35267,10,18.0,-1.2584143,36.8048002,-1.2413316,36.8785525,906,1025,142,3515
6454,15310,1527,3,Business,10,3,34174,10,3,34211,10,3,34365,10,3,34854,10,3,36000,9,21.9,-1.2638185,36.7930057,-1.3004062,36.829741,394,1146,37,643
6455,10879,2987,3,Business,28,1,57397,28,1,58589,28,1,59214,28,1,59694,28,1,60801,10,22.6,-1.270212,36.8210877,-1.3018758,36.7590863,919,1107,1192,1105
6456,4373,2691,3,Business,4,1,41346,4,1,41368,4,1,41963,4,1,42190,4,1,44916,21,25.5,-1.2551895,36.7822034,-1.3705766,36.9120742,498,2726,22,822
6457,6590,2330,3,Business,4,2,63023,4,2,66024,4,2,66332,4,2,66673,4,2,67993,9,22.6,-1.2645318,36.7981775,-1.2124582,36.802894,564,1320,3001,649
6458,6872,3300,3,Business,12,3,41521,12,3,41929,12,3,42891,12,3,43098,12,3,44393,7,19.4,-1.2628473,36.781805,-1.303596,36.778378,582,1295,408,1169
6459,3823,868,3,Business,23,5,51459,23,5,51585,23,5,52156,23,5,52912,23,5,53628,5,26.2,-1.2600926,36.8088685,-1.265715,36.823815,547,716,126,1327
6460,14230,517,3,Business,3,1,45609,3,1,45786,3,1,45806,3,1,47702,3,1,47705,11,21.7,-1.3228003,36.8306435,-1.2638185,36.7930057,855,3,177,1916
6461,1474,3149,3,Business,23,3,48214,23,3,48385,23,3,48389,23,3,51536,23,3,51538,5,27.3,-1.3004062,36.829741,-1.3167113,36.8301563,39,2,171,3151
6462,12597,649,3,Business,24,5,40872,24,5,40905,24,5,43816,24,5,44325,24,5,46876,16,20.9,-1.3332749,36.8708147,-1.2551895,36.7822034,268,2551,33,3420
6463,18574,3201,3,Business,12,4,41830,12,4,41854,12,4,41902,12,4,44696,12,4,44710,1,19.1,-1.2536042,36.8064895,-1.2649605,36.7981777,51,14,24,2842
6464,9487,393,3,Business,17,3,53672,17,3,53696,17,3,53702,17,3,57325,17,3,57329,4,23.25888921888938,-1.3167113,36.8301563,-1.3004062,36.829741,515,4,24,3629
6465,18885,2748,1,Personal,5,6,39678,5,6,39745,5,6,40912,5,6,41010,5,6,42333,9,22.4,-1.269103,36.8223998,-1.2743743,36.7657321,762,1323,67,1265
6466,23797,1500,3,Business,20,4,31358,20,4,37207,20,4,37214,20,4,38230,20,4,39416,11,22.1,-1.3077869,36.8443207,-1.2574219,36.7927073,39,1186,5849,1023
6467,14473,3701,3,Business,4,2,57997,4,2,58187,4,2,59271,4,2,60167,4,2,61448,8,22.4,-1.301735,36.761081,-1.2684239,36.7952462,612,1281,190,1980
6468,23095,1828,1,Personal,26,4,41538,26,4,41544,26,4,41618,26,4,42169,26,4,42776,3,19.1,-1.2538731,36.7850223,-1.263419,36.8060348,379,607,6,625
6469,23406,2066,3,Business,2,5,47796,2,5,48731,2,5,50219,2,5,50351,2,5,51655,11,25.0,-1.316961,36.820337,-1.2463211,36.789487,237,1304,935,1620
6470,3362,673,2,Personal,30,4,53020,30,4,53229,30,4,54373,30,4,54776,30,4,55628,4,20.8,-1.2854453,36.8188363,-1.2684667,36.8002891,447,852,209,1547
6471,6977,1856,3,Business,20,4,46320,20,4,46347,20,4,48313,20,4,48793,20,4,50217,5,28.0,-1.273009,36.802807,-1.2918698,36.7701974,857,1424,27,2446
6472,19491,2521,3,Business,25,1,54559,25,1,54659,25,1,56335,25,1,60522,25,1,61247,4,27.3,-1.3167113,36.8301563,-1.3004062,36.829741,328,725,100,5863
6473,14411,3201,3,Business,2,2,45297,2,2,46521,2,2,47281,2,2,47981,2,2,48947,6,20.8,-1.2891922,36.825189,-1.2649605,36.7981777,532,966,1224,1460
6474,3421,343,3,Personal,3,4,34084,3,4,34096,3,4,34833,3,4,35027,3,4,36207,13,20.5,-1.1855066,36.8254646,-1.267224,36.8442033,932,1180,12,931
6475,28231,496,3,Business,15,5,46298,15,5,46328,15,5,46553,15,5,46823,15,5,48953,14,26.0,-1.2551895,36.7822034,-1.323481,36.7928406,709,2130,30,495
6476,3468,3491,3,Business,31,3,39505,31,3,40919,31,3,42346,31,3,42730,31,3,44200,10,24.7,-1.275931,36.8516227,-1.2297202,36.8819507,237,1470,1414,1811
6477,12914,640,3,Business,12,5,44050,12,5,44098,12,5,44375,12,5,44517,12,5,45266,6,24.5,-1.304033,36.7848695,-1.2962731,36.8111863,932,749,48,419
6478,27814,136,3,Business,3,1,43364,3,1,43397,3,1,44661,3,1,44771,3,1,45817,3,22.1,-1.3326173,36.7146233,-1.3169591,36.7000029,457,1046,33,1374
6479,5810,622,1,Business,8,5,45399,8,5,47993,8,5,49033,8,5,49855,8,5,50583,6,21.3,-1.29237,36.8241297,-1.2951362,36.7876989,549,728,2594,1862
6480,21403,3107,3,Business,7,2,52901,7,2,53941,7,2,54185,7,2,55141,7,2,56364,12,24.6,-1.2930128,36.8356869,-1.3191788,36.8895401,449,1223,1040,1200
6481,809,816,3,Business,17,4,40062,17,4,40120,17,4,40928,17,4,42954,17,4,44661,6,25.2,-1.2571472,36.7950633,-1.290894,36.822971,358,1707,58,2834
6482,19679,3339,3,Business,14,1,43977,14,1,44026,14,1,44511,14,1,44606,14,1,45611,5,23.1,-1.255956,36.789867,-1.2738187,36.7879151,875,1005,49,580
6483,6766,2804,3,Business,15,2,47678,15,2,47685,15,2,47748,15,2,47823,15,2,49443,19,24.5,-1.2551895,36.7822034,-1.2927792,36.9053492,903,1620,7,138
6484,27973,1918,1,Personal,27,4,41745,27,4,41762,27,4,41784,27,4,42929,27,4,42935,2,22.6,-1.253332,36.80636,-1.2707373,36.805441,51,6,17,1167
6485,2807,1245,3,Business,20,4,51159,20,4,53733,20,4,55476,20,4,57949,20,4,59828,20,25.3,-1.300921,36.828195,-1.3494207,36.7025413,456,1879,2574,4216
6486,8865,3283,3,Business,8,1,43113,8,1,44464,8,1,44965,8,1,45239,8,1,46386,13,27.9,-1.2296618,36.8438272,-1.2628473,36.781805,8,1147,1351,775
6487,9175,1719,3,Business,20,3,40163,20,3,40193,20,3,40432,20,3,40742,20,3,41172,3,27.1,-1.2975066,36.7689423,-1.2962832,36.7849683,816,430,30,549
6488,16053,2847,3,Personal,25,6,58408,25,6,58423,25,6,59880,25,6,59959,25,6,61518,13,23.25888921888938,-1.2822773,36.7953121,-1.2311903,36.8102105,400,1559,15,1536
6489,21091,136,3,Business,23,6,43137,23,6,43177,23,6,44137,23,6,44400,23,6,47379,16,23.25888921888938,-1.3254522,36.7216584,-1.2768129,36.8174464,831,2979,40,1223
6490,7932,3557,3,Business,12,2,48189,12,2,48215,12,2,48585,12,2,48875,12,2,49417,1,23.25888921888938,-1.2583017,36.8023526,-1.2546732,36.8086796,660,542,26,660
6491,24239,3689,3,Business,31,3,31488,31,3,31566,31,3,33592,31,3,34068,31,3,35726,9,19.3,-1.2765736,36.8513646,-1.2527958,36.8003131,817,1658,78,2502
6492,5503,2335,3,Business,8,4,37718,8,4,38321,8,4,42393,8,4,42818,8,4,45495,8,26.2,-1.2551895,36.7822034,-1.290894,36.822971,187,2677,603,4497
6493,27084,3091,3,Business,27,2,38794,27,2,38849,27,2,39757,27,2,40228,27,2,42252,14,23.7,-1.2634438,36.8487697,-1.3012008,36.764868,775,2024,55,1379
6494,4745,3214,3,Business,26,2,42423,26,2,42465,26,2,43115,26,2,43434,26,2,46624,21,26.3,-1.289795,36.7957132,-1.3190102,36.9230693,837,3190,42,969
6495,22099,1148,3,Business,8,4,47514,8,4,47637,8,4,48877,8,4,49205,8,4,50661,9,27.3,-1.3100586,36.8500329,-1.2764099,36.8208451,810,1456,123,1568
6496,14412,3149,3,Business,28,5,55211,28,5,55393,28,5,56813,28,5,58793,28,5,58815,5,25.5,-1.3004062,36.829741,-1.3228003,36.8306435,829,22,182,3400
6497,22218,3247,3,Business,17,4,53681,17,4,56147,17,4,57306,17,4,57457,17,4,59383,5,28.0,-1.2571472,36.7950633,-1.2790098,36.8270106,899,1926,2466,1310
6498,28127,3698,3,Business,29,3,35952,29,3,36009,29,3,36722,29,3,37309,29,3,39329,20,18.0,-1.34364,36.8925345,-1.3107918,36.761794,690,2020,57,1300
6499,17563,1354,1,Personal,28,5,40945,28,5,41224,28,5,41902,28,5,42310,28,5,43607,9,25.1,-1.2349281,36.809878,-1.2551895,36.7822034,96,1297,279,1086
6500,5707,1471,3,Business,27,3,47543,27,3,47567,27,3,48533,27,3,49547,27,3,50218,3,23.25888921888938,-1.2551895,36.7822034,-1.2655477,36.8001682,259,671,24,1980
6501,10694,1500,3,Business,23,2,58290,23,2,59662,23,2,60053,23,2,60487,23,2,61746,8,23.25888921888938,-1.3004062,36.829741,-1.2638185,36.7930057,206,1259,1372,825
6502,27415,517,3,Business,4,5,30265,4,5,30430,4,5,30691,4,5,30791,4,5,31791,11,17.6,-1.3167113,36.8301563,-1.2574219,36.7927073,523,1000,165,361
6503,25802,302,3,Business,17,1,68535,17,1,69115,17,1,71957,17,1,72159,17,1,72912,6,19.0,-1.2649605,36.7981777,-1.2624807,36.8368896,178,753,580,3044
6504,11125,246,3,Business,6,3,70091,6,3,70110,6,3,70118,6,3,70186,6,3,70421,2,19.9,-1.2601709,36.8002238,-1.2584143,36.8048002,103,235,19,76
6505,27747,3283,3,Business,15,5,37304,15,5,37332,15,5,37830,15,5,39770,15,5,40965,7,25.9,-1.303596,36.778378,-1.2628473,36.781805,210,1195,28,2438
6506,22613,1796,3,Business,5,2,48325,5,2,48414,5,2,49601,5,2,50229,5,2,52459,15,27.6,-1.2628473,36.781805,-1.331619,36.847976,812,2230,89,1815
6507,512,1023,3,Personal,11,6,55825,11,6,55841,11,6,56300,11,6,56518,11,6,57008,3,21.6,-1.3039695,36.7838267,-1.2873232,36.7658572,45,490,16,677
6508,10831,1500,3,Business,2,3,46575,2,3,46753,2,3,47169,2,3,47501,2,3,48555,8,24.1,-1.3004062,36.829741,-1.2574219,36.7927073,518,1054,178,748
6509,7214,2330,3,Business,24,3,52867,24,3,52894,24,3,52901,24,3,54697,24,3,54702,7,23.25888921888938,-1.293082,36.8278578,-1.2536275,36.7987932,613,5,27,1803
6510,25559,739,1,Personal,17,3,53396,17,3,53422,17,3,54353,17,3,54867,17,3,58616,25,28.3,-1.207546,36.7913976,-1.3291184,36.7892374,299,3749,26,1445
6511,11586,972,3,Business,22,1,53597,22,1,54599,22,1,55280,22,1,55378,22,1,56178,6,26.2,-1.2862033,36.8152966,-1.2528485,36.7953722,343,800,1002,779
6512,16440,2978,3,Business,12,1,37406,12,1,37410,12,1,37788,12,1,38161,12,1,38716,3,23.6,-1.2527958,36.8003131,-1.2551895,36.7822034,620,555,4,751
6513,4307,246,3,Business,16,5,52527,16,5,52534,16,5,52864,16,5,53251,16,5,55902,15,23.25888921888938,-1.2232123,36.8932547,-1.2584143,36.8048002,62,2651,7,717
6514,2315,2896,3,Business,26,1,36480,26,1,36493,26,1,37496,26,1,37786,26,1,40855,13,17.8,-1.3338005,36.863026,-1.2776707,36.820777,114,3069,13,1293
6515,10603,3686,3,Business,13,4,57117,13,4,57181,13,4,57564,13,4,57967,13,4,58853,6,23.3,-1.2551895,36.7822034,-1.2765641,36.793782,538,886,64,786
6516,18177,3599,3,Business,14,5,35007,14,5,40732,14,5,42149,14,5,42270,14,5,44284,8,21.3,-1.2914687,36.7692172,-1.25789,36.79268,470,2014,5725,1538
6517,10163,899,1,Personal,6,6,47382,6,6,47515,6,6,47725,6,6,47999,6,6,48893,9,24.2,-1.2854453,36.8188363,-1.3213011,36.860956,216,894,133,484
6518,19109,1974,3,Personal,17,5,47302,17,5,47379,17,5,47876,17,5,48602,17,5,50085,5,23.25888921888938,-1.2854989,36.8218183,-1.3013102,36.7963702,768,1483,77,1223
6519,22654,1081,3,Business,5,2,53787,5,2,53969,5,2,54577,5,2,55180,5,2,59193,9,27.3,-1.290894,36.822971,-1.3025826,36.7670807,210,4013,182,1211
6520,13222,718,3,Business,21,4,58537,21,4,58571,21,4,58833,21,4,59550,21,4,62658,11,20.0,-1.2551895,36.7822034,-1.303558,36.775613,574,3108,34,979
6521,26837,2546,1,Personal,1,1,42826,1,1,43254,1,1,45775,1,1,45917,1,1,46625,4,24.1,-1.2970553,36.8010921,-1.2902552,36.8179349,88,708,428,2663
6522,2015,1329,3,Business,19,2,32921,19,2,34661,19,2,35491,19,2,35568,19,2,36997,6,23.25888921888938,-1.273056,36.811298,-1.2926564,36.7873181,660,1429,1740,907
6523,6132,868,3,Business,15,3,43120,15,3,45155,15,3,47042,15,3,47962,15,3,52137,9,23.25888921888938,-1.331619,36.847976,-1.265715,36.823815,292,4175,2035,2807
6524,25943,1918,1,Personal,27,4,38363,27,4,38394,27,4,38875,27,4,38999,27,4,39742,2,23.0,-1.253332,36.80636,-1.2572708,36.8124194,795,743,31,605
6525,12897,2627,3,Business,12,3,50821,12,3,50958,12,3,51376,12,3,51756,12,3,53456,8,21.1,-1.2571472,36.7950633,-1.3080696,36.8237191,709,1700,137,798
6526,14303,3471,2,Personal,23,6,42483,23,6,42815,23,6,44073,23,6,44962,23,6,45915,6,23.25888921888938,-1.2873639,36.8256076,-1.2745187,36.7876436,581,953,332,2147
6527,27270,2627,3,Business,15,5,43444,15,5,43539,15,5,44578,15,5,46143,15,5,51182,9,26.5,-1.2813012,36.8323962,-1.2571472,36.7950633,268,5039,95,2604
6528,16994,2748,1,Personal,4,1,61938,4,1,63675,4,1,64870,4,1,65014,4,1,66436,8,20.8,-1.269103,36.8223998,-1.2740995,36.7676788,192,1422,1737,1339
6529,7019,3686,3,Business,3,2,47946,3,2,47983,3,2,48063,3,2,48806,3,2,49782,4,20.2,-1.2551895,36.7822034,-1.2690931,36.8065779,449,976,37,823
6530,22855,718,3,Business,3,5,57950,3,5,58086,3,5,58593,3,5,58798,3,5,59842,4,23.25888921888938,-1.2551895,36.7822034,-1.2707177,36.8009828,933,1044,136,712
6531,25424,868,3,Business,11,2,35650,11,2,35701,11,2,37569,11,2,38234,11,2,38921,7,19.4,-1.2628473,36.781805,-1.2663631,36.8163329,570,687,51,2533
6532,25979,136,3,Business,2,2,39797,2,2,40127,2,2,40582,2,2,40718,2,2,42643,20,26.1,-1.3254522,36.7216584,-1.2352013,36.7776638,205,1925,330,591
6533,27382,391,3,Business,16,6,36601,16,6,36703,16,6,37375,16,6,38182,16,6,38976,5,25.5,-1.300921,36.828195,-1.3292148,36.8474803,576,794,102,1479
6534,25734,3621,3,Business,20,6,36011,20,6,36029,20,6,36873,20,6,38854,20,6,38858,12,23.25888921888938,-1.2836583,36.7886014,-1.2423902,36.8554947,613,4,18,2825
6535,27179,2605,3,Business,10,2,43757,10,2,43856,10,2,43867,10,2,45723,10,2,48035,21,20.4,-1.3562374,36.9042954,-1.2551895,36.7822034,397,2312,99,1867
6536,11053,1850,3,Business,25,4,51229,25,4,51274,25,4,51279,25,4,51682,25,4,52749,8,23.25888921888938,-1.2551895,36.7822034,-1.298744,36.8178237,576,1067,45,408
6537,4858,3222,3,Business,5,5,55662,5,5,55729,5,5,56142,5,5,56296,5,5,57182,4,27.6,-1.2551895,36.7822034,-1.272798,36.8124195,682,886,67,567
6538,8959,1874,3,Business,5,2,35112,5,2,35475,5,2,36517,5,2,36964,5,2,38356,5,21.1,-1.286553,36.8273374,-1.2571472,36.7950633,885,1392,363,1489
6539,14060,3002,1,Personal,11,3,41292,11,3,41316,11,3,41323,11,3,42129,11,3,43229,9,19.0,-1.2528485,36.7953722,-1.2846195,36.7958316,546,1100,24,813
6540,24850,1677,3,Personal,20,1,34584,20,1,34668,20,1,37088,20,1,37637,20,1,39488,14,19.2,-1.23966,36.75258,-1.2963097,36.7688221,876,1851,84,2969
6541,11134,2306,3,Business,12,2,34440,12,2,34492,12,2,35384,12,2,35838,12,2,38791,19,18.0,-1.2271998,36.8084905,-1.3241108,36.8692908,31,2953,52,1346
6542,16218,2174,3,Business,21,4,43611,21,4,43620,21,4,43624,21,4,46676,21,4,49554,29,28.2,-1.2482781,36.884092,-1.392756,36.7495015,86,2878,9,3056
6543,10611,1075,3,Business,26,2,36933,26,2,37080,26,2,38680,26,2,42284,26,2,43061,6,27.4,-1.2904016,36.8226303,-1.2527958,36.8003131,953,777,147,5204
6544,16260,2989,3,Business,29,6,54304,29,6,54327,29,6,54913,29,6,55153,29,6,57063,15,26.5,-1.2584143,36.8048002,-1.3472066,36.7692638,208,1910,23,826
6545,10971,248,3,Business,20,1,48671,20,1,48698,20,1,49500,20,1,49729,20,1,51553,8,23.25888921888938,-1.304735,36.7846054,-1.2635089,36.7887337,177,1824,27,1031
6546,17845,2532,3,Business,21,4,49466,21,4,49499,21,4,49566,21,4,51786,21,4,53232,7,31.2,-1.2571472,36.7950633,-1.2821378,36.7740428,779,1446,33,2287
6547,5866,3264,3,Business,14,2,39089,14,2,39127,14,2,40084,14,2,40166,14,2,41203,3,23.25888921888938,-1.2551895,36.7822034,-1.259919,36.808244,362,1037,38,1039
6548,7755,238,3,Business,13,3,42233,13,3,42264,13,3,42587,13,3,42676,13,3,44351,15,23.25888921888938,-1.3077869,36.8443207,-1.362953,36.904214,168,1675,31,412
6549,17308,553,3,Business,23,2,53061,23,2,54477,23,2,56082,23,2,56925,23,2,59275,23,19.2,-1.3632162,36.9108253,-1.2551895,36.7822034,222,2350,1416,2448
6550,4149,2862,1,Personal,14,7,48486,14,7,49416,14,7,50603,14,7,51054,14,7,52206,9,28.8,-1.2868838,36.8284259,-1.331602,36.7853915,956,1152,930,1638
6551,22860,2150,3,Business,19,2,38520,19,2,38545,19,2,38814,19,2,39688,19,2,40803,14,27.5,-1.303596,36.778378,-1.344446,36.756597,327,1115,25,1143
6552,3208,794,2,Personal,16,6,33995,16,6,34188,16,6,34218,16,6,34482,16,6,34844,4,15.5,-1.2629944,36.7998816,-1.2811695,36.8200313,379,362,193,294
6553,13583,2066,3,Business,12,6,47078,12,6,47102,12,6,48018,12,6,48517,12,6,49505,8,22.9,-1.316961,36.820337,-1.264865,36.810488,103,988,24,1415
6554,11875,1758,1,Personal,17,5,70443,17,5,70489,17,5,70521,17,5,71908,17,5,73167,9,16.8,-1.280753,36.8191175,-1.2387846,36.7901393,229,1259,46,1419
6555,11027,3091,3,Business,3,1,48034,3,1,48284,3,1,49446,3,1,51437,3,1,51443,6,23.1,-1.290894,36.822971,-1.30435,36.86001,921,6,250,3153
6556,318,2900,3,Business,19,1,45868,19,1,46869,19,1,47498,19,1,48297,19,1,50690,10,24.9,-1.295324,36.839629,-1.2963097,36.7688221,848,2393,1001,1428
6557,4827,3213,1,Personal,30,4,45105,30,4,45120,30,4,45970,30,4,46223,30,4,48490,13,20.1,-1.3007534,36.7964576,-1.3413428,36.7022135,249,2267,15,1103
6558,9741,521,1,Personal,29,7,48817,29,7,48847,29,7,49604,29,7,49896,29,7,51265,9,23.1,-1.257585,36.79986,-1.2884344,36.7605699,858,1369,30,1049
6559,19081,1271,3,Business,1,3,43560,1,3,43567,1,3,43911,1,3,45039,1,3,48606,13,19.7,-1.3107918,36.761794,-1.307241,36.8302368,216,3567,7,1472
6560,14808,2290,3,Business,19,3,52488,19,3,52497,19,3,53019,19,3,53760,19,3,56043,18,25.7,-1.2615888,36.7928732,-1.338283,36.8871775,38,2283,9,1263
6561,2267,1345,2,Personal,7,2,37204,7,2,37218,7,2,37487,7,2,37675,7,2,40034,15,16.7,-1.311943,36.8331134,-1.225233,36.796891,16,2359,14,457
6562,19754,302,3,Business,1,1,47769,1,1,47789,1,1,47838,1,1,49533,1,1,49567,1,25.7,-1.2649605,36.7981777,-1.256098,36.800655,647,34,20,1744
6563,16677,3621,3,Business,14,1,42560,14,1,42721,14,1,43353,14,1,43568,14,1,44987,10,23.1,-1.2836583,36.7886014,-1.2698168,36.7421898,919,1419,161,847
6564,16162,1271,3,Business,5,5,53969,5,5,54025,5,5,56803,5,5,57572,5,5,61981,20,27.4,-1.3107918,36.761794,-1.2702844,36.8803209,435,4409,56,3547
6565,21852,393,3,Business,17,5,40286,17,5,40517,17,5,41357,17,5,41615,17,5,44171,11,23.25888921888938,-1.3167113,36.8301563,-1.2638185,36.7930057,328,2556,231,1098
6566,20425,540,3,Business,14,5,55141,14,5,55188,14,5,55752,14,5,56343,14,5,58334,4,23.6,-1.2551895,36.7822034,-1.2753109,36.8130185,50,1991,47,1155
6567,22065,393,3,Business,14,4,32194,14,4,32218,14,4,32868,14,4,33442,14,4,34982,4,19.0,-1.3167113,36.8301563,-1.3004062,36.829741,349,1540,24,1224
6568,1839,1346,3,Business,11,2,46486,11,2,46525,11,2,47145,11,2,47278,11,2,47873,2,19.2,-1.2917868,36.7872675,-1.2985749,36.8088,356,595,39,753
6569,9690,3194,3,Business,15,4,43211,15,4,43222,15,4,45346,15,4,46089,15,4,47493,17,24.3,-1.2859912,36.8756811,-1.2551895,36.7822034,589,1404,11,2867
6570,23874,391,3,Business,30,6,39000,30,6,39065,30,6,39987,30,6,41884,30,6,42937,5,22.1,-1.3010429,36.8353335,-1.2777924,36.8231577,752,1053,65,2819
6571,19397,1642,3,Business,26,5,36821,26,5,36850,26,5,37518,26,5,38437,26,5,40719,16,23.25888921888938,-1.2726506,36.7960153,-1.2046998,36.7839931,306,2282,29,1587
6572,23865,1500,3,Business,18,1,35182,18,1,35330,18,1,35871,18,1,36965,18,1,38578,8,22.2,-1.3004062,36.829741,-1.2638185,36.7930057,311,1613,148,1635
6573,24150,1038,1,Business,13,5,32685,13,5,32782,13,5,33878,13,5,33948,13,5,36104,8,15.6,-1.3099145,36.8022774,-1.326774,36.7878069,465,2156,97,1166
6574,7617,661,3,Business,15,3,43347,15,3,43379,15,3,43980,15,3,45763,15,3,48361,13,18.3,-1.2963097,36.7688221,-1.3299358,36.8524971,140,2598,32,2384
6575,9541,1071,1,Personal,19,4,33081,19,4,33153,19,4,34707,19,4,35972,19,4,37562,11,14.5,-1.3301743,36.8487987,-1.2689015,36.7986106,208,1590,72,2819
6576,10485,1342,3,Business,5,5,38618,5,5,38636,5,5,38984,5,5,39510,5,5,40324,3,23.8,-1.3025826,36.7670807,-1.2765492,36.7669809,565,814,18,874
6577,6117,928,3,Business,30,2,49132,30,2,49838,30,2,51195,30,2,52459,30,2,58100,12,23.25888921888938,-1.2551895,36.7822034,-1.2632236,36.8712896,178,5641,706,2621
6578,11849,1865,1,Personal,14,5,33244,14,5,33265,14,5,34035,14,5,34874,14,5,36376,13,18.4,-1.275931,36.8516227,-1.2166078,36.882501,467,1502,21,1609
6579,10802,805,3,Personal,23,3,34600,23,3,34618,23,3,34991,23,3,35274,23,3,36850,15,23.25888921888938,-1.3088044,36.8106447,-1.398531,36.767365,355,1576,18,656
6580,24529,867,3,Business,22,5,43975,22,5,44106,22,5,44701,22,5,45316,22,5,47229,10,28.6,-1.2996533,36.8292629,-1.2991441,36.7528804,349,1913,131,1210
6581,12009,1245,3,Business,17,3,53008,17,3,53019,17,3,53197,17,3,55820,17,3,57516,10,28.5,-1.300921,36.828195,-1.3455099,36.7682757,662,1696,11,2801
6582,25938,635,3,Business,14,6,38247,14,6,38303,14,6,38846,14,6,39451,14,6,40328,8,17.7,-1.3016417,36.8271679,-1.2599563,36.7993439,427,877,56,1148
6583,2954,136,3,Business,3,1,55360,3,1,55524,3,1,56225,3,1,56696,3,1,57602,4,23.1,-1.2965045,36.7913036,-1.2950408,36.8098172,177,906,164,1172
6584,20674,633,3,Business,24,4,48881,24,4,49220,24,4,50119,24,4,50239,24,4,50898,5,28.1,-1.2770708,36.8231093,-1.3004062,36.829741,576,659,339,1019
6585,25900,72,1,Personal,15,1,38945,15,1,38970,15,1,39684,15,1,39953,15,1,41028,8,23.25888921888938,-1.2901786,36.824294,-1.3227037,36.8470872,208,1075,25,983
6586,22349,3647,3,Business,17,3,45663,17,3,47182,17,3,47994,17,3,48204,17,3,49053,5,23.25888921888938,-1.272639,36.794723,-1.2858997,36.8138634,709,849,1519,1022
6587,3194,2828,3,Business,10,1,41554,10,1,45417,10,1,45875,10,1,46417,10,1,49079,12,23.6,-1.2615888,36.7928732,-1.2095044,36.7832064,268,2662,3863,1000
6588,5210,909,3,Business,16,4,56254,16,4,56754,16,4,59473,16,4,59583,16,4,61192,8,23.25888921888938,-1.225322,36.80855,-1.259697,36.800802,815,1609,500,2829
6589,3353,868,3,Business,4,4,35172,4,4,35211,4,4,35418,4,4,35903,4,4,37200,6,21.8,-1.307143,36.825009,-1.265715,36.823815,690,1297,39,692
6590,1349,2195,3,Business,17,3,44985,17,3,45031,17,3,45322,17,3,45472,17,3,49635,16,23.25888921888938,-1.2628473,36.781805,-1.228911,36.881876,695,4163,46,441
6591,1878,3404,3,Business,18,2,58290,18,2,62425,18,2,63104,18,2,63231,18,2,64673,5,23.5,-1.2765736,36.8513646,-1.279395,36.825364,178,1442,4135,806
6592,16071,1281,3,Business,20,5,39099,20,5,39124,20,5,39703,20,5,40962,20,5,42222,9,18.3,-1.2869041,36.8240057,-1.2707742,36.7578609,329,1260,25,1838
6593,19539,1432,1,Personal,24,1,40119,24,1,40136,24,1,40635,24,1,40875,24,1,41586,4,22.6,-1.2950408,36.8098172,-1.2793148,36.8148394,88,711,17,739
6594,2087,3326,3,Business,10,1,52119,10,1,52163,10,1,54728,10,1,54836,10,1,55954,8,23.25888921888938,-1.2551895,36.7822034,-1.304344,36.812274,742,1118,44,2673
6595,18455,3629,3,Personal,22,3,58696,22,3,58787,22,3,59378,22,3,59707,22,3,63914,6,23.9,-1.2852951,36.8133853,-1.2594002,36.7888767,183,4207,91,920
6596,15652,635,3,Business,31,3,39161,31,3,39203,31,3,39409,31,3,40689,31,3,41518,8,24.6,-1.3016417,36.8271679,-1.2599563,36.7993439,283,829,42,1486
6597,20679,1336,3,Business,25,5,41893,25,5,41963,25,5,42786,25,5,43401,25,5,44556,8,26.5,-1.2885029,36.825605,-1.2615888,36.7928732,336,1155,70,1438
6598,19475,1271,3,Business,26,4,40183,26,4,40224,26,4,40684,26,4,44578,26,4,46378,18,18.8,-1.2600932,36.8041689,-1.3244885,36.897792,103,1800,41,4354
6599,13439,214,1,Personal,26,3,32905,26,3,33326,26,3,34449,26,3,34910,26,3,35739,4,19.0,-1.2615584,36.8149506,-1.2633494,36.7959696,259,829,421,1584
6600,19407,2092,1,Personal,26,4,46326,26,4,46429,26,4,47769,26,4,48625,26,4,50552,20,18.8,-1.2932312,36.8976007,-1.2912918,36.758141,103,1927,103,2196
6601,22305,3496,3,Business,27,3,41041,27,3,41067,27,3,41659,27,3,41963,27,3,42591,4,26.1,-1.315163,36.814073,-1.300921,36.828195,829,628,26,896
6602,20683,1927,3,Business,19,2,32219,19,2,32237,19,2,33669,19,2,34917,19,2,37006,15,21.1,-1.2584143,36.8048002,-1.3472066,36.7692638,207,2089,18,2680
6603,1537,2394,3,Personal,13,3,67319,13,3,67394,13,3,68050,13,3,68460,13,3,70460,17,26.0,-1.2927792,36.9053492,-1.2722185,36.7922525,622,2000,75,1066
6604,13086,33,3,Personal,9,6,47457,9,6,47485,9,6,48405,9,6,48508,9,6,49521,6,24.6,-1.2814609,36.8265932,-1.3159617,36.8117934,89,1013,28,1023
6605,9474,2701,3,Business,14,1,61382,14,1,62413,14,1,62985,14,1,64038,14,1,65485,7,23.1,-1.279395,36.825364,-1.255956,36.789867,761,1447,1031,1625
6606,12099,1207,3,Business,26,5,38645,26,5,38669,26,5,39184,26,5,40153,26,5,43832,12,23.25888921888938,-1.2629666,36.8068369,-1.2351541,36.8748505,934,3679,24,1484
6607,18041,391,3,Business,22,6,48377,22,6,49569,22,6,50113,22,6,50542,22,6,52139,13,26.0,-1.2867454,36.8259017,-1.2054954,36.8985954,237,1597,1192,973
6608,20439,20,3,Business,5,3,53606,5,3,53989,5,3,55996,5,3,56718,5,3,57465,5,23.9,-1.2629666,36.8068369,-1.2881332,36.8214339,857,747,383,2729
6609,704,1500,3,Business,12,5,45644,12,5,45669,12,5,45673,12,5,47398,12,5,47469,8,26.3,-1.3004062,36.829741,-1.2638185,36.7930057,137,71,25,1729
6610,8790,2867,1,Personal,3,2,36808,3,2,38197,3,2,38631,3,2,38817,3,2,40710,4,18.3,-1.2753109,36.8130185,-1.2813849,36.8193667,726,1893,1389,620
6611,23175,2200,3,Business,29,5,44909,29,5,45255,29,5,46207,29,5,47521,29,5,49390,6,26.8,-1.2527958,36.8003131,-1.290894,36.822971,686,1869,346,2266
6612,480,3283,3,Business,2,2,38302,2,2,38317,2,2,38626,2,2,39220,2,2,39784,5,21.1,-1.2600926,36.8088685,-1.2628473,36.781805,882,564,15,903
6613,25101,3686,3,Business,11,1,37398,11,1,37419,11,1,37436,11,1,37783,11,1,38133,2,21.1,-1.2551895,36.7822034,-1.2567464,36.7915273,26,350,21,364
6614,5197,2503,2,Business,16,1,57683,16,1,57690,16,1,57977,16,1,60044,16,1,60303,3,23.25888921888938,-1.2584143,36.8048002,-1.2551895,36.7822034,116,259,7,2354
6615,27673,867,3,Business,20,2,58286,20,2,58365,20,2,58746,20,2,60104,20,2,62187,10,23.9,-1.2996533,36.8292629,-1.306378,36.7519845,640,2083,79,1739
6616,21821,635,3,Business,30,2,48807,30,2,48846,30,2,49091,30,2,53555,30,2,55041,10,23.25888921888938,-1.3081376,36.8329772,-1.2602337,36.7990548,206,1486,39,4709
6617,19581,2828,2,Business,6,5,43428,6,5,43450,6,5,44247,6,5,46068,6,5,46181,3,20.4,-1.2584143,36.8048002,-1.2615888,36.7928732,486,113,22,2618
6618,13288,1216,3,Personal,3,2,32725,3,2,32745,3,2,32857,3,2,33281,3,2,34130,8,15.1,-1.2551895,36.7822034,-1.285355,36.795287,103,849,20,536
6619,5845,3517,3,Business,2,5,58432,2,5,58457,2,5,58555,2,5,59202,2,5,61256,14,25.1,-1.319613,36.711055,-1.3882008,36.7699445,532,2054,25,745
6620,24533,2149,1,Personal,29,6,41946,29,6,41971,29,6,42072,29,6,42345,29,6,43868,5,24.8,-1.2675332,36.808561,-1.2887816,36.8088885,795,1523,25,374
6621,17820,3044,3,Business,27,3,51368,27,3,53589,27,3,56524,27,3,57427,27,3,60573,20,29.3,-1.2991441,36.7528804,-1.3228003,36.8306435,96,3146,2221,3838
6622,14382,2205,2,Personal,27,1,30823,27,1,30840,27,1,30906,27,1,31876,27,1,33725,17,16.6,-1.2697859,36.7946203,-1.2119232,36.8996459,379,1849,17,1036
6623,2781,3291,3,Business,9,4,36425,9,4,36442,9,4,38286,9,4,38666,9,4,40150,12,23.8,-1.331619,36.847976,-1.2600926,36.8088685,415,1484,17,2224
6624,364,3647,3,Business,12,2,56040,12,2,56495,12,2,58540,12,2,58855,12,2,59798,7,27.0,-1.272639,36.794723,-1.2651574,36.7474347,783,943,455,2360
6625,15806,3674,3,Business,22,3,51269,22,3,51367,22,3,52281,22,3,53173,22,3,55644,10,25.6,-1.3034175,36.7944677,-1.2551895,36.7822034,384,2471,98,1806
6626,17092,3700,3,Personal,23,7,34850,23,7,35183,23,7,37380,23,7,37485,23,7,40204,23,18.8,-1.3105877,36.817283,-1.200723,36.9219198,184,2719,333,2302
6627,132,517,3,Business,27,4,37341,27,4,37377,27,4,37382,27,4,38057,27,4,39377,14,23.0,-1.3167113,36.8301563,-1.306378,36.7519845,39,1320,36,680
6628,1619,2457,3,Business,7,3,41148,7,3,41382,7,3,41751,7,3,41950,7,3,44732,8,25.1,-1.2551895,36.7822034,-1.3038156,36.8122733,206,2782,234,568
6629,14599,196,3,Business,7,1,29682,7,1,29687,7,1,30423,7,1,30489,7,1,33080,11,21.6,-1.257569,36.842164,-1.2070019,36.78374,534,2591,5,802
6630,18811,1719,3,Business,11,1,51781,11,1,51820,11,1,52503,11,1,52734,11,1,54509,12,28.0,-1.2859206,36.7888272,-1.23966,36.75258,958,1775,39,914
6631,21317,2271,3,Business,18,6,39137,18,6,39241,18,6,39877,18,6,40355,18,6,41706,11,21.1,-1.318062,36.849326,-1.293515,36.897607,709,1351,104,1114
6632,15737,3462,1,Personal,17,1,43881,17,1,44043,17,1,44581,17,1,44761,17,1,45636,6,24.9,-1.255683,36.813771,-1.2842863,36.7951109,726,875,162,718
6633,23366,1899,3,Business,31,5,51183,31,5,51201,31,5,51601,31,5,52715,31,5,53812,11,20.2,-1.272828,36.816608,-1.331619,36.847976,116,1097,18,1514
6634,18737,1502,3,Business,16,3,47932,16,3,48138,16,3,49420,16,3,50327,16,3,52144,15,26.8,-1.225322,36.80855,-1.2232123,36.8932547,783,1817,206,2189
6635,6541,3517,3,Business,14,2,36809,14,2,36875,14,2,38507,14,2,40413,14,2,43917,6,23.25888921888938,-1.300921,36.828195,-1.2850275,36.8301566,106,3504,66,3538
6636,16845,1961,3,Business,27,6,38633,27,6,38651,27,6,40235,27,6,40504,27,6,42194,21,23.25888921888938,-1.3181159,36.7101559,-1.331619,36.847976,299,1690,18,1853
6637,15277,1363,3,Business,30,4,37691,30,4,37791,30,4,37807,30,4,38565,30,4,39313,7,23.25888921888938,-1.3004062,36.829741,-1.331619,36.847976,89,748,100,774
6638,1315,2058,1,Personal,13,3,38643,13,3,38710,13,3,39357,13,3,39563,13,3,41870,18,20.3,-1.2551895,36.7822034,-1.320819,36.8885013,791,2307,67,853
6639,5499,635,3,Business,4,1,49823,4,1,53710,4,1,54200,4,1,54905,4,1,56291,7,23.25888921888938,-1.2602337,36.7990548,-1.3081376,36.8329772,332,1386,3887,1195
6640,4190,1280,3,Business,8,5,45581,8,5,45711,8,5,46284,8,5,47208,8,5,47509,4,28.3,-1.2551895,36.7822034,-1.266294,36.8057971,575,301,130,1497
6641,4420,1899,3,Business,16,1,46276,16,1,46288,16,1,47087,16,1,47441,16,1,49138,11,19.1,-1.272828,36.816608,-1.331619,36.847976,88,1697,12,1153
6642,1717,893,3,Business,7,5,36486,7,5,36556,7,5,36745,7,5,37462,7,5,39478,21,18.5,-1.2664491,36.8102685,-1.343439,36.912065,86,2016,70,906
6643,16508,2933,2,Personal,21,6,53198,21,6,53209,21,6,55270,21,6,55529,21,6,59346,7,18.5,-1.2721028,36.7953485,-1.2518057,36.7997135,194,3817,11,2320
6644,22254,3647,3,Business,9,2,38142,9,2,38334,9,2,39335,9,2,39938,9,2,44500,5,26.9,-1.272639,36.794723,-1.2828362,36.8189236,435,4562,192,1604
6645,5932,1019,1,Personal,4,3,53005,4,3,53078,4,3,53746,4,3,54345,4,3,56376,16,18.5,-1.29387,36.7907813,-1.214328,36.7911903,334,2031,73,1267
6646,10027,928,3,Business,30,3,38855,30,3,38925,30,3,39543,30,3,40207,30,3,40209,5,24.8,-1.2551895,36.7822034,-1.2657199,36.7914391,647,2,70,1282
6647,15520,2215,1,Personal,3,5,40017,3,5,40028,3,5,40730,3,5,40832,3,5,43103,18,21.3,-1.2062428,36.8379106,-1.3175119,36.8058513,105,2271,11,804
6648,499,733,3,Business,24,5,42947,24,5,47102,24,5,47929,24,5,48986,24,5,49705,7,22.9,-1.2551895,36.7822034,-1.2857241,36.8203481,948,719,4155,1884
6649,28016,391,3,Business,13,1,55451,13,1,56805,13,1,57426,13,1,58347,13,1,59134,5,23.25888921888938,-1.2602337,36.7990548,-1.2784063,36.8222933,291,787,1354,1542
6650,11961,1389,3,Business,20,2,51268,20,2,51462,20,2,52632,20,2,53259,20,2,53295,8,23.8,-1.207546,36.7913976,-1.2326041,36.8009029,870,36,194,1797
6651,27075,391,3,Business,29,1,49745,29,1,50633,29,1,50996,29,1,53195,29,1,53708,20,24.5,-1.319613,36.711055,-1.2784063,36.8222933,70,513,888,2562
6652,19148,824,3,Business,5,2,31101,5,2,32370,5,2,33311,5,2,33614,5,2,35645,15,21.2,-1.2886923,36.8241519,-1.207546,36.7913976,206,2031,1269,1244
6653,11504,3647,3,Business,24,3,58823,24,3,58840,24,3,59329,24,3,60090,24,3,61136,6,23.25888921888938,-1.272639,36.794723,-1.2893234,36.8100047,161,1046,17,1250
6654,11151,2618,1,Personal,17,5,62670,17,5,64169,17,5,66315,17,5,66878,17,5,69024,15,19.0,-1.2342433,36.7317684,-1.2129211,36.7963408,144,2146,1499,2709
6655,2463,1245,3,Business,17,5,35235,17,5,35279,17,5,38521,17,5,39659,17,5,41209,10,17.6,-1.300921,36.828195,-1.271672,36.783604,223,1550,44,4380
6656,5199,3283,3,Business,13,3,54951,13,3,58352,13,3,58920,13,3,59357,13,3,61457,14,29.3,-1.228911,36.881876,-1.2628473,36.781805,691,2100,3401,1005
6657,26915,420,3,Business,12,3,55438,12,3,56169,12,3,56891,12,3,57450,12,3,58605,10,26.7,-1.3080097,36.7494062,-1.2611642,36.7949932,312,1155,731,1281
6658,13352,1209,3,Business,29,3,42572,29,3,42922,29,3,43967,29,3,45292,29,3,45830,4,23.25888921888938,-1.3077869,36.8443207,-1.3004062,36.829741,19,538,350,2370
6659,13022,1484,3,Business,28,1,52211,28,1,52239,28,1,52360,28,1,52934,28,1,52938,4,26.1,-1.2551895,36.7822034,-1.269568,36.8054353,647,4,28,695
6660,12019,3370,3,Business,6,4,44743,6,4,44743,6,4,45331,6,4,46249,6,4,49231,7,19.8,-1.2551895,36.7822034,-1.289498,36.818878,20,2982,0,1506
6661,3281,2014,2,Personal,30,4,45910,30,4,45962,30,4,46708,30,4,47175,30,4,48647,3,20.1,-1.2813973,36.8289204,-1.2666695,36.8328283,167,1472,52,1213
6662,733,1764,1,Personal,5,2,41746,5,2,42058,5,2,42914,5,2,43340,5,2,43698,2,21.7,-1.279199,36.8224926,-1.2789477,36.8122359,925,358,312,1282
6663,6755,778,3,Business,17,3,46713,17,3,46851,17,3,48185,17,3,48613,17,3,50241,10,23.25888921888938,-1.275931,36.8516227,-1.2535486,36.7933541,99,1628,138,1762
6664,4393,2330,3,Business,25,4,57248,25,4,57339,25,4,57667,25,4,59314,25,4,59319,2,23.25888921888938,-1.2612417,36.8138633,-1.2642903,36.8002137,881,5,91,1975
6665,24577,1329,3,Business,2,4,45075,2,4,45098,2,4,46168,2,4,46994,2,4,47443,1,23.25888921888938,-1.273056,36.811298,-1.2698334,36.8078,411,449,23,1896
6666,6165,3517,3,Business,22,5,33035,22,5,33086,22,5,33099,22,5,37621,22,5,39147,16,23.25888921888938,-1.300921,36.828195,-1.3882008,36.7699445,145,1526,51,4535
6667,22136,20,3,Business,18,4,48535,18,4,48731,18,4,49220,18,4,49501,18,4,50526,6,23.25888921888938,-1.2680478,36.8013518,-1.2965824,36.8153022,484,1025,196,770
6668,9894,3599,3,Business,5,3,34591,5,3,34610,5,3,36355,5,3,38113,5,3,39595,14,22.5,-1.3302996,36.8707935,-1.317767,36.8982529,48,1482,19,3503
6669,25843,2801,3,Business,26,3,32491,26,3,33357,26,3,33670,26,3,33750,26,3,35156,6,19.1,-1.2595422,36.7871178,-1.2896399,36.8124498,215,1406,866,393
6670,7248,3599,3,Business,25,2,41331,25,2,42289,25,2,45901,25,2,47712,25,2,50821,12,24.0,-1.3302996,36.8707935,-1.2668071,36.8068157,519,3109,958,5423
6671,12825,2587,3,Business,25,4,43451,25,4,45037,25,4,45271,25,4,45554,25,4,45870,1,19.8,-1.28878,36.8168312,-1.2789477,36.8122359,692,316,1586,517
6672,14697,3283,3,Business,5,2,47132,5,2,47149,5,2,47511,5,2,48390,5,2,49369,14,21.4,-1.228911,36.881876,-1.2628473,36.781805,216,979,17,1241
6673,1464,2412,3,Business,11,1,39800,11,1,41760,11,1,42551,11,1,43263,11,1,44718,12,26.6,-1.2283403,36.8822756,-1.2789477,36.8122359,291,1455,1960,1503
6674,3857,1932,3,Business,6,5,43528,6,5,43772,6,5,46397,6,5,46495,6,5,47785,5,20.4,-1.2985987,36.7809119,-1.3075701,36.7504306,140,1290,244,2723
6675,25141,3718,3,Business,1,4,57549,1,4,57567,1,4,57815,1,4,58138,1,4,58957,3,23.25888921888938,-1.2650027,36.8126242,-1.257309,36.8060084,795,819,18,571
6676,11413,1329,3,Business,10,3,54376,10,3,54418,10,3,54947,10,3,55026,10,3,56207,4,30.5,-1.273056,36.811298,-1.2925317,36.8021114,166,1181,42,608
6677,17112,1075,3,Business,8,1,45040,8,1,45482,8,1,47891,8,1,48384,8,1,49854,8,27.7,-1.2326041,36.8009029,-1.2527958,36.8003131,843,1470,442,2902
6678,18065,1642,3,Business,1,1,41175,1,1,41369,1,1,43266,1,1,43825,1,1,45554,13,23.25888921888938,-1.3316276,36.8727316,-1.2726506,36.7960153,126,1729,194,2456
6679,7386,2030,3,Business,28,1,53610,28,1,53678,28,1,54360,28,1,54507,28,1,55251,3,26.3,-1.304735,36.7846054,-1.295908,36.791433,548,744,68,829
6680,13290,2289,3,Business,18,3,56603,18,3,56633,18,3,57087,18,3,57311,18,3,58831,8,20.9,-1.2551895,36.7822034,-1.2930037,36.8126474,764,1520,30,678
6681,19651,1527,3,Business,10,1,46664,10,1,46732,10,1,47028,10,1,48085,10,1,48156,4,18.3,-1.3077869,36.8443207,-1.3004062,36.829741,403,71,68,1353
6682,20151,3599,3,Business,7,5,33827,7,5,37485,7,5,38698,7,5,40309,7,5,41523,11,25.3,-1.3302996,36.8707935,-1.3293565,36.7867025,454,1214,3658,2824
6683,22960,246,3,Business,15,6,45816,15,6,45987,15,6,47411,15,6,47588,15,6,50197,15,22.2,-1.2584143,36.8048002,-1.3146822,36.8900627,300,2609,171,1601
6684,18113,733,3,Business,28,4,57184,28,4,57207,28,4,58108,28,4,58940,28,4,58973,4,27.4,-1.2551895,36.7822034,-1.2617028,36.7983849,79,33,23,1733
6685,22484,235,1,Personal,17,3,58537,17,3,58693,17,3,59659,17,3,60083,17,3,62199,13,24.7,-1.291623,36.81421,-1.2643343,36.7447423,38,2116,156,1390
6686,9875,1469,3,Business,25,5,32633,25,5,32652,25,5,32734,25,5,33189,25,5,34529,8,20.7,-1.2551895,36.7822034,-1.2812624,36.7714609,412,1340,19,537
6687,19644,3283,3,Business,14,4,58826,14,4,58953,14,4,59568,14,4,60082,14,4,60956,6,26.2,-1.272828,36.816608,-1.2628473,36.781805,427,874,127,1129
6688,19809,2156,2,Personal,9,3,37220,9,3,37236,9,3,39566,9,3,39836,9,3,42545,11,21.2,-1.305947,36.849335,-1.2620419,36.788804,618,2709,16,2600
6689,13800,3061,3,Business,27,4,45587,27,4,47838,27,4,48203,27,4,48988,27,4,50602,13,23.6,-1.3189979,36.7104076,-1.2967702,36.8040381,101,1614,2251,1150
6690,11524,633,3,Business,27,4,45722,27,4,45803,27,4,46342,27,4,46587,27,4,47217,5,22.9,-1.2770708,36.8231093,-1.3004062,36.829741,518,630,81,784
6691,13431,1724,3,Business,5,5,66014,5,5,67232,5,5,67239,5,5,68774,5,5,69839,15,24.6,-1.2551895,36.7822034,-1.32189,36.8589727,886,1065,1218,1542
6692,16814,1205,3,Business,30,6,40817,30,6,40850,30,6,41328,30,6,41418,30,6,42425,3,22.1,-1.2707742,36.7578609,-1.2860804,36.7612956,636,1007,33,568
6693,11585,1469,3,Business,21,4,57213,21,4,57227,21,4,57382,21,4,57570,21,4,58589,3,31.2,-1.2551895,36.7822034,-1.25896,36.8016691,856,1019,14,343
6694,25788,1133,3,Business,27,4,52775,27,4,53009,27,4,53908,27,4,54317,27,4,56168,13,25.1,-1.3332749,36.8708147,-1.2734192,36.8072379,623,1851,234,1308
6695,16465,3521,3,Business,2,2,58149,2,2,58418,2,2,60057,2,2,60200,2,2,60794,2,28.7,-1.2701582,36.8074433,-1.2696908,36.81519,690,594,269,1782
6696,6861,3291,3,Business,7,3,36472,7,3,36488,7,3,36794,7,3,36866,7,3,37053,2,23.25888921888938,-1.2673935,36.8030328,-1.2600926,36.8088685,620,187,16,378
6697,18286,3203,3,Business,14,2,38204,14,2,38222,14,2,39479,14,2,40589,14,2,44450,17,21.6,-1.331619,36.847976,-1.228911,36.881876,519,3861,18,2367
6698,27580,3291,3,Business,18,1,42372,18,1,42390,18,1,42563,18,1,42989,18,1,45586,17,27.9,-1.344446,36.756597,-1.2600926,36.8088685,649,2597,18,599
6699,23216,1148,3,Business,17,3,55375,17,3,55398,17,3,58077,17,3,60276,17,3,60658,9,23.25888921888938,-1.3104867,36.8495593,-1.2664428,36.809453,436,382,23,4878
6700,750,2677,3,Business,25,4,52618,25,4,53648,25,4,54431,25,4,54613,25,4,56356,15,23.25888921888938,-1.2991441,36.7528804,-1.3228003,36.8306435,674,1743,1030,965
6701,139,3651,3,Business,7,5,56331,7,5,57251,7,5,57471,7,5,58264,7,5,60627,8,23.25888921888938,-1.2571472,36.7950633,-1.3138211,36.8257935,253,2363,920,1013
6702,28209,2066,3,Business,2,4,56950,2,4,56968,2,4,57459,2,4,57664,2,4,58421,5,26.0,-1.316961,36.820337,-1.3043821,36.7840586,857,757,18,696
6703,7312,2423,3,Business,13,3,47431,13,3,47572,13,3,47582,13,3,48969,13,3,50286,8,27.0,-1.2551895,36.7822034,-1.300722,36.816865,406,1317,141,1397
6704,18068,3355,3,Business,7,1,33331,7,1,33360,7,1,34452,7,1,36417,7,1,38209,9,18.4,-1.3025826,36.7670807,-1.3052491,36.8223899,874,1792,29,3057
6705,25146,1927,3,Business,30,5,46457,30,5,46480,30,5,47185,30,5,47732,30,5,49761,15,23.6,-1.2571472,36.7950633,-1.3463042,36.768164,205,2029,23,1252
6706,4009,562,3,Business,10,5,50660,10,5,50750,10,5,51457,10,5,51916,10,5,54006,14,23.25888921888938,-1.3227181,36.8528097,-1.242902,36.870334,206,2090,90,1166
6707,11327,325,3,Business,23,3,42544,23,3,42606,23,3,42683,23,3,43504,23,3,44772,8,23.25888921888938,-1.2551895,36.7822034,-1.2950408,36.8098172,648,1268,62,898
6708,5888,2523,3,Business,27,4,46988,27,4,48933,27,4,50026,27,4,51009,27,4,52085,9,23.8,-1.2516167,36.8678844,-1.2830057,36.8175478,477,1076,1945,2076
6709,1613,1984,2,Business,19,7,38589,19,7,38781,19,7,40556,19,7,40688,19,7,41365,3,17.8,-1.3025826,36.7670807,-1.2764692,36.7580111,400,677,192,1907
6710,21395,3669,3,Business,18,1,63724,18,1,64040,18,1,64534,18,1,66270,18,1,68367,22,28.9,-1.2615888,36.7928732,-1.3984711,36.7673103,103,2097,316,2230
6711,21514,941,1,Personal,6,6,38985,6,6,39635,6,6,40472,6,6,41631,6,6,42832,8,24.2,-1.2807298,36.8299116,-1.2813649,36.7764385,622,1201,650,1996
6712,26339,1238,3,Personal,11,5,45049,11,5,45764,11,5,47212,11,5,47285,11,5,49031,7,20.9,-1.263419,36.8060348,-1.302088,36.831162,268,1746,715,1521
6713,19057,2069,3,Business,28,4,39038,28,4,39100,28,4,39354,28,4,40413,28,4,41786,12,27.8,-1.2600926,36.8088685,-1.228911,36.881876,148,1373,62,1313
6714,21834,1452,2,Personal,2,1,48242,2,1,48346,2,1,49576,2,1,49899,2,1,50904,8,20.2,-1.2884128,36.7906666,-1.260232,36.807334,74,1005,104,1553
6715,1566,3201,3,Business,4,2,53162,4,2,53289,4,2,55373,4,2,55443,4,2,56844,3,22.7,-1.2584143,36.8048002,-1.2551895,36.7822034,162,1401,127,2154
6716,14173,570,3,Business,18,2,44927,18,2,46680,18,2,47071,18,2,47744,18,2,48342,3,23.25888921888938,-1.2527958,36.8003131,-1.2551895,36.7822034,658,598,1753,1064
6717,15789,2209,3,Business,21,1,42038,21,1,42075,21,1,42435,21,1,42713,21,1,44195,19,25.6,-1.2551895,36.7822034,-1.2408054,36.6634567,379,1482,37,638
6718,1305,517,3,Business,27,6,32103,27,6,32115,27,6,32119,27,6,34690,27,6,34693,14,23.25888921888938,-1.3167113,36.8301563,-1.2991441,36.7528804,619,3,12,2575
6719,18245,666,2,Personal,26,6,42245,26,6,42464,26,6,42806,26,6,43160,26,6,44149,9,22.4,-1.2770071,36.832167,-1.2867182,36.7579445,409,989,219,696
6720,9608,2523,3,Business,11,1,33651,11,1,34121,11,1,34405,11,1,34630,11,1,38169,8,18.1,-1.2551895,36.7822034,-1.2985749,36.8088,551,3539,470,509
6721,25602,1850,3,Business,11,2,36997,11,2,38181,11,2,39421,11,2,39857,11,2,40722,7,19.2,-1.2551895,36.7822034,-1.2785434,36.8215327,790,865,1184,1676
6722,21580,2112,3,Business,11,1,66082,11,1,66348,11,1,66526,11,1,66880,11,1,67913,11,27.4,-1.2156006,36.8916865,-1.2786703,36.826044,416,1033,266,532
6723,12871,733,3,Business,25,4,43838,25,4,43863,25,4,43876,25,4,44819,25,4,44872,5,23.25888921888938,-1.2551895,36.7822034,-1.2629461,36.7653137,576,53,25,956
6724,20912,2102,3,Business,16,4,30427,16,4,30504,16,4,30940,16,4,32018,16,4,33216,13,23.25888921888938,-1.2613768,36.8019418,-1.3323107,36.8692616,383,1198,77,1514
6725,8095,3647,3,Business,6,3,58868,6,3,58889,6,3,59491,6,3,59855,6,3,62693,20,23.25888921888938,-1.272639,36.794723,-1.1834466,36.8887328,520,2838,21,966
6726,10690,2869,3,Business,21,2,48949,21,2,48983,21,2,49881,21,2,50842,21,2,54621,10,25.0,-1.290894,36.822971,-1.3025826,36.7670807,831,3779,34,1859
6727,7404,393,3,Business,21,2,43285,21,2,43427,21,2,44369,21,2,44975,21,2,47092,11,22.5,-1.3167113,36.8301563,-1.2638185,36.7930057,448,2117,142,1548
6728,26364,1471,3,Business,21,3,46051,21,3,46055,21,3,46067,21,3,46448,21,3,49355,25,22.0,-1.2551895,36.7822034,-1.1648303,36.951368,351,2907,4,393
6729,7210,3291,3,Business,29,3,36902,29,3,36921,29,3,37762,29,3,38150,29,3,39560,11,23.25888921888938,-1.303596,36.778378,-1.2600926,36.8088685,709,1410,19,1229
6730,25874,3669,3,Business,7,2,44791,7,2,44848,7,2,46718,7,2,47378,7,2,48538,4,23.25888921888938,-1.2615888,36.7928732,-1.2560822,36.8209918,646,1160,57,2530
6731,5131,868,3,Business,20,4,53288,20,4,57714,20,4,58498,20,4,58997,20,4,63516,6,25.2,-1.265715,36.823815,-1.307143,36.825009,52,4519,4426,1283
6732,8208,3549,3,Business,20,3,51665,20,3,51727,20,3,52994,20,3,53221,20,3,54470,18,29.2,-1.280897,36.8151821,-1.1901614,36.9346522,377,1249,62,1494
6733,17044,2200,3,Business,14,4,54395,14,4,55086,14,4,55592,14,4,56517,14,4,56827,4,27.8,-1.290894,36.822971,-1.3041129,36.8104939,336,310,691,1431
6734,8512,393,3,Business,7,4,53652,7,4,53872,7,4,54922,7,4,55881,7,4,57344,6,27.6,-1.3167113,36.8301563,-1.3077869,36.8443207,168,1463,220,2009
6735,11204,1502,3,Business,8,4,37577,8,4,37596,8,4,38024,8,4,38119,8,4,41241,15,26.5,-1.2232123,36.8932547,-1.2938211,36.8270021,685,3122,19,523
6736,9285,2260,1,Personal,12,5,57572,12,5,59398,12,5,59509,12,5,61039,12,5,63423,7,25.5,-1.288285,36.815912,-1.255956,36.772901,101,2384,1826,1641
6737,24119,2743,1,Personal,14,2,50048,14,2,50049,14,2,50957,14,2,51241,14,2,52545,8,24.1,-1.3107918,36.761794,-1.2971379,36.8019794,754,1304,1,1192
6738,20141,665,1,Business,28,5,32617,28,5,32631,28,5,33292,28,5,34191,28,5,37009,17,20.5,-1.2843046,36.7746132,-1.2859912,36.8756811,11,2818,14,1560
6739,17561,3560,3,Business,8,4,57513,8,4,58411,8,4,58517,8,4,63765,8,4,64163,14,25.4,-1.279395,36.825364,-1.3103985,36.9114173,284,398,898,5354
6740,26502,1051,3,Business,28,1,44469,28,1,44503,28,1,44507,28,1,44800,28,1,46642,14,23.8,-1.2963097,36.7688221,-1.2500309,36.6690476,24,1842,34,297
6741,28216,1440,2,Personal,20,4,47103,20,4,47143,20,4,49309,20,4,49484,20,4,50934,10,27.9,-1.321737,36.8179788,-1.3005797,36.7729756,79,1450,40,2341
6742,14741,3674,3,Business,13,4,35933,13,4,35992,13,4,36056,13,4,36519,13,4,38364,8,18.4,-1.2551895,36.7822034,-1.3038156,36.8122733,827,1845,59,527
6743,386,1368,3,Business,8,2,43916,8,2,43979,8,2,44915,8,2,45326,8,2,46080,7,23.5,-1.2571472,36.7950633,-1.29387,36.7907813,19,754,63,1347
6744,25022,2069,3,Business,18,4,35490,18,4,35527,18,4,36062,18,4,36408,18,4,37847,6,23.25888921888938,-1.2296618,36.8438272,-1.228911,36.881876,204,1439,37,881
6745,24262,1368,3,Business,11,2,37978,11,2,38051,11,2,38517,11,2,39029,11,2,40386,7,19.6,-1.2571472,36.7950633,-1.2898354,36.7872703,345,1357,73,978
6746,9740,2330,3,Business,8,5,47659,8,5,48924,8,5,49028,8,5,49300,8,5,50530,10,27.3,-1.2524916,36.8656196,-1.2637057,36.80517,845,1230,1265,376
6747,12468,562,3,Business,6,4,47874,6,4,48613,6,4,51509,6,4,51912,6,4,53945,7,23.25888921888938,-1.3227181,36.8528097,-1.2838297,36.8109232,511,2033,739,3299
6748,14635,3420,3,Business,4,4,50607,4,4,52387,4,4,52449,4,4,52890,4,4,53814,6,24.6,-1.3046007,36.8211743,-1.265981,36.7936121,914,924,1780,503
6749,569,1207,3,Business,12,3,41731,12,3,42252,12,3,43647,12,3,43903,12,3,44602,5,19.3,-1.2854453,36.8188363,-1.2628638,36.8070399,538,699,521,1651
6750,18428,635,3,Business,23,5,44330,23,5,49920,23,5,50775,23,5,51132,23,5,52311,6,26.5,-1.3016417,36.8271679,-1.3229345,36.8566974,810,1179,5590,1212
6751,18531,3291,3,Business,24,4,49552,24,4,49615,24,4,50013,24,4,50848,24,4,50855,2,28.1,-1.266837,36.799249,-1.2600926,36.8088685,4,7,63,1233
6752,8993,1271,3,Business,16,4,35094,16,4,35111,16,4,35880,16,4,36511,16,4,40619,17,15.6,-1.3244885,36.897792,-1.2699442,36.8206553,213,4108,17,1400
6753,14095,3291,3,Business,6,4,35222,6,4,35273,6,4,36127,6,4,36568,6,4,37185,5,19.0,-1.2628473,36.781805,-1.2600926,36.8088685,337,617,51,1295
6754,16884,2865,1,Personal,9,4,34819,9,4,34846,9,4,35456,9,4,35710,9,4,36979,8,17.3,-1.324249,36.858201,-1.3183563,36.8140249,726,1269,27,864
6755,15616,2330,3,Business,7,4,61988,7,4,62000,7,4,62634,7,4,63952,7,4,63957,10,25.6,-1.3015197,36.7658456,-1.2649605,36.7981777,246,5,12,1952
6756,23889,2216,3,Business,2,2,36155,2,2,36161,2,2,36181,2,2,37650,2,2,39828,21,20.6,-1.2551895,36.7822034,-1.3705766,36.9120742,576,2178,6,1489
6757,12016,1500,3,Business,29,3,51618,29,3,52594,29,3,52978,29,3,53275,29,3,54797,9,21.1,-1.2638185,36.7930057,-1.3004062,36.829741,155,1522,976,681
6758,22623,1920,3,Business,2,5,31175,2,5,31184,2,5,31621,2,5,31803,2,5,34023,4,18.0,-1.2551895,36.7822034,-1.2668454,36.7940642,228,2220,9,619
6759,19997,2330,3,Business,11,1,44564,11,1,44575,11,1,45398,11,1,45504,11,1,48241,18,23.9,-1.3015197,36.7658456,-1.2284323,36.8757058,933,2737,11,929
6760,24021,2627,3,Business,5,2,33546,5,2,33560,5,2,36860,5,2,37274,5,2,39934,24,18.1,-1.3190102,36.9230693,-1.2571472,36.7950633,404,2660,14,3714
6761,12080,3147,3,Business,2,2,39963,2,2,39983,2,2,40003,2,2,41286,2,2,41425,3,20.8,-1.3467389,36.7690312,-1.346755,36.756349,179,139,20,1303
6762,23832,1205,3,Business,12,1,35578,12,1,36769,12,1,37159,12,1,37412,12,1,38488,8,19.2,-1.257309,36.8060084,-1.2902738,36.7765942,829,1076,1191,643
6763,21642,2212,3,Business,10,5,31536,10,5,31619,10,5,32041,10,5,32625,10,5,34366,14,23.25888921888938,-1.2571472,36.7950633,-1.3291155,36.8861,843,1741,83,1006
6764,24572,2174,3,Business,21,5,36851,21,5,36876,21,5,36889,21,5,40398,21,5,44622,28,22.9,-1.2482781,36.884092,-1.391222,36.760676,946,4224,25,3522
6765,2988,393,3,Business,8,1,30938,8,1,30989,8,1,32478,8,1,34854,8,1,35393,4,21.7,-1.3167113,36.8301563,-1.3004062,36.829741,728,539,51,3865
6766,23413,2066,3,Business,13,1,52892,13,1,52950,13,1,54596,13,1,55301,13,1,57327,12,23.25888921888938,-1.2502493,36.7923169,-1.3210189,36.8410551,300,2026,58,2351
6767,26343,1363,3,Business,21,1,37029,21,1,37123,21,1,37998,21,1,38264,21,1,39944,7,25.3,-1.3004062,36.829741,-1.2655306,36.828148,758,1680,94,1141
6768,7816,1966,3,Business,28,4,57294,28,4,58406,28,4,59087,28,4,59256,28,4,59940,4,27.3,-1.3700383,36.9190174,-1.3462618,36.9071972,863,684,1112,850
6769,10545,2290,3,Business,1,4,52826,1,4,52841,1,4,53001,1,4,53431,1,4,53435,3,23.25888921888938,-1.2615888,36.7928732,-1.2601,36.796528,260,4,15,590
6770,20670,1874,3,Business,28,4,53893,28,4,53962,28,4,54157,28,4,54759,28,4,56176,18,27.4,-1.2571472,36.7950633,-1.3251247,36.8995926,855,1417,69,797
6771,2128,635,3,Business,22,5,57833,22,5,58140,22,5,59702,22,5,60521,22,5,64343,5,28.3,-1.2857764,36.8236622,-1.2602337,36.7990548,910,3822,307,2381
6772,12739,496,3,Business,3,3,54120,3,3,54743,3,3,56354,3,3,56866,3,3,58658,7,28.0,-1.2551895,36.7822034,-1.2802803,36.8271747,855,1792,623,2123
6773,25113,393,3,Business,18,1,35877,18,1,35910,18,1,36233,18,1,37177,18,1,38491,11,21.4,-1.3167113,36.8301563,-1.2638185,36.7930057,590,1314,33,1267
6774,27347,3647,3,Business,19,3,61260,19,3,61441,19,3,62895,19,3,63141,19,3,67736,12,22.3,-1.272639,36.794723,-1.3056581,36.8445565,952,4595,181,1700
6775,8269,2227,3,Personal,21,4,38230,21,4,38256,21,4,38933,21,4,38999,21,4,40491,7,25.1,-1.2541275,36.8263055,-1.2958383,36.8073162,660,1492,26,743
6776,21670,2987,3,Business,30,3,50514,30,3,50720,30,3,51273,30,3,51364,30,3,52202,4,25.3,-1.270212,36.8210877,-1.260232,36.807334,379,838,206,644
6777,27835,2587,3,Business,2,3,42425,2,3,45148,2,3,45153,2,3,46282,2,3,47680,14,24.2,-1.2860183,36.8975338,-1.28878,36.8168312,886,1398,2723,1134
6778,22776,3214,3,Business,23,5,54633,23,5,54935,23,5,57326,23,5,57734,23,5,60674,21,26.5,-1.289795,36.7957132,-1.3190102,36.9230693,956,2940,302,2799
6779,4232,393,3,Business,10,5,41029,10,5,41054,10,5,41340,10,5,41983,10,5,42354,4,23.25888921888938,-1.3167113,36.8301563,-1.3004062,36.829741,687,371,25,929
6780,4920,1368,3,Business,18,4,42680,18,4,43075,18,4,45104,18,4,45306,18,4,46779,5,25.7,-1.2571472,36.7950633,-1.289925,36.820209,328,1473,395,2231
6781,11338,3586,3,Business,17,4,54907,17,4,54961,17,4,55704,17,4,56230,17,4,57686,9,27.8,-1.2869041,36.8240057,-1.275442,36.7660207,237,1456,54,1269
6782,21936,3604,3,Personal,20,3,62312,20,3,62371,20,3,62374,20,3,62448,20,3,64573,18,27.9,-1.2963097,36.7688221,-1.215326,36.8919938,786,2125,59,77
6783,11854,635,3,Business,8,3,54100,8,3,54410,8,3,54759,8,3,56401,8,3,57754,16,23.25888921888938,-1.3081376,36.8329772,-1.1999766,36.8415248,564,1353,310,1991
6784,9987,2200,3,Business,24,6,39924,24,6,41336,24,6,42854,24,6,43183,24,6,44472,6,24.0,-1.2527958,36.8003131,-1.290894,36.822971,581,1289,1412,1847
6785,21113,111,3,Business,7,3,44374,7,3,44385,7,3,44470,7,3,45160,7,3,45781,4,25.0,-1.2551895,36.7822034,-1.2663525,36.8128337,932,621,11,775
6786,5335,788,3,Business,23,5,33906,23,5,35063,23,5,35388,23,5,36128,23,5,38722,10,20.4,-1.290894,36.822971,-1.225322,36.80855,436,2594,1157,1065
6787,7364,1402,3,Business,24,1,31780,24,1,31867,24,1,33697,24,1,34222,24,1,35427,13,19.6,-1.2664227,36.7453671,-1.281754,36.8324229,576,1205,87,2355
6788,9166,136,3,Business,12,5,41850,12,5,41897,12,5,42818,12,5,43072,12,5,46475,19,26.5,-1.2546023,36.8266773,-1.3254522,36.7216584,520,3403,47,1175
6789,22293,1518,3,Personal,16,6,45875,16,6,45910,16,6,46490,16,6,46946,16,6,47673,5,25.8,-1.3104748,36.8129945,-1.2877831,36.8146624,206,727,35,1036
6790,23808,2725,1,Personal,8,1,53661,8,1,55388,8,1,56004,8,1,56990,8,1,58268,5,24.8,-1.306046,36.836705,-1.2851847,36.8314086,662,1278,1727,1602
6791,23933,3222,3,Business,2,5,54297,2,5,54442,2,5,54445,2,5,55563,2,5,56413,9,25.2,-1.2551895,36.7822034,-1.2961742,36.8192864,345,850,145,1121
6792,3579,478,3,Business,8,5,45418,8,5,45496,8,5,46086,8,5,46441,8,5,48961,15,24.3,-1.2551895,36.7822034,-1.3216456,36.7145156,205,2520,78,945
6793,25680,788,3,Business,31,1,33219,31,1,33487,31,1,33746,31,1,34079,31,1,34990,7,18.5,-1.2584143,36.8048002,-1.225322,36.80855,453,911,268,592
6794,25571,1927,3,Business,8,5,51683,8,5,51715,8,5,52210,8,5,52589,8,5,55120,25,27.2,-1.2232123,36.8932547,-1.3472066,36.7692638,803,2531,32,874
6795,16806,3491,3,Business,26,6,47194,26,6,47223,26,6,48593,26,6,48774,26,6,50178,12,28.2,-1.2860183,36.8975338,-1.2283403,36.8822756,547,1404,29,1551
6796,23992,3108,3,Business,8,3,43883,8,3,44306,8,3,45038,8,3,45470,8,3,49381,14,22.4,-1.2551895,36.7822034,-1.3332749,36.8708147,498,3911,423,1164
6797,19185,2330,3,Business,28,4,55024,28,4,55055,28,4,56599,28,4,56996,28,4,59260,8,30.1,-1.293082,36.8278578,-1.3015197,36.7658456,61,2264,31,1941
6798,8029,3686,3,Business,31,3,46176,31,3,46253,31,3,47159,31,3,48620,31,3,49341,8,24.6,-1.2551895,36.7822034,-1.2945074,36.8083195,744,721,77,2367
6799,18757,186,3,Business,13,4,53222,13,4,53589,13,4,55923,13,4,56575,13,4,60494,23,23.0,-1.3700383,36.9190174,-1.2571472,36.7950633,271,3919,367,2986
6800,6181,1756,2,Personal,28,5,47512,28,5,47633,28,5,48077,28,5,48454,28,5,49501,4,24.9,-1.3021964,36.7681681,-1.2923412,36.7951972,932,1047,121,821
6801,22322,3496,3,Business,7,5,54143,7,5,55770,7,5,56720,7,5,57215,7,5,59220,16,26.8,-1.300921,36.828195,-1.2947214,36.7179558,445,2005,1627,1445
6802,15195,3355,3,Business,20,4,43884,20,4,43891,20,4,44456,20,4,45397,20,4,46416,10,24.5,-1.3472066,36.7692638,-1.3052491,36.8223899,263,1019,7,1506
6803,21281,2801,3,Business,14,5,57619,14,5,57684,14,5,58526,14,5,58715,14,5,59513,5,23.2,-1.2674274,36.7870827,-1.269534,36.80697,446,798,65,1031
6804,18748,3291,3,Business,4,1,38747,4,1,38783,4,1,39354,4,1,39491,4,1,41369,8,25.4,-1.303596,36.778378,-1.2600926,36.8088685,71,1878,36,708
6806,19271,3688,3,Business,18,4,56805,18,4,57021,18,4,57631,18,4,57851,18,4,61656,7,23.25888921888938,-1.2551895,36.7822034,-1.2897399,36.8270975,576,3805,216,830
6807,10120,1363,3,Business,24,4,53307,24,4,53555,24,4,53559,24,4,54465,24,4,54466,5,28.2,-1.3004062,36.829741,-1.3228003,36.8306435,619,1,248,910
6808,13452,3686,3,Business,30,4,55832,30,4,55846,30,4,55882,30,4,56327,30,4,58149,9,23.25888921888938,-1.2551895,36.7822034,-1.2948751,36.7938907,709,1822,14,481
6809,18072,2533,1,Personal,17,3,53245,17,3,53496,17,3,54193,17,3,54287,17,3,56083,6,28.4,-1.2727624,36.7674062,-1.289718,36.8193,952,1796,251,791
6810,12143,496,3,Business,22,3,51893,22,3,52424,22,3,52995,22,3,53217,22,3,54811,10,24.5,-1.2551895,36.7822034,-1.2518814,36.859661,933,1594,531,793
6811,11960,2330,3,Business,20,1,37121,20,1,37154,20,1,37299,20,1,37562,20,1,38737,7,19.3,-1.2642903,36.8002137,-1.2557779,36.7879648,205,1175,33,408
6812,12966,2843,3,Personal,18,3,51292,18,3,51318,18,3,51457,18,3,52382,18,3,52981,8,20.9,-1.2567464,36.7915273,-1.2698168,36.7421898,805,599,26,1064
6813,11144,2987,3,Business,17,4,59761,17,4,59771,17,4,60027,17,4,60418,17,4,63190,15,21.9,-1.270212,36.8210877,-1.2927792,36.9053492,101,2772,10,647
6814,4616,273,2,Personal,14,2,62130,14,2,62212,14,2,63088,14,2,63885,14,2,64802,6,23.3,-1.2751745,36.7657676,-1.2649605,36.7981777,536,917,82,1673
6815,11159,1304,3,Business,11,2,45352,11,2,45362,11,2,45416,11,2,45982,11,2,48442,7,24.4,-1.2859912,36.8756811,-1.2416156,36.8736721,771,2460,10,620
6816,28052,2423,3,Business,6,4,35843,6,4,35877,6,4,36051,6,4,36674,6,4,40868,7,18.7,-1.2571472,36.7950633,-1.3012173,36.8093987,441,4194,34,797
6817,13484,3326,3,Business,28,4,43570,28,4,43582,28,4,43605,28,4,43842,28,4,45644,4,23.7,-1.2551895,36.7822034,-1.2752846,36.8027022,831,1802,12,260
6818,11889,3647,3,Business,13,3,46214,13,3,46235,13,3,46789,13,3,47228,13,3,47977,3,23.25888921888938,-1.272639,36.794723,-1.2655477,36.8001682,521,749,21,993
6819,15521,3291,3,Business,27,3,59478,27,3,59516,27,3,59627,27,3,60001,27,3,60816,4,27.7,-1.272828,36.816608,-1.2600926,36.8088685,698,815,38,485
6820,5459,1304,3,Business,3,1,57917,3,1,57960,3,1,58206,3,1,58941,3,1,60489,6,23.6,-1.3226302,36.8719901,-1.329568,36.8520825,439,1548,43,981
6821,407,265,3,Business,19,1,40503,19,1,41263,19,1,43243,19,1,44331,19,1,45580,12,24.8,-1.2525335,36.8751139,-1.300921,36.828195,633,1249,760,3068
6822,10324,3473,1,Personal,28,5,44182,28,5,44704,28,5,44967,28,5,46071,28,5,47841,8,25.3,-1.3233955,36.8562944,-1.2950408,36.8098172,100,1770,522,1367
6823,14981,1482,3,Business,7,3,44299,7,3,44699,7,3,45537,7,3,46249,7,3,47775,10,25.2,-1.3122474,36.8728544,-1.338579,36.8963038,86,1526,400,1550
6824,24868,2423,3,Business,12,2,48715,12,2,49916,12,2,50111,12,2,51368,12,2,53527,7,23.25888921888938,-1.2861765,36.8209086,-1.2551895,36.7822034,247,2159,1201,1452
6825,8043,2412,3,Business,11,1,50098,11,1,50231,11,1,50914,11,1,51772,11,1,53256,13,29.1,-1.207546,36.7913976,-1.2283403,36.8822756,205,1484,133,1541
6826,15536,3698,3,Business,24,3,36067,24,3,36095,24,3,36836,24,3,37354,24,3,41671,28,23.25888921888938,-1.3244885,36.897792,-1.15135,36.9566534,418,4317,28,1259
6827,26068,2956,3,Business,9,5,59528,9,5,59682,9,5,59847,9,5,60037,9,5,60710,3,24.9,-1.2584143,36.8048002,-1.2551895,36.7822034,353,673,154,355
6828,481,3201,3,Business,14,4,41551,14,4,42284,14,4,42593,14,4,43492,14,4,43497,1,24.9,-1.2584143,36.8048002,-1.2594539,36.8067841,681,5,733,1208
6829,12505,186,3,Business,23,3,57865,23,3,57900,23,3,58644,23,3,58972,23,3,60314,4,22.1,-1.2579304,36.8019667,-1.2890399,36.8164942,148,1342,35,1072
6830,2896,788,3,Business,16,3,29105,16,3,29171,16,3,30291,16,3,30900,16,3,32484,9,19.8,-1.225322,36.80855,-1.2626906,36.7827022,720,1584,66,1729
6831,1,556,1,Personal,9,2,43850,9,2,43944,9,2,44106,9,2,44443,9,2,45172,4,21.8,-1.2741728,36.7969108,-1.265971,36.766806,848,729,94,499
6832,23964,3674,3,Business,11,5,39175,11,5,39185,11,5,39234,11,5,39807,11,5,44264,22,20.8,-1.2551895,36.7822034,-1.3190102,36.9230693,331,4457,10,622
6833,25547,461,1,Personal,12,3,38065,12,3,38888,12,3,40819,12,3,41403,12,3,46063,15,23.1,-1.3178263,36.7141818,-1.293278,36.827789,101,4660,823,2515
6834,13465,124,3,Personal,29,2,47797,29,2,47875,29,2,48398,29,2,48914,29,2,50491,4,23.9,-1.271402,36.8238135,-1.2580991,36.7941519,279,1577,78,1039
6835,21147,1082,1,Personal,5,3,59327,5,3,59368,5,3,59797,5,3,59970,5,3,63580,17,22.3,-1.304033,36.7848695,-1.2606138,36.6963627,215,3610,41,602
6836,26215,2098,2,Personal,4,4,56398,4,4,56552,4,4,57165,4,4,57512,4,4,59565,10,25.0,-1.3207146,36.8305771,-1.2810586,36.8838294,254,2053,154,960
6837,24332,419,3,Business,8,1,49603,8,1,49708,8,1,49717,8,1,50110,8,1,51590,12,24.7,-1.2571472,36.7950633,-1.3332749,36.8708147,45,1480,105,402
6838,4248,1250,1,Personal,9,3,53386,9,3,53485,9,3,54357,9,3,55455,9,3,57728,6,23.1,-1.2743743,36.7657321,-1.303382,36.790658,279,2273,99,1970
6839,9207,53,3,Business,16,4,48877,16,4,49119,16,4,49556,16,4,50591,16,4,51764,5,23.25888921888938,-1.3004062,36.829741,-1.2770708,36.8231093,709,1173,242,1472
6840,26772,867,3,Business,26,5,47634,26,5,49129,26,5,49865,26,5,49948,26,5,51700,10,23.25888921888938,-1.306378,36.7519845,-1.339046,36.762596,532,1752,1495,819
6841,3455,527,2,Personal,17,3,35755,17,3,35766,17,3,36733,17,3,37437,17,3,41266,12,21.0,-1.2857524,36.8196806,-1.3319425,36.8944709,268,3829,11,1671
6842,22207,1899,3,Business,30,4,41311,30,4,41328,30,4,42132,30,4,42905,30,4,44660,11,23.25888921888938,-1.2663631,36.8163329,-1.331619,36.847976,68,1755,17,1577
6843,20822,3291,3,Business,17,5,35558,17,5,35598,17,5,36191,17,5,36815,17,5,37447,4,23.25888921888938,-1.2663631,36.8163329,-1.2600926,36.8088685,27,632,40,1217
6844,25273,393,3,Business,7,4,30227,7,4,30233,7,4,30315,7,4,30862,7,4,32702,14,19.3,-1.3167113,36.8301563,-1.306378,36.7519845,523,1840,6,629
6845,9188,3686,3,Business,13,2,34535,13,2,34652,13,2,35153,13,2,35351,13,2,36517,15,19.9,-1.2551895,36.7822034,-1.2343236,36.8861,231,1166,117,699
6846,19594,463,3,Personal,8,3,41335,8,3,41471,8,3,41605,8,3,42101,8,3,43517,12,23.25888921888938,-1.2842665,36.7967626,-1.2220632,36.8427636,564,1416,136,630
6847,18275,3326,3,Business,22,5,47192,22,5,47324,22,5,49138,22,5,49369,22,5,49826,2,31.2,-1.2571472,36.7950633,-1.2697141,36.7981777,405,457,132,2045
6848,17560,1882,3,Business,22,4,26539,22,4,29123,22,4,30612,22,4,31467,22,4,32576,5,19.4,-1.2958783,36.7928125,-1.287781,36.817866,612,1109,2584,2344
6849,9509,627,3,Business,12,3,36402,12,3,36485,12,3,37151,12,3,37331,12,3,38345,8,23.25888921888938,-1.2551895,36.7822034,-1.2821378,36.7740428,407,1014,83,846
6850,2527,2677,3,Business,5,1,33182,5,1,33196,5,1,33211,5,1,36113,5,1,36578,14,18.8,-1.3177547,36.8303703,-1.306378,36.7519845,70,465,14,2917
6851,1085,3720,2,Personal,3,2,33945,3,2,33995,3,2,35418,3,2,36185,3,2,38040,11,15.1,-1.3001235,36.8922983,-1.3272265,36.8231497,618,1855,50,2190
6852,5651,2987,3,Business,17,2,46030,17,2,46100,17,2,46367,17,2,47176,17,2,48418,11,18.9,-1.270212,36.8210877,-1.3014461,36.7661381,100,1242,70,1076
6853,4451,525,1,Personal,27,4,40268,27,4,40426,27,4,41305,27,4,41712,27,4,42745,12,22.7,-1.3321614,36.7820281,-1.320246,36.8369384,865,1033,158,1286
6854,23227,2174,3,Business,27,2,44822,27,2,44828,27,2,44979,27,2,46309,27,2,47621,15,24.0,-1.2482781,36.884092,-1.214071,36.7985052,946,1312,6,1481
6855,20945,3001,3,Business,7,1,57524,7,1,58039,7,1,60059,7,1,60492,7,1,61706,7,20.0,-1.2637515,36.7885663,-1.2991543,36.7827912,100,1214,515,2453
6856,3865,635,3,Business,28,2,44146,28,2,44192,28,2,44846,28,2,45220,28,2,46126,5,21.2,-1.2602337,36.7990548,-1.2823851,36.8186472,843,906,46,1028
6857,12641,916,3,Business,22,2,34385,22,2,34408,22,2,35375,22,2,36136,22,2,37596,11,17.7,-1.2909665,36.8150406,-1.3321944,36.8892329,888,1460,23,1728
6858,8103,1363,3,Business,30,6,33528,30,6,33539,30,6,34384,30,6,34469,30,6,35081,5,23.25888921888938,-1.3004062,36.829741,-1.3228003,36.8306435,728,612,11,930
6859,1383,299,3,Business,31,5,34068,31,5,34085,31,5,34112,31,5,34768,31,5,37312,7,23.25888921888938,-1.2628638,36.8070399,-1.2884231,36.7794566,72,2544,17,683
6860,16797,2583,3,Personal,16,4,45979,16,4,46047,16,4,46748,16,4,47030,16,4,48152,6,23.25888921888938,-1.2607569,36.7747575,-1.2613768,36.8019418,7,1122,68,983
6861,23271,3283,3,Business,19,2,37675,19,2,37767,19,2,38665,19,2,39271,19,2,40346,7,27.3,-1.303596,36.778378,-1.2628473,36.781805,831,1075,92,1504
6862,1966,706,3,Business,13,2,52345,13,2,52627,13,2,53254,13,2,53437,13,2,54145,6,26.4,-1.3077869,36.8443207,-1.3239488,36.8316835,900,708,282,810
6863,21457,496,3,Business,19,2,38597,19,2,39276,19,2,40039,19,2,40703,19,2,42174,10,26.7,-1.2551895,36.7822034,-1.2583409,36.7176324,849,1471,679,1427
6864,4045,635,3,Business,31,5,31402,31,5,31434,31,5,32107,31,5,33040,31,5,34329,7,23.25888921888938,-1.2602337,36.7990548,-1.3081376,36.8329772,582,1289,32,1606
6865,6458,978,1,Personal,20,1,46011,20,1,48227,20,1,48964,20,1,50715,20,1,52346,6,21.5,-1.3084067,36.8345014,-1.276395,36.825707,213,1631,2216,2488
6866,22699,3283,3,Business,18,4,45032,18,4,45530,18,4,46709,18,4,47249,18,4,48084,5,23.25888921888938,-1.2600926,36.8088685,-1.2628473,36.781805,924,835,498,1719
6867,27843,3108,3,Business,7,3,34277,7,3,34519,7,3,35158,7,3,35453,7,3,36996,13,23.25888921888938,-1.2551895,36.7822034,-1.2917771,36.857582,932,1543,242,934
6868,25378,3496,3,Business,3,5,56639,3,5,56660,3,5,56726,3,5,58321,3,5,59521,9,25.3,-1.300921,36.828195,-1.3007592,36.7754197,925,1200,21,1661
6869,20314,60,3,Business,7,2,35325,7,2,35342,7,2,35851,7,2,36422,7,2,37057,7,23.25888921888938,-1.228911,36.881876,-1.22978,36.836215,8,635,17,1080
6870,12811,1329,3,Business,14,2,37923,14,2,37981,14,2,39314,14,2,39517,14,2,40317,4,23.25888921888938,-1.273056,36.811298,-1.290894,36.8031109,576,800,58,1536
6871,9058,2294,3,Business,22,3,28526,22,3,28611,22,3,31123,22,3,31574,22,3,33622,12,18.8,-1.2764051,36.8791384,-1.2861405,36.8078878,557,2048,85,2963
6872,10357,867,3,Business,29,5,33409,29,5,33481,29,5,34167,29,5,34947,29,5,36413,10,20.9,-1.2996533,36.8292629,-1.2991441,36.7528804,728,1466,72,1466
6873,20215,635,3,Business,8,5,36471,8,5,36493,8,5,37363,8,5,37441,8,5,38049,5,23.2,-1.2602337,36.7990548,-1.25681,36.7730826,611,608,22,948
6874,1111,1792,3,Business,25,1,50779,25,1,50807,25,1,52270,25,1,53788,25,1,55406,12,28.2,-1.34474,36.8979457,-1.3104506,36.8687235,955,1618,28,2981
6875,18171,1467,3,Personal,4,4,39053,4,4,39087,4,4,39886,4,4,40446,4,4,42320,10,23.25888921888938,-1.2984591,36.7855438,-1.274381,36.7272265,622,1874,34,1359
6876,25503,893,3,Business,6,4,37440,6,4,37455,6,4,38111,6,4,38364,6,4,39809,12,22.2,-1.2152204,36.8563184,-1.293278,36.827789,456,1445,15,909
6877,19618,635,3,Business,29,6,42603,29,6,42722,29,6,43323,29,6,46143,29,6,47283,8,24.1,-1.3016417,36.8271679,-1.2599563,36.7993439,26,1140,119,3421
6878,17493,2454,3,Business,16,4,43774,16,4,43851,16,4,44808,16,4,45108,16,4,45788,4,23.25888921888938,-1.3034413,36.7770106,-1.2941413,36.7958937,786,680,77,1257
6879,13496,1162,3,Business,5,3,35978,5,3,37150,5,3,37589,5,3,37935,5,3,38844,5,22.4,-1.2733047,36.8109744,-1.2958383,36.8073162,19,909,1172,785
6880,21240,1882,1,Business,6,1,56733,6,1,56878,6,1,58653,6,1,59248,6,1,60148,7,24.7,-1.2268871,36.8073946,-1.2536042,36.8064895,882,900,145,2370
6881,23285,867,3,Business,11,1,51011,11,1,51106,11,1,51544,11,1,51921,11,1,53774,15,28.7,-1.2991441,36.7528804,-1.3167113,36.8301563,8,1853,95,815
6882,28268,2523,3,Business,20,2,46223,20,2,46353,20,2,47703,20,2,47886,20,2,51858,26,19.8,-1.2551895,36.7822034,-1.1605816,36.8977958,70,3972,130,1533
6883,28167,2008,3,Business,16,2,49641,16,2,49667,16,2,50277,16,2,50819,16,2,52975,8,23.25888921888938,-1.2508229,36.7895263,-1.296814,36.8162263,56,2156,26,1152
6884,5394,1209,3,Business,13,6,32774,13,6,32792,13,6,33126,13,6,33659,13,6,35634,9,20.2,-1.2638185,36.7930057,-1.3004062,36.829741,155,1975,18,867
6885,26316,1211,2,Personal,15,1,46647,15,1,46654,15,1,47509,15,1,48110,15,1,48807,8,23.25888921888938,-1.2647688,36.775086,-1.2855799,36.8176209,462,697,7,1456
6886,2075,868,3,Business,30,4,38885,30,4,39689,30,4,39708,30,4,41465,30,4,43313,9,23.25888921888938,-1.331619,36.847976,-1.265715,36.823815,427,1848,804,1776
6887,24198,3674,3,Business,29,3,52318,29,3,53083,29,3,53642,29,3,53808,29,3,54777,10,21.0,-1.2551895,36.7822034,-1.2323335,36.8100356,96,969,765,725
6888,27374,2175,3,Business,19,2,48706,19,2,48762,19,2,49271,19,2,49351,19,2,50663,7,29.9,-1.2885417,36.8100523,-1.2615888,36.7928732,445,1312,56,589
6889,8413,2956,3,Business,28,1,36047,28,1,38310,28,1,39437,28,1,41313,28,1,42821,12,22.8,-1.339046,36.762596,-1.290894,36.822971,56,1508,2263,3003
6890,27599,1961,3,Business,22,3,36109,22,3,36644,22,3,37286,22,3,40070,22,3,43072,17,23.2,-1.2600926,36.8088685,-1.3188359,36.7038526,427,3002,535,3426
6891,12005,3291,3,Business,28,4,34686,28,4,34694,28,4,34698,28,4,35404,28,4,36235,11,23.25888921888938,-1.303596,36.778378,-1.2600926,36.8088685,345,831,8,710
6892,17744,2330,3,Business,15,2,48790,15,2,48872,15,2,49054,15,2,50742,15,2,52586,12,24.4,-1.2284323,36.8757058,-1.2642903,36.8002137,75,1844,82,1870
6893,28170,1342,3,Business,18,1,52852,18,1,52866,18,1,54418,18,1,54854,18,1,57886,18,17.4,-1.3025826,36.7670807,-1.2486689,36.8748969,755,3032,14,1988
6894,12103,2392,3,Personal,3,5,56992,3,5,57311,3,5,59633,3,5,60552,3,5,61283,4,23.25888921888938,-1.2955715,36.7970842,-1.2830989,36.8165739,427,731,319,3241
6895,22055,3222,3,Business,5,2,34781,5,2,34790,5,2,34836,5,2,35216,5,2,35650,3,17.8,-1.2551895,36.7822034,-1.2640571,36.7883547,649,434,9,426
6896,6574,2436,3,Business,22,5,48623,22,5,48713,22,5,49093,22,5,49623,22,5,50923,9,31.0,-1.2551895,36.7822034,-1.2315181,36.8140543,576,1300,90,910
6897,6714,2829,3,Business,7,3,55179,7,3,55220,7,3,55810,7,3,55935,7,3,58637,5,28.5,-1.2571472,36.7950633,-1.2791714,36.8255997,879,2702,41,715
6898,17378,868,3,Business,4,2,41774,4,2,42242,4,2,42435,4,2,42983,4,2,43598,4,20.5,-1.266837,36.799249,-1.265715,36.823815,75,615,468,741
6899,16843,1882,3,Business,16,6,53673,16,6,53708,16,6,54237,16,6,55937,16,6,56709,6,28.6,-1.2956882,36.7861845,-1.2591019,36.800577,855,772,35,2229
6900,13927,527,2,Personal,26,6,36628,26,6,36635,26,6,37738,26,6,37881,26,6,39467,13,18.5,-1.3103985,36.9114173,-1.3295139,36.8985677,618,1586,7,1246
6901,20375,2712,1,Business,25,2,42462,25,2,42548,25,2,42959,25,2,43605,25,2,45229,15,23.7,-1.2944292,36.7793569,-1.2252722,36.8756717,851,1624,86,1057
6902,6185,2982,3,Business,23,2,34629,23,2,34638,23,2,34711,23,2,36360,23,2,38153,21,23.25888921888938,-1.300921,36.828195,-1.2239243,36.710118,923,1793,9,1722
6903,25831,1502,3,Business,6,4,61467,6,4,61637,6,4,63303,6,4,63681,6,4,66227,19,22.8,-1.3014461,36.7661381,-1.2232123,36.8932547,596,2546,170,2044
6904,3781,3557,3,Business,16,5,61594,16,5,62580,16,5,63368,16,5,63905,16,5,64886,6,26.2,-1.2820581,36.8284909,-1.2546732,36.8086796,615,981,986,1325
6905,16208,2701,3,Business,8,5,34154,8,5,34220,8,5,35304,8,5,35424,8,5,36789,12,20.5,-1.255956,36.772901,-1.2765736,36.8513646,933,1365,66,1204
6906,2890,84,3,Business,30,3,59684,30,3,59706,30,3,59779,30,3,60439,30,3,63395,20,27.3,-1.2571472,36.7950633,-1.3632162,36.9108253,517,2956,22,733
6907,14611,71,3,Business,30,3,38624,30,3,38652,30,3,39461,30,3,39772,30,3,40596,2,22.5,-1.2821108,36.8250555,-1.2819054,36.8237089,480,824,28,1120
6908,11534,868,3,Business,5,5,42499,5,5,42554,5,5,43116,5,5,43601,5,5,44192,5,23.6,-1.2600926,36.8088685,-1.265715,36.823815,857,591,55,1047
6909,21303,3621,3,Business,16,6,45912,16,6,45935,16,6,48981,16,6,49124,16,6,51686,7,28.7,-1.2836583,36.7886014,-1.3064585,36.8119065,885,2562,23,3189
6910,17838,656,2,Personal,4,3,64618,4,3,65055,4,3,66707,4,3,67067,4,3,68931,12,23.25888921888938,-1.3301576,36.7830212,-1.2812997,36.7986672,465,1864,437,2012
6911,13844,1850,3,Business,18,4,51095,18,4,51298,18,4,51659,18,4,51861,18,4,53542,7,23.25888921888938,-1.2571472,36.7950633,-1.3047132,36.8089553,250,1681,203,563
6912,4370,2030,3,Business,30,3,52984,30,3,53060,30,3,53374,30,3,54306,30,3,54931,3,29.1,-1.2963097,36.7688221,-1.295908,36.791433,862,625,76,1246
6913,21334,3027,1,Personal,22,5,33536,22,5,33547,22,5,33579,22,5,34894,22,5,37022,13,16.2,-1.2450205,36.8853338,-1.3037179,36.8373602,521,2128,11,1347
6914,16916,2561,1,Business,30,1,57363,30,1,57617,30,1,58946,30,1,59065,30,1,60746,6,20.6,-1.2551895,36.7822034,-1.2833106,36.8240238,882,1681,254,1448
6915,2851,986,3,Personal,8,3,54897,8,3,54953,8,3,55952,8,3,56236,8,3,58456,21,25.8,-1.2639473,36.782966,-1.3264415,36.8793525,449,2220,56,1283
6916,7994,867,3,Business,18,1,40863,18,1,40898,18,1,40924,18,1,41869,18,1,43298,10,26.7,-1.2996533,36.8292629,-1.2991441,36.7528804,472,1429,35,971
6917,6636,1363,3,Business,16,4,31478,16,4,31504,16,4,31506,16,4,31635,16,4,31638,1,23.25888921888938,-1.3083269,36.8253462,-1.3004062,36.829741,120,3,26,131
6918,1276,2464,3,Business,25,6,36103,25,6,36147,25,6,37115,25,6,39230,25,6,42730,15,23.25888921888938,-1.279395,36.825364,-1.3185307,36.9001089,921,3500,44,3083
6919,4558,337,1,Personal,5,4,33352,5,4,33449,5,4,33453,5,4,34314,5,4,35944,6,23.25888921888938,-1.273056,36.811298,-1.2983462,36.8139996,874,1630,97,865
6920,24683,142,3,Business,9,2,50333,9,2,50380,9,2,50947,9,2,52059,9,2,53439,8,30.6,-1.2963097,36.7688221,-1.2630694,36.7743511,269,1380,47,1679
6921,13381,246,3,Business,11,1,34283,11,1,34340,11,1,34949,11,1,35958,11,1,36374,1,14.6,-1.2579304,36.8019667,-1.2584143,36.8048002,770,416,57,1618
6922,20481,2677,3,Business,14,2,40377,14,2,40454,14,2,40778,14,2,41742,14,2,43633,10,23.25888921888938,-1.3004062,36.829741,-1.2991441,36.7528804,298,1891,77,1288
6923,7963,1627,1,Personal,22,3,35878,22,3,37400,22,3,37987,22,3,38267,22,3,38668,3,23.0,-1.3339943,36.7263409,-1.3204931,36.7043102,226,401,1522,867
6924,1433,55,1,Personal,3,3,54938,3,3,54983,3,3,56372,3,3,58442,3,3,59306,11,26.7,-1.3173869,36.8112044,-1.2551895,36.7822034,789,864,45,3459
6925,23566,3426,3,Business,30,3,65207,30,3,65246,30,3,65316,30,3,65854,30,3,67827,3,27.6,-1.3012008,36.764868,-1.2765492,36.7669809,925,1973,39,608
6926,6281,187,3,Business,9,1,47540,9,1,51055,9,1,51817,9,1,52484,9,1,53742,10,20.9,-1.3169591,36.7000029,-1.3581286,36.6580851,478,1258,3515,1429
6927,22246,552,3,Business,3,1,44404,3,1,44445,3,1,44457,3,1,45215,3,1,48524,18,21.7,-1.279395,36.825364,-1.3562374,36.9042954,906,3309,41,770
6928,11673,2909,3,Personal,1,6,35348,1,6,35374,1,6,36028,1,6,36648,1,6,38472,14,15.4,-1.2850644,36.8343657,-1.2780989,36.7286308,857,1824,26,1274
6929,612,2987,3,Business,7,2,42135,7,2,42151,7,2,42386,7,2,42507,7,2,43596,7,23.3,-1.270212,36.8210877,-1.3043821,36.7840586,754,1089,16,356
6930,1897,2069,3,Business,13,1,42999,13,1,43172,13,1,43492,13,1,44500,13,1,45752,12,23.25888921888938,-1.2600926,36.8088685,-1.228911,36.881876,675,1252,173,1328
6931,1113,3568,1,Personal,17,3,38908,17,3,38994,17,3,39174,17,3,39442,17,3,40440,7,25.3,-1.2675332,36.808561,-1.2948997,36.7875428,16,998,86,448
6932,8546,1856,3,Business,2,5,47398,2,5,47440,2,5,48259,2,5,49598,2,5,50151,5,25.1,-1.273009,36.802807,-1.2637421,36.7814816,337,553,42,2158
6933,14964,402,3,Business,30,4,53343,30,4,53377,30,4,54783,30,4,55526,30,4,56074,3,23.25888921888938,-1.2551895,36.7822034,-1.2527958,36.8003131,279,548,34,2149
6934,22641,2066,3,Business,16,2,63719,16,2,63837,16,2,64334,16,2,68751,16,2,69808,10,23.25888921888938,-1.3210189,36.8410551,-1.2699958,36.795639,438,1057,118,4914
6935,27694,248,3,Business,27,1,43429,27,1,43497,27,1,43809,27,1,45503,27,1,47179,7,20.7,-1.2729652,36.8064396,-1.304735,36.7846054,183,1676,68,2006
6936,13039,3752,3,Business,3,5,51595,3,5,51745,3,5,52187,3,5,54776,3,5,55443,5,23.25888921888938,-1.3216969,36.8313968,-1.29658,36.823699,125,667,150,3031
6937,21568,914,3,Business,24,5,50034,24,5,50047,24,5,50559,24,5,51128,24,5,52803,11,22.9,-1.2670213,36.7994482,-1.3270716,36.8406371,119,1675,13,1081
6938,26006,1934,2,Personal,8,1,60682,8,1,61047,8,1,64694,8,1,65623,8,1,67724,7,18.4,-1.2862252,36.8234218,-1.304033,36.7848695,328,2101,365,4576
6939,108,2869,3,Business,18,4,47515,18,4,47583,18,4,48128,18,4,48301,18,4,51047,9,23.25888921888938,-1.3025826,36.7670807,-1.2551895,36.7822034,92,2746,68,718
6940,21243,1064,1,Personal,4,2,36995,4,2,37015,4,2,37493,4,2,38334,4,2,39900,11,18.7,-1.2643694,36.7854135,-1.2365703,36.8054368,754,1566,20,1319
6941,9946,2415,1,Personal,15,6,35141,15,6,35515,15,6,36159,15,6,37716,15,6,38789,6,17.8,-1.2699263,36.8468961,-1.2766474,36.8155764,189,1073,374,2201
6942,802,2587,3,Business,23,6,42983,23,6,43136,23,6,43994,23,6,44386,23,6,47112,5,26.4,-1.2527958,36.8003131,-1.28878,36.8168312,498,2726,153,1250
6943,12777,346,3,Business,16,4,47497,16,4,47561,16,4,49569,16,4,49734,16,4,52847,3,23.25888921888938,-1.2909536,36.8407162,-1.28878,36.8168312,790,3113,64,2173
6944,849,2784,3,Business,22,5,57257,22,5,57822,22,5,58556,22,5,58643,22,5,59766,4,31.1,-1.2963097,36.7688221,-1.2981858,36.747492,306,1123,565,821
6945,15137,2801,3,Business,6,4,40259,6,4,40428,6,4,40672,6,4,41475,6,4,42609,10,24.1,-1.307726,36.839117,-1.2595422,36.7871178,848,1134,169,1047
6946,25023,1245,3,Business,26,5,29605,26,5,29626,26,5,30878,26,5,32364,26,5,34498,22,23.25888921888938,-1.300921,36.828195,-1.3077309,36.6856214,206,2134,21,2738
6947,12722,2066,3,Business,14,2,48744,14,2,48818,14,2,49206,14,2,49329,14,2,50183,6,24.2,-1.316961,36.820337,-1.2967108,36.7871135,663,854,74,511
6948,11083,2154,3,Business,15,5,60251,15,5,60294,15,5,60855,15,5,61287,15,5,62443,8,27.6,-1.2571472,36.7950633,-1.2765736,36.8513646,207,1156,43,993
6949,3149,540,3,Business,16,3,38358,16,3,38922,16,3,39168,16,3,39798,16,3,42007,7,22.6,-1.2551895,36.7822034,-1.287818,36.828623,26,2209,564,876
6950,3213,635,3,Business,18,4,56738,18,4,56815,18,4,57830,18,4,58266,18,4,59679,8,23.25888921888938,-1.3081376,36.8329772,-1.2602337,36.7990548,924,1413,77,1451
6951,21491,3647,3,Business,31,3,56075,31,3,56119,31,3,56314,31,3,56586,31,3,59783,6,26.8,-1.272639,36.794723,-1.2939186,36.8069693,878,3197,44,467
6952,3322,3289,3,Personal,1,5,47322,1,5,47482,1,5,49764,1,5,54864,1,5,58067,15,28.5,-1.3216456,36.7145156,-1.2707373,36.805441,226,3203,160,7382
6953,2859,960,1,Personal,31,4,61447,31,4,64792,31,4,64813,31,4,66544,31,4,69125,6,22.4,-1.2747111,36.8083983,-1.3088824,36.8311983,100,2581,3345,1752
6954,6070,1075,3,Business,24,1,54664,24,1,54679,24,1,55035,24,1,55496,24,1,56087,3,24.6,-1.2551895,36.7822034,-1.2527958,36.8003131,79,591,15,817
6955,4312,3091,3,Business,9,2,39387,9,2,39443,9,2,40567,9,2,41349,9,2,42619,9,27.2,-1.3012008,36.764868,-1.290894,36.822971,855,1270,56,1906
6956,1788,2145,3,Personal,7,5,34697,7,5,34715,7,5,35401,7,5,35676,7,5,37432,19,23.25888921888938,-1.2752846,36.8027022,-1.2540899,36.7042728,875,1756,18,961
6957,27948,83,3,Personal,3,3,60472,3,3,60519,3,3,61508,3,3,62180,3,3,64058,10,23.6,-1.2849377,36.824196,-1.2676943,36.7813658,906,1878,47,1661
6958,25100,1245,3,Business,14,3,35996,14,3,36195,14,3,37644,14,3,40974,14,3,42573,17,24.7,-1.300921,36.828195,-1.3198615,36.7110323,69,1599,199,4779
6959,20557,1205,1,Business,8,2,41377,8,2,42586,8,2,43513,8,2,44138,8,2,45439,3,21.3,-1.281767,36.8220791,-1.2958383,36.8073162,241,1301,1209,1552
6960,15524,3049,1,Personal,27,5,56687,27,5,57516,27,5,57748,27,5,58431,27,5,59321,10,24.2,-1.2845902,36.8254724,-1.2297202,36.8819507,174,890,829,915
6961,7850,1346,1,Business,9,4,61349,9,4,61363,9,4,61827,9,4,62101,9,4,63329,6,22.9,-1.2849951,36.8241746,-1.299813,36.7871392,857,1228,14,738
6962,5305,28,3,Business,6,4,53412,6,4,53493,6,4,54884,6,4,55053,6,4,57575,20,23.25888921888938,-1.300722,36.7882234,-1.3705766,36.9120742,387,2522,81,1560
6963,12981,419,3,Business,9,4,63342,9,4,63414,9,4,63910,9,4,64187,9,4,64544,3,23.25888921888938,-1.2571472,36.7950633,-1.2551895,36.7822034,205,357,72,773
6964,9907,2057,2,Personal,23,4,42134,23,4,42197,23,4,43299,23,4,46667,23,4,47144,4,18.6,-1.2603179,36.8305747,-1.2630521,36.8068019,857,477,63,4470
6965,1738,20,3,Business,6,4,41042,6,4,41073,6,4,41166,6,4,42068,6,4,42082,1,19.5,-1.2652279,36.8020159,-1.2628638,36.8070399,354,14,31,995
6966,23100,2169,2,Personal,9,6,44199,9,6,44206,9,6,44914,9,6,46141,9,6,46911,8,17.0,-1.3205164,36.8098882,-1.3025826,36.7670807,844,770,7,1935
6967,6214,3560,3,Business,28,5,41739,28,5,41756,28,5,41763,28,5,42133,28,5,42875,5,23.8,-1.2765736,36.8513646,-1.279395,36.825364,31,742,17,377
6968,1084,2150,3,Business,6,1,46645,6,1,46664,6,1,46884,6,1,47951,6,1,49146,11,20.7,-1.307143,36.825009,-1.344446,36.756597,297,1195,19,1287
6969,4809,1389,3,Business,29,6,56496,29,6,56517,29,6,56537,29,6,58285,29,6,58840,14,28.1,-1.2584143,36.8048002,-1.207546,36.7913976,720,555,21,1768
6970,12695,3647,3,Business,1,1,57012,1,1,57179,1,1,58272,1,1,58722,1,1,61842,17,23.25888921888938,-1.272639,36.794723,-1.2113548,36.8814114,686,3120,167,1543
6971,26741,2330,3,Business,26,5,48411,26,5,48428,26,5,49507,26,5,50028,26,5,50679,8,23.25888921888938,-1.1926151,36.9347904,-1.2284323,36.8757058,710,651,17,1600
6972,12273,3686,3,Business,17,2,38354,17,2,38362,17,2,40139,17,2,40284,17,2,43485,15,19.1,-1.2551895,36.7822034,-1.3152797,36.8611458,951,3201,8,1922
6973,3938,2069,3,Business,13,3,55426,13,3,55513,13,3,56516,13,3,57010,13,3,58614,12,29.1,-1.2600926,36.8088685,-1.228911,36.881876,825,1604,87,1497
6974,7350,3647,3,Business,15,5,47719,15,5,47779,15,5,48585,15,5,48743,15,5,50476,17,28.1,-1.272639,36.794723,-1.207763,36.8825151,91,1733,60,964
6975,16801,3201,3,Business,13,2,54712,13,2,54720,13,2,54740,13,2,54849,13,2,55227,3,26.0,-1.2584143,36.8048002,-1.2551895,36.7822034,720,378,8,129
6976,25059,868,3,Business,5,3,60230,5,3,61865,5,3,61870,5,3,62518,5,3,62519,3,22.7,-1.2783849,36.8163445,-1.265715,36.823815,813,1,1635,653
6977,13599,2628,1,Personal,8,5,45074,8,5,45200,8,5,46379,8,5,47925,8,5,50839,18,23.25888921888938,-1.2224143,36.8896164,-1.2966323,36.7875842,441,2914,126,2725
6978,20394,3698,3,Business,4,2,54336,4,2,58013,4,2,58711,4,2,59986,4,2,64536,22,22.5,-1.3244885,36.897792,-1.3107918,36.761794,883,4550,3677,1973
6979,17767,393,3,Business,7,4,47230,7,4,47239,7,4,47272,7,4,49552,7,4,49554,4,27.8,-1.3167113,36.8301563,-1.3004062,36.829741,188,2,9,2313
6980,9818,1500,3,Business,28,3,33636,28,3,36654,28,3,37451,28,3,39063,28,3,40430,8,23.25888921888938,-1.3004062,36.829741,-1.2574219,36.7927073,660,1367,3018,2409
6981,24475,627,3,Business,16,2,42023,16,2,42038,16,2,42897,16,2,43901,16,2,43903,2,23.6,-1.2551895,36.7822034,-1.2580991,36.7941519,56,2,15,1863
6982,9555,2537,2,Personal,6,6,31799,6,6,32707,6,6,35694,6,6,36149,6,6,40142,30,18.9,-1.3779324,36.6868613,-1.2664227,36.7453671,565,3993,908,3442
6983,11484,1500,3,Business,17,3,43113,17,3,43172,17,3,43185,17,3,44397,17,3,45282,8,23.25888921888938,-1.3004062,36.829741,-1.2638185,36.7930057,206,885,59,1225
6984,21640,173,3,Business,16,5,65005,16,5,65299,16,5,65818,16,5,66023,16,5,66761,2,26.0,-1.2993231,36.7753372,-1.294598,36.781639,102,738,294,724
6985,11479,3291,3,Business,28,3,47067,28,3,48436,28,3,48484,28,3,49917,28,3,50735,11,23.25888921888938,-1.303596,36.778378,-1.2600926,36.8088685,179,818,1369,1481
6986,2382,1500,3,Business,15,6,39560,15,6,42773,15,6,43788,15,6,44907,15,6,46385,8,22.1,-1.3004062,36.829741,-1.2574219,36.7927073,523,1478,3213,2134
6987,14986,867,3,Business,10,1,55627,10,1,55823,10,1,56321,10,1,56810,10,1,58406,9,18.5,-1.2638185,36.7930057,-1.2991441,36.7528804,491,1596,196,987
6988,26645,1527,3,Business,3,3,53755,3,3,53762,3,3,53767,3,3,54220,3,3,54221,5,28.0,-1.3004062,36.829741,-1.3228003,36.8306435,515,1,7,458
6989,21228,897,2,Personal,11,1,31572,11,1,31618,11,1,32883,11,1,33042,11,1,34478,10,14.3,-1.2295075,36.8016971,-1.2665946,36.7888833,434,1436,46,1424
6990,24252,2987,3,Business,12,5,54160,12,5,54451,12,5,54455,12,5,56079,12,5,56748,9,27.0,-1.270212,36.8210877,-1.3014461,36.7661381,813,669,291,1628
6991,13405,1966,3,Business,18,1,41332,18,1,41348,18,1,43422,18,1,43562,18,1,46535,21,26.8,-1.3700383,36.9190174,-1.2917868,36.7872675,385,2973,16,2214
6992,2031,3459,1,Personal,10,7,38906,10,7,38994,10,7,40070,10,7,40282,10,7,41788,6,17.7,-1.3170774,36.856955,-1.3255193,36.8258719,890,1506,88,1288
6993,11319,265,3,Business,8,5,49137,8,5,49173,8,5,51896,8,5,51984,8,5,55083,23,21.7,-1.300921,36.828195,-1.1554889,36.809043,340,3099,36,2811
6994,10128,1051,3,Business,21,5,52929,21,5,55697,21,5,55789,21,5,55918,21,5,59146,8,24.5,-1.2963097,36.7688221,-1.2647206,36.7259313,725,3228,2768,221
6995,24689,972,3,Business,2,2,56440,2,2,56460,2,2,57351,2,2,57524,2,2,58821,5,26.3,-1.2862033,36.8152966,-1.3087917,36.8286342,583,1297,20,1064
6996,4012,439,3,Business,14,5,52070,14,5,52090,14,5,53600,14,5,54010,14,5,56732,13,23.1,-1.2613768,36.8019418,-1.3328208,36.8692292,567,2722,20,1920
6997,5430,2789,3,Business,18,1,41501,18,1,41590,18,1,42214,18,1,42284,18,1,44252,7,27.1,-1.304735,36.7846054,-1.2875013,36.8171787,548,1968,89,694
6998,7746,391,3,Business,25,4,49475,25,4,52345,25,4,52546,25,4,53359,25,4,54781,7,23.25888921888938,-1.2867454,36.8259017,-1.3203917,36.8334751,855,1422,2870,1014
6999,13948,3006,2,Personal,15,3,30705,15,3,30735,15,3,31298,15,3,31494,15,3,32898,10,16.2,-1.2854406,36.789409,-1.2463211,36.789487,343,1404,30,759
7000,21713,1329,3,Business,15,1,41465,15,1,45646,15,1,46154,15,1,46245,15,1,47219,6,23.25888921888938,-1.273056,36.811298,-1.297324,36.7878632,147,974,4181,599
7001,20535,3207,1,Personal,15,3,51290,15,3,51341,15,3,51948,15,3,52280,15,3,53676,3,21.4,-1.3014461,36.7661381,-1.300968,36.7727325,140,1396,51,939
7002,5354,1471,3,Business,12,1,42609,12,1,42712,12,1,43187,12,1,44005,12,1,45409,9,23.7,-1.2925919,36.8170577,-1.2551895,36.7822034,519,1404,103,1293
7003,8500,3724,1,Personal,3,3,58740,3,3,59334,3,3,60366,3,3,60792,3,3,61132,3,23.4,-1.254778,36.790006,-1.2697141,36.7981777,147,340,594,1458
7004,9525,2801,3,Business,10,1,64971,10,1,64989,10,1,65233,10,1,65599,10,1,66088,4,19.1,-1.2671974,36.804959,-1.2674274,36.7870827,344,489,18,610
7005,17815,1746,3,Business,21,6,48330,21,6,48357,21,6,50152,21,6,51088,21,6,53512,23,18.5,-1.2029923,36.9066203,-1.296797,36.7764525,102,2424,27,2731
7006,23953,3685,3,Personal,16,3,49428,16,3,50525,16,3,51767,16,3,51880,16,3,53049,8,25.6,-1.296599,36.7629672,-1.2934657,36.8212737,812,1169,1097,1355
7007,1902,186,3,Business,25,1,50934,25,1,50975,25,1,51275,25,1,52558,25,1,52561,7,30.1,-1.2825816,36.8092346,-1.2571472,36.7950633,404,3,41,1583
7008,10392,1178,3,Business,30,1,32939,30,1,32984,30,1,34228,30,1,34554,30,1,35801,9,16.6,-1.2717609,36.8400291,-1.2862269,36.7841601,857,1247,45,1570
7009,24966,3491,3,Business,14,2,49809,14,2,49831,14,2,51255,14,2,52013,14,2,52730,9,23.9,-1.2810586,36.8838294,-1.2297202,36.8819507,812,717,22,2182
7010,7830,2348,3,Personal,10,5,46897,10,5,46965,10,5,47547,10,5,48880,10,5,50320,10,22.0,-1.2611578,36.8145307,-1.312469,36.815177,427,1440,68,1915
7011,28168,3599,3,Business,2,4,45668,2,4,47058,2,4,47752,2,4,48418,2,4,49757,13,23.25888921888938,-1.3302996,36.8707935,-1.2760462,36.8074697,675,1339,1390,1360
7012,16023,1346,3,Business,25,5,43749,25,5,43757,25,5,43771,25,5,44109,25,5,46166,20,26.3,-1.2917868,36.7872675,-1.3700383,36.9190174,338,2057,8,352
7013,14745,510,3,Business,12,3,56365,12,3,56373,12,3,56446,12,3,58335,12,3,60827,12,26.3,-1.2860183,36.8975338,-1.325469,36.862403,402,2492,8,1962
7014,1269,788,3,Business,14,3,48681,14,3,49016,14,3,50449,14,3,51688,14,3,54052,11,25.9,-1.2571472,36.7950633,-1.225322,36.80855,266,2364,335,2672
7015,20281,2100,3,Business,31,5,40834,31,5,40854,31,5,40939,31,5,42168,31,5,42843,6,17.3,-1.2765736,36.8513646,-1.300722,36.816865,179,675,20,1314
7016,21910,2587,3,Business,10,5,45356,10,5,46517,10,5,48122,10,5,48670,10,5,50004,10,23.25888921888938,-1.225322,36.80855,-1.28878,36.8168312,709,1334,1161,2153
7017,24767,2582,3,Business,11,1,38236,11,1,38258,11,1,39406,11,1,39642,11,1,44272,22,26.8,-1.2551895,36.7822034,-1.333148,36.922453,238,4630,22,1384
7018,16540,3503,2,Personal,11,2,45141,11,2,45246,11,2,46063,11,2,46308,11,2,47038,4,24.4,-1.2828204,36.7842621,-1.2861322,36.7939866,851,730,105,1062
7019,6813,633,3,Business,21,4,37696,21,4,37704,21,4,37794,21,4,37882,21,4,38348,4,21.6,-1.3004062,36.829741,-1.3173869,36.8112044,329,466,8,178
7020,7022,186,3,Business,8,1,58049,8,1,58149,8,1,59020,8,1,59928,8,1,63078,4,18.5,-1.2571472,36.7950633,-1.2890399,36.8164942,215,3150,100,1779
7021,4611,3496,3,Business,21,5,52400,21,5,55402,21,5,55851,21,5,56254,21,5,57475,7,24.8,-1.300921,36.828195,-1.2941585,36.7947375,829,1221,3002,852
7022,2062,2423,3,Business,8,5,43623,8,5,43751,8,5,44345,8,5,44612,8,5,45489,8,28.2,-1.2551895,36.7822034,-1.3044313,36.818504,336,877,128,861
7023,4657,889,3,Business,20,2,29359,20,2,29817,20,2,30727,20,2,30970,20,2,32844,8,19.0,-1.2985153,36.7876043,-1.2664491,36.8102685,612,1874,458,1153
7024,24204,2030,3,Business,20,2,40238,20,2,47645,20,2,48679,20,2,49625,20,2,54151,22,24.0,-1.1612808,36.9563278,-1.2145529,36.790778,770,4526,7407,1980
7025,13756,2582,3,Business,11,1,52589,11,1,52751,11,1,53282,11,1,53445,11,1,54839,15,29.0,-1.2551895,36.7822034,-1.244778,36.6725425,836,1394,162,694
7026,5585,1103,3,Business,18,1,32349,18,1,33827,18,1,36505,18,1,36740,18,1,37882,8,21.2,-1.2551895,36.7822034,-1.290894,36.822971,88,1142,1478,2913
7027,26082,1527,3,Business,9,4,45584,9,4,45756,9,4,45798,9,4,46239,9,4,47604,12,23.25888921888938,-1.2991441,36.7528804,-1.3004062,36.829741,206,1365,172,483
7028,4325,633,3,Business,27,4,54238,27,4,56347,27,4,57275,27,4,57465,27,4,58077,4,25.0,-1.3077869,36.8443207,-1.3004062,36.829741,532,612,2109,1118
7029,19186,3752,3,Business,17,5,54285,17,5,54297,17,5,54487,17,5,58003,17,5,58523,2,23.25888921888938,-1.2649605,36.7981777,-1.2753109,36.8130185,361,520,12,3706
7030,457,478,3,Business,15,3,43478,15,3,43500,15,3,43507,15,3,44154,15,3,45566,8,23.25888921888938,-1.2551895,36.7822034,-1.3045333,36.8228072,576,1412,22,654
7031,4812,3701,3,Business,13,2,51536,13,2,51645,13,2,52260,13,2,52465,13,2,53333,4,26.1,-1.2684239,36.7952462,-1.2842754,36.7863547,279,868,109,820
7032,19035,3283,3,Business,30,1,36006,30,1,36025,30,1,36145,30,1,37283,30,1,37874,6,16.3,-1.272828,36.816608,-1.2628473,36.781805,174,591,19,1258
7033,18551,3404,3,Business,19,3,51851,19,3,52596,19,3,53629,19,3,53947,19,3,56507,12,24.3,-1.2860183,36.8975338,-1.279395,36.825364,31,2560,745,1351
7034,23083,478,3,Business,14,5,50344,14,5,50802,14,5,51145,14,5,51550,14,5,52994,10,23.5,-1.2551895,36.7822034,-1.2973682,36.7859878,952,1444,458,748
7035,9647,3633,3,Personal,9,6,41997,9,6,42113,9,6,43607,9,6,44255,9,6,48761,14,17.4,-1.2739208,36.8310153,-1.2797013,36.7299371,581,4506,116,2142
7036,16026,3080,3,Business,13,3,46135,13,3,46227,13,3,46744,13,3,47169,13,3,48811,17,24.6,-1.2551895,36.7822034,-1.3421304,36.718364,845,1642,92,942
7037,10447,1207,3,Business,6,3,42786,6,3,43014,6,3,43615,6,3,44469,6,3,45906,7,22.7,-1.2629666,36.8068369,-1.2745321,36.765088,887,1437,228,1455
7038,16932,493,3,Personal,9,3,61643,9,3,62762,9,3,63534,9,3,63735,9,3,64791,5,21.8,-1.2591113,36.8267853,-1.2628937,36.798537,103,1056,1119,973
7039,25194,1687,3,Business,4,4,31339,4,4,31361,4,4,32345,4,4,32549,4,4,33178,4,18.5,-1.2890333,36.8234839,-1.2896933,36.7929035,88,629,22,1188
7040,15522,439,3,Business,10,1,49309,10,1,49407,10,1,50255,10,1,51008,10,1,54881,8,18.9,-1.3323107,36.8692616,-1.2935617,36.835057,404,3873,98,1601
7041,20478,547,1,Personal,8,3,57956,8,3,58054,8,3,59206,8,3,59540,8,3,60864,10,23.9,-1.2840605,36.8191699,-1.3180993,36.8676304,636,1324,98,1486
7042,23360,2423,3,Business,13,3,47486,13,3,47534,13,3,49513,13,3,49758,13,3,52295,7,27.1,-1.2551895,36.7822034,-1.2896171,36.8241291,452,2537,48,2224
7043,10604,239,1,Personal,15,6,49512,15,6,49544,15,6,50384,15,6,50563,15,6,51923,9,25.7,-1.2836832,36.8306719,-1.32571,36.805533,674,1360,32,1019
7044,12399,1502,3,Business,20,3,50830,20,3,51033,20,3,51997,20,3,52343,20,3,53772,12,28.4,-1.279395,36.825364,-1.2232123,36.8932547,206,1429,203,1310
7045,11101,1873,3,Business,11,2,63557,11,2,63750,11,2,64422,11,2,64626,11,2,65987,9,21.0,-1.2571472,36.7950633,-1.3138647,36.811896,208,1361,193,876
7046,10005,1340,3,Business,13,3,37057,13,3,37088,13,3,37589,13,3,38331,13,3,41002,18,25.0,-1.3285987,36.9037428,-1.2707179,36.7979713,411,2671,31,1243
7047,7426,2982,3,Business,1,4,38526,1,4,38531,1,4,39396,1,4,40093,1,4,42839,29,23.25888921888938,-1.300921,36.828195,-1.1355095,36.9689533,516,2746,5,1562
7048,16892,1167,1,Personal,28,5,40941,28,5,40955,28,5,41879,28,5,42684,28,5,44114,8,25.0,-1.2969741,36.7856612,-1.26097,36.787286,751,1430,14,1729
7049,5581,391,3,Business,1,4,43125,1,4,43444,1,4,43690,1,4,44165,1,4,45331,5,23.25888921888938,-1.2777924,36.8231577,-1.3016417,36.8271679,88,1166,319,721
7050,17681,393,3,Business,14,3,32073,14,3,32174,14,3,32353,14,3,33083,14,3,35113,14,18.6,-1.3177547,36.8303703,-1.306378,36.7519845,663,2030,101,909
7051,1774,2344,3,Business,19,1,55672,19,1,55691,19,1,56808,19,1,57090,19,1,61514,21,25.1,-1.2571472,36.7950633,-1.336304,36.9132662,956,4424,19,1399
7052,4527,60,3,Business,9,2,38521,9,2,38535,9,2,40311,9,2,41376,9,2,43464,16,26.8,-1.331619,36.847976,-1.2296618,36.8438272,126,2088,14,2841
7053,11339,1437,3,Personal,9,3,45634,9,3,45749,9,3,46665,9,3,47045,9,3,49350,9,25.2,-1.2890635,36.8318522,-1.2850318,36.8907864,48,2305,115,1296
7054,17647,53,3,Business,22,3,54609,22,3,57581,22,3,59025,22,3,60507,22,3,61800,5,24.0,-1.3004062,36.829741,-1.2770708,36.8231093,422,1293,2972,2926
7055,8158,111,3,Business,9,4,56690,9,4,57761,9,4,57915,9,4,58244,9,4,59484,3,23.25888921888938,-1.2551895,36.7822034,-1.2568411,36.8012533,538,1240,1071,483
7056,18869,2987,3,Business,10,4,34368,10,4,36000,10,4,36817,10,4,37317,10,4,38961,7,18.2,-1.270212,36.8210877,-1.3064585,36.8119065,101,1644,1632,1317
7057,20787,2701,3,Business,19,3,52579,19,3,56802,19,3,57305,19,3,59000,19,3,60178,5,24.5,-1.290894,36.822971,-1.2765736,36.8513646,31,1178,4223,2198
7058,1064,3599,3,Business,30,6,35218,30,6,35249,30,6,36674,30,6,37238,30,6,38735,12,23.25888921888938,-1.3302996,36.8707935,-1.3251825,36.7897587,675,1497,31,1989
7059,17203,1363,3,Business,14,5,53770,14,5,53780,14,5,53981,14,5,54591,14,5,55025,5,23.2,-1.3004062,36.829741,-1.3083266,36.8494756,766,434,10,811
7060,7433,2956,3,Business,22,5,32770,22,5,32797,22,5,33412,22,5,33520,22,5,33942,2,23.25888921888938,-1.2551895,36.7822034,-1.2584143,36.8048002,427,422,27,723
7061,9403,3091,3,Business,3,3,31885,3,3,31965,3,3,32498,3,3,33425,3,3,34531,7,21.6,-1.290894,36.822971,-1.2551895,36.7822034,61,1106,80,1460
7062,11740,393,3,Business,14,5,53003,14,5,53013,14,5,53027,14,5,53715,14,5,54282,4,23.0,-1.3228003,36.8306435,-1.3004062,36.829741,168,567,10,702
7063,6519,517,3,Business,23,6,39307,23,6,39319,23,6,39628,23,6,40456,23,6,41801,11,26.3,-1.3167113,36.8301563,-1.2638185,36.7930057,436,1345,12,1137
7064,2484,391,3,Business,23,4,57202,23,4,57472,23,4,57703,23,4,57962,23,4,61526,7,24.7,-1.2789469,36.7796691,-1.2784063,36.8222933,19,3564,270,490
7065,28040,111,3,Business,27,5,58331,27,5,58432,27,5,60506,27,5,60940,27,5,62078,8,17.6,-1.2551895,36.7822034,-1.2930488,36.8280877,836,1138,101,2508
7066,7315,238,3,Business,18,1,55631,18,1,55739,18,1,56480,18,1,56601,18,1,58200,15,30.7,-1.3077869,36.8443207,-1.3559093,36.9100452,418,1599,108,862
7067,18220,2383,3,Business,10,5,56305,10,5,56568,10,5,57205,10,5,57399,10,5,58918,7,23.25888921888938,-1.2608993,36.799246,-1.2892435,36.8221852,341,1519,263,831
7068,11407,635,3,Business,28,4,42426,28,4,42464,28,4,42966,28,4,43095,28,4,44494,7,23.5,-1.2602337,36.7990548,-1.3081376,36.8329772,686,1399,38,631
7069,1110,1724,3,Business,14,2,38887,14,2,39044,14,2,39773,14,2,40105,14,2,40903,6,23.25888921888938,-1.2551895,36.7822034,-1.2814273,36.8132815,959,798,157,1061
7070,970,3434,3,Business,9,5,44660,9,5,44689,9,5,45384,9,5,45869,9,5,50154,28,25.8,-1.2963097,36.7688221,-1.1612808,36.9563278,958,4285,29,1180
7071,15949,225,3,Personal,13,3,43426,13,3,43588,13,3,49110,13,3,49308,13,3,50431,13,27.4,-1.285851,36.816496,-1.320722,36.8803076,48,1123,162,5720
7072,16950,3173,1,Personal,11,3,45359,11,3,45365,11,3,45951,11,3,46250,11,3,50498,27,19.1,-1.2717609,36.8400291,-1.3707479,36.6563289,629,4248,6,885
7073,21407,909,3,Business,3,5,48623,3,5,49055,3,5,49898,3,5,50380,3,5,52003,14,23.25888921888938,-1.225322,36.80855,-1.2413316,36.8785525,72,1623,432,1325
7074,10402,3647,3,Business,22,3,48157,22,3,48284,22,3,49119,22,3,49265,22,3,51160,16,24.5,-1.298037,36.6934582,-1.272639,36.794723,692,1895,127,981
7075,26428,838,3,Business,19,2,36529,19,2,37532,19,2,39531,19,2,40341,19,2,44989,33,27.3,-1.1648303,36.951368,-1.329568,36.8520825,447,4648,1003,2809
7076,6378,3211,1,Personal,7,4,46566,7,4,49104,7,4,49574,7,4,49854,7,4,50909,3,20.0,-1.2783772,36.8201617,-1.2883346,36.8148489,742,1055,2538,750
7077,3191,2869,3,Business,6,3,40863,6,3,40907,6,3,42587,6,3,44214,6,3,46374,9,23.25888921888938,-1.28878,36.8168312,-1.3025826,36.7670807,118,2160,44,3307
7078,14115,2658,3,Business,19,1,41470,19,1,42561,19,1,44583,19,1,44749,19,1,45308,2,24.5,-1.2891922,36.825189,-1.2868546,36.824811,456,559,1091,2188
7079,24864,1341,3,Business,20,1,45902,20,1,45960,20,1,46840,20,1,47855,20,1,48894,9,23.25888921888938,-1.3033561,36.8163631,-1.331619,36.847976,831,1039,58,1895
7080,23596,186,3,Business,13,2,49692,13,2,50176,13,2,50270,13,2,50496,13,2,52899,18,26.0,-1.3700383,36.9190174,-1.2902869,36.8085396,516,2403,484,320
7081,21033,2587,3,Business,2,4,42113,2,4,42213,2,4,43963,2,4,44375,2,4,45224,2,23.25888921888938,-1.290894,36.822971,-1.28878,36.8168312,585,849,100,2162
7082,19430,435,3,Business,27,1,44325,27,1,44444,27,1,45643,27,1,48900,27,1,49480,5,23.2,-1.300921,36.828195,-1.2797623,36.8050683,139,580,119,4456
7083,8083,1207,3,Business,22,5,57715,22,5,59323,22,5,60622,22,5,62334,22,5,64267,17,25.5,-1.3169591,36.7000029,-1.2652279,36.8020159,576,1933,1608,3011
7084,3630,2986,3,Personal,27,1,42241,27,1,42341,27,1,43803,27,1,43996,27,1,46085,15,21.0,-1.3245779,36.7021035,-1.2903886,36.8063847,690,2089,100,1655
7085,27268,633,3,Business,11,5,54267,11,5,55274,11,5,55313,11,5,55496,11,5,57032,11,26.3,-1.2991441,36.7528804,-1.3004062,36.829741,914,1536,1007,222
7086,5308,3565,3,Business,11,5,30229,11,5,30253,11,5,32170,11,5,32704,11,5,35339,20,17.9,-1.2844665,36.7866113,-1.355309,36.6541393,45,2635,24,2451
7087,23824,1500,3,Business,3,3,32403,3,3,32495,3,3,32498,3,3,35441,3,3,35541,8,21.4,-1.3004062,36.829741,-1.2638185,36.7930057,70,100,92,2946
7088,274,2509,3,Business,11,4,44896,11,4,44983,11,4,45183,11,4,45483,11,4,46424,4,23.8,-1.2571472,36.7950633,-1.2825816,36.8092346,536,941,87,500
7089,2563,635,3,Business,16,6,45772,16,6,45820,16,6,46009,16,6,46121,16,6,47368,2,25.8,-1.2599563,36.7993439,-1.2618264,36.8141179,326,1247,48,301
7090,21502,1500,3,Business,18,4,41134,18,4,42016,18,4,42405,18,4,43419,18,4,44778,10,23.25888921888938,-1.2991441,36.7528804,-1.2638185,36.7930057,327,1359,882,1403
7091,14140,53,3,Business,15,3,31673,15,3,31753,15,3,32087,15,3,33093,15,3,34113,6,23.25888921888938,-1.3080092,36.8284543,-1.2770708,36.8231093,921,1020,80,1340
7092,24221,246,3,Business,3,4,58042,3,4,58106,3,4,60599,3,4,61531,3,4,62101,3,18.1,-1.2584143,36.8048002,-1.255956,36.789867,103,570,64,3425
7093,15045,2636,1,Personal,29,5,46423,29,5,46836,29,5,48025,29,5,48093,29,5,48510,2,19.9,-1.2979631,36.7869859,-1.2898354,36.7872703,312,417,413,1257
7094,576,517,3,Business,8,6,36475,8,6,36568,8,6,36895,8,6,37242,8,6,39020,5,16.6,-1.3228003,36.8306435,-1.3077869,36.8443207,863,1778,93,674
7095,11619,2330,3,Business,20,3,60621,20,3,60924,20,3,62123,20,3,62572,20,3,64621,12,27.9,-1.2854537,36.9051024,-1.2284323,36.8757058,126,2049,303,1648
7096,13865,2030,3,Business,3,4,35646,3,4,36355,3,4,37329,3,4,37471,3,4,37898,2,20.2,-1.328259,36.860975,-1.3333725,36.8717613,559,427,709,1116
7097,12570,3283,3,Business,25,5,48046,25,5,48059,25,5,48355,25,5,49357,25,5,50064,7,29.2,-1.2783849,36.8163445,-1.2628473,36.781805,906,707,13,1298
7098,14056,3647,3,Business,28,5,44624,28,5,44648,28,5,45025,28,5,45234,28,5,45892,5,23.7,-1.272639,36.794723,-1.2904993,36.8043877,940,658,24,586
7099,20302,1687,3,Business,22,5,56641,22,5,56666,22,5,57713,22,5,57823,22,5,58763,5,27.2,-1.2626574,36.8014034,-1.2901228,36.8234237,88,940,25,1157
7100,17479,795,3,Personal,20,4,53804,20,4,53867,20,4,54574,20,4,54964,20,4,56302,7,28.0,-1.3104734,36.7363698,-1.287429,36.786357,65,1338,63,1097
7101,5602,2987,1,Business,13,5,45312,13,5,45473,13,5,46024,13,5,46255,13,5,46986,4,23.25888921888938,-1.270212,36.8210877,-1.260232,36.807334,726,731,161,782
7102,13794,517,3,Business,29,3,47744,29,3,47823,29,3,48217,29,3,49024,29,3,49677,4,21.3,-1.3228003,36.8306435,-1.3004062,36.829741,690,653,79,1201
7103,250,136,3,Business,1,4,36028,1,4,36136,1,4,36693,1,4,36789,1,4,38221,11,23.25888921888938,-1.3326173,36.7146233,-1.2909634,36.7813995,288,1432,108,653
7104,23262,1500,3,Business,20,3,46451,20,3,46553,20,3,47518,20,3,48320,20,3,49474,10,26.4,-1.2991441,36.7528804,-1.2638185,36.7930057,858,1154,102,1767
7105,23549,53,3,Business,13,3,51550,13,3,51585,13,3,52188,13,3,53799,13,3,54835,7,29.1,-1.3012842,36.8561033,-1.2750282,36.8532236,218,1036,35,2214
7106,18292,1075,3,Business,28,1,62888,28,1,62993,28,1,63971,28,1,64490,28,1,66607,15,25.4,-1.2156006,36.8916865,-1.2527958,36.8003131,779,2117,105,1497
7107,9939,2804,3,Business,11,1,52468,11,1,52649,11,1,52950,11,1,53358,11,1,54957,5,29.1,-1.2551895,36.7822034,-1.2686558,36.7982618,655,1599,181,709
7108,23661,2700,1,Business,4,3,34284,4,3,34364,4,3,35662,4,3,36059,4,3,40171,23,15.1,-1.2757858,36.7886841,-1.3678102,36.9360455,465,4112,80,1695
7109,15130,2154,3,Business,15,2,48918,15,2,49160,15,2,49181,15,2,50008,15,2,51295,6,24.7,-1.279395,36.825364,-1.2765736,36.8513646,26,1287,242,848
7110,17994,357,3,Business,19,2,38153,19,2,38209,19,2,38433,19,2,39308,19,2,40328,6,26.8,-1.2700027,36.7669015,-1.2945179,36.7685349,268,1020,56,1099
7111,18043,1991,3,Personal,18,2,67117,18,2,67129,18,2,67289,18,2,68668,18,2,72198,12,23.8,-1.2727269,36.8298864,-1.2987787,36.7448429,569,3530,12,1539
7112,27170,3283,3,Business,31,5,32731,31,5,33008,31,5,33906,31,5,34386,31,5,35225,5,23.25888921888938,-1.2600926,36.8088685,-1.2628473,36.781805,542,839,277,1378
7113,8074,635,3,Business,3,4,33206,3,4,34923,3,4,35354,3,4,36377,3,4,37055,8,20.2,-1.3016417,36.8271679,-1.2599563,36.7993439,871,678,1717,1454
7114,17060,909,3,Business,15,5,57064,15,5,58614,15,5,59820,15,5,61735,15,5,62024,7,27.6,-1.207546,36.7913976,-1.225322,36.80855,588,289,1550,3121
7115,23593,2398,1,Personal,31,5,46776,31,5,46863,31,5,47006,31,5,47425,31,5,48768,9,17.0,-1.2574088,36.799712,-1.3004846,36.7901591,937,1343,87,562
7116,18736,2154,3,Business,26,5,53912,26,5,54784,26,5,55550,26,5,56135,26,5,59695,6,23.25888921888938,-1.2859912,36.8756811,-1.2765736,36.8513646,890,3560,872,1351
7117,23050,1075,3,Business,8,1,43269,8,1,43365,8,1,44980,8,1,45080,8,1,47826,10,28.0,-1.3014461,36.7661381,-1.2527958,36.8003131,316,2746,96,1715
7118,299,293,1,Personal,27,5,47475,27,5,47513,27,5,47993,27,5,49673,27,5,52334,15,23.8,-1.2653589,36.8090021,-1.3472066,36.7692638,620,2661,38,2160
7119,22500,391,3,Business,11,2,32586,11,2,32651,11,2,32973,11,2,34877,11,2,36389,5,16.7,-1.300921,36.828195,-1.2867454,36.8259017,448,1512,65,2226
7120,17290,1527,3,Business,4,4,44697,4,4,44765,4,4,49370,4,4,50531,4,4,50537,4,27.5,-1.2770708,36.8231093,-1.3004062,36.829741,843,6,68,5766
7121,2099,1534,2,Personal,19,2,55729,19,2,55760,19,2,56334,19,2,56783,19,2,60176,11,18.4,-1.2583017,36.8023526,-1.33013,36.83102,755,3393,31,1023
7122,19190,2330,3,Business,12,2,34002,12,2,34029,12,2,34190,12,2,34531,12,2,35754,9,20.9,-1.2649605,36.7981777,-1.3015197,36.7658456,953,1223,27,502
7123,9074,3599,3,Business,20,1,52407,20,1,55344,20,1,56578,20,1,57630,20,1,60456,17,23.25888921888938,-1.3302996,36.8707935,-1.2949439,36.7604214,591,2826,2937,2286
7124,9597,718,3,Business,4,2,54989,4,2,55344,4,2,56509,4,2,58481,4,2,60442,3,22.7,-1.2551895,36.7822034,-1.270212,36.8037249,25,1961,355,3137
7125,18619,635,3,Business,16,3,53703,16,3,54090,16,3,54545,16,3,55074,16,3,55750,7,27.1,-1.2602337,36.7990548,-1.3081376,36.8329772,675,676,387,984
7126,20781,633,3,Business,15,2,42304,15,2,42776,15,2,43461,15,2,43706,15,2,45456,9,24.3,-1.2574219,36.7927073,-1.3004062,36.829741,80,1750,472,930
7127,107,1207,3,Business,31,3,48909,31,3,48999,31,3,51321,31,3,51538,31,3,54314,14,26.8,-1.2629666,36.8068369,-1.2180795,36.87497,880,2776,90,2539
7128,23972,3194,3,Business,15,2,54652,15,2,57251,15,2,57990,15,2,59442,15,2,63920,7,24.6,-1.2811695,36.8200313,-1.2626906,36.7827022,881,4478,2599,2191
7129,12706,1500,3,Business,14,1,43938,14,1,43948,14,1,44196,14,1,44428,14,1,45295,9,23.3,-1.2574219,36.7927073,-1.3004062,36.829741,932,867,10,480
7130,4264,1500,3,Business,28,2,35148,28,2,35165,28,2,35458,28,2,36221,28,2,38718,8,18.9,-1.3004062,36.829741,-1.2638185,36.7930057,191,2497,17,1056
7131,20958,909,3,Business,14,4,48544,14,4,48687,14,4,49108,14,4,49584,14,4,50866,7,27.4,-1.2527958,36.8003131,-1.225322,36.80855,600,1282,143,897
7132,14883,867,3,Business,9,2,33747,9,2,33786,9,2,34364,9,2,35311,9,2,35942,11,20.6,-1.2770708,36.8231093,-1.2991441,36.7528804,819,631,39,1525
7133,15289,733,3,Business,30,2,43101,30,2,43112,30,2,43357,30,2,43461,30,2,45606,15,22.2,-1.2551895,36.7822034,-1.207546,36.7913976,878,2145,11,349
7134,14815,3291,3,Business,29,6,36372,29,6,36383,29,6,36584,29,6,37467,29,6,38465,5,19.2,-1.2628473,36.781805,-1.2600926,36.8088685,576,998,11,1084
7135,24361,1245,3,Business,9,2,43757,9,2,43763,9,2,43781,9,2,44353,9,2,45769,18,22.2,-1.3198615,36.7110323,-1.300921,36.828195,179,1416,6,590
7136,25351,3051,1,Personal,3,1,51372,3,1,51454,3,1,52336,3,1,52889,3,1,54316,6,23.0,-1.2702333,36.80065,-1.303664,36.818777,447,1427,82,1435
7137,20336,1346,3,Business,10,4,38464,10,4,38501,10,4,39250,10,4,39463,10,4,40495,7,23.25888921888938,-1.299813,36.7871392,-1.2695287,36.7981777,345,1032,37,962
7138,25736,1500,3,Business,29,1,57813,29,1,58547,29,1,58610,29,1,60933,29,1,61086,8,23.25888921888938,-1.3004062,36.829741,-1.2638185,36.7930057,403,153,734,2386
7139,19213,3044,3,Business,12,2,44808,12,2,44886,12,2,45513,12,2,45576,12,2,46108,4,24.4,-1.3228003,36.8306435,-1.3004062,36.829741,523,532,78,690
7140,20246,1471,3,Business,20,3,43106,20,3,43151,20,3,43201,20,3,43576,20,3,44629,9,27.3,-1.2551895,36.7822034,-1.296797,36.7764525,780,1053,45,425
7141,6107,2228,1,Personal,28,4,48134,28,4,48140,28,4,48304,28,4,48859,28,4,49593,5,23.25888921888938,-1.2601197,36.7985271,-1.2479362,36.772759,925,734,6,719
7142,28128,570,3,Business,6,4,46770,6,4,47690,6,4,49094,6,4,52490,6,4,57094,22,23.6,-1.3342256,36.9106741,-1.2551895,36.7822034,6,4604,920,4800
7143,5521,296,3,Personal,13,3,43040,13,3,44726,13,3,45306,13,3,46512,13,3,47271,7,19.9,-1.2951243,36.8281344,-1.2772632,36.7922251,241,759,1686,1786
7144,3668,3140,1,Personal,27,4,36607,27,4,36655,27,4,37514,27,4,37734,27,4,38915,10,19.0,-1.2850644,36.8343657,-1.2832325,36.7676728,208,1181,48,1079
7145,3211,136,3,Business,19,1,51232,19,1,51243,19,1,53479,19,1,53835,19,1,56033,11,25.1,-1.3326173,36.7146233,-1.2857671,36.7875614,874,2198,11,2592
7146,4170,3218,3,Business,7,4,59441,7,4,60349,7,4,60353,7,4,60469,7,4,61581,9,17.7,-1.2927792,36.9053492,-1.2765736,36.8513646,589,1112,908,120
7147,4003,1304,3,Business,30,2,43665,30,2,43687,30,2,44632,30,2,44772,30,2,48973,13,22.1,-1.3332749,36.8708147,-1.2697141,36.7981777,544,4201,22,1085
7148,12930,3404,3,Business,16,6,55364,16,6,56335,16,6,57946,16,6,58048,16,6,59626,6,23.25888921888938,-1.279395,36.825364,-1.3185736,36.8258933,448,1578,971,1713
7149,3720,2962,1,Personal,9,1,40257,9,1,40862,9,1,42509,9,1,42572,9,1,43466,8,20.4,-1.2789902,36.7650115,-1.2886923,36.8241519,102,894,605,1710
7150,19670,108,1,Personal,23,3,60198,23,3,60584,23,3,61139,23,3,61761,23,3,63229,11,20.5,-1.2762223,36.8009675,-1.3210622,36.802019,633,1468,386,1177
7151,2262,1882,3,Business,20,7,32014,20,7,32039,20,7,33378,20,7,34313,20,7,36198,15,21.8,-1.2273427,36.7994683,-1.2160907,36.8851949,512,1885,25,2274
7152,18194,1379,1,Personal,9,7,30408,9,7,30996,9,7,31831,9,7,32070,9,7,34589,17,19.0,-1.3178903,36.8414491,-1.2363092,36.8823617,543,2519,588,1074
7153,17823,1809,3,Business,11,4,56268,11,4,56321,11,4,56737,11,4,57259,11,4,57803,1,27.0,-1.2649605,36.7981777,-1.2571472,36.7950633,699,544,53,938
7154,4050,3067,1,Personal,10,1,72511,10,1,72533,10,1,73992,10,1,74616,10,1,76024,10,18.8,-1.2615584,36.8149506,-1.3251584,36.8199384,517,1408,22,2083
7155,13024,3291,3,Business,29,6,43628,29,6,43653,29,6,44093,29,6,44850,29,6,45975,12,23.8,-1.228911,36.881876,-1.2600926,36.8088685,698,1125,25,1197
7156,12696,517,3,Business,7,1,44565,7,1,47031,7,1,48518,7,1,48655,7,1,48658,4,24.7,-1.3167113,36.8301563,-1.3004062,36.829741,436,3,2466,1624
7157,9498,1271,3,Business,21,4,47484,21,4,48543,21,4,50708,21,4,51233,21,4,53983,27,31.0,-1.3949989,36.7654761,-1.3244885,36.897792,628,2750,1059,2690
7158,2349,928,3,Business,30,2,55126,30,2,60786,30,2,60828,30,2,61014,30,2,63283,6,23.25888921888938,-1.2551895,36.7822034,-1.285324,36.812901,800,2269,5660,228
7159,2663,3752,3,Business,14,2,42494,14,2,42536,14,2,44018,14,2,44320,14,2,45284,3,23.25888921888938,-1.304081,36.777099,-1.2962832,36.7849683,952,964,42,1784
7160,16093,3016,1,Personal,23,1,38181,23,1,38191,23,1,39579,23,1,39721,23,1,40974,9,18.3,-1.2937028,36.7874493,-1.269199,36.8236418,956,1253,10,1530
7161,18081,136,3,Business,7,5,46814,7,5,46915,7,5,48164,7,5,48816,7,5,50722,9,23.25888921888938,-1.2654716,36.7983635,-1.2313147,36.8016863,55,1906,101,1901
7162,11657,635,3,Business,31,4,46060,31,4,46082,31,4,46412,31,4,47090,31,4,48592,4,26.5,-1.3012141,36.826224,-1.2907474,36.8453439,206,1502,22,1008
7163,24803,635,3,Business,24,4,45290,24,4,45320,24,4,45443,24,4,47739,24,4,47861,8,24.3,-1.3081376,36.8329772,-1.2602337,36.7990548,70,122,30,2419
7164,18870,60,3,Business,12,5,40857,12,5,41033,12,5,41691,12,5,42118,12,5,43841,8,24.3,-1.272828,36.816608,-1.2296618,36.8438272,453,1723,176,1085
7165,6669,2169,2,Personal,11,5,59538,11,5,59893,11,5,61062,11,5,61205,11,5,63420,9,20.3,-1.311208,36.778743,-1.2613754,36.795771,742,2215,355,1312
7166,14880,1245,3,Business,14,5,35469,14,5,35482,14,5,35506,14,5,37327,14,5,39177,17,16.9,-1.300921,36.828195,-1.3198615,36.7110323,515,1850,13,1845
7167,4740,2632,1,Personal,9,2,30676,9,2,30707,9,2,31665,9,2,31880,9,2,33715,12,17.5,-1.2871085,36.8303905,-1.265952,36.8842106,532,1835,31,1173
7168,14491,435,3,Business,14,5,55503,14,5,55528,14,5,55532,14,5,58045,14,5,58547,6,23.1,-1.300921,36.828195,-1.3264614,36.8472485,669,502,25,2517
7169,11653,3283,3,Business,24,5,54670,24,5,54684,24,5,54862,24,5,55234,24,5,55797,4,22.9,-1.266837,36.799249,-1.2628473,36.781805,770,563,14,550
7170,20214,2676,3,Business,18,5,43645,18,5,43657,18,5,43930,18,5,46056,18,5,47064,2,20.0,-1.2969741,36.7856612,-1.2963097,36.7688221,559,1008,12,2399
7171,20680,1856,3,Business,23,4,57528,23,4,57550,23,4,57883,23,4,58166,23,4,58711,4,20.6,-1.273009,36.802807,-1.263987,36.798891,620,545,22,616
7172,18137,2200,3,Business,23,5,62161,23,5,62443,23,5,62719,23,5,63246,23,5,66990,7,24.4,-1.2668734,36.8054026,-1.3124088,36.8252715,775,3744,282,803
7173,13688,3560,3,Business,8,2,41813,8,2,41844,8,2,42538,8,2,43089,8,2,43737,2,23.4,-1.279395,36.825364,-1.290894,36.822971,720,648,31,1245
7174,1520,867,3,Business,6,3,27358,6,3,27423,6,3,28208,6,3,28557,6,3,29923,9,16.8,-1.2638185,36.7930057,-1.2991441,36.7528804,523,1366,65,1134
7175,606,2523,3,Business,4,1,39754,4,1,39764,4,1,40233,4,1,40380,4,1,42645,20,25.5,-1.2551895,36.7822034,-1.1541755,36.7454964,131,2265,10,616
7176,14936,542,3,Personal,18,4,47181,18,4,47188,18,4,47518,18,4,47900,18,4,49330,17,25.5,-1.3340618,36.7108942,-1.283527,36.8236512,409,1430,7,712
7177,4414,2523,3,Business,20,4,52924,20,4,53310,20,4,53343,20,4,53716,20,4,55412,18,25.4,-1.2551895,36.7822034,-1.2198413,36.9054958,387,1696,386,406
7178,17334,3647,3,Business,30,2,53696,30,2,54194,30,2,55511,30,2,56019,30,2,58675,17,23.25888921888938,-1.272639,36.794723,-1.2242729,36.8880921,831,2656,498,1825
7179,21387,302,3,Business,10,1,54616,10,1,54738,10,1,55017,10,1,55794,10,1,56538,4,23.25888921888938,-1.2649605,36.7981777,-1.2767473,36.8095371,882,744,122,1056
7180,8423,391,3,Business,1,1,38433,1,1,40391,1,1,41273,1,1,42519,1,1,44298,18,23.25888921888938,-1.3958588,36.7701901,-1.2867454,36.8259017,411,1779,1958,2128
7181,14770,3560,3,Business,14,4,47829,14,4,47982,14,4,48865,14,4,49024,14,4,50684,7,27.4,-1.279395,36.825364,-1.3222535,36.8246176,291,1660,153,1042
7182,25130,3466,2,Personal,21,5,39705,21,5,39730,21,5,41445,21,5,42029,21,5,42888,6,19.8,-1.2245407,36.7583778,-1.2533103,36.8057423,144,859,25,2299
7183,18324,2587,3,Business,24,3,56661,24,3,57722,24,3,58373,24,3,58597,24,3,59413,5,18.5,-1.2584143,36.8048002,-1.28878,36.8168312,88,816,1061,875
7184,3690,1651,3,Business,8,5,45969,8,5,46152,8,5,46587,8,5,47051,8,5,48599,14,28.3,-1.2551895,36.7822034,-1.3263105,36.8622904,205,1548,183,899
7185,4332,101,2,Personal,18,5,50983,18,5,52675,18,5,52996,18,5,53549,18,5,54761,6,24.2,-1.2868973,36.8232984,-1.2872058,36.7802742,644,1212,1692,874
7186,27050,2174,3,Business,29,6,40354,29,6,40358,29,6,40597,29,6,43477,29,6,47252,33,25.1,-1.2482781,36.884092,-1.324878,36.7070285,946,3775,4,3119
7187,19837,1849,3,Business,30,2,51542,30,2,52873,30,2,52900,30,2,53076,30,2,53937,7,27.4,-1.290894,36.822971,-1.2571472,36.7950633,726,861,1331,203
7188,7135,2982,3,Business,3,3,44504,3,3,44543,3,3,44562,3,3,48234,3,3,49968,18,23.9,-1.300921,36.828195,-1.177202,36.8351183,120,1734,39,3691
7189,20578,1280,3,Business,28,4,46774,28,4,46798,28,4,47228,28,4,48213,28,4,49713,10,23.8,-1.2551895,36.7822034,-1.2975066,36.7689423,831,1500,24,1415
7190,9244,3647,3,Business,30,4,50423,30,4,50499,30,4,51657,30,4,51914,30,4,53127,6,23.25888921888938,-1.272639,36.794723,-1.2972916,36.7880497,868,1213,76,1415
7191,9917,53,3,Business,25,4,34595,25,4,34615,25,4,34998,25,4,35564,25,4,36470,7,23.25888921888938,-1.2638185,36.7930057,-1.2770708,36.8231093,76,906,20,949
7192,9016,867,3,Business,7,4,49925,7,4,49950,7,4,49998,7,4,50915,7,4,52344,10,27.7,-1.3004062,36.829741,-1.2991441,36.7528804,914,1429,25,965
7193,15479,3135,3,Personal,12,2,63868,12,2,63891,12,2,65315,12,2,66582,12,2,69898,9,26.7,-1.2803877,36.8300596,-1.2856319,36.7672998,953,3316,23,2691
7194,15703,3232,3,Business,2,3,43313,2,3,43327,2,3,43440,2,3,43783,2,3,47362,4,23.9,-1.2551895,36.7822034,-1.27267,36.8124492,191,3579,14,456
7195,15338,2763,3,Business,23,3,41696,23,3,41735,23,3,41997,23,3,42891,23,3,44015,6,23.25888921888938,-1.273733,36.818022,-1.2551895,36.7822034,31,1124,39,1156
7196,2649,3647,3,Business,5,1,46667,5,1,46735,5,1,47444,5,1,47656,5,1,48570,4,24.4,-1.272639,36.794723,-1.2569503,36.7834728,905,914,68,921
7197,27174,59,3,Business,7,4,53683,7,4,53702,7,4,54240,7,4,55248,7,4,57992,6,31.1,-1.290894,36.822971,-1.2726925,36.7951829,831,2744,19,1546
7198,7201,517,3,Business,6,4,57134,6,4,58176,6,4,58573,6,4,59136,6,4,61419,10,23.25888921888938,-1.3177547,36.8303703,-1.2574219,36.7927073,523,2283,1042,960
7199,26729,2989,3,Business,23,1,54519,23,1,54527,23,1,54904,23,1,56915,23,1,59369,15,23.25888921888938,-1.2571472,36.7950633,-1.3404187,36.7614685,770,2454,8,2388
7200,25641,3565,3,Business,3,7,48962,3,7,48968,3,7,49457,3,7,49705,3,7,52641,29,30.2,-1.2844665,36.7866113,-1.1428716,36.962347,206,2936,6,737
7201,20147,3001,3,Business,29,3,50640,29,3,51037,29,3,51280,29,3,51584,29,3,52241,3,19.1,-1.2846195,36.7958316,-1.2922689,36.7760763,670,657,397,547
7202,556,1207,3,Business,23,5,64576,23,5,64657,23,5,65482,23,5,65688,23,5,67477,8,24.7,-1.2628638,36.8070399,-1.2745321,36.765088,829,1789,81,1031
7203,26077,3686,3,Business,7,5,46164,7,5,46195,7,5,46230,7,5,46518,7,5,47112,3,25.2,-1.2551895,36.7822034,-1.265338,36.8088155,630,594,31,323
7204,27205,552,3,Business,2,4,55527,2,4,55570,2,4,57519,2,4,58221,2,4,59573,16,23.25888921888938,-1.2859912,36.8756811,-1.3562374,36.9042954,126,1352,43,2651
7205,3032,393,3,Business,11,1,52423,11,1,52533,11,1,52563,11,1,53754,11,1,54795,11,28.7,-1.3167113,36.8301563,-1.2638185,36.7930057,809,1041,110,1221
7206,6313,788,3,Business,28,1,43021,28,1,43094,28,1,44202,28,1,45199,28,1,46966,6,23.8,-1.225322,36.80855,-1.2608592,36.8311977,547,1767,73,2105
7207,3158,1584,3,Business,10,5,44919,10,5,45290,10,5,46231,10,5,46897,10,5,48475,7,19.2,-1.2767864,36.8213306,-1.2969741,36.7856612,88,1578,371,1607
7208,20844,706,3,Business,7,1,37400,7,1,37568,7,1,37598,7,1,37840,7,1,38146,3,21.6,-1.3077869,36.8443207,-1.3080092,36.8284543,627,306,168,272
7209,19228,3496,3,Business,13,4,43991,13,4,47435,13,4,47457,13,4,48682,13,4,49600,5,21.8,-1.300921,36.828195,-1.2780878,36.8469436,340,918,3444,1247
7210,27012,982,3,Business,22,5,50801,22,5,51803,22,5,53652,22,5,54479,22,5,56593,15,27.2,-1.2517871,36.6795716,-1.2614987,36.7905804,588,2114,1002,2676
7211,1552,788,3,Business,19,3,43422,19,3,43537,19,3,44349,19,3,47379,19,3,48616,9,22.1,-1.2551895,36.7822034,-1.225322,36.80855,125,1237,115,3842
7212,1755,207,3,Personal,30,3,53669,30,3,53708,30,3,54633,30,3,54887,30,3,58410,37,25.2,-1.2928928,36.79455849,-1.0924846,37.0108117,543,3523,39,1179
7213,26214,1329,3,Business,28,3,45223,28,3,45242,28,3,45600,28,3,46003,28,3,46830,5,23.25888921888938,-1.273056,36.811298,-1.2956951,36.8129242,45,827,19,761
7214,20943,1075,3,Business,28,4,42994,28,4,43042,28,4,44065,28,4,45403,28,4,45410,3,28.2,-1.2551895,36.7822034,-1.2527958,36.8003131,658,7,48,2361
7215,6637,3674,3,Business,30,2,48952,30,2,49127,30,2,50125,30,2,50554,30,2,53203,15,23.25888921888938,-1.2551895,36.7822034,-1.3329777,36.866203,418,2649,175,1427
7216,8746,2328,2,Personal,7,2,32743,7,2,32755,7,2,34355,7,2,34640,7,2,36271,13,16.5,-1.2423801,36.8478805,-1.22589,36.7822548,124,1631,12,1885
7217,24743,190,3,Business,18,4,37975,18,4,40203,18,4,40927,18,4,41108,18,4,41891,5,25.7,-1.3382857,36.8870715,-1.3270347,36.8667362,532,783,2228,905
7218,2582,1687,3,Business,28,3,35181,28,3,35202,28,3,35543,28,3,36422,28,3,37203,2,20.5,-1.2962832,36.7849683,-1.2944172,36.8002562,612,781,21,1220
7219,7320,3662,1,Personal,25,5,38260,25,5,38358,25,5,39002,25,5,39124,25,5,40801,9,21.1,-1.2819711,36.8097934,-1.3215473,36.8435326,749,1677,98,766
7220,1442,872,3,Business,20,3,53299,20,3,53367,20,3,54049,20,3,54519,20,3,55400,5,23.0,-1.2674001,36.7986537,-1.2807481,36.7765481,322,881,68,1152
7221,14727,3358,2,Personal,17,4,53863,17,4,54172,17,4,54748,17,4,55524,17,4,56210,7,23.8,-1.2869217,36.7732203,-1.2682322,36.7935927,101,686,309,1352
7222,17899,1473,3,Business,14,1,43985,14,1,44001,14,1,44755,14,1,45086,14,1,50009,32,23.6,-1.3700383,36.9190174,-1.2489594,36.7358883,620,4923,16,1085
7223,1524,2330,3,Business,22,3,65781,22,3,65797,22,3,65839,22,3,65914,22,3,67077,2,24.1,-1.294597,36.7742999,-1.3015197,36.7658456,362,1163,16,117
7224,6818,3689,3,Business,26,5,51608,26,5,51614,26,5,52135,26,5,52351,26,5,53170,2,23.25888921888938,-1.2615888,36.7928732,-1.2527958,36.8003131,228,819,6,737
7225,17781,420,3,Business,19,3,54932,19,3,55738,19,3,56306,19,3,56437,19,3,58690,10,24.2,-1.2517448,36.7924971,-1.3043821,36.7840586,65,2253,806,699
7226,7137,2154,3,Business,28,3,55250,28,3,55560,28,3,57300,28,3,57639,28,3,59440,16,23.25888921888938,-1.207546,36.7913976,-1.2765736,36.8513646,504,1801,310,2079
7227,19937,540,3,Business,18,5,51379,18,5,53540,18,5,54143,18,5,54280,18,5,55906,8,27.1,-1.2551895,36.7822034,-1.2824911,36.8218042,250,1626,2161,740
7228,10644,2982,3,Business,13,4,31565,13,4,32485,13,4,34189,13,4,35660,13,4,38077,18,18.3,-1.177202,36.8351183,-1.300921,36.828195,31,2417,920,3175
7229,4895,2439,3,Business,27,2,50483,27,2,50499,27,2,50627,27,2,53032,27,2,54196,4,25.4,-1.2551895,36.7822034,-1.2689924,36.798157,812,1164,16,2533
7230,18469,111,3,Business,10,2,55718,10,2,55743,10,2,56406,10,2,56612,10,2,59454,10,21.1,-1.2551895,36.7822034,-1.2380935,36.8072947,467,2842,25,869
7231,25634,1237,3,Personal,23,3,32178,23,3,32193,23,3,32676,23,3,32915,23,3,34013,3,16.9,-1.2741728,36.7969108,-1.2611987,36.8060913,50,1098,15,722
7232,17433,1596,1,Personal,12,4,47803,12,4,47814,12,4,48672,12,4,49697,12,4,50446,8,21.6,-1.2918239,36.8235665,-1.25537,36.7756,629,749,11,1883
7233,10002,2876,1,Personal,3,2,41704,3,2,41717,3,2,41918,3,2,42259,3,2,43011,6,18.4,-1.2684239,36.7952462,-1.2944292,36.7793569,103,752,13,542
7234,2084,2200,3,Business,7,5,51129,7,5,60763,7,5,61147,7,5,62690,7,5,63658,6,22.9,-1.2649605,36.7981777,-1.290894,36.822971,267,968,9634,1927
7235,6547,3635,1,Business,9,2,39094,9,2,39928,9,2,40058,9,2,40740,9,2,43864,11,22.2,-1.2615888,36.7928732,-1.2538004,36.7303906,956,3124,834,812
7236,20227,517,3,Business,7,1,39929,7,1,39978,7,1,40004,7,1,43261,7,1,43280,14,24.7,-1.3167113,36.8301563,-1.306378,36.7519845,515,19,49,3283
7237,26743,2330,3,Business,4,2,55086,4,2,55475,4,2,55982,4,2,56483,4,2,57690,8,22.5,-1.3015197,36.7658456,-1.3192789,36.7112991,155,1207,389,1008
7238,23626,1287,3,Business,28,4,66198,28,4,66222,28,4,66519,28,4,66618,28,4,67834,3,27.9,-1.2584143,36.8048002,-1.2551895,36.7822034,452,1216,24,396
7239,6264,1086,3,Business,21,5,52474,21,5,52484,21,5,52925,21,5,53109,21,5,54416,6,24.8,-1.2653185,36.8358841,-1.259213,36.811003,231,1307,10,625
7240,25065,1544,3,Business,1,6,44730,1,6,44730,1,6,44763,1,6,46797,1,6,47180,4,23.25888921888938,-1.2994817,36.819316,-1.2923738,36.7987236,206,383,0,2067
7241,15571,2330,3,Business,7,4,44682,7,4,44693,7,4,45093,7,4,45457,7,4,46669,9,24.1,-1.2642903,36.8002137,-1.2326041,36.8009029,953,1212,11,764
7242,7006,2089,3,Business,1,5,48153,1,5,48177,1,5,49425,1,5,49724,1,5,51557,11,31.8,-1.3322618,36.8045412,-1.2610722,36.8147074,164,1833,24,1547
7243,8493,570,3,Business,30,5,57453,30,5,58472,30,5,58710,30,5,58909,30,5,59443,3,24.8,-1.2551895,36.7822034,-1.2527958,36.8003131,913,534,1019,437
7244,13101,2069,3,Business,14,2,45408,14,2,45476,14,2,45851,14,2,46602,14,2,47306,9,23.25888921888938,-1.265715,36.823815,-1.228911,36.881876,845,704,68,1126
7245,18103,1583,3,Business,3,3,51838,3,3,51866,3,3,53979,3,3,55787,3,3,57475,21,28.3,-1.3700383,36.9190174,-1.2917868,36.7872675,863,1688,28,3921
7246,22056,1259,3,Business,5,1,41241,5,1,41249,5,1,43745,5,1,43936,5,1,47701,25,24.6,-1.2359565,36.7622728,-1.3478563,36.8935824,870,3765,8,2687
7247,15645,1724,3,Business,5,2,55535,5,2,55567,5,2,58036,5,2,58868,5,2,59625,3,23.25888921888938,-1.259382,36.807205,-1.2551895,36.7822034,755,757,32,3301
7248,24513,3326,3,Business,18,4,42697,18,4,42742,18,4,43443,18,4,44067,18,4,47241,21,23.25888921888938,-1.2527958,36.8003131,-1.3351305,36.9184161,166,3174,45,1325
7249,19560,134,3,Business,20,3,49531,20,3,49548,20,3,49581,20,3,50670,20,3,52875,16,28.6,-1.2609745,36.7886626,-1.207546,36.7913976,955,2205,17,1122
7250,15401,3536,1,Personal,11,4,34722,11,4,34775,11,4,35620,11,4,37180,11,4,38652,13,18.4,-1.2782261,36.8225009,-1.2035228,36.7772505,726,1472,53,2405
7251,25847,3698,3,Business,10,1,47489,10,1,47540,10,1,48630,10,1,49041,10,1,50130,14,18.3,-1.3244885,36.897792,-1.3073569,36.8202163,883,1089,51,1501
7252,20531,3080,3,Business,30,5,38274,30,5,38705,30,5,39544,30,5,39763,30,5,40951,9,23.5,-1.2551895,36.7822034,-1.2948835,36.7830474,259,1188,431,1058
7253,15406,868,3,Business,23,6,51998,23,6,52016,23,6,52166,23,6,53192,23,6,54130,7,28.1,-1.2628473,36.781805,-1.265715,36.823815,489,938,18,1176
7254,5441,1304,3,Business,3,1,47676,3,1,47686,3,1,49357,3,1,51027,3,1,52534,17,22.8,-1.2859912,36.8756811,-1.2646084,36.8028645,179,1507,10,3341
7255,21265,3560,3,Business,15,1,46135,15,1,46227,15,1,46370,15,1,46630,15,1,46696,2,23.25888921888938,-1.2813012,36.8323962,-1.279395,36.825364,99,66,92,403
7256,14504,53,3,Business,31,2,45498,31,2,45503,31,2,45603,31,2,47455,31,2,48109,4,18.5,-1.2770708,36.8231093,-1.3004062,36.829741,927,654,5,1952
7257,19440,2330,3,Business,20,3,53978,20,3,56191,20,3,56785,20,3,56908,20,3,57982,8,28.3,-1.2124582,36.802894,-1.2324923,36.8363775,131,1074,2213,717
7258,10036,20,3,Business,22,5,47221,22,5,47258,22,5,47618,22,5,47784,22,5,49239,3,23.25888921888938,-1.2629666,36.8068369,-1.274927,36.8028302,354,1455,37,526
7259,16688,2899,3,Personal,17,1,59001,17,1,59017,17,1,60061,17,1,60587,17,1,61096,1,25.7,-1.3014461,36.7661381,-1.298762,36.7636456,101,509,16,1570
7260,17866,2330,3,Business,29,3,64771,29,3,64794,29,3,65373,29,3,65597,29,3,65599,5,21.3,-1.3040812,36.7924217,-1.2890715,36.8157588,800,2,23,803
7261,4919,2008,3,Business,10,5,52448,10,5,54209,10,5,54994,10,5,55548,10,5,57451,6,23.25888921888938,-1.2508229,36.7895263,-1.2881035,36.8142095,815,1903,1761,1339
7262,21695,2216,3,Business,22,5,47050,22,5,47083,22,5,48477,22,5,49670,22,5,53433,10,27.1,-1.2551895,36.7822034,-1.3108783,36.8392726,48,3763,33,2587
7263,18446,71,3,Business,5,2,53846,5,2,53896,5,2,54612,5,2,55425,5,2,56582,6,22.8,-1.2601709,36.8002238,-1.2821108,36.8250555,742,1157,50,1529
7264,25917,3372,3,Business,4,3,58862,4,3,59256,4,3,59497,4,3,60028,4,3,61978,11,23.25888921888938,-1.3169591,36.7000029,-1.304033,36.7848695,45,1950,394,772
7265,26241,1271,3,Business,1,5,33051,1,5,33098,1,5,33970,1,5,34766,1,5,35575,7,23.3,-1.3244885,36.897792,-1.2911643,36.8772933,459,809,47,1668
7266,14894,2425,1,Personal,6,1,45922,6,1,45933,6,1,46224,6,1,46429,6,1,47091,5,20.7,-1.3195185,36.8180902,-1.2840002,36.829922,343,662,11,496
7267,25123,3424,1,Personal,4,2,55136,4,2,55829,4,2,57895,4,2,58003,4,2,60165,7,20.3,-1.2940713,36.7890758,-1.2891615,36.7305665,350,2162,693,2174
7268,9519,2526,3,Personal,22,5,33080,22,5,33094,22,5,33110,22,5,36463,22,5,36949,4,23.25888921888938,-1.2999944,36.758729,-1.3104734,36.7363698,523,486,14,3369
7269,7716,1280,3,Business,18,4,49546,18,4,49575,18,4,50019,18,4,50120,18,4,52308,16,26.9,-1.2551895,36.7822034,-1.3291454,36.7123591,532,2188,29,545
7270,13880,2828,3,Business,16,6,43612,16,6,43655,16,6,43841,16,6,44713,16,6,45270,3,19.0,-1.263987,36.798891,-1.2615888,36.7928732,598,557,43,1058
7271,20149,1588,3,Business,8,5,56670,8,5,58971,8,5,61357,8,5,64590,8,5,66485,7,28.0,-1.2897399,36.8270975,-1.2551895,36.7822034,448,1895,2301,5619
7272,14625,867,3,Business,12,5,34395,12,5,34439,12,5,35797,12,5,37778,12,5,37783,11,21.7,-1.2770708,36.8231093,-1.2991441,36.7528804,99,5,44,3339
7273,15393,135,1,Personal,14,4,52018,14,4,54587,14,4,56360,14,4,56825,14,4,57647,6,21.3,-1.2631187,36.7889654,-1.2919323,36.7659602,45,822,2569,2238
7274,24687,510,3,Business,31,5,59629,31,5,60349,31,5,60729,31,5,61246,31,5,62495,10,23.8,-1.2765736,36.8513646,-1.2860183,36.8975338,291,1249,720,897
7275,4460,2042,3,Business,7,2,41518,7,2,41552,7,2,41903,7,2,42379,7,2,45134,19,23.1,-1.2860183,36.8975338,-1.2551895,36.7822034,900,2755,34,827
7276,17231,1249,3,Business,24,6,50906,24,6,50921,24,6,51531,24,6,56572,24,6,58311,11,27.1,-1.3681253,36.9155298,-1.3189252,36.8617269,612,1739,15,5651
7277,17603,142,3,Business,27,1,33502,27,1,33522,27,1,35183,27,1,35282,27,1,36690,6,17.9,-1.2857723,36.8088058,-1.2963097,36.7688221,341,1408,20,1760
7278,9636,1646,3,Business,23,2,39344,23,2,39362,23,2,39495,23,2,40527,23,2,45021,24,23.25888921888938,-1.3006954,36.7416164,-1.2285835,36.8826468,800,4494,18,1165
7279,8671,2102,3,Business,30,4,37302,30,4,37317,30,4,39532,30,4,39878,30,4,41590,14,23.25888921888938,-1.3250048,36.8697188,-1.2613768,36.8019418,25,1712,15,2561
7280,10440,2801,3,Business,29,3,44083,29,3,44151,29,3,44514,29,3,44710,29,3,47023,26,23.25888921888938,-1.2674274,36.7870827,-1.34364,36.8925345,432,2313,68,559
7281,13411,2521,3,Business,11,6,36573,11,6,37492,11,6,38484,11,6,43795,11,6,44545,5,20.9,-1.3177547,36.8303703,-1.3077869,36.8443207,223,750,919,6303
7282,12245,1075,3,Business,14,4,42686,14,4,44039,14,4,44168,14,4,44450,14,4,45980,9,23.9,-1.2765736,36.8513646,-1.2527958,36.8003131,448,1530,1353,411
7283,5437,3772,1,Personal,13,3,42302,13,3,42351,13,3,42424,13,3,42854,13,3,43877,7,19.9,-1.3054347,36.8242029,-1.274716,36.789582,116,1023,49,503
7284,4673,496,3,Business,28,2,56245,28,2,56299,28,2,56649,28,2,57079,28,2,57596,2,23.7,-1.2551895,36.7822034,-1.2561334,36.7990458,407,517,54,780
7285,17264,3599,3,Business,28,4,52277,28,4,52331,28,4,55901,28,4,57256,28,4,57353,7,27.5,-1.3302996,36.8707935,-1.3094481,36.8652486,459,97,54,4925
7286,11078,1410,3,Business,3,4,43621,3,4,43627,3,4,43646,3,4,44906,3,4,46842,20,22.0,-1.300921,36.828195,-1.2847613,36.967084,581,1936,6,1279
7287,12601,496,3,Business,28,5,59207,28,5,59309,28,5,59352,28,5,60379,28,5,62111,8,23.25888921888938,-1.2571472,36.7950633,-1.2696795,36.8640088,31,1732,102,1070
7288,24074,1584,3,Business,25,1,42890,25,1,42909,25,1,43639,25,1,43810,25,1,44628,4,27.3,-1.2969741,36.7856612,-1.2857117,36.7968296,138,818,19,901
7289,16708,2801,3,Business,7,1,55485,7,1,55521,7,1,56797,7,1,56925,7,1,60036,13,20.4,-1.2595422,36.7871178,-1.3288576,36.8465936,510,3111,36,1404
7290,7275,3381,3,Business,1,4,61236,1,4,62359,1,4,63442,1,4,63798,1,4,64903,5,23.25888921888938,-1.279662,36.814902,-1.3172551,36.8208701,554,1105,1123,1439
7291,26606,517,3,Business,28,5,29505,28,5,29531,28,5,29537,28,5,30838,28,5,30839,4,19.3,-1.3167113,36.8301563,-1.3004062,36.829741,515,1,26,1307
7292,7752,3647,3,Business,9,3,33310,9,3,33940,9,3,34390,9,3,35975,9,3,37620,6,20.3,-1.272639,36.794723,-1.2897399,36.8270975,828,1645,630,2035
7293,18766,1927,3,Business,11,5,56047,11,5,56055,11,5,56145,11,5,56222,11,5,57788,12,26.4,-1.3472066,36.7692638,-1.2866012,36.8195691,649,1566,8,167
7294,22382,3560,3,Business,28,4,55158,28,4,55181,28,4,57178,28,4,58493,28,4,58502,6,27.3,-1.279395,36.825364,-1.2571472,36.7950633,569,9,23,3312
7295,10218,3295,3,Business,8,2,50212,8,2,50233,8,2,50589,8,2,51368,8,2,52094,3,25.5,-1.2571472,36.7950633,-1.2753902,36.808223,509,726,21,1135
7296,5947,265,3,Business,11,4,46978,11,4,47032,11,4,48470,11,4,48927,11,4,49577,4,26.9,-1.300921,36.828195,-1.295162,36.8115914,855,650,54,1895
7297,27963,2627,3,Business,13,3,35511,13,3,35604,13,3,37058,13,3,37226,13,3,39947,8,20.2,-1.225322,36.80855,-1.2571472,36.7950633,660,2721,93,1622
7298,26902,1245,3,Business,15,5,52717,15,5,52783,15,5,52885,15,5,57124,15,5,57132,18,17.8,-1.3198615,36.7110323,-1.300921,36.828195,404,8,66,4341
7299,20237,1750,1,Personal,29,5,51428,29,5,51438,29,5,51616,29,5,54743,29,5,58155,34,21.3,-1.413547,36.9550764,-1.2675351,36.7456136,919,3412,10,3305
7300,17650,3647,3,Business,6,4,33183,6,4,33312,6,4,33917,6,4,34170,6,4,35002,7,18.6,-1.272639,36.794723,-1.2533103,36.8057423,720,832,129,858
7301,23578,533,3,Business,26,1,61147,26,1,61162,26,1,61443,26,1,61661,26,1,62405,6,20.2,-1.2551895,36.7822034,-1.2765492,36.7669809,290,744,15,499
7302,17908,1117,1,Personal,28,6,45286,28,6,45304,28,6,46255,28,6,48917,28,6,49910,10,24.9,-1.307726,36.839117,-1.3472066,36.7692638,754,993,18,3613
7303,28179,517,3,Business,28,5,34944,28,5,34967,28,5,35174,28,5,35937,28,5,36760,11,19.5,-1.3167113,36.8301563,-1.2574219,36.7927073,523,823,23,970
7304,2797,65,1,Personal,16,2,51791,16,2,51983,16,2,52477,16,2,52788,16,2,54742,7,27.4,-1.2684319,36.8165853,-1.2943401,36.7872661,22,1954,192,805
7305,7666,3647,3,Business,5,1,58174,5,1,59900,5,1,60400,5,1,60589,5,1,61468,6,24.6,-1.272639,36.794723,-1.2902141,36.7714825,722,879,1726,689
7306,18817,1527,3,Business,6,4,44875,6,4,44920,6,4,44922,6,4,45502,6,4,45503,4,19.7,-1.3077869,36.8443207,-1.3004062,36.829741,293,1,45,582
7307,23479,1075,3,Business,13,3,47478,13,3,47603,13,3,48460,13,3,48977,13,3,50309,5,29.0,-1.2527958,36.8003131,-1.281385,36.8176006,76,1332,125,1374
7308,21596,2207,3,Business,23,5,41290,23,5,41422,23,5,41670,23,5,42245,23,5,42718,2,24.0,-1.2684667,36.8002891,-1.2768326,36.8073804,720,473,132,823
7309,6034,1482,3,Business,17,5,54239,17,5,54373,17,5,55210,17,5,56977,17,5,58062,11,23.25888921888938,-1.2409346,36.8743053,-1.2649605,36.7981777,419,1085,134,2604
7310,16324,1422,3,Business,28,5,57451,28,5,57472,28,5,58655,28,5,59707,28,5,62372,10,23.25888921888938,-1.307774,36.8407541,-1.3053865,36.8917332,731,2665,21,2235
7311,8459,2008,3,Business,15,4,40144,15,4,40214,15,4,42334,15,4,46347,15,4,46350,22,24.3,-1.2508229,36.7895263,-1.2070577,36.9206406,717,3,70,6133
7312,2259,393,3,Business,14,2,46576,14,2,46627,14,2,47082,14,2,47479,14,2,49351,14,23.25888921888938,-1.3167113,36.8301563,-1.2991441,36.7528804,328,1872,51,852
7313,7761,685,3,Business,10,1,50715,10,1,50913,10,1,51424,10,1,51676,10,1,53547,5,18.2,-1.265432,36.795034,-1.2876365,36.816096,778,1871,198,763
7314,485,598,1,Business,19,6,48445,19,6,48470,19,6,48896,19,6,49131,19,6,51655,24,24.0,-1.2248308,36.8012573,-1.3157001,36.7075432,103,2524,25,661
7315,16477,2532,3,Business,4,3,35518,4,3,35526,4,3,35552,4,3,37748,4,3,38306,2,14.8,-1.2579304,36.8019667,-1.2753109,36.8130185,379,558,8,2222
7316,25519,970,3,Business,28,4,34830,28,4,34857,28,4,34899,28,4,35342,28,4,35395,2,22.7,-1.2551895,36.7822034,-1.2567251,36.798841,523,53,27,485
7317,8527,3264,3,Business,17,3,52890,17,3,53086,17,3,53162,17,3,53501,17,3,54170,6,23.25888921888938,-1.2551895,36.7822034,-1.2882462,36.8164538,291,669,196,415
7318,3387,633,3,Business,18,1,43582,18,1,43622,18,1,43743,18,1,45187,18,1,46196,9,27.9,-1.2638185,36.7930057,-1.3004062,36.829741,154,1009,40,1565
7319,10968,948,3,Business,28,2,31101,28,2,31144,28,2,31452,28,2,31693,28,2,32069,2,18.5,-1.2700436,36.8209976,-1.2594474,36.8089122,409,376,43,549
7320,7706,517,3,Business,10,1,26997,10,1,30869,10,1,31219,10,1,32954,10,1,33758,4,18.7,-1.3228003,36.8306435,-1.3004062,36.829741,623,804,3872,2085
7321,9495,136,3,Business,2,4,39879,2,4,39904,2,4,41824,2,4,41898,2,4,43348,16,23.25888921888938,-1.3254522,36.7216584,-1.2551895,36.7822034,783,1450,25,1994
7322,22615,2641,3,Business,28,4,42668,28,4,42683,28,4,43209,28,4,44493,28,4,45761,6,23.8,-1.2571472,36.7950633,-1.2857671,36.7875614,279,1268,15,1810
7323,4705,1724,3,Business,28,4,61757,28,4,61793,28,4,61859,28,4,62109,28,4,63441,8,28.2,-1.2551895,36.7822034,-1.2907854,36.7774108,89,1332,36,316
7324,5005,3781,3,Business,23,3,36707,23,3,36726,23,3,36795,23,3,37420,23,3,40341,20,23.25888921888938,-1.1855066,36.8254646,-1.2419938,36.7683729,918,2921,19,694
7325,13138,633,3,Business,28,4,41589,28,4,41604,28,4,42204,28,4,42289,28,4,42896,4,28.0,-1.3077869,36.8443207,-1.3004062,36.829741,114,607,15,685
7326,7521,640,3,Business,23,4,56848,23,4,56880,23,4,56967,23,4,58448,23,4,59319,7,24.6,-1.304033,36.7848695,-1.2824911,36.8218042,119,871,32,1568
7327,3506,3222,3,Business,14,5,52556,14,5,53650,14,5,53824,14,5,54023,14,5,55319,4,23.5,-1.2551895,36.7822034,-1.2668469,36.8041691,112,1296,1094,373
7328,20299,2521,3,Business,5,5,32207,5,5,32561,5,5,33387,5,5,34849,5,5,36291,8,19.9,-1.3167113,36.8301563,-1.2770708,36.8231093,819,1442,354,2288
7329,2185,432,3,Business,24,5,35362,24,5,35377,24,5,35456,24,5,38231,24,5,38239,3,21.4,-1.3012008,36.764868,-1.2846863,36.7383051,855,8,15,2854
7330,4404,1207,3,Business,15,1,58811,15,1,58840,15,1,59081,15,1,60024,15,1,62734,12,23.25888921888938,-1.2629666,36.8068369,-1.2351541,36.8748505,519,2710,29,1184
7331,2407,2987,3,Business,28,5,46581,28,5,46608,28,5,46736,28,5,47636,28,5,48107,12,25.3,-1.270212,36.8210877,-1.2156006,36.8916865,886,471,27,1028
7332,19565,3560,3,Business,31,1,49041,31,1,49072,31,1,49450,31,1,51555,31,1,52116,1,23.9,-1.290894,36.822971,-1.279395,36.825364,477,561,31,2483
7333,15642,2212,3,Business,7,3,45940,7,3,45992,7,3,46487,7,3,47040,7,3,47684,5,25.2,-1.2571472,36.7950633,-1.255956,36.772901,952,644,52,1048
7334,3325,2790,1,Personal,14,2,43749,14,2,43835,14,2,44431,14,2,44745,14,2,45777,4,21.6,-1.2891922,36.825189,-1.298529,36.816482,629,1032,86,910
7335,13828,1874,3,Business,15,4,53116,15,4,53630,15,4,56031,15,4,56267,15,4,57623,6,27.5,-1.2571472,36.7950633,-1.257569,36.842164,522,1356,514,2637
7336,5408,635,3,Business,7,2,40438,7,2,40636,7,2,42350,7,2,42984,7,2,44583,5,23.25888921888938,-1.2857764,36.8236622,-1.2602337,36.7990548,624,1599,198,2348
7337,18293,393,3,Business,8,2,35685,8,2,36292,8,2,36745,8,2,37696,8,2,39692,13,23.25888921888938,-1.3177547,36.8303703,-1.306378,36.7519845,912,1996,607,1404
7338,3134,3300,3,Business,8,3,38581,8,3,38596,8,3,40820,8,3,42089,8,3,43334,9,22.4,-1.2600926,36.8088685,-1.303596,36.778378,100,1245,15,3493
7339,27130,1500,3,Business,5,2,38039,5,2,38057,5,2,38298,5,2,39286,5,2,40557,8,25.5,-1.3004062,36.829741,-1.2638185,36.7930057,154,1271,18,1229
7340,10634,2828,3,Business,5,3,50839,5,3,54454,5,3,54462,5,3,55784,5,3,57993,8,24.8,-1.2615888,36.7928732,-1.3034072,36.8218035,382,2209,3615,1330
7341,19169,1932,1,Business,28,6,45693,28,6,45712,28,6,46975,28,6,48096,28,6,49234,13,24.1,-1.2498583,36.7754966,-1.2922857,36.7813274,180,1138,19,2384
7342,7878,3706,2,Personal,10,3,27148,10,3,27224,10,3,29233,10,3,29717,10,3,30592,9,17.6,-1.2518057,36.7997135,-1.2846195,36.7958316,846,875,76,2493
7343,408,788,3,Business,5,2,61615,5,2,62157,5,2,62697,5,2,63101,5,2,65055,10,23.25888921888938,-1.290894,36.822971,-1.225322,36.80855,953,1954,542,944
7344,4593,1075,3,Business,9,4,41961,9,4,42016,9,4,43308,9,4,47077,9,4,48527,10,23.25888921888938,-1.3014461,36.7661381,-1.2527958,36.8003131,61,1450,55,5061
7345,24537,1882,3,Business,22,5,33835,22,5,34604,22,5,35064,22,5,35255,22,5,36119,7,23.25888921888938,-1.2956882,36.7861845,-1.2591019,36.800577,783,864,769,651
7346,13708,2457,3,Business,7,2,31077,7,2,31087,7,2,31483,7,2,31770,7,2,33342,7,16.6,-1.2571472,36.7950633,-1.3047132,36.8089553,228,1572,10,683
7347,27574,1724,3,Business,15,1,36567,15,1,36599,15,1,36620,15,1,37046,15,1,37652,4,20.8,-1.2551895,36.7822034,-1.2690013,36.8092872,291,606,32,447
7348,19689,642,2,Personal,3,1,51271,3,1,51468,3,1,52575,3,1,52842,3,1,53307,3,23.2,-1.2854453,36.8188363,-1.2790558,36.8151527,208,465,197,1374
7349,3952,478,3,Business,17,3,38883,17,3,41674,17,3,42705,17,3,43350,17,3,44576,8,25.4,-1.2551895,36.7822034,-1.29387,36.7907813,147,1226,2791,1676
7350,13618,3647,3,Business,7,4,59302,7,4,59323,7,4,59965,7,4,60179,7,4,61551,5,29.2,-1.272639,36.794723,-1.2962832,36.7849683,452,1372,21,856
7351,8419,478,3,Business,4,4,52863,4,4,52901,4,4,53233,4,4,53901,4,4,56874,13,25.0,-1.2551895,36.7822034,-1.3233955,36.8562944,805,2973,38,1000
7352,8267,391,3,Business,8,1,46635,8,1,46663,8,1,47065,8,1,48711,8,1,50825,16,24.4,-1.300921,36.828195,-1.3540392,36.9078543,890,2114,28,2048
7353,13982,2709,3,Personal,29,5,52379,29,5,52540,29,5,53490,29,5,53664,29,5,54650,6,28.8,-1.2571472,36.7950633,-1.2945041,36.8151527,245,986,161,1124
7354,25905,1677,3,Personal,7,5,58313,7,5,58505,7,5,58939,7,5,59497,7,5,60584,10,26.8,-1.2963097,36.7688221,-1.2601903,36.8066946,178,1087,192,992
7355,26914,867,3,Business,5,3,56908,5,3,57113,5,3,57741,5,3,58433,5,3,59317,9,25.1,-1.2574219,36.7927073,-1.306378,36.7519845,878,884,205,1320
7356,11275,2150,3,Business,28,4,58571,28,4,58613,28,4,58807,28,4,59745,28,4,61105,11,25.8,-1.307143,36.825009,-1.344446,36.756597,119,1360,42,1132
7357,9035,2801,3,Business,31,3,33330,31,3,33351,31,3,33788,31,3,33900,31,3,34515,3,19.2,-1.2595422,36.7871178,-1.2566586,36.7929682,167,615,21,549
7358,12298,633,3,Business,26,2,36681,26,2,36784,26,2,37123,26,2,37275,26,2,38165,5,21.9,-1.3004062,36.829741,-1.3083266,36.8494756,910,890,103,491
7359,15604,2516,1,Personal,18,4,33104,18,4,33137,18,4,33629,18,4,34306,18,4,36524,5,20.7,-1.2862436,36.791017,-1.2904753,36.8144721,156,2218,33,1169
7360,11561,3222,3,Business,26,1,39232,26,1,39331,26,1,39831,26,1,39960,26,1,41839,20,23.0,-1.2551895,36.7822034,-1.3251247,36.8995926,190,1879,99,629
7361,6915,2066,3,Business,26,5,46055,26,5,46074,26,5,46101,26,5,47072,26,5,49613,21,23.25888921888938,-1.3210189,36.8410551,-1.207546,36.7913976,120,2541,19,998
7362,787,393,3,Business,19,2,45992,19,2,46024,19,2,46839,19,2,47262,19,2,48488,5,27.6,-1.3167113,36.8301563,-1.3077869,36.8443207,855,1226,32,1238
7363,16789,706,3,Business,23,2,48388,23,2,48777,23,2,49087,23,2,49158,23,2,49687,4,18.8,-1.3077869,36.8443207,-1.308366,36.823613,69,529,389,381
7364,2010,635,3,Business,25,1,42955,25,1,43904,25,1,43939,25,1,45174,25,1,46340,7,25.4,-1.3081376,36.8329772,-1.2602337,36.7990548,518,1166,949,1270
7365,4346,2587,3,Business,12,1,53644,12,1,53735,12,1,54726,12,1,55146,12,1,56110,4,27.0,-1.28878,36.8168312,-1.2979063,36.8373372,237,964,91,1411
7366,18434,1584,3,Business,31,3,54352,31,3,54418,31,3,54627,31,3,54884,31,3,56100,6,27.1,-1.2969741,36.7856612,-1.2857524,36.8196806,414,1216,66,466
7367,10914,2801,3,Business,14,2,57602,14,2,57633,14,2,57904,14,2,58234,14,2,59523,7,23.25888921888938,-1.2674274,36.7870827,-1.285355,36.795287,161,1289,31,601
7368,13245,3557,3,Business,6,4,56983,6,4,57922,6,4,59377,6,4,60246,6,4,63609,14,22.7,-1.2825804,36.8775087,-1.2546732,36.8086796,250,3363,939,2324
7369,4226,970,3,Business,5,2,34046,5,2,34082,5,2,35940,5,2,36318,5,2,37969,8,18.2,-1.2551895,36.7822034,-1.2927895,36.7591232,290,1651,36,2236
7370,22994,2069,3,Business,12,3,38758,12,3,40839,12,3,43629,12,3,43714,12,3,44664,6,19.6,-1.22978,36.836215,-1.228911,36.881876,27,950,2081,2875
7371,21470,3247,3,Business,13,4,39211,13,4,39272,13,4,40134,13,4,40544,13,4,41232,5,22.1,-1.2571472,36.7950633,-1.2425149,36.7890137,937,688,61,1272
7372,10602,1675,1,Personal,13,1,34654,13,1,34765,13,1,35581,13,1,35661,13,1,36838,7,15.4,-1.296797,36.7764525,-1.2857095,36.8188266,571,1177,111,896
7373,12473,3201,3,Business,28,4,54127,28,4,54734,28,4,56346,28,4,57237,28,4,58122,6,27.4,-1.290894,36.822971,-1.2584143,36.8048002,448,885,607,2503
7374,3089,346,3,Business,19,2,32942,19,2,32975,19,2,33869,19,2,34042,19,2,34499,1,21.3,-1.279395,36.825364,-1.28878,36.8168312,583,457,33,1067
7375,16311,970,3,Business,3,5,34871,3,5,34999,3,5,36515,3,5,36731,3,5,37357,4,23.25888921888938,-1.2551895,36.7822034,-1.2525704,36.7955754,394,626,128,1732
7376,20230,391,3,Business,22,3,39961,22,3,40168,22,3,40227,22,3,42043,22,3,43926,5,22.9,-1.300921,36.828195,-1.2784063,36.8222933,158,1883,207,1875
7377,20503,2200,3,Business,31,3,32472,31,3,32494,31,3,32570,31,3,35261,31,3,35880,9,19.0,-1.3025826,36.7670807,-1.290894,36.822971,330,619,22,2767
7378,23723,2330,3,Business,30,3,56240,30,3,56288,30,3,57173,30,3,57434,30,3,60123,9,29.0,-1.2680363,36.7990466,-1.3015197,36.7658456,311,2689,48,1146
7379,22686,998,2,Personal,25,3,33240,25,3,33256,25,3,33413,25,3,33916,25,3,35144,5,13.6,-1.3043821,36.7840586,-1.3228978,36.7785022,726,1228,16,660
7380,5603,1245,3,Business,4,4,37276,4,4,37301,4,4,38017,4,4,38398,4,4,40399,17,25.6,-1.2602337,36.7990548,-1.3198615,36.7110323,793,2001,25,1097
7381,20865,286,3,Business,22,4,57182,22,4,59259,22,4,60067,22,4,60413,22,4,61691,7,24.1,-1.2551895,36.7822034,-1.2962967,36.8020231,913,1278,2077,1154
7382,477,2289,3,Business,22,5,49450,22,5,50525,22,5,51490,22,5,51639,22,5,54180,6,23.25888921888938,-1.2551895,36.7822034,-1.2877796,36.8149258,531,2541,1075,1114
7383,758,2154,3,Business,11,2,46318,11,2,46565,11,2,47647,11,2,48519,11,2,50404,12,19.3,-1.303031,36.758577,-1.2765736,36.8513646,412,1885,247,1954
7384,3131,2330,3,Business,18,4,49466,18,4,49522,18,4,49624,18,4,49842,18,4,50401,6,23.25888921888938,-1.2890715,36.8157588,-1.2645318,36.7981775,253,559,56,320
7385,19204,635,3,Business,8,3,37083,8,3,37119,8,3,37133,8,3,42847,8,3,43782,10,23.25888921888938,-1.3081376,36.8329772,-1.2602337,36.7990548,206,935,36,5728
7386,13107,3064,3,Business,2,5,39733,2,5,39819,2,5,42646,2,5,43193,2,5,44939,7,23.7,-1.2571472,36.7950633,-1.298437,36.781971,733,1746,86,3374
7387,16615,3404,3,Business,21,4,38833,21,4,39502,21,4,39986,21,4,40707,21,4,42098,8,25.3,-1.3014461,36.7661381,-1.279395,36.825364,88,1391,669,1205
7388,18760,2982,3,Business,15,4,46278,15,4,46319,15,4,46747,15,4,48106,15,4,51805,19,24.2,-1.300921,36.828195,-1.2239243,36.710118,95,3699,41,1787
7389,3717,2423,3,Business,13,3,47391,13,3,47484,13,3,47748,13,3,48273,13,3,49156,4,24.8,-1.2551895,36.7822034,-1.2618632,36.8100226,379,883,93,789
7390,18780,1195,3,Business,22,5,36026,22,5,36068,22,5,37171,22,5,38265,22,5,43163,38,23.25888921888938,-1.3228003,36.8306435,-1.1360575,36.6308896,519,4898,42,2197
7391,20006,1268,1,Personal,25,5,62308,25,5,62344,25,5,62979,25,5,63218,25,5,65257,9,21.1,-1.2745187,36.7657388,-1.2988168,36.8198572,334,2039,36,874
7392,20964,517,3,Business,29,3,59767,29,3,59870,29,3,59880,29,3,61765,29,3,61767,11,21.0,-1.3228003,36.8306435,-1.2638185,36.7930057,515,2,103,1895
7393,17862,776,1,Personal,12,6,40387,12,6,40785,12,6,41615,12,6,44517,12,6,45831,7,23.1,-1.2665774,36.8069908,-1.3175119,36.8058513,103,1314,398,3732
7394,20692,3291,3,Business,17,4,58794,17,4,58865,17,4,58907,17,4,59422,17,4,59426,5,28.2,-1.2628473,36.781805,-1.2600926,36.8088685,395,4,71,557
7395,12600,1551,1,Personal,10,2,49049,10,2,49159,10,2,49917,10,2,50360,10,2,51133,5,21.3,-1.307726,36.839117,-1.2911796,36.8215068,629,773,110,1201
7396,17346,3565,3,Business,1,5,61730,1,5,61736,1,5,62307,1,5,62751,1,5,63729,6,22.7,-1.2844665,36.7866113,-1.2949474,36.8270407,735,978,6,1015
7397,20637,1329,3,Business,3,3,66724,3,3,66755,3,3,67337,3,3,68017,3,3,68742,6,27.2,-1.288212,36.778334,-1.273056,36.811298,855,725,31,1262
7398,13464,970,3,Business,1,1,47921,1,1,47980,1,1,48323,1,1,48751,1,1,49775,10,23.25888921888938,-1.2551895,36.7822034,-1.2518814,36.859661,634,1024,59,771
7399,24137,923,1,Personal,17,5,48887,17,5,48901,17,5,49081,17,5,52165,17,5,53641,8,20.4,-1.2945179,36.7685349,-1.2668071,36.8068157,272,1476,14,3264
7400,11890,3647,3,Business,29,2,49053,29,2,49243,29,2,50168,29,2,50671,29,2,52054,7,26.9,-1.272639,36.794723,-1.2959613,36.7684114,246,1383,190,1428
7401,4849,3647,3,Business,27,4,61545,27,4,61571,27,4,62167,27,4,62241,27,4,63192,5,23.1,-1.272639,36.794723,-1.2538731,36.7850223,566,951,26,670
7402,19166,3291,3,Business,1,1,36074,1,1,36102,1,1,36112,1,1,36635,1,1,37518,4,21.3,-1.272828,36.816608,-1.2600926,36.8088685,397,883,28,533
7403,5090,778,3,Business,6,3,51902,6,3,51931,6,3,52454,6,3,52619,6,3,53611,7,23.25888921888938,-1.2535486,36.7933541,-1.2717174,36.7753883,523,992,29,688
7404,22667,1271,3,Business,11,2,36254,11,2,36273,11,2,38056,11,2,38483,11,2,43230,27,19.5,-1.3244885,36.897792,-1.3204931,36.7043102,205,4747,19,2210
7405,10013,1824,3,Business,31,3,56635,31,3,57237,31,3,57698,31,3,58391,31,3,59749,6,26.8,-1.2674001,36.7986537,-1.297213,36.7862115,19,1358,602,1154
7406,5312,1085,3,Business,27,3,64765,27,3,64814,27,3,65110,27,3,65887,27,3,66912,7,27.5,-1.2628638,36.8070399,-1.232864,36.8084708,178,1025,49,1073
7407,12647,1573,3,Personal,7,4,59880,7,4,59943,7,4,59960,7,4,60510,7,4,61860,10,29.6,-1.273056,36.811298,-1.2524627,36.7772593,839,1350,63,567
7408,4531,868,3,Business,26,5,54692,26,5,54738,26,5,55704,26,5,56141,26,5,60136,14,23.25888921888938,-1.293515,36.897607,-1.265715,36.823815,411,3995,46,1403
7409,25154,3108,3,Business,30,3,44798,30,3,45007,30,3,45260,30,3,45361,30,3,48438,16,25.1,-1.2551895,36.7822034,-1.2893678,36.8842169,206,3077,209,354
7410,27474,2468,3,Business,20,3,47711,20,3,47778,20,3,48191,20,3,48574,20,3,52423,7,27.1,-1.2821883,36.8269611,-1.2931104,36.7677484,404,3849,67,796
7411,22284,265,3,Business,2,2,42088,2,2,43494,2,2,44404,2,2,44642,2,2,46179,7,21.2,-1.300921,36.828195,-1.260039,36.8159152,496,1537,1406,1148
7412,21038,1500,3,Business,18,4,32821,18,4,32838,18,4,33603,18,4,34252,18,4,36345,10,23.25888921888938,-1.2991441,36.7528804,-1.2638185,36.7930057,92,2093,17,1414
7413,1478,2212,3,Business,9,4,59048,9,4,61552,9,4,61555,9,4,61852,9,4,62559,5,23.25888921888938,-1.2571472,36.7950633,-1.2845341,36.8252076,564,707,2504,300
7414,1778,1484,3,Business,17,4,46004,17,4,46012,17,4,46311,17,4,47373,17,4,47887,2,25.6,-1.2571472,36.7950633,-1.2567464,36.7915273,167,514,8,1361
7415,6090,1205,3,Business,21,2,53394,21,2,54007,21,2,54052,21,2,55069,21,2,56180,4,25.1,-1.2495931,36.8065087,-1.2663889,36.8322105,58,1111,613,1062
7416,10804,3222,3,Business,27,3,53767,27,3,53858,27,3,54379,27,3,54586,27,3,57917,6,29.6,-1.2551895,36.7822034,-1.2869955,36.8202749,156,3331,91,728
7417,12635,3064,3,Business,28,1,38551,28,1,38573,28,1,38600,28,1,39085,28,1,40053,6,23.9,-1.2571472,36.7950633,-1.2985749,36.8088,191,968,22,512
7418,26373,1688,3,Business,30,2,47729,30,2,47863,30,2,47930,30,2,49042,30,2,51773,16,23.25888921888938,-1.300921,36.828195,-1.3990905,36.7682846,155,2731,134,1179
7419,13826,349,1,Personal,28,6,56533,28,6,56537,28,6,56712,28,6,57770,28,6,58619,5,25.0,-1.2821211,36.8222021,-1.2707179,36.7979713,229,849,4,1233
7420,25002,1688,3,Business,6,3,52350,6,3,52379,6,3,52686,6,3,55112,6,3,58211,19,27.5,-1.300921,36.828195,-1.223961,36.7169413,26,3099,29,2733
7421,13476,1002,1,Personal,24,1,69333,24,1,69353,24,1,69486,24,1,69784,24,1,71875,17,24.3,-1.2931104,36.7677484,-1.3205335,36.8789718,336,2091,20,431
7422,15354,3686,3,Business,8,5,52818,8,5,52846,8,5,53729,8,5,54190,8,5,56923,23,27.2,-1.2551895,36.7822034,-1.3447079,36.91105,880,2733,28,1344
7423,27213,1384,3,Business,5,5,36429,5,5,36490,5,5,36872,5,5,37351,5,5,40286,17,19.6,-1.2517448,36.7924971,-1.16478,36.8223899,205,2935,61,861
7424,1528,2664,1,Personal,21,1,42187,21,1,42378,21,1,44481,21,1,44676,21,1,45322,6,19.9,-1.2626906,36.7827022,-1.2816664,36.8226716,406,646,191,2298
7425,25804,928,3,Business,27,3,46963,27,3,47125,27,3,47876,27,3,49089,27,3,51141,8,23.25888921888938,-1.2551895,36.7822034,-1.2995132,36.8043032,327,2052,162,1964
7426,24174,2310,1,Business,22,2,57413,22,2,57624,22,2,57628,22,2,58514,22,2,59611,11,21.1,-1.2859912,36.8756811,-1.3332749,36.8708147,406,1097,211,890
7427,8486,2047,1,Personal,18,4,52493,18,4,53633,18,4,54649,18,4,54862,18,4,56101,7,26.8,-1.310796,36.86283,-1.3044313,36.818504,365,1239,1140,1229
7428,20053,2174,3,Business,14,5,46926,14,5,46948,14,5,46970,14,5,49688,14,5,52202,23,23.9,-1.2482781,36.884092,-1.3446058,36.7605178,12,2514,22,2740
7429,4826,3285,2,Personal,15,6,40776,15,6,40815,15,6,41473,15,6,42452,15,6,42768,3,23.25888921888938,-1.2650182,36.7926717,-1.2635425,36.8021963,882,316,39,1637
7430,15603,1850,3,Business,8,5,40350,8,5,40428,8,5,41033,8,5,41419,8,5,42298,7,28.3,-1.2571472,36.7950633,-1.3074264,36.8226123,70,879,78,991
7431,14025,198,3,Business,21,4,51240,21,4,54524,21,4,56312,21,4,56458,21,4,58815,21,22.7,-1.3396256,36.8863135,-1.3412198,36.7355439,285,2357,3284,1934
7432,5126,393,3,Business,14,1,35881,14,1,35902,14,1,35917,14,1,38511,14,1,38521,11,23.5,-1.3167113,36.8301563,-1.2574219,36.7927073,515,10,21,2609
7433,3004,3322,3,Personal,26,2,47938,26,2,48076,26,2,48282,26,2,49434,26,2,49983,5,29.9,-1.2883158,36.8199114,-1.2991116,36.7960658,156,549,138,1358
7434,26889,2982,3,Business,21,4,45181,21,4,45241,21,4,45976,21,4,46669,21,4,48276,15,25.2,-1.2855173,36.8474224,-1.177202,36.8351183,576,1607,60,1428
7435,9584,811,2,Personal,19,5,44557,19,5,44571,19,5,44612,19,5,44763,19,5,45446,4,25.0,-1.2963097,36.7688221,-1.2793831,36.7617573,352,683,14,192
7436,3371,2207,3,Business,31,3,50492,31,3,51277,31,3,52187,31,3,57978,31,3,58215,4,26.9,-1.28164,36.816867,-1.2768326,36.8073804,333,237,785,6701
7437,19000,53,3,Business,8,5,42519,8,5,42641,8,5,44251,8,5,44902,8,5,46011,5,28.4,-1.3004062,36.829741,-1.2770708,36.8231093,88,1109,122,2261
7438,12324,2200,3,Business,26,1,51654,26,1,54419,26,1,55530,26,1,56814,26,1,57099,5,22.0,-1.2710687,36.8142839,-1.290894,36.822971,660,285,2765,2395
7439,7606,2987,3,Business,16,4,41866,16,4,41892,16,4,42134,16,4,42498,16,4,43285,7,14.5,-1.270212,36.8210877,-1.3043821,36.7840586,754,787,26,606
7440,19615,393,3,Business,19,6,33077,19,6,33149,19,6,36132,19,6,37481,19,6,37488,4,21.7,-1.3167113,36.8301563,-1.3004062,36.829741,725,7,72,4332
7441,6109,1579,3,Personal,27,1,50503,27,1,50548,27,1,51149,27,1,51542,27,1,52884,12,23.25888921888938,-1.2902553,36.7949332,-1.3221935,36.8464972,749,1342,45,994
7442,21769,1500,3,Business,29,5,50171,29,5,54557,29,5,56327,29,5,56650,29,5,57745,6,28.9,-1.2770708,36.8231093,-1.2638185,36.7930057,858,1095,4386,2093
7443,5752,643,2,Personal,3,3,63524,3,3,63576,3,3,64203,3,3,64408,3,3,66234,16,23.7,-1.2956583,36.7744517,-1.2580057,36.6893887,105,1826,52,832
7444,20446,84,3,Business,14,4,54181,14,4,59050,14,4,59693,14,4,59886,14,4,64883,14,26.6,-1.2551895,36.7822034,-1.3263105,36.8622904,276,4997,4869,836
7445,27852,3222,3,Business,7,5,42158,7,5,44260,7,5,44687,7,5,44774,7,5,45229,4,25.2,-1.2551895,36.7822034,-1.2715686,36.8023526,390,455,2102,514
7446,25389,2150,3,Business,19,2,45889,19,2,45942,19,2,46520,19,2,47032,19,2,48435,13,27.4,-1.3033561,36.8163631,-1.344446,36.756597,338,1403,53,1090
7447,19829,257,1,Personal,8,1,32336,8,1,32402,8,1,33349,8,1,34060,8,1,35577,9,19.8,-1.2644443,36.7734547,-1.2872899,36.820434,692,1517,66,1658
7448,23786,2956,3,Business,28,2,54549,28,2,54560,28,2,54612,28,2,54861,28,2,55492,3,19.3,-1.2584143,36.8048002,-1.2551895,36.7822034,207,631,11,301
7449,15169,635,3,Business,28,4,54694,28,4,54733,28,4,55016,28,4,55913,28,4,55927,2,27.5,-1.2684816,36.8085622,-1.2602337,36.7990548,541,14,39,1180
7450,249,3352,3,Personal,17,3,50905,17,3,50916,17,3,51463,17,3,51773,17,3,53636,13,23.25888921888938,-1.3189908,36.777074,-1.2592947,36.7698085,166,1863,11,857
7451,25321,1882,1,Business,2,2,32922,2,2,32937,2,2,33265,2,2,34667,2,2,36305,8,15.2,-1.2268871,36.8073946,-1.2591019,36.800577,432,1638,15,1730
7452,705,510,3,Business,27,3,57987,27,3,58028,27,3,59451,27,3,59695,27,3,61082,13,27.5,-1.2860183,36.8975338,-1.3263105,36.8622904,26,1387,41,1667
7453,15362,2523,3,Business,16,4,46514,16,4,46529,16,4,46551,16,4,46847,16,4,48529,12,23.25888921888938,-1.2551895,36.7822034,-1.3104734,36.7363698,663,1682,15,318
7454,20568,944,1,Personal,11,3,48838,11,3,49056,11,3,50868,11,3,51407,11,3,53594,7,20.4,-1.255597,36.830024,-1.264788,36.7883897,726,2187,218,2351
7455,8880,633,3,Business,8,2,35778,8,2,35810,8,2,35815,8,2,36981,8,2,37940,4,19.1,-1.3077869,36.8443207,-1.3004062,36.829741,239,959,32,1171
7456,4696,510,3,Business,22,5,36350,22,5,36368,22,5,36878,22,5,37013,22,5,38506,13,16.3,-1.2860183,36.8975338,-1.3332749,36.8708147,397,1493,18,645
7457,23705,3194,3,Business,15,5,43066,15,5,43091,15,5,44021,15,5,44152,15,5,45448,8,26.2,-1.2551895,36.7822034,-1.2854174,36.7951152,523,1296,25,1061
7458,24969,3647,3,Business,1,5,57714,1,5,57751,1,5,57759,1,5,58667,1,5,61442,20,28.4,-1.272639,36.794723,-1.3770858,36.7546064,31,2775,37,916
7459,851,289,2,Personal,28,5,37069,28,5,37133,28,5,37924,28,5,38710,28,5,39088,5,25.1,-1.2726925,36.7951829,-1.2551895,36.7822034,446,378,64,1577
7460,8270,432,3,Business,2,2,55834,2,2,57079,2,2,58551,2,2,59756,2,2,63381,9,28.5,-1.290894,36.822971,-1.3012008,36.764868,760,3625,1245,2677
7461,17232,2532,3,Business,2,2,43109,2,2,43687,2,2,43693,2,2,45148,2,2,48540,6,26.1,-1.2571472,36.7950633,-1.2824911,36.8218042,828,3392,578,1461
7462,25403,1120,3,Personal,20,4,56689,20,4,57865,20,4,59052,20,4,59573,20,4,60240,5,24.8,-1.2832123,36.8260812,-1.2627019,36.7937751,86,667,1176,1708
7463,14244,3445,1,Personal,31,2,44273,31,2,44287,31,2,44563,31,2,44787,31,2,45411,4,18.6,-1.2615983,36.8083096,-1.2516793,36.786481,726,624,14,500
7464,1087,3222,3,Business,6,4,34341,6,4,35267,6,4,36917,6,4,37766,6,4,41169,7,18.7,-1.2551895,36.7822034,-1.2883439,36.8092304,56,3403,926,2499
7465,13886,1477,2,Personal,7,2,43146,7,2,43249,7,2,43810,7,2,44459,7,2,45767,8,23.4,-1.2560455,36.7800867,-1.28159,36.8143758,882,1308,103,1210
7466,15753,517,3,Business,12,6,43988,12,6,43994,12,6,43997,12,6,44458,12,6,44903,4,23.25888921888938,-1.3167113,36.8301563,-1.3004062,36.829741,515,445,6,464
7467,25429,776,1,Personal,6,5,62040,6,5,62303,6,5,62881,6,5,63223,6,5,65155,4,23.25888921888938,-1.2665774,36.8069908,-1.2551895,36.7822034,898,1932,263,920
7468,4418,2866,3,Business,13,4,45713,13,4,45734,13,4,47551,13,4,48299,13,4,49126,4,22.2,-1.2551895,36.7822034,-1.2675979,36.8155653,193,827,21,2565
7469,27061,3135,3,Personal,24,1,52407,24,1,52432,24,1,52781,24,1,53280,24,1,54042,4,23.25888921888938,-1.277585,36.77145,-1.265432,36.795034,734,762,25,848
7470,20312,1271,3,Business,28,4,61294,28,4,63325,28,4,63738,28,4,63946,28,4,64610,8,27.9,-1.3244885,36.897792,-1.3263105,36.8622904,675,664,2031,621
7471,2631,3355,3,Business,19,1,53508,19,1,53909,19,1,54254,19,1,55684,19,1,56808,8,25.4,-1.3332749,36.8708147,-1.3052491,36.8223899,258,1124,401,1775
7472,19946,2587,3,Business,25,5,52574,25,5,52862,25,5,53193,25,5,53573,25,5,54686,5,29.2,-1.2584143,36.8048002,-1.28878,36.8168312,268,1113,288,711
7473,25487,3647,3,Business,8,4,34828,8,4,34834,8,4,36056,8,4,36286,8,4,37580,13,20.3,-1.272639,36.794723,-1.326496,36.702379,932,1294,6,1452
7474,11046,59,3,Business,19,1,37372,19,1,39808,19,1,39836,19,1,45070,19,1,46373,7,24.6,-1.290894,36.822971,-1.2571472,36.7950633,659,1303,2436,5262
7475,18266,1865,1,Personal,31,5,63735,31,5,64104,31,5,64918,31,5,65283,31,5,66805,14,20.0,-1.2166078,36.882501,-1.2782978,36.8273238,629,1522,369,1179
7476,10355,97,3,Business,14,1,40060,14,1,40103,14,1,40363,14,1,40989,14,1,43107,6,23.6,-1.2879618,36.8200863,-1.2969741,36.7856612,178,2118,43,886
7477,7047,393,3,Business,24,3,52662,24,3,52706,24,3,52713,24,3,53174,24,3,54850,4,23.25888921888938,-1.3167113,36.8301563,-1.3004062,36.829741,942,1676,44,468
7478,3378,2335,3,Business,3,1,41828,3,1,46956,3,1,47360,3,1,47835,3,1,48899,8,22.4,-1.2551895,36.7822034,-1.290894,36.822971,845,1064,5128,879
7479,19636,704,1,Business,9,2,37594,9,2,38086,9,2,38434,9,2,43958,9,2,45333,12,22.1,-1.3332749,36.8708147,-1.2860183,36.8975338,478,1375,492,5872
7480,2188,3470,3,Business,29,4,41603,29,4,44640,29,4,44699,29,4,45369,29,4,46827,8,21.6,-1.3014461,36.7661381,-1.28878,36.8168312,260,1458,3037,729
7481,12457,1329,3,Business,12,5,56411,12,5,56432,12,5,56712,12,5,58187,12,5,62857,18,27.3,-1.273056,36.811298,-1.3103985,36.9114173,519,4670,21,1755
7482,25632,2757,3,Business,6,2,62425,6,2,63106,6,2,64023,6,2,64128,6,2,65847,13,23.25888921888938,-1.2891922,36.825189,-1.3332025,36.7789361,237,1719,681,1022
7483,15397,1724,3,Business,4,2,30968,4,2,31087,4,2,33839,4,2,34138,4,2,35752,9,16.7,-1.2907854,36.7774108,-1.2638898,36.8223638,774,1614,119,3051
7484,12942,868,3,Business,13,3,43935,13,3,49502,13,3,50080,13,3,50997,13,3,52396,9,23.5,-1.331619,36.847976,-1.265715,36.823815,770,1399,5567,1495
7485,7659,3404,3,Business,6,4,38421,6,4,40453,6,4,40994,6,4,41100,6,4,41774,4,24.0,-1.279395,36.825364,-1.2565836,36.8123982,878,674,2032,647
7486,5136,1740,3,Personal,28,4,57347,28,4,58026,28,4,59563,28,4,60471,28,4,62035,12,23.25888921888938,-1.286837,36.823308,-1.338579,36.8963038,360,1564,679,2445
7487,27403,540,3,Business,23,5,43988,23,5,44837,23,5,45311,23,5,45876,23,5,46663,6,23.9,-1.2571472,36.7950633,-1.2967702,36.8040381,178,787,849,1039
7488,27298,1209,3,Business,2,4,31923,2,4,31982,2,4,32505,2,4,32766,2,4,33971,9,23.25888921888938,-1.2638185,36.7930057,-1.3004062,36.829741,96,1205,59,784
7489,15242,893,3,Business,3,1,45995,3,1,46060,3,1,47015,3,1,47484,3,1,48203,5,21.4,-1.2663194,36.809901,-1.2655306,36.8358511,279,719,65,1424
7490,24493,3291,3,Business,30,2,37175,30,2,37229,30,2,37368,30,2,37842,30,2,38857,9,17.3,-1.307143,36.825009,-1.2600926,36.8088685,283,1015,54,613
7491,5864,2216,3,Business,18,1,36344,18,1,36771,18,1,37080,18,1,37403,18,1,38690,10,21.5,-1.2551895,36.7822034,-1.2287282,36.8115304,783,1287,427,632
7492,26089,2987,3,Business,22,3,49112,22,3,49308,22,3,50371,22,3,50716,22,3,51516,11,25.8,-1.270212,36.8210877,-1.2156006,36.8916865,100,800,196,1408
7493,8707,265,3,Business,29,1,37023,29,1,37819,29,1,38841,29,1,40949,29,1,43727,26,23.25888921888938,-1.2543158,36.9910462,-1.300921,36.828195,340,2778,796,3130
7494,2462,2801,3,Business,5,5,49502,5,5,49696,5,5,50063,5,5,50702,5,5,52977,9,27.5,-1.2674274,36.7870827,-1.3024794,36.8228284,755,2275,194,1006
7495,28085,3599,3,Business,22,4,48185,22,4,48198,22,4,49099,22,4,50655,22,4,52127,12,26.6,-1.3302996,36.8707935,-1.2858786,36.7888062,268,1472,13,2457
7496,18378,2200,3,Business,14,4,57600,14,4,57755,14,4,58310,14,4,58438,14,4,61372,4,27.8,-1.3041129,36.8104939,-1.290894,36.822971,336,2934,155,683
7497,3736,1983,3,Personal,6,5,40501,6,5,40540,6,5,40745,6,5,43023,6,5,44777,14,20.2,-1.2235201,36.8020608,-1.2929577,36.7955434,100,1754,39,2483
7498,9807,3169,1,Personal,8,3,73600,8,3,74562,8,3,76073,8,3,77103,8,3,79416,11,19.2,-1.2273128,36.8090399,-1.2629292,36.8032916,541,2313,962,2541
7499,17178,2066,3,Business,3,5,58011,3,5,58017,3,5,58342,3,5,58615,3,5,59432,2,25.3,-1.316961,36.820337,-1.3113209,36.8230282,857,817,6,598
7500,25080,3426,3,Business,31,1,49729,31,1,49759,31,1,50310,31,1,51042,31,1,52440,9,23.9,-1.290894,36.822971,-1.3014461,36.7661381,576,1398,30,1283
7501,16836,3149,3,Business,26,2,40038,26,2,40140,26,2,40738,26,2,42018,26,2,42765,12,26.3,-1.2638185,36.7930057,-1.3167113,36.8301563,778,747,102,1878
7502,2445,3128,1,Personal,21,5,38379,21,5,38392,21,5,40135,21,5,40625,21,5,41979,5,20.1,-1.2653957,36.8384937,-1.2753109,36.8130185,427,1354,13,2233
7503,4972,2995,3,Business,3,3,49474,3,3,49484,3,3,49565,3,3,50103,3,3,55167,23,28.4,-1.207546,36.7913976,-1.3025826,36.7670807,409,5064,10,619
7504,4043,3070,3,Business,17,3,44116,17,3,44166,17,3,48728,17,3,49287,17,3,52546,7,23.25888921888938,-1.3127834,36.8696399,-1.2837469,36.8309294,48,3259,50,5121
7505,13261,3403,3,Business,28,4,47246,28,4,47526,28,4,47930,28,4,48919,28,4,49458,6,27.4,-1.2551895,36.7822034,-1.2827261,36.8231543,576,539,280,1393
7506,16034,510,3,Business,7,4,63105,7,4,63128,7,4,63162,7,4,64976,7,4,67090,17,29.5,-1.2584143,36.8048002,-1.2860183,36.8975338,865,2114,23,1848
7507,18210,733,3,Business,7,2,46090,7,2,46101,7,2,46246,7,2,46688,7,2,48098,18,23.25888921888938,-1.2551895,36.7822034,-1.3277669,36.8975169,411,1410,11,587
7508,21444,391,3,Business,21,5,36996,21,5,37708,21,5,38158,21,5,38706,21,5,43053,21,22.7,-1.319613,36.711055,-1.2867454,36.8259017,831,4347,712,998
7509,16124,1925,2,Personal,19,2,54745,19,2,54751,19,2,54757,19,2,55193,19,2,57148,17,18.7,-1.2860183,36.8975338,-1.2661246,36.7961775,397,1955,6,442
7510,3671,635,3,Business,15,5,43542,15,5,43644,15,5,46434,15,5,47632,15,5,48806,7,25.8,-1.3081376,36.8329772,-1.2602337,36.7990548,76,1174,102,3988
7511,4446,1966,3,Business,26,5,57201,26,5,57210,26,5,57224,26,5,58378,26,5,60034,14,23.25888921888938,-1.3700383,36.9190174,-1.3046598,36.8537387,863,1656,9,1168
7512,26938,2358,4,Business,15,6,37817,15,6,37919,15,6,38652,15,6,38933,15,6,41423,18,23.25888921888938,-1.3256904,36.8747943,-1.2223457,36.8904633,89,2490,102,1014
7513,423,1646,3,Business,20,6,54349,20,6,54359,20,6,55415,20,6,55529,20,6,56688,11,23.25888921888938,-1.2517448,36.7924971,-1.3039025,36.7715803,161,1159,10,1170
7514,21509,2789,3,Business,28,1,58245,28,1,58267,28,1,58622,28,1,58965,28,1,59874,5,26.4,-1.304735,36.7846054,-1.300037,36.805514,354,909,22,698
7515,956,1484,3,Business,19,4,51489,19,4,51506,19,4,52108,19,4,52218,19,4,53543,7,20.3,-1.2551895,36.7822034,-1.2880351,36.8286389,752,1325,17,712
7516,18925,3355,3,Business,30,2,60398,30,2,60458,30,2,60673,30,2,60962,30,2,65595,7,23.7,-1.2584143,36.8048002,-1.3052491,36.8223899,532,4633,60,504
7517,808,1482,3,Business,16,4,47560,16,4,47666,16,4,48954,16,4,49553,16,4,50804,9,23.25888921888938,-1.3025667,36.7803495,-1.2649605,36.7981777,831,1251,106,1887
7518,9274,2196,3,Personal,25,5,54852,25,5,54878,25,5,55287,25,5,55476,25,5,56627,9,23.2,-1.2945179,36.7685349,-1.2553615,36.7895376,46,1151,26,598
7519,18034,978,1,Personal,12,3,38521,12,3,38810,12,3,40943,12,3,41392,12,3,43187,6,23.4,-1.3084067,36.8345014,-1.2780023,36.8241653,336,1795,289,2582
7520,17429,2768,3,Business,10,1,39794,10,1,39839,10,1,41233,10,1,43482,10,1,47499,38,18.3,-1.3344999,36.8966374,-1.1344906,36.9123061,418,4017,45,3643
7521,24003,393,3,Business,23,4,54703,23,4,54743,23,4,54746,23,4,54889,23,4,54945,5,24.5,-1.3228003,36.8306435,-1.3077869,36.8443207,39,56,40,146
7522,17059,2439,1,Business,29,2,52366,29,2,53103,29,2,55057,29,2,57302,29,2,58189,7,24.0,-1.290894,36.822971,-1.2615888,36.7928732,379,887,737,4199
7523,4859,104,3,Personal,22,6,59281,22,6,59775,22,6,61110,22,6,61215,22,6,62290,6,24.0,-1.2804891,36.7865102,-1.2971245,36.7532428,368,1075,494,1440
7524,9699,974,1,Personal,3,5,56009,3,5,56025,3,5,57379,3,5,59827,3,5,61943,10,22.6,-1.2795261,36.8260185,-1.3080097,36.7494062,167,2116,16,3802
7525,19707,2216,3,Business,23,1,41072,23,1,41080,23,1,41681,23,1,41930,23,1,44694,18,18.3,-1.2551895,36.7822034,-1.3105809,36.8897292,937,2764,8,850
7526,26202,2956,3,Business,9,2,45036,9,2,45124,9,2,45546,9,2,45889,9,2,47359,5,27.2,-1.279395,36.825364,-1.2584143,36.8048002,435,1470,88,765
7527,14624,3291,3,Business,7,3,47587,7,3,47627,7,3,47640,7,3,47856,7,3,48730,7,24.9,-1.2628473,36.781805,-1.272828,36.816608,633,874,40,229
7528,3607,1873,3,Business,1,1,35889,1,1,35930,1,1,35960,1,1,39228,1,1,39230,4,23.25888921888938,-1.2571472,36.7950633,-1.2889396,36.8155486,613,2,41,3298
7529,28157,2045,3,Personal,5,5,38007,5,5,38024,5,5,38648,5,5,39070,5,5,42616,26,24.0,-1.3272343,36.7110502,-1.2248308,36.8012573,789,3546,17,1046
7530,3955,982,3,Business,21,4,40878,21,4,40938,21,4,43070,21,4,44829,21,4,48818,26,27.9,-1.3087008,36.8565578,-1.2517871,36.6795716,787,3989,60,3891
7531,10544,928,3,Business,20,3,42606,20,3,42620,20,3,42910,20,3,43287,20,3,44996,8,26.2,-1.2551895,36.7822034,-1.2857671,36.7875614,831,1709,14,667
7532,10618,1304,3,Business,7,5,46512,7,5,47493,7,5,49069,7,5,49341,7,5,52201,9,26.7,-1.2551895,36.7822034,-1.3090727,36.8315262,205,2860,981,1848
7533,6105,1482,3,Business,18,5,42617,18,5,42747,18,5,43754,18,5,45801,18,5,46597,8,20.3,-1.3214137,36.8569475,-1.338579,36.8963038,622,796,130,3054
7534,4598,552,3,Business,25,1,47481,25,1,47495,25,1,48476,25,1,48959,25,1,50498,16,27.9,-1.2859912,36.8756811,-1.3562374,36.9042954,108,1539,14,1464
7535,20261,2009,2,Personal,26,3,39120,26,3,39127,26,3,39388,26,3,39788,26,3,42717,3,23.9,-1.2956882,36.7861845,-1.2868736,36.7805882,750,2929,7,661
7536,9394,1075,3,Business,4,5,60136,4,5,60242,4,5,61026,4,5,61331,4,5,63296,10,21.8,-1.3014461,36.7661381,-1.2527958,36.8003131,254,1965,106,1089
7537,5124,1544,3,Business,18,6,34160,18,6,34455,18,6,35065,18,6,35974,18,6,38109,6,23.25888921888938,-1.2924639,36.7795798,-1.2869955,36.8202749,119,2135,295,1519
7538,27368,2789,3,Business,8,5,36349,8,5,36373,8,5,37225,8,5,37601,8,5,38672,10,20.7,-1.304735,36.7846054,-1.3239248,36.7091136,649,1071,24,1228
7539,21836,186,3,Business,6,1,41132,6,1,41140,6,1,41452,6,1,42560,6,1,44190,17,20.3,-1.2902869,36.8085396,-1.3700383,36.9190174,857,1630,8,1420
7540,25151,1205,3,Business,3,3,48947,3,3,49157,3,3,49291,3,3,49682,3,3,50057,2,26.7,-1.2921114,36.819219,-1.2862457,36.8214792,456,375,210,525
7541,7379,1976,3,Business,6,1,35225,6,1,35263,6,1,35568,6,1,35750,6,1,36435,7,15.0,-1.257028,36.7810435,-1.2857671,36.7875614,726,685,38,487
7542,14474,1500,3,Business,7,4,38124,7,4,38146,7,4,39238,7,4,40060,7,4,41830,11,27.4,-1.3077869,36.8443207,-1.2638185,36.7930057,448,1770,22,1914
7543,17775,1787,3,Business,3,1,45758,3,1,45789,3,1,45860,3,1,47710,3,1,49211,15,21.4,-1.2283403,36.8822756,-1.2571472,36.7950633,248,1501,31,1921
7544,18968,12,3,Business,23,4,36545,23,4,37024,23,4,37969,23,4,38048,23,4,39913,25,23.2,-1.240021,36.84999,-1.3724413,36.9284922,8,1865,479,1024
7545,27720,1271,3,Business,11,5,59050,11,5,59058,11,5,60858,11,5,60979,11,5,63888,11,24.1,-1.3107918,36.761794,-1.2864733,36.8239937,451,2909,8,1921
7546,27209,2066,3,Business,24,3,40636,24,3,40742,24,3,44350,24,3,44466,24,3,45731,12,23.25888921888938,-1.3270716,36.8406371,-1.338558,36.9215488,48,1265,106,3724
7547,27782,970,3,Business,13,3,26709,13,3,30890,13,3,31343,13,3,31678,13,3,33230,6,20.1,-1.2551895,36.7822034,-1.2834816,36.8219031,119,1552,4181,788
7548,22741,1026,2,Personal,4,4,61288,4,4,61305,4,4,61500,4,4,62164,4,4,63133,5,23.25888921888938,-1.312942,36.8152651,-1.2916556,36.8262516,942,969,17,859
7549,17267,2828,3,Business,28,4,56322,28,4,56343,28,4,56459,28,4,56835,28,4,56990,3,27.5,-1.2584143,36.8048002,-1.2615888,36.7928732,598,155,21,492
7550,6433,246,3,Business,30,5,39123,30,5,40262,30,5,40566,30,5,44107,30,5,44449,2,23.8,-1.2615888,36.7928732,-1.2584143,36.8048002,28,342,1139,3845
7551,1952,3633,3,Personal,16,7,55162,16,7,55229,16,7,56481,16,7,56875,16,7,58136,7,24.3,-1.2963097,36.7688221,-1.2998789,36.8168963,725,1261,67,1646
7552,27350,1245,3,Business,11,1,54147,11,1,54157,11,1,54319,11,1,55360,11,1,57327,18,27.8,-1.3198615,36.7110323,-1.300921,36.828195,846,1967,10,1203
7553,28186,136,3,Business,20,4,51717,20,4,51736,20,4,51969,20,4,52201,20,4,53551,9,28.2,-1.2582974,36.8002238,-1.3025826,36.7670807,535,1350,19,465
7554,21926,3355,3,Business,6,2,45216,6,2,46610,6,2,48204,6,2,48625,6,2,49547,4,25.0,-1.279395,36.825364,-1.3052491,36.8223899,895,922,1394,2015
7555,23037,928,3,Business,23,3,40597,23,3,40624,23,3,40631,23,3,41093,23,3,42931,17,23.25888921888938,-1.2551895,36.7822034,-1.2264168,36.8767125,518,1838,27,469
7556,26812,1584,3,Business,7,3,34599,7,3,42445,7,3,42879,7,3,43476,7,3,44316,7,25.2,-1.2771155,36.82668,-1.2969741,36.7856612,88,840,7846,1031
7557,2829,1364,1,Personal,20,1,34942,20,1,34953,20,1,35230,20,1,35855,20,1,37379,13,14.2,-1.2745107,36.7974503,-1.3282758,36.8590281,805,1524,11,902
7558,20831,640,3,Business,14,4,34557,14,4,34589,14,4,35405,14,4,35575,14,4,37146,6,18.9,-1.2969741,36.7856612,-1.2833106,36.8240238,118,1571,32,986
7559,2611,553,3,Business,7,5,55204,7,5,56505,7,5,56973,7,5,57497,7,5,58814,6,26.8,-1.2765492,36.7669809,-1.2551895,36.7822034,332,1317,1301,992
7560,20079,2112,3,Business,1,1,40414,1,1,40478,1,1,41687,1,1,42683,1,1,44343,16,23.25888921888938,-1.2857247,36.7894293,-1.2156006,36.8916865,468,1660,64,2205
7561,15061,3599,3,Business,3,5,42171,3,5,42238,3,5,43154,3,5,44466,3,5,46442,13,23.25888921888938,-1.3302996,36.8707935,-1.2567393,36.8143232,675,1976,67,2228
7562,17464,1527,3,Business,8,1,54639,8,1,54660,8,1,55776,8,1,56837,8,1,57944,9,29.5,-1.2638185,36.7930057,-1.3004062,36.829741,349,1107,21,2177
7563,9645,1578,3,Business,24,5,34472,24,5,34579,24,5,35562,24,5,35652,24,5,36917,6,15.6,-1.2584143,36.8048002,-1.290894,36.822971,249,1265,107,1073
7564,22479,3621,3,Business,24,5,30309,24,5,30334,24,5,31659,24,5,31751,24,5,33110,7,18.2,-1.2836583,36.7886014,-1.31447,36.802047,468,1359,25,1417
7565,11426,496,3,Business,24,4,58617,24,4,58633,24,4,59319,24,4,59757,24,4,60695,7,21.4,-1.2553615,36.7895376,-1.2843046,36.7746132,103,938,16,1124
7566,21164,3420,3,Business,19,6,51218,19,6,51294,19,6,52865,19,6,53019,19,6,54346,9,27.5,-1.3046007,36.8211743,-1.3272688,36.7758397,622,1327,76,1725
7567,13890,1966,3,Business,19,2,36941,19,2,36958,19,2,37577,19,2,38223,19,2,40176,21,26.4,-1.3700383,36.9190174,-1.2917868,36.7872675,242,1953,17,1265
7568,6104,2200,3,Business,13,3,46078,13,3,47691,13,3,48152,13,3,48253,13,3,49136,4,19.9,-1.2765736,36.8513646,-1.290894,36.822971,444,883,1613,562
7569,25623,2330,3,Business,4,1,58546,4,1,58584,4,1,59474,4,1,59582,4,1,61080,9,25.9,-1.2326041,36.8009029,-1.2649605,36.7981777,244,1498,38,998
7570,24515,3521,3,Business,18,4,33791,18,4,34000,18,4,36271,18,4,37006,18,4,37592,2,20.4,-1.2684667,36.8002891,-1.2768326,36.8073804,299,586,209,3006
7571,9559,1527,3,Business,5,5,37009,5,5,37037,5,5,38648,5,5,39862,5,5,41173,9,24.7,-1.2638185,36.7930057,-1.3004062,36.829741,245,1311,28,2825
7572,11111,2801,3,Business,8,1,41132,8,1,41169,8,1,41422,8,1,42516,8,1,42925,9,24.4,-1.2690701,36.8314977,-1.2595422,36.7871178,179,409,37,1347
7573,26271,2381,3,Personal,5,2,36947,5,2,37060,5,2,37461,5,2,39220,5,2,40394,8,21.3,-1.2950041,36.8143583,-1.278067,36.783487,322,1174,113,2160
7574,23498,1642,3,Business,3,4,34207,3,4,34241,3,4,36283,3,4,36822,3,4,37296,3,20.5,-1.2837018,36.7860445,-1.2728069,36.7962362,829,474,34,2581
7575,23951,3264,3,Business,25,1,57606,25,1,57626,25,1,57722,25,1,57911,25,1,59164,9,30.2,-1.2551895,36.7822034,-1.2963316,36.7863289,709,1253,20,285
7576,4271,1850,3,Business,13,1,59257,13,1,59279,13,1,59356,13,1,59674,13,1,60277,2,23.25888921888938,-1.2551895,36.7822034,-1.2566586,36.7929682,411,603,22,395
7577,7480,85,2,Business,19,5,49520,19,5,49645,19,5,49771,19,5,50209,19,5,52700,9,27.5,-1.267229,36.806399,-1.3014461,36.7661381,279,2491,125,564
7578,19392,1075,3,Business,20,3,41778,20,3,41804,20,3,42280,20,3,42810,20,3,43240,1,27.3,-1.2584143,36.8048002,-1.2527958,36.8003131,205,430,26,1006
7579,3300,517,3,Business,27,4,43354,27,4,44096,27,4,44729,27,4,44998,27,4,45912,11,23.1,-1.3167113,36.8301563,-1.2574219,36.7927073,523,914,742,902
7580,28071,393,3,Business,1,5,30975,1,5,31315,1,5,31963,1,5,32802,1,5,33490,4,23.4,-1.3167113,36.8301563,-1.3004062,36.829741,328,688,340,1487
7581,3818,928,3,Business,17,4,56758,17,4,56870,17,4,56920,17,4,57560,17,4,60558,15,27.9,-1.2551895,36.7822034,-1.3319467,36.7766998,215,2998,112,690
7582,23333,2871,1,Personal,25,1,48439,25,1,48451,25,1,48470,25,1,49291,25,1,49630,4,23.25888921888938,-1.2616743,36.7852711,-1.2623805,36.7805404,379,339,12,840
7583,18030,393,3,Business,17,3,32073,17,3,32113,17,3,32768,17,3,32948,17,3,35138,14,23.25888921888938,-1.3167113,36.8301563,-1.2991441,36.7528804,148,2190,40,835
7584,5089,733,3,Business,4,2,50514,4,2,50624,4,2,52988,4,2,54027,4,2,57791,20,22.6,-1.2551895,36.7822034,-1.3251247,36.8995926,536,3764,110,3403
7585,960,1787,3,Business,7,2,57702,7,2,58042,7,2,59134,7,2,59489,7,2,61914,24,23.25888921888938,-1.2283403,36.8822756,-1.3393061,36.7674236,299,2425,340,1447
7586,16084,2069,3,Business,25,4,34945,25,4,35183,25,4,36148,25,4,37327,25,4,39464,9,16.5,-1.272828,36.816608,-1.228911,36.881876,646,2137,238,2144
7587,16541,2271,3,Business,3,5,53276,3,5,53313,3,5,53703,3,5,54568,3,5,56195,14,25.4,-1.272828,36.816608,-1.293515,36.897607,174,1627,37,1255
7588,26564,3064,3,Business,4,2,34816,4,2,34984,4,2,35618,4,2,36535,4,2,40316,20,15.8,-1.2571472,36.7950633,-1.3700383,36.9190174,630,3781,168,1551
7589,25614,3560,3,Business,25,1,59828,25,1,59927,25,1,60835,25,1,61277,25,1,61596,1,27.3,-1.2899256,36.815551,-1.279395,36.825364,48,319,99,1350
7590,3404,1386,2,Personal,26,3,43646,26,3,43696,26,3,44271,26,3,44466,26,3,45316,6,24.2,-1.2940713,36.7890758,-1.2796103,36.8127301,674,850,50,770
7591,23897,248,3,Business,12,2,56667,12,2,56713,12,2,58162,12,2,58526,12,2,59839,11,27.1,-1.2645805,36.752543,-1.304735,36.7846054,240,1313,46,1813
7592,17922,1260,3,Business,16,2,43066,16,2,43721,16,2,43792,16,2,46101,16,2,46715,12,23.25888921888938,-1.2551895,36.7822034,-1.3322618,36.8045412,436,614,655,2380
7593,25137,2150,3,Business,30,6,34329,30,6,34383,30,6,35118,30,6,37074,30,6,38094,12,23.25888921888938,-1.331619,36.847976,-1.344446,36.756597,218,1020,54,2691
7594,3150,2916,2,Personal,12,4,38883,12,4,39101,12,4,40138,12,4,40897,12,4,45520,14,19.1,-1.2287314,36.8367354,-1.2924639,36.7795798,752,4623,218,1796
7595,13043,3179,1,Personal,15,3,40626,15,3,40633,15,3,41064,15,3,41704,15,3,42846,7,17.9,-1.2566078,36.7832089,-1.2404575,36.7960814,229,1142,7,1071
7596,12908,439,3,Business,27,2,54742,27,2,54784,27,2,55174,27,2,55339,27,2,57068,5,25.7,-1.3323107,36.8692616,-1.3168075,36.8626441,812,1729,42,555
7597,10676,3175,3,Business,14,4,34783,14,4,34794,14,4,35968,14,4,36043,14,4,37999,13,15.3,-1.2612417,36.7958868,-1.214328,36.7911903,881,1956,11,1249
7598,1138,2411,3,Business,28,1,39494,28,1,39705,28,1,40270,28,1,40842,28,1,41561,5,23.5,-1.2615888,36.7928732,-1.28101,36.8115102,596,719,211,1137
7599,5792,1484,3,Business,29,2,34749,29,2,34807,29,2,34813,29,2,35359,29,2,36742,8,18.4,-1.2551895,36.7822034,-1.3032,36.817333,228,1383,58,552
7600,2976,1798,3,Business,30,2,40401,30,2,40416,30,2,41136,30,2,41392,30,2,42115,3,22.4,-1.2615888,36.7928732,-1.2630856,36.8082807,50,723,15,976
7601,17272,2174,3,Business,7,2,48275,7,2,48280,7,2,48682,7,2,50658,7,2,53173,19,24.6,-1.2482781,36.884092,-1.2941449,36.7592641,12,2515,5,2378
7602,14079,439,3,Business,6,4,33428,6,4,34239,6,4,35734,6,4,37357,6,4,38146,5,18.9,-1.327079,36.881469,-1.3323107,36.8692616,611,789,811,3118
7603,3992,1224,1,Personal,6,1,44095,6,1,44546,6,1,45176,6,1,45304,6,1,46703,10,20.7,-1.2841895,36.7930938,-1.320062,36.7999133,449,1399,451,758
7604,19421,3426,3,Business,12,2,58250,12,2,58424,12,2,59093,12,2,59282,12,2,61918,21,23.25888921888938,-1.2232123,36.8932547,-1.3012008,36.764868,58,2636,174,858
7605,5618,3647,3,Business,10,4,56833,10,4,58475,10,4,58684,10,4,59030,10,4,59746,5,21.9,-1.272639,36.794723,-1.2737591,36.8142522,100,716,1642,555
7606,2272,3710,3,Business,30,5,61839,30,5,62317,30,5,63808,30,5,64010,30,5,66012,20,22.1,-1.2551895,36.7822034,-1.3106315,36.9012422,383,2002,478,1693
7607,6706,3326,3,Business,11,4,43299,11,4,43329,11,4,43839,11,4,44293,11,4,46598,15,25.6,-1.2551895,36.7822034,-1.221085,36.8587279,690,2305,30,964
7608,18861,635,3,Business,2,3,45388,2,3,45685,2,3,46521,2,3,47046,2,3,48259,7,21.8,-1.3007481,36.8341778,-1.2599563,36.7993439,753,1213,297,1361
7609,17002,635,3,Business,30,4,41208,30,4,43017,30,4,43554,30,4,44543,30,4,46038,7,23.25888921888938,-1.2602337,36.7990548,-1.2922966,36.8374042,732,1495,1809,1526
7610,18842,2154,3,Business,8,6,39744,8,6,40197,8,6,41264,8,6,42222,8,6,43876,6,19.8,-1.279395,36.825364,-1.2765736,36.8513646,243,1654,453,2025
7611,26043,2178,1,Personal,5,6,76331,5,6,76389,5,6,77211,5,6,77724,5,6,78983,11,19.1,-1.276975,36.8231488,-1.3010017,36.8974511,103,1259,58,1335
7612,28132,938,1,Personal,9,3,33616,9,3,33654,9,3,34432,9,3,35149,9,3,37393,15,17.6,-1.3048328,36.9129202,-1.2857929,36.8240829,543,2244,38,1495
7613,23456,2330,3,Business,28,1,40452,28,1,40462,28,1,40607,28,1,40764,28,1,41647,6,23.6,-1.2915247,36.8055757,-1.3015197,36.7658456,191,883,10,302
7614,23185,868,3,Business,6,6,49406,6,6,49425,6,6,49624,6,6,50419,6,6,51210,7,28.3,-1.2628473,36.781805,-1.265715,36.823815,695,791,19,994
7615,11474,970,3,Business,11,1,40612,11,1,41188,11,1,41914,11,1,42218,11,1,43184,6,24.1,-1.2551895,36.7822034,-1.2904753,36.8144721,336,966,576,1030
7616,18074,893,3,Business,23,3,45131,23,3,45180,23,3,45394,23,3,45553,23,3,45703,2,23.25888921888938,-1.2663194,36.809901,-1.2675979,36.8155653,498,150,49,373
7617,27162,3517,3,Business,25,4,39506,25,4,39627,25,4,41738,25,4,43181,25,4,44974,15,19.9,-1.300921,36.828195,-1.3882008,36.7699445,340,1793,121,3554
7618,15738,3710,3,Business,23,5,60117,23,5,62650,23,5,62697,23,5,64756,23,5,65692,7,24.4,-1.233433,36.8004202,-1.2654879,36.7984789,925,936,2533,2106
7619,6404,2016,1,Personal,8,3,36418,8,3,36455,8,3,36599,8,3,36851,8,3,37591,6,17.2,-1.2671943,36.807601,-1.2871136,36.785507,62,740,37,396
7620,13105,277,1,Personal,27,1,47340,27,1,47349,27,1,47647,27,1,48392,27,1,50030,12,24.1,-1.3066837,36.8177502,-1.266264,36.762418,676,1638,9,1043
7621,21547,1336,3,Business,19,2,45641,19,2,45755,19,2,45885,19,2,46840,19,2,48825,18,26.5,-1.2885029,36.825605,-1.3425573,36.7102504,800,1985,114,1085
7622,21908,527,2,Personal,15,2,45770,15,2,46037,15,2,47030,15,2,47659,15,2,48709,12,22.6,-1.279448,36.823568,-1.3295139,36.8985677,393,1050,267,1622
7623,13597,3560,3,Business,14,1,32222,14,1,32234,14,1,33589,14,1,33732,14,1,34652,11,20.4,-1.2283403,36.8822756,-1.279395,36.825364,456,920,12,1498
7624,5758,1724,3,Business,12,5,40167,12,5,40378,12,5,41701,12,5,41818,12,5,44229,8,24.7,-1.2551895,36.7822034,-1.2972794,36.8014817,147,2411,211,1440
7625,17137,1207,3,Business,7,1,49574,7,1,49741,7,1,49966,7,1,51546,7,1,51556,7,26.7,-1.2629666,36.8068369,-1.284382,36.7746045,517,10,167,1805
7626,11754,2030,3,Business,29,1,46163,29,1,46197,29,1,46462,29,1,46757,29,1,47283,3,23.25888921888938,-1.2969741,36.7856612,-1.295908,36.791433,726,526,34,560
7627,2798,393,3,Business,15,1,48028,15,1,48046,15,1,48089,15,1,48690,15,1,49134,4,23.25888921888938,-1.3167113,36.8301563,-1.3002554,36.8256566,349,444,18,644
7628,22911,1075,3,Business,13,3,55368,13,3,55476,13,3,57226,13,3,57409,13,3,59208,13,29.0,-1.2285835,36.8826468,-1.2527958,36.8003131,63,1799,108,1933
7629,21275,2789,3,Business,15,5,52311,15,5,52340,15,5,52750,15,5,52847,15,5,55034,6,17.6,-1.304735,36.7846054,-1.2896399,36.8124498,590,2187,29,507
7630,23244,2344,3,Business,29,2,58118,29,2,58660,29,2,59548,29,2,60060,29,2,61555,6,22.5,-1.2553615,36.7895376,-1.280753,36.8191175,805,1495,542,1400
7631,17688,393,3,Business,15,1,59334,15,1,59353,15,1,59459,15,1,60009,15,1,61289,11,23.25888921888938,-1.3167113,36.8301563,-1.2638185,36.7930057,168,1280,19,656
7632,16726,2216,3,Business,22,2,56545,22,2,56583,22,2,57484,22,2,57964,22,2,60437,14,25.5,-1.2867627,36.883446,-1.3448483,36.9004081,620,2473,38,1381
7633,5440,3283,3,Business,30,5,53415,30,5,53612,30,5,54527,30,5,56996,30,5,58153,14,24.4,-1.228911,36.881876,-1.2628473,36.781805,307,1157,197,3384
7634,9126,3686,3,Business,20,3,47443,20,3,47511,20,3,48214,20,3,48340,20,3,49494,10,27.0,-1.2551895,36.7822034,-1.303148,36.792768,770,1154,68,829
7635,8492,3300,3,Business,17,3,36575,17,3,36619,17,3,37121,17,3,37745,17,3,38931,9,23.25888921888938,-1.2600926,36.8088685,-1.303596,36.778378,96,1186,44,1126
7636,3178,867,3,Business,27,1,38381,27,1,38394,27,1,38400,27,1,40108,27,1,40416,10,20.8,-1.3004062,36.829741,-1.2991441,36.7528804,70,308,13,1714
7637,351,3426,3,Business,3,4,54177,3,4,54198,3,4,55912,3,4,56218,3,4,60802,9,26.1,-1.279395,36.825364,-1.3014461,36.7661381,831,4584,21,2020
7638,27706,268,3,Business,14,4,57161,14,4,57882,14,4,58239,14,4,58497,14,4,61632,7,27.8,-1.2551895,36.7822034,-1.290724,36.81947,404,3135,721,615
7639,26393,1471,3,Business,11,2,45757,11,2,45786,11,2,46077,11,2,46538,11,2,49681,26,24.4,-1.2551895,36.7822034,-1.1605816,36.8977958,629,3143,29,752
7640,26208,2987,3,Business,18,1,43839,18,1,45024,18,1,45028,18,1,47397,18,1,47807,3,23.25888921888938,-1.270212,36.8210877,-1.263987,36.798891,813,410,1185,2373
7641,25228,868,3,Business,5,2,43829,5,2,43864,5,2,44313,5,2,44862,5,2,45949,8,21.3,-1.303596,36.778378,-1.265715,36.823815,116,1087,35,998
7642,18093,1959,3,Business,23,4,42641,23,4,42687,23,4,42759,23,4,43759,23,4,44411,3,23.2,-1.2584143,36.8048002,-1.2551895,36.7822034,107,652,46,1072
7643,15056,1687,3,Business,15,3,52919,15,3,53026,15,3,53772,15,3,54592,15,3,55688,9,21.7,-1.3011535,36.8437979,-1.3267367,36.8844852,754,1096,107,1566
7644,3473,1873,3,Business,5,5,47809,5,5,48177,5,5,48800,5,5,49895,5,5,51717,8,26.6,-1.225322,36.80855,-1.2571472,36.7950633,410,1822,368,1718
7645,9990,186,3,Business,18,2,47593,18,2,48138,18,2,48235,18,2,48710,18,2,52053,17,23.25888921888938,-1.3700383,36.9190174,-1.2899256,36.815551,345,3343,545,572
7646,15229,3774,2,Personal,18,1,57107,18,1,57495,18,1,58817,18,1,59607,18,1,62151,8,23.25888921888938,-1.248177,36.7766125,-1.2731645,36.7902246,322,2544,388,2112
7647,15434,794,2,Personal,12,2,40092,12,2,40111,12,2,40187,12,2,40736,12,2,42129,9,21.0,-1.2629944,36.7998816,-1.3141593,36.8101097,379,1393,19,625
7648,28051,3239,3,Personal,26,6,36357,26,6,36414,26,6,37349,26,6,37707,26,6,39791,8,18.6,-1.2839322,36.8292426,-1.2873232,36.7658572,480,2084,57,1293
7649,11033,3621,3,Business,21,7,41073,21,7,41092,21,7,42579,21,7,42919,21,7,44348,6,25.2,-1.2836583,36.7886014,-1.2622145,36.8087391,789,1429,19,1827
7650,12231,3149,3,Business,14,2,40436,14,2,40475,14,2,41383,14,2,42194,14,2,44915,5,21.5,-1.3004062,36.829741,-1.3177547,36.8303703,213,2721,39,1719
7651,7788,1955,3,Business,19,3,58834,19,3,58908,19,3,59390,19,3,59724,19,3,60855,8,23.3,-1.2854406,36.789409,-1.2571472,36.7950633,410,1131,74,816
7652,22250,1075,3,Business,22,5,30557,22,5,30593,22,5,30935,22,5,31067,22,5,31076,4,23.25888921888938,-1.2657464,36.7801144,-1.2527958,36.8003131,108,9,36,474
7653,3913,2085,3,Personal,14,2,50038,14,2,50055,14,2,50404,14,2,50569,14,2,51990,6,23.8,-1.296797,36.7764525,-1.2668611,36.7956387,281,1421,17,514
7654,7355,3300,3,Business,8,1,49104,8,1,49151,8,1,49405,8,1,49955,8,1,51817,7,29.6,-1.2628473,36.781805,-1.303596,36.778378,7,1862,47,804
7655,20029,3686,3,Business,15,5,34417,15,5,34448,15,5,35121,15,5,35460,15,5,38540,22,20.4,-1.2551895,36.7822034,-1.3692201,36.9252718,932,3080,31,1012
7656,8638,1882,3,Business,15,4,53447,15,4,54249,15,4,54737,15,4,55301,15,4,58044,13,27.5,-1.2958783,36.7928125,-1.3175825,36.7004796,612,2743,802,1052
7657,3163,393,3,Business,14,3,53080,14,3,54613,14,3,54619,14,3,56586,14,3,58042,10,25.7,-1.3177547,36.8303703,-1.2574219,36.7927073,97,1456,1533,1973
7658,15415,649,3,Business,2,5,60367,2,5,60415,2,5,61222,2,5,61368,2,5,62186,3,24.2,-1.2649605,36.7981777,-1.2551895,36.7822034,330,818,48,953
7659,123,2283,2,Personal,5,3,48094,5,3,48148,5,3,48630,5,3,48749,5,3,51642,6,23.7,-1.2696341,36.791664,-1.2958383,36.8073162,167,2893,54,601
7660,18232,2627,3,Business,14,2,53638,14,2,53670,14,2,54002,14,2,54095,14,2,54760,2,23.25888921888938,-1.2584143,36.8048002,-1.2571472,36.7950633,138,665,32,425
7661,16766,2310,3,Business,15,2,51917,15,2,56080,15,2,56772,15,2,57137,15,2,58775,9,24.4,-1.290894,36.822971,-1.2859912,36.8756811,742,1638,4163,1057
7662,5479,3050,3,Business,1,5,43914,1,5,43938,1,5,43985,1,5,44859,1,5,46891,7,28.8,-1.2945074,36.8083195,-1.2760462,36.8074697,354,2032,24,921
7663,26771,412,3,Business,11,1,43520,11,1,43555,11,1,43885,11,1,44184,11,1,45036,8,24.1,-1.266837,36.799249,-1.303596,36.778378,62,852,35,629
7664,5471,2162,3,Business,7,1,49121,7,1,49478,7,1,50937,7,1,51786,7,1,53753,12,20.3,-1.256624,36.8706846,-1.2615888,36.7928732,479,1967,357,2308
7665,11008,1500,3,Business,4,2,53087,4,2,53173,4,2,53322,4,2,54425,4,2,56172,11,22.5,-1.3228003,36.8306435,-1.2638185,36.7930057,36,1747,86,1252
7666,28097,2360,3,Business,21,4,40593,21,4,40617,21,4,42026,21,4,43111,21,4,46806,23,28.2,-1.3696893,36.7354703,-1.2551895,36.7822034,847,3695,24,2494
7667,26305,1797,3,Personal,18,4,43043,18,4,43073,18,4,44867,18,4,45146,18,4,48209,19,25.5,-1.3295831,36.7388987,-1.2630521,36.8068019,893,3063,30,2073
7668,20066,3689,3,Business,21,3,56691,21,3,57003,21,3,57020,21,3,58548,21,3,58550,2,23.4,-1.2527958,36.8003131,-1.2571472,36.7950633,295,2,312,1545
7669,6469,2587,3,Business,20,4,46233,20,4,46302,20,4,47292,20,4,48106,20,4,50317,15,24.5,-1.28878,36.8168312,-1.216682,36.9085778,736,2211,69,1804
7670,15953,2174,3,Business,21,1,46781,21,1,46800,21,1,46841,21,1,48676,21,1,50558,18,19.8,-1.2482781,36.884092,-1.2948802,36.766374,423,1882,19,1876
7671,27590,1231,3,Business,3,1,37672,3,1,38157,3,1,38935,3,1,39106,3,1,40857,12,22.3,-1.2821422,36.8161565,-1.2283403,36.8822756,677,1751,485,949
7672,25842,3647,3,Business,4,1,51972,4,1,52008,4,1,52668,4,1,53097,4,1,55522,28,28.5,-1.272639,36.794723,-1.1846355,36.9485728,147,2425,36,1089
7673,27972,2523,3,Business,14,3,52489,14,3,54658,14,3,55984,14,3,56151,14,3,57366,9,25.5,-1.2551895,36.7822034,-1.306431,36.812042,383,1215,2169,1493
7674,19061,3291,3,Business,31,5,39139,31,5,39207,31,5,41509,31,5,43370,31,5,45725,18,21.5,-1.3393547,36.8910035,-1.2600926,36.8088685,126,2355,68,4163
7675,24018,210,3,Business,3,1,37342,3,1,37444,3,1,37903,3,1,38465,3,1,39408,6,21.5,-1.2728947,36.8079426,-1.2868736,36.7805882,383,943,102,1021
7676,13444,1736,3,Personal,5,2,39479,5,2,39538,5,2,40339,5,2,41083,5,2,42225,14,25.3,-1.296485,36.7931959,-1.3189252,36.8617269,222,1142,59,1545
7677,24745,635,3,Business,9,4,39180,9,4,39326,9,4,42844,9,4,42974,9,4,44542,5,23.6,-1.2857764,36.8236622,-1.2599563,36.7993439,519,1568,146,3648
7678,21703,286,3,Business,6,4,34043,6,4,34152,6,4,34928,6,4,35889,6,4,36716,3,18.9,-1.2809121,36.7852524,-1.2962967,36.8020231,404,827,109,1737
7679,3345,3517,3,Business,13,3,49853,13,3,49894,13,3,50378,13,3,51767,13,3,53149,15,29.2,-1.300921,36.828195,-1.3882008,36.7699445,130,1382,41,1873
7680,22778,2174,3,Business,23,3,30597,23,3,30605,23,3,30649,23,3,33663,23,3,35329,15,23.25888921888938,-1.2482781,36.884092,-1.214071,36.7985052,75,1666,8,3058
7681,1005,2956,3,Business,15,3,52382,15,3,52443,15,3,52635,15,3,52916,15,3,53946,4,25.9,-1.2584143,36.8048002,-1.2551895,36.7822034,930,1030,61,473
7682,1907,2017,3,Business,9,1,26578,9,1,26842,9,1,28598,9,1,28873,9,1,29501,2,15.1,-1.304033,36.7848695,-1.2963097,36.7688221,735,628,264,2031
7683,18986,3439,3,Business,14,5,52416,14,5,52416,14,5,52435,14,5,53119,14,5,53805,6,22.8,-1.2649605,36.7981777,-1.2393157,36.7668877,709,686,0,703
7684,16804,909,3,Business,12,5,51730,12,5,52201,12,5,53159,12,5,53585,12,5,56341,24,23.25888921888938,-1.225322,36.80855,-1.3251247,36.8995926,14,2756,471,1384
7685,16645,1107,2,Personal,24,1,49620,24,1,49626,24,1,50478,24,1,50679,24,1,51587,4,23.25888921888938,-1.2728058,36.8049903,-1.288167,36.8181484,336,908,6,1053
7686,2492,2523,3,Business,7,1,36625,7,1,36706,7,1,38476,7,1,38565,7,1,40688,6,24.8,-1.2551895,36.7822034,-1.2889219,36.8256084,795,2123,81,1859
7687,22473,3599,3,Business,21,2,37946,21,2,38096,21,2,38810,21,2,40391,21,2,42749,9,22.6,-1.3302996,36.8707935,-1.2911796,36.8215068,48,2358,150,2295
7688,24116,1363,3,Business,14,5,39722,14,5,39789,14,5,40626,14,5,41783,14,5,42113,8,22.0,-1.3004062,36.829741,-1.2574219,36.7927073,567,330,67,1994
7689,22728,2587,3,Business,16,2,51687,16,2,51863,16,2,52862,16,2,53185,16,2,54082,5,23.25888921888938,-1.2584143,36.8048002,-1.28878,36.8168312,438,897,176,1322
7690,11247,1482,3,Business,26,3,34262,26,3,34287,26,3,35912,26,3,36686,26,3,39018,17,18.8,-1.3415373,36.7295377,-1.2822773,36.7953121,565,2332,25,2399
7691,16421,3283,3,Business,1,4,50585,1,4,51868,1,4,52332,1,4,53300,1,4,54399,13,23.25888921888938,-1.331619,36.847976,-1.2628473,36.781805,406,1099,1283,1432
7692,14054,1075,3,Business,16,3,49508,16,3,49532,16,3,49799,16,3,49958,16,3,50991,3,26.9,-1.2527958,36.8003131,-1.2615888,36.7928732,547,1033,24,426
7693,14138,136,3,Business,29,5,33016,29,5,33067,29,5,33869,29,5,34143,29,5,36031,14,21.0,-1.2848376,36.8027622,-1.3254522,36.7216584,576,1888,51,1076
7694,17663,2587,3,Business,23,4,57910,23,4,57929,23,4,59050,23,4,59236,23,4,59707,2,20.7,-1.28878,36.8168312,-1.2905033,36.8096462,88,471,19,1307
7695,23127,1418,1,Personal,14,4,55157,14,4,55172,14,4,56465,14,4,56611,14,4,57146,1,21.5,-1.2915307,36.7905865,-1.29362,36.78745,312,535,15,1439
7696,27616,867,3,Business,28,4,32512,28,4,32549,28,4,33474,28,4,33661,28,4,36281,10,22.4,-1.2996533,36.8292629,-1.2991441,36.7528804,448,2620,37,1112
7697,18708,412,3,Business,25,6,37230,25,6,37859,25,6,38027,25,6,38828,25,6,40125,2,23.25888921888938,-1.2600926,36.8088685,-1.266837,36.799249,27,1297,629,969
7698,16003,1209,3,Business,18,4,37446,18,4,37470,18,4,38151,18,4,39127,18,4,39154,5,23.25888921888938,-1.2770708,36.8231093,-1.3004062,36.829741,61,27,24,1657
7699,5112,3598,1,Personal,9,2,44294,9,2,45185,9,2,45611,9,2,45715,9,2,49249,8,21.8,-1.2675334,36.7658246,-1.2877501,36.8146599,131,3534,891,530
7700,21934,1500,3,Business,4,4,36861,4,4,36989,4,4,36997,4,4,37261,4,4,38537,13,21.8,-1.2638185,36.7930057,-1.3228003,36.8306435,576,1276,128,272
7701,19078,1280,3,Business,10,3,38620,10,3,38640,10,3,38976,10,3,39187,10,3,41200,13,27.8,-1.2551895,36.7822034,-1.3207951,36.8286902,411,2013,20,547
7702,28037,1370,3,Personal,16,3,46228,16,3,46253,16,3,46262,16,3,46441,16,3,48811,13,24.1,-1.261692,36.80161,-1.3332749,36.8708147,84,2370,25,188
7703,19935,793,3,Personal,27,3,45890,27,3,47796,27,3,49623,27,3,50571,27,3,55364,12,29.5,-1.2651574,36.7474347,-1.2837255,36.8220797,411,4793,1906,2775
7704,2054,1075,3,Business,31,4,56040,31,4,56075,31,4,56847,31,4,58165,31,4,59540,13,28.7,-1.207546,36.7913976,-1.2527958,36.8003131,52,1375,35,2090
7705,13818,2330,3,Business,30,4,55111,30,4,55441,30,4,57086,30,4,57196,30,4,58675,13,23.25888921888938,-1.2124582,36.802894,-1.2284323,36.8757058,7,1479,330,1755
7706,25544,1469,3,Business,14,4,35050,14,4,35062,14,4,35341,14,4,35414,14,4,35986,3,17.8,-1.2551895,36.7822034,-1.2640571,36.7883547,932,572,12,352
7707,23883,2580,1,Personal,12,4,29778,12,4,29916,12,4,30946,12,4,31402,12,4,32014,4,16.2,-1.2555326,36.781296,-1.260039,36.8159152,726,612,138,1486
7708,12679,3295,3,Business,12,2,53930,12,2,53975,12,2,56455,12,2,56740,12,2,57210,2,23.25888921888938,-1.2571472,36.7950633,-1.2495931,36.8065087,107,470,45,2765
7709,370,3757,3,Personal,15,1,43060,15,1,43095,15,1,44037,15,1,45570,15,1,46856,9,23.25888921888938,-1.2655381,36.8354648,-1.3173869,36.8112044,907,1286,35,2475
7710,26924,948,3,Business,10,1,39113,10,1,39141,10,1,39297,10,1,39560,10,1,41032,7,18.6,-1.2936611,36.8260953,-1.2594474,36.8089122,247,1472,28,419
7711,20025,3521,3,Business,9,2,32860,9,2,32900,9,2,33348,9,2,33751,9,2,34382,2,20.9,-1.2696908,36.81519,-1.2701354,36.8072167,276,631,40,851
7712,16253,375,3,Business,30,2,51715,30,2,58109,30,2,58950,30,2,59105,30,2,63110,8,23.25888921888938,-1.2551895,36.7822034,-1.2969293,36.8027733,548,4005,6394,996
7713,10106,2190,3,Business,6,2,57119,6,2,57193,6,2,57213,6,2,57746,6,2,57782,2,27.5,-1.301953,36.788458,-1.2919665,36.7961087,390,36,74,553
7714,14705,3575,3,Personal,10,5,32827,10,5,32852,10,5,33379,10,5,33766,10,5,34367,4,13.6,-1.269534,36.80697,-1.293973,36.80169,754,601,25,914
7715,17259,2523,3,Business,7,5,56861,7,5,57241,7,5,58482,7,5,58667,7,5,59553,5,23.25888921888938,-1.2551895,36.7822034,-1.2731645,36.7900343,147,886,380,1426
7716,19863,1102,3,Business,26,5,53546,26,5,53569,26,5,54155,26,5,54366,26,5,54791,2,23.25888921888938,-1.3004062,36.829741,-1.2945128,36.8396881,506,425,23,797
7717,11703,3698,3,Business,7,2,39595,7,2,39655,7,2,40380,7,2,40567,7,2,42200,18,23.25888921888938,-1.2649605,36.7981777,-1.3244885,36.897792,911,1633,60,912
7718,22225,2748,1,Personal,6,3,52830,6,3,54071,6,3,54958,6,3,55144,6,3,55960,6,21.6,-1.269103,36.8223998,-1.293365,36.7961955,726,816,1241,1073
7719,24916,868,3,Business,15,2,42115,15,2,42231,15,2,42249,15,2,43251,15,2,44308,9,22.8,-1.318062,36.849326,-1.265715,36.823815,408,1057,116,1020
7720,10865,3283,3,Business,12,2,35418,12,2,36741,12,2,38183,12,2,38611,12,2,39205,4,24.5,-1.266837,36.799249,-1.2628473,36.781805,268,594,1323,1870
7721,21548,3517,3,Business,30,2,60380,30,2,60801,30,2,61746,30,2,62140,30,2,64860,15,23.25888921888938,-1.300921,36.828195,-1.2156006,36.8916865,155,2720,421,1339
7722,15568,635,3,Business,4,1,46426,4,1,50534,4,1,51853,4,1,52047,4,1,53284,7,23.25888921888938,-1.2602337,36.7990548,-1.3081376,36.8329772,516,1237,4108,1513
7723,2576,3669,3,Business,5,3,56450,5,3,56539,5,3,58185,5,3,58253,5,3,60906,15,23.8,-1.2615888,36.7928732,-1.3282758,36.8590281,399,2653,89,1714
7724,5044,2150,3,Business,11,4,33057,11,4,33081,11,4,33868,11,4,35069,11,4,36151,11,22.1,-1.307143,36.825009,-1.344446,36.756597,507,1082,24,1988
7725,12137,1961,3,Business,10,1,52025,10,1,52059,10,1,52955,10,1,53478,10,1,54980,19,18.2,-1.331619,36.847976,-1.3188359,36.7038526,524,1502,34,1419
7726,11505,2330,3,Business,15,1,54737,15,1,54847,15,1,55625,15,1,55860,15,1,57543,11,23.25888921888938,-1.2524916,36.8656196,-1.233018,36.8004477,653,1683,110,1013
7727,13771,1856,3,Business,9,5,35890,9,5,36195,9,5,38203,9,5,38369,9,5,41627,5,25.5,-1.273009,36.802807,-1.2890893,36.8268633,660,3258,305,2174
7728,13340,1310,2,Personal,15,1,39598,15,1,39646,15,1,40373,15,1,40713,15,1,41522,8,23.25888921888938,-1.325307,36.825157,-1.3038156,36.8122733,72,809,48,1067
7729,23750,1217,3,Personal,8,1,35409,8,1,35650,8,1,37437,8,1,38180,8,1,40839,12,24.4,-1.2867809,36.8218665,-1.2251345,36.8835216,86,2659,241,2530
7730,20152,1179,3,Business,24,3,50661,24,3,50873,24,3,50876,24,3,52220,24,3,54577,21,18.4,-1.3700383,36.9190174,-1.2917868,36.7872675,345,2357,212,1347
7731,25885,1578,3,Business,18,2,30202,18,2,32285,18,2,33778,18,2,34391,18,2,35426,2,16.6,-1.290894,36.822971,-1.28878,36.8168312,932,1035,2083,2106
7732,10538,867,3,Business,29,3,42224,29,3,42248,29,3,42870,29,3,44735,29,3,46219,10,23.25888921888938,-1.3004062,36.829741,-1.2991441,36.7528804,591,1484,24,2487
7733,20196,1340,3,Business,1,5,37816,1,5,37857,1,5,38567,1,5,38733,1,5,39118,2,26.4,-1.2707179,36.7979713,-1.2667532,36.8024002,547,385,41,876
7734,19063,867,3,Business,21,1,37600,21,1,37676,21,1,38556,21,1,39212,21,1,40838,10,25.5,-1.2996533,36.8292629,-1.2991441,36.7528804,576,1626,76,1536
7735,16971,2112,3,Business,21,5,66342,21,5,68975,21,5,69226,21,5,69585,21,5,71260,13,23.0,-1.2156006,36.8916865,-1.279395,36.825364,72,1675,2633,610
7736,17280,1424,3,Business,3,1,39149,3,1,39220,3,1,39843,3,1,40383,3,1,42402,11,22.1,-1.30157,36.7871,-1.257984,36.745016,647,2019,71,1163
7737,25203,3548,3,Personal,15,5,51280,15,5,51302,15,5,51993,15,5,52057,15,5,53072,5,28.0,-1.2948385,36.7768079,-1.3104734,36.7363698,328,1015,22,755
7738,5881,302,3,Business,3,6,51851,3,6,51897,3,6,53570,3,6,53641,3,6,54543,1,22.4,-1.2649605,36.7981777,-1.25841,36.804026,112,902,46,1744
7739,27370,2828,3,Business,8,6,33329,8,6,37192,8,6,40174,8,6,40697,8,6,42928,22,18.4,-1.2344098,36.7290354,-1.2156006,36.8916865,937,2231,3863,3505
7740,14017,309,3,Business,4,2,39840,4,2,39976,4,2,41145,4,2,41213,4,2,42712,6,20.5,-1.2156006,36.8916865,-1.2413316,36.8785525,92,1499,136,1237
7741,17179,2910,3,Business,10,1,56457,10,1,56701,10,1,57836,10,1,59833,10,1,61230,8,18.6,-1.2601197,36.7985271,-1.296797,36.7764525,382,1397,244,3132
7742,27312,3291,3,Business,27,1,48496,27,1,48526,27,1,48844,27,1,50064,27,1,53239,8,23.2,-1.3040553,36.8092658,-1.2600926,36.8088685,72,3175,30,1538
7743,3547,627,3,Business,8,5,46781,8,5,46824,8,5,47175,8,5,48767,8,5,49597,6,21.5,-1.2579304,36.8019667,-1.3001813,36.811122,116,830,43,1943
7744,2378,3201,3,Business,12,2,44731,12,2,44808,12,2,44840,12,2,44962,12,2,48210,21,28.4,-1.3562374,36.9042954,-1.2584143,36.8048002,385,3248,77,154
7745,14924,2982,3,Business,25,1,34726,25,1,34735,25,1,35391,25,1,36316,25,1,38670,18,23.25888921888938,-1.300921,36.828195,-1.177202,36.8351183,399,2354,9,1581
7746,8451,3621,3,Business,22,1,36243,22,1,36294,22,1,37325,22,1,37845,22,1,39347,16,23.25888921888938,-1.2836583,36.7886014,-1.2083221,36.8392443,161,1502,51,1551
7747,2396,640,3,Business,7,3,38982,7,3,40632,7,3,41962,7,3,42295,7,3,44176,10,24.9,-1.304033,36.7848695,-1.2644886,36.8018968,208,1881,1650,1663
7748,25012,3432,3,Business,23,4,58837,23,4,59827,23,4,60863,23,4,62614,23,4,62697,2,23.25888921888938,-1.2672588,36.8000252,-1.258606,36.800887,119,83,990,2787
7749,17764,2680,3,Business,7,5,55020,7,5,55362,7,5,55372,7,5,56138,7,5,57258,7,23.25888921888938,-1.2882073,36.8237673,-1.3039706,36.7688174,906,1120,342,776
7750,21748,1594,3,Business,25,1,55900,25,1,57723,25,1,58887,25,1,59775,25,1,61346,16,28.3,-1.2156006,36.8916865,-1.3285517,36.9018,520,1571,1823,2052
7751,2243,393,3,Business,22,5,50665,22,5,50673,22,5,50700,22,5,52407,22,5,52409,11,27.5,-1.3167113,36.8301563,-1.2638185,36.7930057,10,2,8,1734
7752,26426,1933,1,Personal,10,1,65584,10,1,65646,10,1,65965,10,1,66246,10,1,66870,5,19.2,-1.2656592,36.8014259,-1.2543899,36.8091271,86,624,62,600
7753,325,868,3,Business,8,3,38824,8,3,38920,8,3,39268,8,3,39570,8,3,40170,4,23.25888921888938,-1.2600926,36.8088685,-1.265715,36.823815,829,600,96,650
7754,4128,2330,3,Business,2,4,56432,2,4,56517,2,4,58064,2,4,58473,2,4,59503,8,23.25888921888938,-1.3015197,36.7658456,-1.3192789,36.7112991,548,1030,85,1956
7755,6816,3560,3,Business,10,1,51135,10,1,53149,10,1,55787,10,1,56695,10,1,61338,12,18.7,-1.2852569,36.8976121,-1.279395,36.825364,697,4643,2014,3546
7756,27981,1900,3,Personal,7,2,45807,7,2,45859,7,2,45877,7,2,46502,7,2,47918,6,23.25888921888938,-1.3040651,36.7981254,-1.2764851,36.8007126,647,1416,52,643
7757,782,3420,3,Business,30,5,33918,30,5,35147,30,5,35908,30,5,36090,30,5,39939,6,18.8,-1.3046007,36.8211743,-1.265981,36.7936121,607,3849,1229,943
7758,2689,136,3,Business,28,2,37097,28,2,38313,28,2,38886,28,2,39033,28,2,42209,17,21.1,-1.3254522,36.7216584,-1.266022,36.8269774,572,3176,1216,720
7759,439,1178,3,Business,27,2,57765,27,2,58333,27,2,58881,27,2,59477,27,2,61327,13,25.7,-1.2261885,36.8206948,-1.2868515,36.7844247,648,1850,568,1144
7760,14970,3477,3,Business,28,1,42819,28,1,43176,28,1,43457,28,1,44337,28,1,45412,4,23.9,-1.2791714,36.8255997,-1.304127,36.805743,360,1075,357,1161
7761,14617,1205,3,Business,13,3,43357,13,3,44005,13,3,44482,13,3,45092,13,3,46956,6,23.25888921888938,-1.2513025,36.8094419,-1.290724,36.81947,291,1864,648,1087
7762,7231,2532,3,Business,18,2,37191,18,2,37772,18,2,37853,18,2,39930,18,2,42484,8,23.25888921888938,-1.2551895,36.7822034,-1.2967702,36.8040381,19,2554,581,2158
7763,19297,1673,2,Personal,25,3,44391,25,3,44428,25,3,45181,25,3,45601,25,3,47132,8,23.25888921888938,-1.261395,36.8263891,-1.288512,36.7731539,313,1531,37,1173
7764,12278,2523,3,Business,25,1,42038,25,1,42078,25,1,42681,25,1,42747,25,1,44058,11,26.9,-1.2551895,36.7822034,-1.2310607,36.8035776,598,1311,40,669
7765,428,627,3,Business,11,1,53642,11,1,53668,11,1,54141,11,1,54939,11,1,55443,3,28.0,-1.2571472,36.7950633,-1.2635089,36.7887337,205,504,26,1271
7766,26997,3201,3,Business,12,2,52061,12,2,52079,12,2,52488,12,2,53288,12,2,53630,2,26.9,-1.2551895,36.7822034,-1.2584143,36.8048002,647,342,18,1209
7767,24543,916,3,Business,10,5,46178,10,5,46254,10,5,46556,10,5,47936,10,5,47967,5,19.2,-1.3321944,36.8892329,-1.325517,36.907822,102,31,76,1682
7768,21103,2982,3,Business,2,3,54009,2,3,54031,2,3,55156,2,3,56772,2,3,58569,18,26.0,-1.300921,36.828195,-1.177202,36.8351183,457,1797,22,2741
7769,12071,391,3,Business,18,4,32510,18,4,32531,18,4,33037,18,4,33831,18,4,35181,10,23.25888921888938,-1.300921,36.828195,-1.2959666,36.7697163,933,1350,21,1300
7770,26071,111,3,Business,25,5,58348,25,5,58413,25,5,59389,25,5,59460,25,5,59595,4,29.3,-1.2551895,36.7822034,-1.272798,36.8124195,764,135,65,1047
7771,8691,1482,3,Business,29,1,43353,29,1,43382,29,1,43449,29,1,46411,29,1,47231,8,23.25888921888938,-1.3214137,36.8569475,-1.338579,36.8963038,698,820,29,3029
7772,2459,627,3,Business,10,1,55305,10,1,55329,10,1,55804,10,1,56160,10,1,56714,2,18.3,-1.2551895,36.7822034,-1.2575555,36.7987053,591,554,24,831
7773,23948,2763,3,Business,10,1,56409,10,1,59707,10,1,59749,10,1,60352,10,1,62858,16,19.0,-1.2551895,36.7822034,-1.332175,36.8819641,108,2506,3298,645
7774,26497,2021,3,Business,13,4,57187,13,4,57870,13,4,58122,13,4,58540,13,4,60423,25,23.0,-1.2945128,36.8396881,-1.4238401,36.9730061,675,1883,683,670
7775,14399,2627,3,Business,4,1,53283,4,1,53341,4,1,53371,4,1,54787,4,1,56328,14,28.5,-1.2285835,36.8826468,-1.2571472,36.7950633,75,1541,58,1446
7776,16141,286,3,Business,18,1,43467,18,1,43718,18,1,45575,18,1,45671,18,1,47280,7,27.1,-1.2551895,36.7822034,-1.2875013,36.8171787,169,1609,251,1953
7777,27262,391,3,Business,7,5,45262,7,5,47200,7,5,48034,7,5,48997,7,5,50654,5,23.25888921888938,-1.300921,36.828195,-1.2784063,36.8222933,158,1657,1938,1797
7778,16155,469,3,Personal,27,7,60079,27,7,62368,27,7,63269,27,7,64689,27,7,65870,12,23.25888921888938,-1.291231,36.8344488,-1.3253826,36.8822315,206,1181,2289,2321
7779,20051,3064,3,Business,16,4,37673,16,4,37705,16,4,38389,16,4,38883,16,4,40054,7,14.5,-1.2571472,36.7950633,-1.2948835,36.7830474,329,1171,32,1178
7780,19896,704,3,Business,17,5,31880,17,5,32176,17,5,34858,17,5,35370,17,5,36267,8,23.25888921888938,-1.2860183,36.8975338,-1.2910116,36.8573231,547,897,296,3194
7781,7516,3147,3,Business,5,3,48446,5,3,50561,5,3,51295,5,3,52079,5,3,54027,13,24.9,-1.2765736,36.8513646,-1.3472066,36.7692638,933,1948,2115,1518
7782,25412,393,3,Business,20,4,28219,20,4,28255,20,4,31548,20,4,31817,20,4,32456,4,18.0,-1.3177547,36.8303703,-1.3004062,36.829741,731,639,36,3562
7783,2316,3201,3,Business,9,3,56893,9,3,56904,9,3,56927,9,3,58442,9,3,58443,2,25.2,-1.2551895,36.7822034,-1.2584143,36.8048002,501,1,11,1538
7784,11803,1882,3,Business,13,6,34746,13,6,34764,13,6,34779,13,6,36126,13,6,38247,7,20.2,-1.2956882,36.7861845,-1.2591019,36.800577,613,2121,18,1362
7785,393,2829,3,Business,9,4,47421,9,4,47581,9,4,48004,9,4,48253,9,4,51231,21,23.25888921888938,-1.2571472,36.7950633,-1.3562374,36.9042954,205,2978,160,672
7786,24380,3149,3,Business,27,3,55452,27,3,55549,27,3,56486,27,3,58584,27,3,59577,6,29.2,-1.3004062,36.829741,-1.3167113,36.8301563,686,993,97,3035
7787,10408,2866,3,Business,5,1,40626,5,1,40660,5,1,40809,5,1,41210,5,1,41723,4,24.6,-1.2551895,36.7822034,-1.2658335,36.8042867,65,513,34,550
7788,14274,187,3,Business,7,1,42547,7,1,43735,7,1,44609,7,1,45744,7,1,46657,8,24.8,-1.3472066,36.7692638,-1.3165542,36.700067,874,913,1188,2009
7789,12127,1103,3,Business,8,1,33042,8,1,33440,8,1,34445,8,1,35277,8,1,36225,7,19.8,-1.290894,36.822971,-1.2571472,36.7950633,656,948,398,1837
7790,22267,302,3,Business,10,1,68774,10,1,68818,10,1,68850,10,1,70164,10,1,71012,7,18.6,-1.2649605,36.7981777,-1.287428,36.7800821,427,848,44,1346
7791,26744,2416,1,Personal,5,4,33211,5,4,33300,5,4,34346,5,4,34768,5,4,35558,6,23.25888921888938,-1.2980229,36.78865,-1.266362,36.796939,726,790,89,1468
7792,22556,797,3,Business,15,3,50550,15,3,55293,15,3,55310,15,3,55884,15,3,57252,8,21.5,-1.2551895,36.7822034,-1.2824911,36.8218042,89,1368,4743,591
7793,17147,2556,1,Personal,6,5,55245,6,5,55258,6,5,55598,6,5,56079,6,5,57910,16,22.3,-1.2933541,36.7958784,-1.2151769,36.8846524,103,1831,13,821
7794,24492,1154,3,Business,9,2,52537,9,2,52550,9,2,52867,9,2,53511,9,2,55214,21,30.6,-1.3700383,36.9190174,-1.2917868,36.7872675,877,1703,13,961
7795,12472,187,3,Business,3,2,54297,3,2,54504,3,2,55263,3,2,55624,3,2,57793,8,20.4,-1.3014461,36.7661381,-1.3169591,36.7000029,140,2169,207,1120
7796,5627,1222,3,Personal,15,1,41671,15,1,41743,15,1,42278,15,1,42438,15,1,44930,6,23.25888921888938,-1.2707179,36.7979713,-1.3006208,36.7727444,131,2492,72,695
7797,23241,435,3,Business,4,2,32944,4,2,32980,4,2,35060,4,2,35384,4,2,38832,16,16.4,-1.3411844,36.7108768,-1.300921,36.828195,831,3448,36,2404
7798,5649,1873,3,Business,13,3,35364,13,3,35417,13,3,37495,13,3,37583,13,3,40571,17,20.4,-1.3100117,36.8226483,-1.2253996,36.8875735,519,2988,53,2166
7799,2813,1362,1,Personal,6,5,73189,6,5,73216,6,5,73960,6,5,74555,6,5,76151,16,18.4,-1.2856498,36.794566,-1.2143842,36.8122348,105,1596,27,1339
7800,4707,1392,3,Business,7,5,49007,7,5,49201,7,5,49981,7,5,50249,7,5,52964,12,23.25888921888938,-1.2551895,36.7822034,-1.3272115,36.7924151,709,2715,194,1048
7801,13011,136,3,Business,15,5,33058,15,5,33107,15,5,34386,15,5,35738,15,5,38132,30,20.3,-1.3043416,36.9074199,-1.3254522,36.7216584,856,2394,49,2631
7802,22756,3527,3,Personal,7,2,57343,7,2,57436,7,2,58472,7,2,59777,7,2,61047,7,23.25888921888938,-1.2640571,36.7883547,-1.2935921,36.7876166,547,1270,93,2341
7803,26516,3050,3,Business,8,5,49182,8,5,52431,8,5,52665,8,5,55179,8,5,55256,10,30.6,-1.2945074,36.8083195,-1.3104734,36.7363698,655,77,3249,2748
7804,16705,1995,3,Business,25,4,42991,25,4,43083,25,4,43157,25,4,43809,25,4,45311,6,23.25888921888938,-1.2551895,36.7822034,-1.279395,36.825364,709,1502,92,726
7805,2956,3434,3,Business,3,1,53363,3,1,54274,3,1,57315,3,1,61875,3,1,66871,30,22.7,-1.1612808,36.9563278,-1.2963097,36.7688221,700,4996,911,7601
7806,16470,909,3,Business,30,3,57876,30,3,57890,30,3,57911,30,3,58379,30,3,58386,1,24.9,-1.290894,36.822971,-1.291829,36.829358,408,7,14,489
7807,25823,1868,3,Business,3,1,40767,3,1,40828,3,1,41248,3,1,41462,3,1,42768,17,21.5,-1.2752846,36.8027022,-1.207546,36.7913976,96,1306,61,634
7808,1120,201,3,Business,6,4,43404,6,4,43470,6,4,44219,6,4,44630,6,4,45837,10,19.8,-1.2762743,36.8152789,-1.2577289,36.7410772,72,1207,66,1160
7809,9472,3194,3,Business,19,1,44784,19,1,44995,19,1,45790,19,1,45975,19,1,46650,3,24.7,-1.2551895,36.7822034,-1.257309,36.8060084,38,675,211,980
7810,4738,2346,1,Personal,15,5,41187,15,5,41217,15,5,41718,15,5,41866,15,5,44081,4,19.9,-1.3054537,36.8284768,-1.3046069,36.8075485,444,2215,30,649
7811,1646,1329,3,Business,27,1,52661,27,1,52745,27,1,53462,27,1,54377,27,1,55322,11,23.1,-1.273056,36.811298,-1.2217641,36.788444,411,945,84,1632
7812,3403,3184,3,Business,2,5,34343,2,5,34358,2,5,34360,2,5,35000,2,5,36546,17,18.2,-1.3396256,36.8863135,-1.2673786,36.8081593,813,1546,15,642
7813,21860,357,3,Business,24,3,35954,24,3,35991,24,3,36574,24,3,41761,24,3,43015,9,19.8,-1.2657992,36.8036825,-1.2945179,36.7685349,649,1254,37,5770
7814,10956,2501,1,Personal,24,5,48435,24,5,48454,24,5,48920,24,5,50006,24,5,51082,6,23.2,-1.295162,36.8115914,-1.3188148,36.8092478,402,1076,19,1552
7815,4483,2847,3,Personal,6,5,52615,6,5,52821,6,5,53647,6,5,54362,6,5,56216,10,22.3,-1.3261879,36.8601793,-1.2822773,36.7953121,147,1854,206,1541
7816,27709,2470,1,Personal,8,3,34807,8,3,34833,8,3,35604,8,3,36072,8,3,37774,12,17.1,-1.3323107,36.8692616,-1.297701,36.806896,791,1702,26,1239
7817,26691,2174,3,Business,12,5,45831,12,5,45848,12,5,45859,12,5,50218,12,5,54384,14,23.25888921888938,-1.2482781,36.884092,-1.2016077,36.930397,86,4166,17,4370
7818,11298,994,1,Personal,28,1,54244,28,1,55095,28,1,55651,28,1,55796,28,1,56903,9,24.3,-1.3004062,36.829741,-1.2994194,36.7647917,409,1107,851,701
7819,1512,1721,3,Business,30,2,43805,30,2,44002,30,2,44734,30,2,45381,30,2,48054,14,23.25888921888938,-1.2551895,36.7822034,-1.242902,36.870334,598,2673,197,1379
7820,6688,2982,3,Business,29,3,34268,29,3,34291,29,3,34315,29,3,36415,29,3,36881,18,17.8,-1.300921,36.828195,-1.177202,36.8351183,41,466,23,2124
7821,25064,1346,3,Business,20,4,42576,20,4,43166,20,4,43885,20,4,44154,20,4,45191,6,22.2,-1.2695287,36.7981777,-1.2917868,36.7872675,382,1037,590,988
7822,5561,475,3,Business,21,4,44420,21,4,44795,21,4,44799,21,4,45423,21,4,47364,8,25.0,-1.2551895,36.7822034,-1.3024794,36.8228284,86,1941,375,628
7823,23135,3112,1,Personal,28,5,69120,28,5,69171,28,5,70936,28,5,71417,28,5,73965,12,19.3,-1.296567,36.8748023,-1.3120584,36.8052037,532,2548,51,2246
7824,8576,3537,2,Personal,4,3,30879,4,3,31890,4,3,33488,4,3,33933,4,3,35552,5,15.1,-1.2881035,36.8142095,-1.2749209,36.7857781,208,1619,1011,2043
7825,21704,1623,1,Personal,30,6,57727,30,6,58369,30,6,61217,30,6,61514,30,6,63361,12,21.9,-1.3205335,36.8789718,-1.3784696,36.9430328,212,1847,642,3145
7826,20477,3647,3,Business,29,3,59608,29,3,59703,29,3,60346,29,3,60808,29,3,62265,10,19.3,-1.272639,36.794723,-1.3114292,36.7360592,427,1457,95,1105
7827,1545,419,3,Business,13,4,36669,13,4,36706,13,4,37277,13,4,37804,13,4,40066,20,18.3,-1.2571472,36.7950633,-1.3700383,36.9190174,766,2262,37,1098
7828,20906,1527,3,Business,5,5,42951,5,5,43115,5,5,43758,5,5,44137,5,5,44908,4,24.7,-1.2770708,36.8231093,-1.3004062,36.829741,358,771,164,1022
7829,24020,2423,3,Business,14,5,52161,14,5,52237,14,5,52264,14,5,52487,14,5,54283,7,23.0,-1.2551895,36.7822034,-1.2934657,36.8212737,868,1796,76,250
7830,24370,3417,1,Personal,4,1,59023,4,1,59292,4,1,59577,4,1,63208,4,1,64520,9,21.2,-1.2833106,36.8240238,-1.3332749,36.8708147,360,1312,269,3916
7831,20661,2908,3,Personal,14,4,41882,14,4,42040,14,4,42434,14,4,42821,14,4,44720,7,23.9,-1.2929747,36.7646358,-1.3031315,36.8175661,38,1899,158,781
7832,21931,2154,3,Business,11,5,40023,11,5,40092,11,5,40924,11,5,41474,11,5,43043,5,21.0,-1.2765736,36.8513646,-1.28878,36.8168312,150,1569,69,1382
7833,13974,1363,3,Business,12,5,33570,12,5,33615,12,5,34101,12,5,34635,12,5,35770,5,18.4,-1.3004062,36.829741,-1.3083266,36.8494756,519,1135,45,1020
7834,3596,3091,3,Business,26,3,36510,26,3,36531,26,3,37233,26,3,39156,26,3,41935,12,24.1,-1.2765736,36.8513646,-1.3012008,36.764868,123,2779,21,2625
7835,15641,186,3,Business,12,5,34622,12,5,34629,12,5,36813,12,5,36982,12,5,39894,23,21.7,-1.3700383,36.9190174,-1.2571472,36.7950633,863,2912,7,2353
7836,19516,909,3,Business,11,4,49947,11,4,53452,11,4,54268,11,4,54785,11,4,56451,7,27.0,-1.2584143,36.8048002,-1.225322,36.80855,710,1666,3505,1333
7837,1710,1849,3,Business,9,4,37727,9,4,37793,9,4,37829,9,4,41033,9,4,41823,6,23.25888921888938,-1.2571472,36.7950633,-1.290894,36.822971,341,790,66,3240
7838,23409,1502,3,Business,13,3,48298,13,3,48315,13,3,49747,13,3,50072,13,3,50743,5,27.1,-1.2283403,36.8822756,-1.2232123,36.8932547,958,671,17,1757
7839,27531,788,3,Business,5,2,55810,5,2,55838,5,2,56624,5,2,56877,5,2,58105,7,27.6,-1.2584143,36.8048002,-1.225322,36.80855,426,1228,28,1039
7840,23959,1500,3,Business,21,4,31005,21,4,31034,21,4,33455,21,4,33807,21,4,35531,11,22.0,-1.3077869,36.8443207,-1.2638185,36.7930057,763,1724,29,2773
7841,22921,1271,3,Business,19,2,52411,19,2,52439,19,2,53032,19,2,53442,19,2,57507,17,30.2,-1.2927792,36.9053492,-1.2649605,36.7981777,543,4065,28,1003
7842,11965,251,1,Personal,23,1,37662,23,1,37682,23,1,38182,23,1,38654,23,1,39481,4,18.6,-1.3099145,36.8022774,-1.2871136,36.785507,844,827,20,972
7843,22719,1831,3,Business,6,1,54065,6,1,54611,6,1,55371,6,1,55488,6,1,58817,21,23.25888921888938,-1.3562374,36.9042954,-1.2551895,36.7822034,19,3329,546,877
7844,14163,2271,3,Business,19,2,44782,19,2,44804,19,2,44877,19,2,46892,19,2,46894,11,27.7,-1.228911,36.881876,-1.293515,36.897607,377,2,22,2088
7845,16685,283,3,Business,20,4,64854,20,4,68229,20,4,68298,20,4,68906,20,4,70904,2,22.6,-1.2804227,36.8250375,-1.285442,36.8312707,404,1998,3375,677
7846,7089,391,3,Business,8,5,29865,8,5,30186,8,5,31336,8,5,32120,8,5,32996,5,20.5,-1.2602337,36.7990548,-1.2867454,36.8259017,899,876,321,1934
7847,27287,3080,3,Business,14,5,46195,14,5,46206,14,5,46233,14,5,46597,14,5,47139,3,21.8,-1.2551895,36.7822034,-1.2649861,36.7989408,690,542,11,391
7848,23638,1323,1,Business,8,5,64104,8,5,64132,8,5,64494,8,5,65722,8,5,68282,20,19.8,-1.2579304,36.8019667,-1.3700383,36.9190174,116,2560,28,1590
7849,2311,1527,3,Business,9,2,56770,9,2,56796,9,2,59289,9,2,60642,9,2,61184,4,27.7,-1.3077869,36.8443207,-1.3004062,36.829741,763,542,26,3846
7850,12857,1236,3,Personal,26,5,54034,26,5,54218,26,5,55285,26,5,55763,26,5,58351,4,23.25888921888938,-1.2813012,36.8323962,-1.2765736,36.8513646,843,2588,184,1545
7851,22426,2423,3,Business,4,2,39066,4,2,39237,4,2,40135,4,2,40305,4,2,41362,9,19.4,-1.2967702,36.8040381,-1.2551895,36.7822034,205,1057,171,1068
7852,4369,1363,3,Business,21,1,54659,21,1,54669,21,1,54679,21,1,54877,21,1,55648,3,27.7,-1.3004062,36.829741,-1.3064585,36.8119065,518,771,10,208
7853,19862,3621,3,Business,11,2,34506,11,2,34514,11,2,34972,11,2,35035,11,2,35927,5,18.6,-1.2836583,36.7886014,-1.2795796,36.819062,648,892,8,521
7854,26276,1209,3,Business,30,2,52613,30,2,55242,30,2,55247,30,2,56401,30,2,58714,5,23.25888921888938,-1.2770708,36.8231093,-1.3004062,36.829741,61,2313,2629,1159
7855,21521,2801,3,Business,25,1,32526,25,1,32564,25,1,32924,25,1,34889,25,1,35538,7,20.9,-1.2595422,36.7871178,-1.2898747,36.7661248,258,649,38,2325
7856,11146,265,3,Business,29,1,29960,29,1,30001,29,1,31170,29,1,31957,29,1,33536,12,23.25888921888938,-1.3251247,36.8995926,-1.300921,36.828195,411,1579,41,1956
7857,8494,3291,3,Business,22,6,32966,22,6,33023,22,6,33565,22,6,35937,22,6,36851,12,17.6,-1.331619,36.847976,-1.2600926,36.8088685,85,914,57,2914
7858,10290,2691,3,Business,11,4,41256,11,4,41322,11,4,41994,11,4,42319,11,4,43390,8,24.0,-1.2857671,36.7875614,-1.2571472,36.7950633,933,1071,66,997
7859,9194,893,3,Business,27,3,43317,27,3,43399,27,3,44000,27,3,44091,27,3,45701,8,25.9,-1.2663194,36.809901,-1.2455906,36.8174969,660,1610,82,692
7860,18388,2344,3,Business,22,4,41023,22,4,41125,22,4,41397,22,4,42662,22,4,44130,9,22.5,-1.3024794,36.8228284,-1.2551895,36.7822034,441,1468,102,1537
7861,22698,2309,2,Personal,12,5,57325,12,5,57397,12,5,58095,12,5,60888,12,5,62972,17,25.5,-1.308177,36.879807,-1.233018,36.8004477,871,2084,72,3491
7862,3732,236,3,Business,13,3,34710,13,3,34822,13,3,36091,13,3,36265,13,3,38004,8,16.2,-1.289498,36.818878,-1.3235665,36.8491269,208,1739,112,1443
7863,22279,527,2,Personal,18,2,52611,18,2,53443,18,2,53643,18,2,55799,18,2,61324,13,27.3,-1.2854453,36.8188363,-1.3319425,36.8944709,101,5525,832,2356
7864,10823,2200,3,Business,24,1,41203,24,1,49641,24,1,50573,24,1,51175,24,1,53002,11,24.6,-1.2927792,36.9053492,-1.290894,36.822971,194,1827,8438,1534
7865,22665,2694,1,Personal,24,1,43790,24,1,44065,24,1,44458,24,1,45140,24,1,47208,13,22.5,-1.2023463,36.8282909,-1.2881295,36.8473281,622,2068,275,1075
7866,24423,3149,3,Business,14,1,40789,14,1,40838,14,1,41704,14,1,42637,14,1,43218,6,23.4,-1.3004062,36.829741,-1.3228003,36.8306435,771,581,49,1799
7867,10575,1417,3,Business,12,2,54603,12,2,54654,12,2,55519,12,2,56522,12,2,58296,6,27.0,-1.2950041,36.8143583,-1.2741728,36.7969108,216,1774,51,1868
7868,17929,633,3,Business,10,4,33751,10,4,35101,10,4,35618,10,4,36335,10,4,37163,8,19.4,-1.3004062,36.829741,-1.2574219,36.7927073,515,828,1350,1234
7869,18193,1075,3,Business,28,1,53962,28,1,53973,28,1,54175,28,1,54830,28,1,56830,1,26.4,-1.2649605,36.7981777,-1.2527958,36.8003131,647,2000,11,857
7870,3339,1304,3,Business,8,1,34987,8,1,39946,8,1,41407,8,1,41945,8,1,42977,4,24.6,-1.3332749,36.8708147,-1.338579,36.8963038,805,1032,4959,1999
7871,5125,3560,3,Business,15,1,57523,15,1,57539,15,1,57781,15,1,57965,15,1,58908,7,23.25888921888938,-1.279395,36.825364,-1.2551895,36.7822034,330,943,16,426
7872,5240,1578,3,Business,7,3,46355,7,3,46368,7,3,46613,7,3,47324,7,3,47328,2,24.9,-1.290894,36.822971,-1.28878,36.8168312,57,4,13,956
7873,12661,928,3,Business,9,4,52587,9,4,52697,9,4,53636,9,4,54377,9,4,59064,7,23.25888921888938,-1.2571472,36.7950633,-1.2922364,36.7895538,92,4687,110,1680
7874,27670,1787,3,Business,15,1,44721,15,1,45364,15,1,45374,15,1,47369,15,1,49117,9,23.25888921888938,-1.2859912,36.8756811,-1.2283403,36.8822756,397,1748,643,2005
7875,13765,1724,3,Business,18,4,43585,18,4,43647,18,4,43908,18,4,44101,18,4,46001,14,23.25888921888938,-1.2551895,36.7822034,-1.312745,36.875715,690,1900,62,454
7876,26762,3637,2,Personal,5,3,58152,5,3,58180,5,3,59186,5,3,59944,5,3,61579,8,22.3,-1.3001735,36.8042049,-1.3261286,36.8469625,895,1635,28,1764
7877,1279,346,3,Business,29,5,48148,29,5,48202,29,5,50224,29,5,50742,29,5,51783,7,29.1,-1.28878,36.8168312,-1.2551895,36.7822034,907,1041,54,2540
7878,22127,3404,3,Business,29,2,56228,29,2,56664,29,2,57368,29,2,57588,29,2,58837,7,27.1,-1.279395,36.825364,-1.2551895,36.7822034,862,1249,436,924
7879,19844,1899,3,Business,30,4,43506,30,4,43611,30,4,43615,30,4,44462,30,4,45234,9,23.25888921888938,-1.3033561,36.8163631,-1.331619,36.847976,531,772,105,851
7880,2107,3024,2,Personal,26,3,36449,26,3,36470,26,3,37133,26,3,37298,26,3,38725,7,19.1,-1.2535486,36.7933541,-1.271337,36.786712,247,1427,21,828
7881,14172,3060,3,Business,15,5,50507,15,5,50538,15,5,52177,15,5,52516,15,5,53541,4,27.9,-1.2764099,36.8208451,-1.2534301,36.8000983,434,1025,31,1978
7882,27975,186,3,Business,8,2,45628,8,2,46574,8,2,47352,8,2,47673,8,2,50276,23,23.2,-1.3700383,36.9190174,-1.2571472,36.7950633,114,2603,946,1099
7883,15048,1066,1,Personal,15,1,34144,15,1,34274,15,1,35173,15,1,35377,15,1,37050,7,23.25888921888938,-1.2527958,36.8003131,-1.3047026,36.8172033,751,1673,130,1103
7884,25721,1882,3,Business,11,1,52062,11,1,52280,11,1,53108,11,1,55088,11,1,55420,8,29.0,-1.3014461,36.7661381,-1.2628638,36.8070399,678,332,218,2808
7885,27392,893,3,Business,13,1,35531,13,1,35564,13,1,35720,13,1,35982,13,1,38613,7,23.25888921888938,-1.2663194,36.809901,-1.2847316,36.7658086,99,2631,33,418
7886,26035,633,3,Business,12,6,42651,12,6,42669,12,6,42698,12,6,43327,12,6,43329,5,23.25888921888938,-1.3004062,36.829741,-1.3228003,36.8306435,10,2,18,658
7887,2215,2066,3,Business,23,6,41430,23,6,41517,23,6,43491,23,6,43831,23,6,45572,13,23.25888921888938,-1.3210189,36.8410551,-1.3002993,36.9153417,448,1741,87,2314
7888,21802,391,3,Business,2,2,42742,2,2,43084,2,2,44543,2,2,45973,2,2,47151,5,26.0,-1.300921,36.828195,-1.2784063,36.8222933,77,1178,342,2889
7889,17287,567,3,Business,25,4,59598,25,4,59687,25,4,60044,25,4,60477,25,4,61102,5,23.25888921888938,-1.2799006,36.7916973,-1.2963097,36.7688221,484,625,89,790
7890,22110,3647,3,Business,4,4,44907,4,4,44936,4,4,47458,4,4,47661,4,4,50662,8,25.7,-1.272639,36.794723,-1.2981102,36.8293513,291,3001,29,2725
7891,10589,3674,3,Business,29,3,52211,29,3,52386,29,3,52988,29,3,53694,29,3,58355,20,21.2,-1.2551895,36.7822034,-1.3251247,36.8995926,162,4661,175,1308
7892,8568,1831,3,Business,11,5,33357,11,5,33416,11,5,33878,11,5,36343,11,5,36484,21,21.2,-1.3562374,36.9042954,-1.2551895,36.7822034,656,141,59,2927
7893,13201,868,3,Business,13,3,37702,13,3,37779,13,3,38253,13,3,43462,13,3,44354,6,24.7,-1.307143,36.825009,-1.265715,36.823815,258,892,77,5683
7894,1802,478,3,Business,20,4,44080,20,4,44089,20,4,46071,20,4,46389,20,4,48262,12,22.3,-1.3013451,36.8747364,-1.2571472,36.7950633,205,1873,9,2300
7895,20759,2677,3,Business,25,4,43618,25,4,43646,25,4,44397,25,4,44536,25,4,46315,11,23.25888921888938,-1.2770708,36.8231093,-1.2991441,36.7528804,953,1779,28,890
7896,26224,1500,3,Business,8,5,40866,8,5,40972,8,5,41036,8,5,44467,8,5,44470,8,24.3,-1.3004062,36.829741,-1.2638185,36.7930057,10,3,106,3495
7897,11459,3647,3,Business,22,5,53749,22,5,53794,22,5,54813,22,5,55102,22,5,56260,8,31.0,-1.272639,36.794723,-1.2972794,36.8014817,205,1158,45,1308
7898,1642,867,3,Business,12,5,49074,12,5,49161,12,5,49672,12,5,50753,12,5,52228,12,23.25888921888938,-1.2991441,36.7528804,-1.2996533,36.8292629,926,1475,87,1592
7899,7741,186,3,Business,9,4,59248,9,4,60482,9,4,61074,9,4,61451,9,4,62303,6,23.25888921888938,-1.2571472,36.7950633,-1.2904016,36.8226303,341,852,1234,969
7900,12425,1245,3,Business,27,3,43576,27,3,43974,27,3,44421,27,3,45380,27,3,47216,13,26.0,-1.3882008,36.7699445,-1.3421304,36.718364,661,1836,398,1406
7901,25211,1527,3,Business,30,4,43835,30,4,43896,30,4,45153,30,4,46677,30,4,48515,12,23.25888921888938,-1.2991441,36.7528804,-1.3004062,36.829741,948,1838,61,2781
7902,14127,393,3,Business,10,4,56334,10,4,56383,10,4,57328,10,4,58078,10,4,59746,10,25.2,-1.3231001,36.8283559,-1.2574219,36.7927073,518,1668,49,1695
7903,9971,1075,3,Business,4,4,45308,4,4,45371,4,4,45878,4,4,46699,4,4,47374,3,25.5,-1.2551895,36.7822034,-1.2527958,36.8003131,131,675,63,1328
7904,14312,2289,3,Business,19,1,51658,19,1,51785,19,1,52765,19,1,53075,19,1,54499,6,25.1,-1.2551895,36.7822034,-1.2799997,36.8237091,660,1424,127,1290
7905,17304,393,3,Business,7,2,32437,7,2,32530,7,2,32898,7,2,33220,7,2,37830,14,23.25888921888938,-1.3167113,36.8301563,-1.2991441,36.7528804,778,4610,93,690
7906,26983,1422,3,Business,13,4,55671,13,4,55720,13,4,56529,13,4,56816,13,4,57391,4,22.2,-1.3261286,36.8469625,-1.3221059,36.8606598,205,575,49,1096
7907,8367,868,3,Business,30,3,36703,30,3,36763,30,3,38103,30,3,38773,30,3,39728,9,24.8,-1.2296618,36.8438272,-1.265715,36.823815,377,955,60,2010
7908,22482,1341,3,Business,23,4,34117,23,4,34169,23,4,34208,23,4,35154,23,4,38515,11,23.25888921888938,-1.2663631,36.8163329,-1.331619,36.847976,99,3361,52,985
7909,20487,2161,2,Personal,13,1,40503,13,1,40553,13,1,40877,13,1,42389,13,1,43290,9,17.2,-1.3001432,36.7764912,-1.3149338,36.7135703,754,901,50,1836
7910,25490,2674,3,Personal,16,7,42781,16,7,42808,16,7,43304,16,7,43948,16,7,44640,8,23.4,-1.2968742,36.7937803,-1.2797013,36.7299371,337,692,27,1140
7911,9651,393,3,Business,2,4,50071,2,4,50278,2,4,51377,2,4,51737,2,4,51740,6,23.25888921888938,-1.3167113,36.8301563,-1.3077869,36.8443207,931,3,207,1459
7912,24605,1133,3,Business,25,5,28326,25,5,32004,25,5,32698,25,5,33058,25,5,37756,10,20.8,-1.3323107,36.8692616,-1.2844342,36.8225105,26,4698,3678,1054
7913,27681,113,3,Business,18,3,52234,18,3,52289,18,3,53075,18,3,53449,18,3,56368,8,20.7,-1.283998,36.819886,-1.2963097,36.7688221,148,2919,55,1160
7914,5033,635,3,Business,27,6,43889,27,6,43993,27,6,44008,27,6,47220,27,6,47947,10,23.25888921888938,-1.3081376,36.8329772,-1.2602337,36.7990548,404,727,104,3227
7915,16679,1809,3,Business,1,4,40869,1,4,40886,1,4,41266,1,4,41412,1,4,41439,2,23.25888921888938,-1.2584143,36.8048002,-1.2571472,36.7950633,647,27,17,526
7916,12952,370,1,Personal,21,1,67680,21,1,68104,21,1,69035,21,1,69455,21,1,70775,7,23.25888921888938,-1.2682179,36.8009289,-1.2867717,36.7735237,134,1320,424,1351
7917,12728,3521,3,Business,6,2,26678,6,2,30786,6,2,30861,6,2,31623,6,2,33773,5,20.0,-1.2768326,36.8073804,-1.302634,36.8110146,699,2150,4108,837
7918,10918,1787,3,Business,24,7,52926,24,7,53010,24,7,54732,24,7,55258,24,7,57132,12,23.25888921888938,-1.2860183,36.8975338,-1.2283403,36.8822756,668,1874,84,2248
7919,2879,1292,3,Business,15,4,43276,15,4,43290,15,4,43990,15,4,44895,15,4,48032,10,24.2,-1.3025826,36.7670807,-1.299114,36.834836,124,3137,14,1605
7920,23072,3482,1,Personal,8,3,33719,8,3,33818,8,3,35164,8,3,35639,8,3,38640,25,17.4,-1.3681253,36.9155298,-1.2944931,36.7698389,379,3001,99,1821
7921,7153,2956,3,Business,27,1,54022,27,1,54073,27,1,54236,27,1,56322,27,1,62867,7,22.9,-1.2584143,36.8048002,-1.3004062,36.829741,624,6545,51,2249
7922,2950,435,3,Business,12,3,51851,12,3,52061,12,3,52180,12,3,53065,12,3,54134,3,20.9,-1.297451,36.8210544,-1.300921,36.828195,462,1069,210,1004
7923,1543,3560,3,Business,9,3,52010,9,3,52125,9,3,55370,9,3,55485,9,3,56833,9,25.5,-1.279395,36.825364,-1.2413316,36.8785525,801,1348,115,3360
7924,20982,2869,3,Business,11,6,68481,11,6,68521,11,6,69602,11,6,69763,11,6,72183,10,23.25888921888938,-1.2584143,36.8048002,-1.3025826,36.7670807,521,2420,40,1242
7925,9372,3201,3,Business,26,1,55752,26,1,55794,26,1,55962,26,1,56705,26,1,57338,3,22.4,-1.2584143,36.8048002,-1.2551895,36.7822034,393,633,42,911
7926,26288,1787,3,Business,9,2,52277,9,2,52473,9,2,53206,9,2,54319,9,2,57754,13,22.7,-1.3052491,36.8223899,-1.2297202,36.8819507,932,3435,196,1846
7927,27836,1316,1,Business,14,4,53508,14,4,53557,14,4,53942,14,4,54479,14,4,54974,3,21.2,-1.2551895,36.7822034,-1.2635283,36.7946012,908,495,49,922
7928,25659,758,3,Business,1,1,47036,1,1,47103,1,1,47583,1,1,48134,1,1,50694,14,23.25888921888938,-1.2917868,36.7872675,-1.3194518,36.869396,498,2560,67,1031
7929,10684,914,3,Business,31,5,53774,31,5,53920,31,5,56393,31,5,57525,31,5,60166,11,24.8,-1.2670213,36.7994482,-1.3270716,36.8406371,155,2641,146,3605
7930,4028,972,3,Business,1,4,39983,1,4,40173,1,4,41097,1,4,41168,1,4,42311,4,23.25888921888938,-1.2862033,36.8152966,-1.2654348,36.8022464,660,1143,190,995
7931,8623,868,3,Business,23,3,35237,23,3,35281,23,3,36137,23,3,37113,23,3,37665,5,23.25888921888938,-1.2600926,36.8088685,-1.265715,36.823815,937,552,44,1832
7932,2408,625,3,Business,22,6,43562,22,6,43588,22,6,43852,22,6,44588,22,6,47094,7,21.2,-1.2628473,36.781805,-1.265715,36.823815,103,2506,26,1000
7933,26628,3698,3,Business,23,4,54015,23,4,54046,23,4,54511,23,4,54964,23,4,55864,7,24.6,-1.3244885,36.897792,-1.34364,36.8925345,856,900,31,918
7934,17789,498,1,Personal,25,5,43476,25,5,43488,25,5,44136,25,5,44316,25,5,45489,7,21.2,-1.3018758,36.7590863,-1.3046965,36.8016456,101,1173,12,828
7935,25460,1146,3,Business,29,1,47600,29,1,47676,29,1,48133,29,1,49293,29,1,50023,7,23.25888921888938,-1.3167113,36.8301563,-1.3083266,36.8494756,206,730,76,1617
7936,2658,867,3,Business,17,4,48333,17,4,48375,17,4,48792,17,4,50029,17,4,51489,10,28.2,-1.3004062,36.829741,-1.2991441,36.7528804,576,1460,42,1654
7937,6530,350,1,Personal,5,3,42835,5,3,42847,5,3,43071,5,3,44049,5,3,45259,11,22.1,-1.2268906,36.8373103,-1.2915199,36.8289158,726,1210,12,1202
7938,21671,1500,3,Business,12,6,40217,12,6,41582,12,6,42202,12,6,44060,12,6,45106,8,22.9,-1.3004062,36.829741,-1.2569006,36.7925141,56,1046,1365,2478
7939,16446,2754,3,Personal,14,4,53493,14,4,53553,14,4,54161,14,4,54331,14,4,55361,5,28.1,-1.2580936,36.7967408,-1.2885417,36.8100523,498,1030,60,778
7940,6134,3647,3,Business,27,1,42287,27,1,42390,27,1,43417,27,1,43917,27,1,45486,4,21.0,-1.272639,36.794723,-1.262762,36.772194,770,1569,103,1527
7941,27693,3547,3,Business,28,4,39503,28,4,39523,28,4,40274,28,4,40516,28,4,43130,19,28.1,-1.3189252,36.8617269,-1.2856319,36.7672998,418,2614,20,993
7942,3140,3283,3,Business,7,2,46084,7,2,46098,7,2,46398,7,2,47092,7,2,47622,5,23.25888921888938,-1.2600926,36.8088685,-1.2628473,36.781805,178,530,14,994
7943,25820,2358,4,Business,8,5,47727,8,5,47843,8,5,50090,8,5,50538,8,5,51845,4,21.5,-1.2884227,36.7724509,-1.2790653,36.7907262,148,1307,116,2695
7944,12751,1340,3,Business,14,4,33948,14,4,34011,14,4,34359,14,4,34451,14,4,35807,3,18.9,-1.2707179,36.7979713,-1.264917,36.8150651,953,1356,63,440
7945,7388,3404,3,Business,17,3,38607,17,3,38615,17,3,38859,17,3,39437,17,3,40320,3,25.2,-1.3052491,36.8223899,-1.279395,36.825364,208,883,8,822
7946,18946,2344,3,Business,5,2,59603,5,2,59610,5,2,59689,5,2,60418,5,2,63936,23,21.6,-1.2553615,36.7895376,-1.3447079,36.91105,379,3518,7,808
7947,6805,432,3,Business,4,4,56380,4,4,56418,4,4,57115,4,4,57248,4,4,59771,20,27.1,-1.3012008,36.764868,-1.2232123,36.8932547,272,2523,38,830
7948,8314,868,3,Business,26,6,36473,26,6,36487,26,6,36645,26,6,37129,26,6,37896,5,20.6,-1.2600926,36.8088685,-1.265715,36.823815,607,767,14,642
7949,22570,3011,3,Personal,31,2,57152,31,2,57248,31,2,58608,31,2,59467,31,2,60413,4,22.1,-1.2966453,36.8191342,-1.2931437,36.7874139,452,946,96,2219
7950,22598,2364,3,Personal,8,1,51223,8,1,51250,8,1,51749,8,1,52624,8,1,54077,12,29.4,-1.273786,36.7806375,-1.3121154,36.7109299,652,1453,27,1374
7951,9934,3291,3,Business,25,4,34863,25,4,34872,25,4,35306,25,4,35855,25,4,36431,5,23.25888921888938,-1.2566689,36.7796952,-1.2600926,36.8088685,438,576,9,983
7952,541,3441,3,Business,3,5,43348,3,5,43357,3,5,45353,3,5,45611,3,5,47665,3,21.6,-1.299846,36.7940155,-1.3008254,36.8049897,322,2054,9,2254
7953,27441,3647,3,Business,16,2,59746,16,2,59963,16,2,61337,16,2,61570,16,2,63036,7,23.25888921888938,-1.272639,36.794723,-1.2950041,36.8143583,815,1466,217,1607
7954,4486,3647,3,Business,8,1,46653,8,1,46724,8,1,47479,8,1,47691,8,1,49759,14,27.8,-1.272639,36.794723,-1.3038645,36.8684596,131,2068,71,967
7955,15804,814,3,Business,5,1,51109,5,1,51274,5,1,51759,5,1,52757,5,1,54875,7,26.0,-1.2571472,36.7950633,-1.2878216,36.799598,770,2118,165,1483
7956,11913,755,1,Personal,8,7,57678,8,7,57709,8,7,58565,8,7,59146,8,7,63161,13,21.4,-1.282357,36.782501,-1.2289456,36.7651122,465,4015,31,1437
7957,4337,1245,3,Business,21,4,30163,21,4,30238,21,4,30292,21,4,33483,21,4,35142,17,21.6,-1.300921,36.828195,-1.3198615,36.7110323,10,1659,75,3245
7958,25484,2828,3,Business,6,3,33365,6,3,33640,6,3,34853,6,3,35564,6,3,38025,6,23.25888921888938,-1.2615888,36.7928732,-1.28878,36.8168312,372,2461,275,1924
7959,6316,3521,3,Business,27,4,51877,27,4,51942,27,4,53151,27,4,53352,27,4,53904,5,25.1,-1.2811505,36.8145398,-1.2696908,36.81519,622,552,65,1410
7960,17638,3108,3,Business,16,2,53737,16,2,53860,16,2,54875,16,2,55128,16,2,56926,9,27.4,-1.2551895,36.7822034,-1.3043649,36.7816132,726,1798,123,1268
7961,26191,3291,3,Business,3,1,33241,3,1,33287,3,1,33411,3,1,34008,3,1,35270,11,18.4,-1.303596,36.778378,-1.2600926,36.8088685,161,1262,46,721
7962,22611,540,3,Business,17,1,53793,17,1,53868,17,1,54540,17,1,54869,17,1,55509,4,24.6,-1.2551895,36.7822034,-1.2665065,36.7970081,290,640,75,1001
7963,2904,1141,3,Business,25,1,51341,25,1,53344,25,1,55238,25,1,56339,25,1,58108,7,23.25888921888938,-1.2877645,36.8378535,-1.303149,36.864154,752,1769,2003,2995
7964,8687,3430,1,Personal,10,4,46093,10,4,46512,10,4,47320,10,4,47872,10,4,49191,5,23.25888921888938,-1.3162537,36.8199906,-1.2899469,36.8078877,782,1319,419,1360
7965,3999,1559,2,Personal,16,4,49512,16,4,49520,16,4,50179,16,4,52065,16,4,56212,13,18.9,-1.3026696,36.8418734,-1.221696,36.8270195,229,4147,8,2545
7966,193,2523,3,Business,18,2,45701,18,2,46081,18,2,46317,18,2,46496,18,2,47919,8,23.25888921888938,-1.2551895,36.7822034,-1.304344,36.812274,698,1423,380,415
7967,15646,1148,3,Business,22,4,50703,22,4,50897,22,4,52038,22,4,53503,22,4,57224,14,26.4,-1.3100586,36.8500329,-1.2441236,36.8812807,519,3721,194,2606
7968,7372,3108,3,Business,24,4,31713,24,4,31733,24,4,31854,24,4,32098,24,4,32576,1,19.2,-1.2551895,36.7822034,-1.2606254,36.783056,880,478,20,365
7969,11120,1796,3,Business,24,3,48068,24,3,48447,24,3,49117,24,3,49793,24,3,50668,11,23.25888921888938,-1.265715,36.823815,-1.331619,36.847976,675,875,379,1346
7970,23860,649,3,Business,12,5,36636,12,5,40194,12,5,40364,12,5,40695,12,5,41500,6,24.4,-1.2551895,36.7822034,-1.2890333,36.8234839,726,805,3558,501
7971,671,1329,3,Business,8,6,44966,8,6,44995,8,6,46704,8,6,46911,8,6,52175,19,20.0,-1.273056,36.811298,-1.3103985,36.9114173,498,5264,29,1916
7972,22017,3718,3,Business,18,2,36017,18,2,36034,18,2,36310,18,2,36728,18,2,37755,5,16.6,-1.2646305,36.8120134,-1.2906618,36.8131222,857,1027,17,694
7973,26693,391,3,Business,29,1,30914,29,1,36504,29,1,37317,29,1,37838,29,1,40310,18,18.8,-1.3882008,36.7699445,-1.2784063,36.8222933,781,2472,5590,1334
7974,2173,3404,3,Business,26,5,61061,26,5,61069,26,5,61175,26,5,61797,26,5,63027,8,23.25888921888938,-1.3014461,36.7661381,-1.2793686,36.8259233,743,1230,8,728
7975,24357,1245,3,Business,29,4,48106,29,4,48126,29,4,48689,29,4,49109,29,4,51486,17,24.6,-1.2599563,36.7993439,-1.3198615,36.7110323,167,2377,20,983
7976,4636,1281,3,Business,1,3,44609,1,3,44629,1,3,44890,1,3,45269,1,3,46411,8,19.8,-1.2707742,36.7578609,-1.2728058,36.8049903,735,1142,20,640
7977,18797,3291,3,Business,4,2,43419,4,2,43458,4,2,43684,4,2,44265,4,2,45981,9,20.7,-1.307143,36.825009,-1.2600926,36.8088685,2,1716,39,807
7978,11420,1105,3,Business,19,2,38803,19,2,38821,19,2,40296,19,2,40444,19,2,42971,10,26.4,-1.3193222,36.8084901,-1.2594753,36.806273,468,2527,18,1623
7979,25910,2801,3,Business,4,1,29163,4,1,29219,4,1,30170,4,1,30275,4,1,31674,4,22.1,-1.2674274,36.7870827,-1.2738522,36.7992818,290,1399,56,1056
7980,22471,704,3,Business,26,2,44637,26,2,46502,26,2,46946,26,2,48461,26,2,50503,20,23.25888921888938,-1.3404187,36.7614685,-1.2860183,36.8975338,636,2042,1865,1959
7981,24741,3346,2,Personal,8,2,70627,8,2,71050,8,2,71078,8,2,72195,8,2,74239,11,18.0,-1.2857241,36.8203481,-1.3404187,36.7614685,805,2044,423,1145
7982,24219,1392,3,Business,27,1,41023,27,1,41350,27,1,42725,27,1,43358,27,1,44131,3,20.7,-1.2551895,36.7822034,-1.2683511,36.8006573,617,773,327,2008
7983,14259,2069,3,Business,4,2,40509,4,2,40530,4,2,41391,4,2,43153,4,2,44067,16,19.5,-1.303596,36.778378,-1.228911,36.881876,598,914,21,2623
7984,18670,393,3,Business,24,3,42457,24,3,42913,24,3,44507,24,3,45477,24,3,46816,5,23.25888921888938,-1.3167113,36.8301563,-1.3077869,36.8443207,921,1339,456,2564
7985,13543,2271,3,Business,21,2,34454,21,2,34529,21,2,35080,21,2,35792,21,2,36834,8,23.25888921888938,-1.293515,36.897607,-1.3322116,36.890379,377,1042,75,1263
7986,13997,2488,1,Personal,10,5,63493,10,5,63618,10,5,65136,10,5,65575,10,5,66706,8,21.1,-1.2747671,36.8139951,-1.2343087,36.84749,229,1131,125,1957
7987,28133,119,1,Personal,3,4,50915,3,4,50939,3,4,53210,3,4,53904,3,4,55783,19,24.8,-1.278027,36.909125,-1.255956,36.789867,900,1879,24,2965
7988,10360,517,3,Business,27,4,57311,27,4,57322,27,4,57326,27,4,57459,27,4,58360,11,23.7,-1.3167113,36.8301563,-1.2574219,36.7927073,523,901,11,137
7989,7542,1500,3,Business,4,4,36965,4,4,37099,4,4,37442,4,4,37658,4,4,40647,6,21.6,-1.2638185,36.7930057,-1.2944081,36.7897046,855,2989,134,559
7990,28267,2956,3,Business,1,1,58431,1,1,60164,1,1,60638,1,1,61467,1,1,62977,10,27.4,-1.2584143,36.8048002,-1.2413316,36.8785525,218,1510,1733,1303
7991,26406,3297,3,Business,19,4,53034,19,4,53124,19,4,53889,19,4,54066,19,4,56642,14,20.7,-1.3077027,36.8163543,-1.2274192,36.8008308,614,2576,90,942
7992,15083,1850,3,Business,28,1,42101,28,1,42672,28,1,43744,28,1,43909,28,1,45138,6,23.7,-1.2551895,36.7822034,-1.2785434,36.8215327,862,1229,571,1237
7993,14591,2829,3,Business,16,2,43044,16,2,43772,16,2,44533,16,2,44624,16,2,49405,16,23.25888921888938,-1.2571472,36.7950633,-1.3165542,36.700067,279,4781,728,852
7994,28067,2987,3,Business,13,4,36385,13,4,36424,13,4,37146,13,4,37634,13,4,39527,15,18.0,-1.270212,36.8210877,-1.3284365,36.8970679,419,1893,39,1210
7995,19009,2609,1,Business,21,1,57706,21,1,57726,21,1,57781,21,1,59118,21,1,59141,3,21.5,-1.2601709,36.8002238,-1.2626906,36.7827022,51,23,20,1392
7996,24592,2030,3,Business,11,5,53675,11,5,53692,11,5,54105,11,5,54390,11,5,55082,3,26.5,-1.2768326,36.8073804,-1.2601197,36.7985271,289,692,17,698
7997,8447,635,3,Business,21,2,52808,21,2,52875,21,2,53476,21,2,57301,21,2,60214,16,25.2,-1.3081376,36.8329772,-1.26365,36.719989,591,2913,67,4426
7998,8016,914,3,Business,5,3,58766,5,3,58818,5,3,59262,5,3,59797,5,3,60321,3,22.7,-1.2670213,36.7994482,-1.2630521,36.8068019,518,524,52,979
7999,882,1329,3,Business,12,3,55664,12,3,55832,12,3,56318,12,3,56428,12,3,58742,18,20.8,-1.273056,36.811298,-1.332624,36.913187,538,2314,168,596
8000,22491,2987,3,Business,14,2,46659,14,2,47606,14,2,49145,14,2,49765,14,2,53142,25,24.0,-1.3692158,36.7696587,-1.3450192,36.9211859,676,3377,947,2159
8001,23732,53,3,Business,20,1,53828,20,1,53840,20,1,53847,20,1,55142,20,1,55237,5,23.25888921888938,-1.3004062,36.829741,-1.2770708,36.8231093,41,95,12,1302
8002,14292,633,3,Business,24,4,38835,24,4,40117,24,4,40122,24,4,40511,24,4,41422,5,24.7,-1.3004062,36.829741,-1.2770708,36.8231093,576,911,1282,394
8003,5714,627,3,Business,3,5,40444,3,5,40479,3,5,40632,3,5,40901,3,5,42763,10,23.25888921888938,-1.2551895,36.7822034,-1.2299678,36.8153079,161,1862,35,422
8004,3609,867,3,Business,24,4,41670,24,4,41813,24,4,42289,24,4,46690,24,4,48572,10,24.7,-1.3004062,36.829741,-1.2991441,36.7528804,331,1882,143,4877
8005,27544,2030,3,Business,16,2,41592,16,2,45920,16,2,47046,16,2,48078,16,2,49338,15,23.25888921888938,-1.1648303,36.951368,-1.2285835,36.8826468,96,1260,4328,2158
8006,16984,60,3,Business,31,5,39817,31,5,39860,31,5,41565,31,5,41937,31,5,44477,7,21.9,-1.228911,36.881876,-1.22978,36.836215,691,2540,43,2077
8007,18253,1659,1,Personal,6,4,36393,6,4,36409,6,4,37020,6,4,38448,6,4,40504,11,22.2,-1.258348,36.8449018,-1.3066143,36.8161046,447,2056,16,2039
8008,9756,473,2,Personal,31,4,36627,31,4,36671,31,4,37188,31,4,37378,31,4,40305,13,17.3,-1.2930705,36.8279433,-1.3541409,36.7555557,159,2927,44,707
8009,1118,2017,3,Business,22,5,57773,22,5,57893,22,5,58976,22,5,60245,22,5,62543,8,23.25888921888938,-1.2963097,36.7688221,-1.281614,36.8275424,444,2298,120,2352
8010,12081,3201,3,Business,31,3,39195,31,3,39219,31,3,39903,31,3,40232,31,3,40760,3,24.7,-1.2584143,36.8048002,-1.2551895,36.7822034,49,528,24,1013
8011,16079,2380,1,Personal,23,6,67901,23,6,68868,23,6,70227,23,6,70389,23,6,73259,21,23.25888921888938,-1.2591498,36.7137624,-1.3249067,36.8015554,898,2870,967,1521
8012,22961,1075,3,Business,19,3,41315,19,3,41341,19,3,41619,19,3,41848,19,3,43894,2,22.2,-1.2527958,36.8003131,-1.2561334,36.7990458,453,2046,26,507
8013,8290,867,3,Business,29,5,53726,29,5,53779,29,5,54331,29,5,54755,29,5,55948,9,28.9,-1.2638185,36.7930057,-1.2991441,36.7528804,484,1193,53,976
8014,951,122,3,Business,28,5,44462,28,5,44487,28,5,45814,28,5,48306,28,5,49374,6,23.6,-1.2641496,36.7914139,-1.2722993,36.8219844,477,1068,25,3819
8015,27548,2786,1,Personal,31,2,52407,31,2,52432,31,2,53581,31,2,53962,31,2,55716,14,21.9,-1.316637,36.7009304,-1.2738348,36.7852209,670,1754,25,1530
8016,2540,3647,3,Business,21,5,49187,21,5,49198,21,5,50111,21,5,50269,21,5,51084,3,27.3,-1.272639,36.794723,-1.2619756,36.800139,467,815,11,1071
8017,11573,3295,3,Business,8,5,37858,8,5,37906,8,5,38316,8,5,38611,8,5,40830,16,28.6,-1.2571472,36.7950633,-1.27915,36.89929,520,2219,48,705
8018,24406,2563,1,Personal,1,1,38458,1,1,38533,1,1,38553,1,1,39753,1,1,41040,12,24.0,-1.3108386,36.7555239,-1.2665477,36.7410165,179,1287,75,1220
8019,11772,3145,3,Business,7,1,34095,7,1,34151,7,1,34865,7,1,35155,7,1,36361,5,21.2,-1.272639,36.794723,-1.2862436,36.791017,434,1206,56,1004
8020,24152,2956,3,Business,14,5,34669,14,5,37915,14,5,37980,14,5,40185,14,5,42022,9,21.6,-1.281754,36.8324229,-1.2584143,36.8048002,300,1837,3246,2270
8021,12691,1304,3,Business,27,2,56199,27,2,57233,27,2,57716,27,2,58038,27,2,58067,7,25.5,-1.3226302,36.8719901,-1.3327654,36.8853117,522,29,1034,805
8022,3944,2485,1,Personal,11,4,60955,11,4,61138,11,4,62072,11,4,62843,11,4,63427,3,23.8,-1.2808667,36.7883545,-1.2938245,36.7913345,612,584,183,1705
8023,21601,3109,2,Personal,10,5,37685,10,5,37700,10,5,38589,10,5,40414,10,5,42778,11,19.4,-1.3107918,36.761794,-1.2916556,36.8262516,452,2364,15,2714
8024,17833,685,3,Business,8,3,36486,8,3,36557,8,3,37317,8,3,37781,8,3,39538,5,23.25888921888938,-1.2726506,36.7960153,-1.2887076,36.8254658,155,1757,71,1224
8025,12678,1620,1,Personal,7,5,40044,7,5,40250,7,5,42545,7,5,42922,7,5,44774,16,25.7,-1.227132,36.8374277,-1.2969741,36.7856612,124,1852,206,2672
8026,13196,1650,1,Personal,19,7,39477,19,7,39960,19,7,41443,19,7,41747,19,7,42528,6,18.1,-1.2707583,36.8237131,-1.3069436,36.8172066,956,781,483,1787
8027,5359,2970,1,Personal,6,1,61992,6,1,61998,6,1,62920,6,1,63048,6,1,65317,21,22.5,-1.3681253,36.9155298,-1.2796151,36.8910091,629,2269,6,1050
8028,24638,585,1,Personal,6,3,25582,6,3,27173,6,3,27878,6,3,28369,6,3,29588,10,15.8,-1.2340873,36.7996694,-1.2597649,36.775631,103,1219,1591,1196
8029,3083,640,3,Business,18,4,33388,18,4,33989,18,4,34640,18,4,35091,18,4,36319,6,23.25888921888938,-1.2969741,36.7856612,-1.2962731,36.8111863,778,1228,601,1102
8030,13123,2279,3,Business,25,5,37081,25,5,38739,25,5,39628,25,5,40614,25,5,41366,5,21.2,-1.2897368,36.8226783,-1.263194,36.797624,742,752,1658,1875
8031,22784,2113,3,Personal,24,3,54613,24,3,54792,24,3,55341,24,3,56222,24,3,57345,8,23.25888921888938,-1.274165,36.814577,-1.275442,36.7660207,345,1123,179,1430
8032,23481,1500,3,Business,8,3,38971,8,3,39818,8,3,41007,8,3,41391,8,3,42233,6,23.25888921888938,-1.2770708,36.8231093,-1.2638185,36.7930057,155,842,847,1573
8033,21702,2801,3,Business,10,1,46528,10,1,46572,10,1,46906,10,1,47471,10,1,48946,8,18.4,-1.300722,36.816865,-1.2674274,36.7870827,709,1475,44,899
8034,7235,2330,3,Business,19,2,42968,19,2,43025,19,2,44017,19,2,44472,19,2,45801,11,27.5,-1.2890715,36.8157588,-1.2325706,36.8083923,764,1329,57,1447
8035,25419,1207,3,Business,28,1,52538,28,1,52546,28,1,52781,28,1,53371,28,1,54347,8,26.1,-1.2629666,36.8068369,-1.2745321,36.765088,45,976,8,825
8036,23989,2030,3,Business,11,1,46669,11,1,47871,11,1,50975,11,1,52490,11,1,53429,2,23.3,-1.2970941,36.7789326,-1.295908,36.791433,616,939,1202,4619
8037,19773,1583,3,Business,31,5,54147,31,5,55348,31,5,58751,31,5,61031,31,5,62374,21,23.6,-1.3700383,36.9190174,-1.2917868,36.7872675,856,1343,1201,5683
8038,26716,2469,3,Business,21,2,40706,21,2,40783,21,2,43071,21,2,43210,21,2,45499,15,22.5,-1.303924,36.8758792,-1.369541,36.907455,697,2289,77,2427
8039,1002,3599,3,Business,27,2,37525,27,2,39615,27,2,40803,27,2,41386,27,2,43961,15,23.8,-1.3302996,36.8707935,-1.2658003,36.8983864,675,2575,2090,1771
8040,8055,3283,3,Business,8,2,34546,8,2,35882,8,2,38371,8,2,38519,8,2,40959,19,23.3,-1.293515,36.897607,-1.2628473,36.781805,457,2440,1336,2637
8041,20731,3355,3,Business,9,2,40730,9,2,41190,9,2,41553,9,2,41844,9,2,43604,6,21.8,-1.3052491,36.8223899,-1.276245,36.8363293,208,1760,460,654
8042,9715,3222,3,Business,8,5,51674,8,5,51731,8,5,52324,8,5,52732,8,5,53882,6,27.4,-1.2551895,36.7822034,-1.2357748,36.7900524,882,1150,57,1001
8043,14260,478,3,Business,9,2,46045,9,2,46094,9,2,46167,9,2,46712,9,2,48394,15,22.1,-1.2551895,36.7822034,-1.3216456,36.7145156,651,1682,49,618
8044,12524,2829,3,Business,29,1,37251,29,1,37485,29,1,37488,29,1,38253,29,1,39464,6,23.25888921888938,-1.2571472,36.7950633,-1.3012902,36.80964,291,1211,234,768
8045,27276,2521,3,Business,25,5,47016,25,5,47161,25,5,47961,25,5,48287,25,5,49013,5,26.2,-1.3167113,36.8301563,-1.3077869,36.8443207,436,726,145,1126
8046,25041,2523,3,Business,22,4,41951,22,4,43593,22,4,43657,22,4,43750,22,4,47187,8,22.5,-1.2551895,36.7822034,-1.2989934,36.8136694,829,3437,1642,157
8047,9103,635,3,Business,17,5,48358,17,5,48386,17,5,48422,17,5,49854,17,5,50935,10,23.25888921888938,-1.3081376,36.8329772,-1.2602337,36.7990548,206,1081,28,1468
8048,22359,3214,3,Business,8,5,35945,8,5,36016,8,5,36886,8,5,37192,8,5,38620,10,20.4,-1.3102256,36.8432368,-1.289795,36.7957132,148,1428,71,1176
8049,18185,635,3,Business,8,5,32453,8,5,32554,8,5,33194,8,5,33792,8,5,34500,7,23.0,-1.2602337,36.7990548,-1.3081376,36.8329772,119,708,101,1238
8050,16275,2154,3,Business,4,4,45367,4,4,45410,4,4,46521,4,4,48092,4,4,49013,6,25.4,-1.2859912,36.8756811,-1.2765736,36.8513646,448,921,43,2682
8051,13224,2330,3,Business,27,6,39568,27,6,39768,27,6,40469,27,6,41209,27,6,42296,9,23.25888921888938,-1.2645318,36.7981775,-1.2326041,36.8009029,96,1087,200,1441
8052,11969,2523,3,Business,21,4,40969,21,4,41051,21,4,41829,21,4,41917,21,4,44384,7,28.2,-1.2551895,36.7822034,-1.2897399,36.8270975,682,2467,82,866
8053,12443,1255,1,Personal,15,1,49616,15,1,49733,15,1,51541,15,1,51830,15,1,52937,11,23.25888921888938,-1.2833895,36.8212908,-1.2218778,36.8206017,832,1107,117,2097
8054,9026,2960,1,Personal,28,4,42638,28,4,42642,28,4,42650,28,4,43167,28,4,43846,3,23.25888921888938,-1.2763916,36.8246826,-1.2876659,36.8179934,698,679,4,525
8055,9489,1578,3,Business,28,2,45223,28,2,47587,28,2,49231,28,2,49607,28,2,51971,9,19.4,-1.2859912,36.8756811,-1.290894,36.822971,447,2364,2364,2020
8056,13203,1724,3,Business,6,4,61893,6,4,62473,6,4,63051,6,4,63552,6,4,65963,14,22.4,-1.2551895,36.7822034,-1.3271684,36.8173021,38,2411,580,1079
8057,25373,571,3,Business,18,5,57968,18,5,57972,18,5,58076,18,5,59413,18,5,62779,18,27.1,-1.3236332,36.701152,-1.265174,36.8094022,831,3366,4,1441
8058,21207,3091,3,Business,13,2,54037,13,2,54184,13,2,55631,13,2,56490,13,2,58672,10,26.3,-1.3012008,36.764868,-1.25896,36.8016691,328,2182,147,2306
8059,23165,1721,3,Business,11,4,54885,11,4,54979,11,4,56219,11,4,56563,11,4,58896,9,27.2,-1.2571472,36.7950633,-1.2295205,36.8120426,933,2333,94,1584
8060,7513,2174,3,Business,12,2,37896,12,2,37904,12,2,38090,12,2,39107,12,2,44583,15,28.2,-1.2482781,36.884092,-1.214071,36.7985052,12,5476,8,1203
8061,25126,391,3,Business,11,2,42662,11,2,48681,11,2,50249,11,2,50790,11,2,53879,5,22.2,-1.2599563,36.7993439,-1.2867454,36.8259017,47,3089,6019,2109
8062,5631,1209,3,Business,18,4,37488,18,4,37526,18,4,37883,18,4,38633,18,4,39734,9,23.25888921888938,-1.2638185,36.7930057,-1.3004062,36.829741,855,1101,38,1107
8063,13711,1389,3,Business,13,3,45672,13,3,46059,13,3,46463,13,3,46942,13,3,48804,15,24.7,-1.2551895,36.7822034,-1.207546,36.7913976,576,1862,387,883
8064,5836,3105,3,Personal,3,1,64378,3,1,65379,3,1,66282,3,1,66565,3,1,67715,7,17.6,-1.2793172,36.8276567,-1.256522,36.7864132,341,1150,1001,1186
8065,25122,661,3,Business,11,1,39085,11,1,40027,11,1,40929,11,1,41780,11,1,44215,4,18.3,-1.2963097,36.7688221,-1.2950044,36.7512209,140,2435,942,1753
8066,10584,1389,3,Business,25,4,48665,25,4,49271,25,4,50126,25,4,50396,25,4,54864,31,21.0,-1.3165542,36.700067,-1.207546,36.7913976,936,4468,606,1125
8067,11989,346,3,Business,21,4,45055,21,4,45314,21,4,46112,21,4,46463,21,4,47603,5,25.3,-1.2584143,36.8048002,-1.28878,36.8168312,831,1140,259,1149
8068,3573,3326,3,Business,17,5,56452,17,5,56516,17,5,57056,17,5,57299,17,5,59227,3,23.25888921888938,-1.2551895,36.7822034,-1.2575407,36.7868197,147,1928,64,783
8069,15780,2190,3,Business,26,3,43642,26,3,43671,26,3,44506,26,3,44696,26,3,45460,5,23.8,-1.301953,36.788458,-1.2869041,36.8240057,726,764,29,1025
8070,7101,3496,3,Business,30,2,57850,30,2,58450,30,2,59103,30,2,59987,30,2,62054,17,23.25888921888938,-1.300921,36.828195,-1.3297531,36.7063699,299,2067,600,1537
8071,1562,3404,3,Business,7,4,55016,7,4,55461,7,4,56557,7,4,56967,7,4,59124,8,27.7,-1.279395,36.825364,-1.2765492,36.7669809,411,2157,445,1506
8072,12230,393,3,Business,7,4,44391,7,4,44403,7,4,44406,7,4,45569,7,4,45572,4,27.5,-1.3167113,36.8301563,-1.3004062,36.829741,39,3,12,1166
8073,21639,1927,3,Business,2,2,56201,2,2,56466,2,2,57064,2,2,60256,2,2,60268,14,28.6,-1.3472066,36.7692638,-1.3263105,36.8622904,947,12,265,3790
8074,1847,2216,3,Business,25,2,42124,25,2,42137,25,2,42632,25,2,42764,25,2,44911,4,24.0,-1.2551895,36.7822034,-1.2754242,36.8139279,215,2147,13,627
8075,21612,1186,3,Personal,20,3,58146,20,3,58821,20,3,59344,20,3,59989,20,3,62922,11,21.5,-1.300921,36.828195,-1.274807,36.771931,312,2933,675,1168
8076,16831,517,3,Business,7,5,32172,7,5,32185,7,5,32330,7,5,32607,7,5,34602,14,20.8,-1.3177547,36.8303703,-1.306378,36.7519845,523,1995,13,422
8077,3232,186,3,Business,9,4,44661,9,4,44766,9,4,45145,9,4,45700,9,4,46834,8,23.25888921888938,-1.2571472,36.7950633,-1.304078,36.83014,383,1134,105,934
8078,11987,44,1,Personal,12,4,42271,12,4,42300,12,4,42694,12,4,43292,12,4,44500,15,18.9,-1.2536725,36.6804915,-1.2560455,36.7800867,735,1208,29,992
8079,24430,265,3,Business,27,1,44934,27,1,44958,27,1,45212,27,1,49615,27,1,49632,21,23.25888921888938,-1.300921,36.828195,-1.2434951,36.6760986,927,17,24,4657
8080,11827,393,3,Business,20,4,31894,20,4,32501,20,4,32581,20,4,34185,20,4,38328,11,18.5,-1.3167113,36.8301563,-1.2574219,36.7927073,188,4143,607,1684
8081,10361,3222,3,Business,25,1,59135,25,1,59202,25,1,59261,25,1,59334,25,1,60847,7,27.8,-1.2551895,36.7822034,-1.2545163,36.8243717,468,1513,67,132
8082,12862,2403,2,Personal,9,6,46393,9,6,46399,9,6,47735,9,6,48185,9,6,51323,14,17.4,-1.3046156,36.7658572,-1.2696795,36.8640088,6,3138,6,1786
8083,14416,1304,3,Business,24,2,56508,24,2,56519,24,2,56875,24,2,57052,24,2,57407,3,18.4,-1.2551895,36.7822034,-1.2562249,36.7868661,519,355,11,533
8084,26774,552,3,Business,12,4,49319,12,4,49331,12,4,49646,12,4,51700,12,4,53082,18,21.7,-1.2799394,36.8192374,-1.3562374,36.9042954,906,1382,12,2369
8085,23709,2733,3,Business,28,5,54997,28,5,55746,28,5,56229,28,5,56603,28,5,57286,2,25.6,-1.328259,36.860975,-1.3332749,36.8708147,932,683,749,857
8086,8559,393,3,Business,1,4,44568,1,4,44575,1,4,44819,1,4,45560,1,4,46988,10,23.25888921888938,-1.3177547,36.8303703,-1.2574219,36.7927073,761,1428,7,985
8087,18960,640,3,Business,27,3,53852,27,3,53886,27,3,54546,27,3,54701,27,3,55560,6,29.1,-1.2969741,36.7856612,-1.28359,36.823092,812,859,34,815
8088,18154,2477,2,Personal,24,5,45927,24,5,45946,24,5,46845,24,5,47713,24,5,48868,17,21.0,-1.2889751,36.8154048,-1.3610501,36.7520889,249,1155,19,1767
8089,4492,3147,3,Business,17,1,32315,17,1,32331,17,1,32333,17,1,34069,17,1,34788,14,19.1,-1.3226302,36.8719901,-1.3472066,36.7692638,345,719,16,1738
8090,4348,635,3,Business,12,4,39759,12,4,39785,12,4,40475,12,4,40848,12,4,42529,8,18.9,-1.2599563,36.7993439,-1.2443443,36.8085667,519,1681,26,1063
8091,19666,2423,3,Business,10,3,54987,10,3,55224,10,3,55345,10,3,55736,10,3,57507,10,30.8,-1.2551895,36.7822034,-1.3126476,36.831455,548,1771,237,512
8092,6934,3647,3,Business,6,4,48768,6,4,51232,6,4,52192,6,4,52403,6,4,54426,8,23.25888921888938,-1.272639,36.794723,-1.2653185,36.8358841,447,2023,2464,1171
8093,488,533,3,Business,31,3,43620,31,3,43678,31,3,44119,31,3,44636,31,3,45743,7,24.8,-1.2571472,36.7950633,-1.2765492,36.7669809,937,1107,58,958
8094,12056,3182,2,Personal,27,7,63407,27,7,63417,27,7,64407,27,7,64672,27,7,65351,1,22.1,-1.294042,36.766291,-1.2901669,36.7685878,148,679,10,1255
8095,1144,198,3,Business,21,4,43086,21,4,43115,21,4,44834,21,4,47184,21,4,49719,24,25.4,-1.2261753,36.8077307,-1.3396256,36.8863135,91,2535,29,4069
8096,25972,1789,3,Business,20,1,44754,20,1,44779,20,1,45672,20,1,45762,20,1,47428,13,23.25888921888938,-1.2917868,36.7872675,-1.332454,36.8835186,158,1666,25,983
8097,8395,2956,3,Business,13,1,34432,13,1,34441,13,1,35346,13,1,35647,13,1,35830,2,15.2,-1.2584143,36.8048002,-1.2571472,36.7950633,520,183,9,1206
8098,26205,2801,3,Business,21,4,55787,21,4,55839,21,4,57060,21,4,57914,21,4,59579,9,26.3,-1.307726,36.839117,-1.2595422,36.7871178,953,1665,52,2075
8099,7258,173,3,Business,30,5,67295,30,5,67316,30,5,67743,30,5,68369,30,5,68755,2,22.0,-1.2993231,36.7753372,-1.2963097,36.7688221,539,386,21,1053
8100,6486,3486,3,Business,19,3,53064,19,3,53082,19,3,53920,19,3,54019,19,3,54551,4,24.6,-1.2551895,36.7822034,-1.269534,36.80697,915,532,18,937
8101,25915,440,1,Personal,5,5,67339,5,5,67475,5,5,68366,5,5,68495,5,5,69823,12,25.0,-1.3222489,36.7867025,-1.2724885,36.7856999,328,1328,136,1020
8102,16528,3560,3,Business,9,4,47996,9,4,48170,9,4,48719,9,4,50154,9,4,50157,1,23.25888921888938,-1.290894,36.822971,-1.279395,36.825364,843,3,174,1984
8103,27181,1927,3,Business,29,5,45878,29,5,46144,29,5,49182,29,5,50022,29,5,52540,15,28.8,-1.3472066,36.7692638,-1.2591019,36.800577,500,2518,266,3878
8104,14621,2212,3,Business,27,3,44872,27,3,44929,27,3,45431,27,3,45969,27,3,47765,14,25.9,-1.2571472,36.7950633,-1.3291155,36.8861,922,1796,57,1040
8105,8917,3201,3,Business,26,3,46495,26,3,46513,26,3,47096,26,3,47229,26,3,49806,15,23.8,-1.2649605,36.7981777,-1.337784,36.7586518,914,2577,18,716
8106,324,3283,3,Business,5,3,35943,5,3,36398,5,3,37022,5,3,37412,5,3,39532,10,17.8,-1.2628473,36.781805,-1.300337,36.829327,175,2120,455,1014
8107,5533,3149,3,Business,15,1,48827,15,1,48844,15,1,48858,15,1,50734,15,1,50946,6,23.25888921888938,-1.3004062,36.829741,-1.3167113,36.8301563,41,212,17,1890
8108,2759,3355,3,Business,4,2,61657,4,2,61776,4,2,65371,4,2,65653,4,2,70676,11,22.3,-1.3052491,36.8223899,-1.238874,36.807889,267,5023,119,3877
8109,19947,1576,3,Business,18,5,55256,18,5,55781,18,5,56644,18,5,56748,18,5,57638,8,24.2,-1.3100609,36.8205365,-1.3332749,36.8708147,192,890,525,967
8110,8802,136,3,Business,4,2,60300,4,2,60765,4,2,63250,4,2,66332,4,2,66361,9,22.6,-1.2654716,36.7983635,-1.2313147,36.8016863,739,29,465,5567
8111,20186,3486,3,Business,5,2,37275,5,2,37306,5,2,37492,5,2,37602,5,2,39616,16,18.2,-1.2551895,36.7822034,-1.3165542,36.700067,854,2014,31,296
8112,2025,2523,3,Business,18,4,61206,18,4,61221,18,4,61463,18,4,61775,18,4,62964,4,23.25888921888938,-1.2551895,36.7822034,-1.2633049,36.8031251,168,1189,15,554
8113,22240,2195,3,Business,17,3,46580,17,3,46592,17,3,47483,17,3,48029,17,3,48672,6,23.25888921888938,-1.2296618,36.8438272,-1.228911,36.881876,8,643,12,1437
8114,3354,2856,1,Personal,2,2,49717,2,2,49766,2,2,50029,2,2,50739,2,2,52347,13,26.0,-1.3283152,36.862882,-1.3104166,36.8968337,543,1608,49,973
8115,13262,2532,3,Business,24,4,50376,24,4,50401,24,4,51286,24,4,51681,24,4,53187,8,28.3,-1.2551895,36.7822034,-1.3047132,36.8089553,436,1506,25,1280
8116,11124,3222,3,Business,20,3,34732,20,3,34757,20,3,34791,20,3,35183,20,3,36605,10,20.9,-1.2551895,36.7822034,-1.307376,36.813404,576,1422,25,426
8117,36,1329,3,Business,13,6,44455,13,6,44609,13,6,44917,13,6,45071,13,6,46355,7,26.1,-1.273056,36.811298,-1.275612,36.7637978,660,1284,154,462
8118,24728,1075,3,Business,7,4,46882,7,4,46931,7,4,47567,7,4,47996,7,4,48489,2,27.5,-1.2679657,36.8081617,-1.2527958,36.8003131,658,493,49,1065
8119,19374,867,3,Business,13,2,34049,13,2,34100,13,2,35408,13,2,35660,13,2,37045,12,19.7,-1.306378,36.7519845,-1.2996533,36.8292629,188,1385,51,1560
8120,26554,402,3,Business,1,6,49669,1,6,49811,1,6,51252,1,6,52395,1,6,54177,6,26.6,-1.290894,36.822971,-1.2527958,36.8003131,502,1782,142,2584
8121,16150,1882,3,Business,2,4,52331,2,4,54433,2,4,55691,2,4,55921,2,4,58073,13,23.25888921888938,-1.323615,36.700475,-1.2956882,36.7861845,831,2152,2102,1488
8122,2101,635,3,Business,3,5,31495,3,5,31531,3,5,32437,3,5,35476,3,5,35479,11,23.25888921888938,-1.2857764,36.8236622,-1.2121659,36.8112437,921,3,36,3945
8123,7001,893,3,Business,3,1,39460,3,1,39565,3,1,40014,3,1,40190,3,1,41442,7,22.3,-1.2594474,36.8089122,-1.2847316,36.7658086,147,1252,105,625
8124,21431,2150,3,Business,6,1,35575,6,1,37730,6,1,38222,6,1,38497,6,1,40133,9,23.25888921888938,-1.303596,36.778378,-1.344446,36.756597,660,1636,2155,767
8125,28045,2587,3,Business,7,1,54994,7,1,55056,7,1,55424,7,1,55731,7,1,56638,2,26.7,-1.281754,36.8324229,-1.28878,36.8168312,379,907,62,675
8126,3666,577,3,Personal,16,3,52555,16,3,52566,16,3,53180,16,3,53706,16,3,55388,12,26.8,-1.3270347,36.8667362,-1.2662728,36.8151265,698,1682,11,1140
8127,21144,2956,3,Business,11,1,42647,11,1,42670,11,1,42885,11,1,43377,11,1,44117,4,26.6,-1.2584143,36.8048002,-1.2866012,36.8195691,953,740,23,707
8128,26427,3203,3,Business,4,1,54378,4,1,54496,4,1,55575,4,1,56081,4,1,56910,13,22.5,-1.2600926,36.8088685,-1.228911,36.881876,852,829,118,1585
8129,6399,1075,3,Business,11,4,42161,11,4,43136,11,4,43630,11,4,44393,11,4,47126,13,25.5,-1.2285835,36.8826468,-1.2527958,36.8003131,404,2733,975,1257
8130,19371,393,3,Business,8,1,59800,8,1,59846,8,1,60659,8,1,60817,8,1,62235,11,28.8,-1.3167113,36.8301563,-1.2638185,36.7930057,570,1418,46,971
8131,4502,893,3,Business,17,5,56448,17,5,56515,17,5,56573,17,5,57129,17,5,57981,4,23.25888921888938,-1.2663194,36.809901,-1.2575407,36.7868197,547,852,67,614
8132,19638,426,3,Business,5,1,29593,5,1,29737,5,1,33545,5,1,33967,5,1,35331,6,18.7,-1.3323107,36.8692616,-1.3097713,36.849494,849,1364,144,4230
8133,17701,412,3,Business,18,2,38269,18,2,38346,18,2,39134,18,2,40413,18,2,41113,4,23.25888921888938,-1.266837,36.799249,-1.265715,36.823815,547,700,77,2067
8134,11633,2200,3,Business,2,2,41570,2,2,42131,2,2,43661,2,2,44708,2,2,46617,12,20.8,-1.225322,36.80855,-1.290894,36.822971,726,1909,561,2577
8135,5164,265,3,Business,22,1,30110,22,1,30139,22,1,30734,22,1,31062,22,1,34102,21,20.1,-1.300921,36.828195,-1.2434951,36.6760986,216,3040,29,923
8136,16066,3080,3,Business,7,5,35580,7,5,35672,7,5,37130,7,5,37221,7,5,39460,17,23.25888921888938,-1.2551895,36.7822034,-1.3227393,36.705093,827,2239,92,1549
8137,8255,1471,3,Business,15,5,45422,15,5,45444,15,5,45779,15,5,46052,15,5,46688,3,26.6,-1.2551895,36.7822034,-1.2649783,36.8071436,720,636,22,608
8138,26864,3222,3,Business,4,2,52922,4,2,53121,4,2,53841,4,2,54259,4,2,55554,8,22.7,-1.2551895,36.7822034,-1.2922992,36.7983035,161,1295,199,1138
8139,12584,362,1,Personal,22,3,53812,22,3,53826,22,3,54420,22,3,54727,22,3,55961,5,25.7,-1.2942023,36.7958179,-1.2873232,36.7658572,54,1234,14,901
8140,13482,3426,3,Business,12,6,40700,12,6,40721,12,6,41151,12,6,41864,12,6,43155,2,23.25888921888938,-1.3012008,36.764868,-1.2873232,36.7658572,246,1291,21,1143
8141,20675,2663,1,Personal,29,6,60842,29,6,60886,29,6,61454,29,6,62071,29,6,62770,3,23.6,-1.2884066,36.7866984,-1.2931317,36.7778105,282,699,44,1185
8142,28153,84,3,Business,24,4,57219,24,4,57226,24,4,57877,24,4,58073,24,4,60841,8,22.7,-1.2553615,36.7895376,-1.2962832,36.7849683,71,2768,7,847
8143,9434,435,3,Business,6,4,57007,6,4,57023,6,4,57039,6,4,57876,6,4,60247,16,21.1,-1.300921,36.828195,-1.2016802,36.8190225,293,2371,16,853
8144,10606,1594,3,Business,16,2,55871,16,2,55916,16,2,56235,16,2,56589,16,2,57530,7,23.25888921888938,-1.2156006,36.8916865,-1.2467896,36.8698733,388,941,45,673
8145,5190,2828,3,Business,6,3,28753,6,3,28813,6,3,30699,6,3,31783,6,3,34019,12,23.25888921888938,-1.3263105,36.8622904,-1.3193822,36.7949906,61,2236,60,2970
8146,4898,2289,3,Business,27,3,51209,27,3,51280,27,3,51305,27,3,51718,27,3,52717,9,29.3,-1.2551895,36.7822034,-1.2857117,36.7968296,523,999,71,438
8147,27630,3517,3,Business,16,2,48208,16,2,48223,16,2,48295,16,2,50401,16,2,52499,13,27.5,-1.300921,36.828195,-1.2655495,36.910537,622,2098,15,2178
8148,10158,2216,3,Business,21,2,36127,21,2,36175,21,2,36200,21,2,36544,21,2,38309,10,23.25888921888938,-1.2551895,36.7822034,-1.2287282,36.8115304,576,1765,48,369
8149,27756,516,3,Business,30,5,40083,30,5,40110,30,5,40848,30,5,41601,30,5,42978,6,23.5,-1.2571472,36.7950633,-1.2925919,36.8170577,19,1377,27,1491
8150,10258,3201,3,Business,6,2,52928,6,2,53944,6,2,54485,6,2,54600,6,2,55975,14,27.4,-1.2232123,36.8932547,-1.2649605,36.7981777,456,1375,1016,656
8151,11015,49,3,Business,18,2,62184,18,2,62252,18,2,62316,18,2,63528,18,2,65807,7,23.7,-1.2798347,36.8219092,-1.3010773,36.7752554,469,2279,68,1276
8152,20668,2216,3,Business,28,5,60060,28,5,60089,28,5,61709,28,5,62004,28,5,65139,15,24.5,-1.2867627,36.883446,-1.2198413,36.9054958,56,3135,29,1915
8153,20592,2710,3,Personal,28,4,56714,28,4,56723,28,4,56763,28,4,57407,28,4,59333,14,27.2,-1.2535486,36.7933541,-1.2374255,36.8920631,674,1926,9,684
8154,25365,136,3,Business,4,4,35745,4,4,35787,4,4,37609,4,4,38752,4,4,41637,15,23.25888921888938,-1.3326173,36.7146233,-1.3233496,36.8139159,565,2885,42,2965
8155,12994,265,3,Business,12,2,38645,12,2,38678,12,2,40275,12,2,40998,12,2,42892,14,28.0,-1.2171852,36.8145508,-1.300921,36.828195,882,1894,33,2320
8156,9139,1178,3,Business,28,5,42104,28,5,42142,28,5,43042,28,5,43150,28,5,44706,13,25.1,-1.280285,36.780954,-1.3169591,36.7000029,731,1556,38,1008
8157,16244,393,3,Business,7,2,31859,7,2,31871,7,2,31874,7,2,34854,7,2,34857,11,23.25888921888938,-1.3167113,36.8301563,-1.2638185,36.7930057,619,3,12,2983
8158,5624,868,3,Business,2,4,55840,2,4,59547,2,4,59987,2,4,60846,2,4,62746,14,23.6,-1.293515,36.897607,-1.265715,36.823815,676,1900,3707,1299
8159,3477,2801,3,Business,16,2,44691,16,2,44749,16,2,45714,16,2,46203,16,2,48225,15,23.25888921888938,-1.3104506,36.8687235,-1.2674274,36.7870827,448,2022,58,1454
8160,9327,76,1,Personal,25,6,52705,25,6,52742,25,6,54092,25,6,54269,25,6,55372,8,23.25888921888938,-1.260232,36.807334,-1.2962832,36.7849683,598,1103,37,1527
8161,11620,2570,3,Personal,20,1,54238,20,1,54287,20,1,54819,20,1,54980,20,1,56259,12,23.25888921888938,-1.25896,36.8016691,-1.2295297,36.8833095,96,1279,49,693
8162,812,1500,3,Business,30,2,46819,30,2,46833,30,2,46838,30,2,47018,30,2,48539,12,22.4,-1.2574219,36.7927073,-1.3177547,36.8303703,10,1521,14,185
8163,18288,3410,3,Business,12,3,39499,12,3,40457,12,3,45064,12,3,45299,12,3,48414,21,23.3,-1.3700383,36.9190174,-1.2917868,36.7872675,753,3115,958,4842
8164,26149,2216,3,Business,4,5,35261,4,5,35284,4,5,35505,4,5,37617,4,5,39425,15,17.3,-1.2867627,36.883446,-1.2854174,36.7951152,557,1808,23,2333
8165,6824,2448,2,Personal,25,5,52582,25,5,53712,25,5,55332,25,5,55683,25,5,57417,8,23.6,-1.3251584,36.8199384,-1.265715,36.808525,888,1734,1130,1971
8166,5695,3621,3,Business,29,5,36258,29,5,36330,29,5,37023,29,5,37097,29,5,37938,3,20.7,-1.2836583,36.7886014,-1.3025667,36.7803495,468,841,72,767
8167,24247,3158,2,Personal,24,4,59189,24,4,59331,24,4,60359,24,4,62009,24,4,63437,7,21.0,-1.2855799,36.8176209,-1.289274,36.7781339,808,1428,142,2678
8168,5575,2956,3,Business,4,1,49383,4,1,49398,4,1,51005,4,1,51246,4,1,53557,3,28.4,-1.2584143,36.8048002,-1.2551895,36.7822034,727,2311,15,1848
8169,8312,868,3,Business,4,2,43328,4,2,43447,4,2,43898,4,2,44769,4,2,46003,5,18.7,-1.2600926,36.8088685,-1.265715,36.823815,208,1234,119,1322
8170,15303,1395,1,Personal,17,7,46580,17,7,48210,17,7,48595,17,7,48709,17,7,49613,10,15.7,-1.3015907,36.7684633,-1.3149257,36.8441635,185,904,1630,499
8171,2390,248,3,Business,6,4,40109,6,4,40244,6,4,41182,6,4,41653,6,4,42688,6,19.7,-1.286937,36.8246742,-1.2988291,36.7795686,821,1035,135,1409
8172,10508,1637,3,Business,30,4,41590,30,4,41627,30,4,42582,30,4,44681,30,4,46363,9,20.5,-1.2551895,36.7822034,-1.3014461,36.7661381,548,1682,37,3054
8173,5348,1544,3,Business,3,1,58808,3,1,61748,3,1,62070,3,1,63738,3,1,64109,1,17.5,-1.2887801,36.8297743,-1.2885029,36.825605,673,371,2940,1990
8174,326,1946,1,Personal,13,1,33095,13,1,33131,13,1,34304,13,1,34871,13,1,35665,5,15.4,-1.2913382,36.8018508,-1.2765064,36.8215724,234,794,36,1740
8175,19792,3715,1,Personal,10,4,32906,10,4,36534,10,4,38750,10,4,38989,10,4,40082,7,23.25888921888938,-1.2794105,36.8215655,-1.3159197,36.8516724,123,1093,3628,2455
8176,22122,867,3,Business,2,3,45435,2,3,45438,2,3,45483,2,3,47143,2,3,48664,14,22.0,-1.306378,36.7519845,-1.3177547,36.8303703,294,1521,3,1705
8177,14865,438,3,Personal,7,4,61092,7,4,61105,7,4,62548,7,4,62646,7,4,63537,5,29.2,-1.2563576,36.7881585,-1.2695287,36.7981777,291,891,13,1541
8178,22584,72,1,Personal,30,3,45248,30,3,47747,30,3,49336,30,3,50247,30,3,53750,7,24.9,-1.3222489,36.7867025,-1.2932803,36.774089,480,3503,2499,2500
8179,538,2280,2,Personal,24,1,51816,24,1,51897,24,1,52393,24,1,52674,24,1,53425,3,23.25888921888938,-1.274089,36.7997508,-1.2675613,36.8133001,882,751,81,777
8180,11236,633,3,Business,4,2,33796,4,2,34713,4,2,35706,4,2,35937,4,2,36444,4,15.8,-1.3077869,36.8443207,-1.3004062,36.829741,932,507,917,1224
8181,16090,2523,3,Business,30,3,34393,30,3,34418,30,3,34618,30,3,36581,30,3,37801,10,19.9,-1.2551895,36.7822034,-1.3073569,36.8202163,322,1220,25,2163
8182,3484,3291,3,Business,29,5,33649,29,5,33680,29,5,35565,29,5,37055,29,5,39681,16,20.9,-1.293515,36.897607,-1.2600926,36.8088685,377,2626,31,3375
8183,22040,3727,3,Business,21,1,48230,21,1,48272,21,1,48859,21,1,48938,21,1,49849,3,27.6,-1.2963097,36.7688221,-1.2860203,36.7832538,355,911,42,666
8184,11009,2889,1,Personal,7,1,48589,7,1,48652,7,1,49203,7,1,49669,7,1,50474,4,20.7,-1.2720542,36.7910241,-1.263419,36.8060348,100,805,63,1017
8185,6019,3403,3,Business,6,2,55698,6,2,56356,6,2,57801,6,2,57967,6,2,59980,16,27.7,-1.2551895,36.7822034,-1.3326173,36.7146233,123,2013,658,1611
8186,4231,3410,3,Business,1,1,44648,1,1,44668,1,1,45249,1,1,47712,1,1,47729,21,24.1,-1.2917868,36.7872675,-1.3700383,36.9190174,41,17,20,3044
8187,2201,811,3,Personal,3,5,52521,3,5,52683,3,5,53064,3,5,54250,3,5,55849,4,23.25888921888938,-1.2963097,36.7688221,-1.285355,36.795287,599,1599,162,1567
8188,18865,788,3,Business,27,2,38887,27,2,38899,27,2,41545,27,2,41688,27,2,43594,14,24.0,-1.2156006,36.8916865,-1.225322,36.80855,199,1906,12,2789
8189,3382,3109,2,Personal,22,5,29568,22,5,29600,22,5,30844,22,5,32448,22,5,35079,9,16.3,-1.2894847,36.7556088,-1.3066143,36.8161046,140,2631,32,2848
8190,3654,1781,3,Business,5,3,50208,5,3,50262,5,3,51706,5,3,52344,5,3,54622,7,25.1,-1.2571472,36.7950633,-1.3004062,36.829741,439,2278,54,2082
8191,1080,1342,3,Business,4,4,58266,4,4,58273,4,4,58297,4,4,58736,4,4,59365,6,24.6,-1.3025826,36.7670807,-1.3043952,36.7664138,882,629,7,463
8192,14662,1124,3,Business,15,3,45307,15,3,45356,15,3,45533,15,3,46662,15,3,48077,11,18.1,-1.269018,36.796803,-1.2812601,36.7340272,446,1415,49,1306
8193,584,12,3,Business,12,4,47820,12,4,48016,12,4,49586,12,4,50203,12,4,51699,11,21.8,-1.240021,36.84999,-1.2655477,36.8001682,937,1496,196,2187
8194,24100,2523,3,Business,9,2,52141,9,2,52150,9,2,52300,9,2,52778,9,2,53086,3,30.7,-1.2551895,36.7822034,-1.2560455,36.7800867,690,308,9,628
8195,7961,2801,3,Business,10,5,41743,10,5,41772,10,5,42930,10,5,43145,10,5,44464,10,23.25888921888938,-1.2674274,36.7870827,-1.2653185,36.8358841,930,1319,29,1373
8196,28174,1725,3,Business,25,3,44729,25,3,44755,25,3,45385,25,3,45975,25,3,47020,4,23.25888921888938,-1.2652108,36.8056075,-1.2566078,36.7832089,88,1045,26,1220
8197,601,3295,3,Business,22,4,53914,22,4,54042,22,4,54533,22,4,54770,22,4,55845,8,26.2,-1.2571472,36.7950633,-1.3025667,36.7803495,199,1075,128,728
8198,16263,2587,3,Business,7,1,54845,7,1,54884,7,1,55083,7,1,56730,7,1,57813,6,26.6,-1.2551895,36.7822034,-1.28878,36.8168312,205,1083,39,1846
8199,7167,1389,3,Business,1,3,53143,1,3,53171,1,3,53585,1,3,55094,1,3,57177,13,23.25888921888938,-1.2283403,36.8822756,-1.207546,36.7913976,691,2083,28,1923
8200,3611,3631,3,Personal,9,2,38520,9,2,38617,9,2,39023,9,2,39331,9,2,39734,2,22.0,-1.2963097,36.7688221,-1.3043649,36.7816132,750,403,97,714
8201,23233,2195,1,Business,25,2,36428,25,2,36447,25,2,37057,25,2,38823,25,2,40367,10,23.7,-1.265715,36.823815,-1.3313643,36.8577422,96,1544,19,2376
8202,15122,1715,3,Business,3,4,41593,3,4,41639,3,4,42154,3,4,43873,3,4,45538,10,21.9,-1.320982,36.828491,-1.253966,36.7987692,720,1665,46,2234
8203,5636,627,3,Business,25,1,35493,25,1,35552,25,1,35600,25,1,36232,25,1,37577,9,21.2,-1.2551895,36.7822034,-1.2986123,36.8076281,783,1345,59,680
8204,11199,3222,3,Business,8,5,62014,8,5,62495,8,5,63188,8,5,63317,8,5,65313,4,28.1,-1.2551895,36.7822034,-1.261403,36.7692242,300,1996,481,822
8205,26991,3560,3,Business,17,3,37449,17,3,37499,17,3,38900,17,3,39130,17,3,40297,5,25.5,-1.2765736,36.8513646,-1.279395,36.825364,477,1167,50,1631
8206,17704,3578,3,Business,4,2,49037,4,2,49247,4,2,50434,4,2,51023,4,2,52139,10,22.5,-1.2440647,36.7190288,-1.2527958,36.7976244,161,1116,210,1776
8207,15092,3647,3,Business,7,2,59612,7,2,59629,7,2,59746,7,2,59972,7,2,61346,8,23.25888921888938,-1.272639,36.794723,-1.3068209,36.8282524,660,1374,17,343
8208,8475,2066,3,Business,30,4,61194,30,4,61299,30,4,62206,30,4,62535,30,4,63708,8,20.3,-1.316961,36.820337,-1.2849815,36.7767751,101,1173,105,1236
8209,26076,185,1,Personal,9,1,33745,9,1,33778,9,1,34067,9,1,34359,9,1,35736,15,15.5,-1.3069127,36.8351372,-1.2624998,36.7516423,216,1377,33,581
8210,22543,3688,3,Business,27,3,52483,27,3,52517,27,3,54305,27,3,54769,27,3,57121,17,29.3,-1.3463042,36.768164,-1.2551895,36.7822034,168,2352,34,2252
8211,6003,2271,3,Business,18,6,38382,18,6,38404,18,6,39556,18,6,40511,18,6,41717,12,21.3,-1.228911,36.881876,-1.293515,36.897607,68,1206,22,2107
8212,3575,265,3,Business,20,3,36284,20,3,36314,20,3,36537,20,3,36809,20,3,37654,3,21.0,-1.300921,36.828195,-1.3230539,36.8464688,206,845,30,495
8213,8088,1357,1,Personal,28,5,44138,28,5,44239,28,5,45506,28,5,46194,28,5,48998,5,25.1,-1.2663525,36.8128337,-1.2897215,36.7945959,537,2804,101,1955
8214,16498,1075,3,Business,23,6,54086,23,6,54124,23,6,54767,23,6,55054,23,6,55461,1,28.5,-1.2649605,36.7981777,-1.2527958,36.8003131,167,407,38,930
8215,21674,393,3,Business,27,2,42025,27,2,42051,27,2,42055,27,2,43138,27,2,44933,14,23.8,-1.3177547,36.8303703,-1.306378,36.7519845,10,1795,26,1087
8216,5370,246,3,Business,16,3,54856,16,3,54917,16,3,55838,16,3,56009,16,3,58141,5,26.8,-1.2584143,36.8048002,-1.2653185,36.8358841,879,2132,61,1092
8217,14527,517,3,Business,5,4,33611,5,4,33670,5,4,33724,5,4,36720,5,4,36836,8,23.25888921888938,-1.3177547,36.8303703,-1.2770708,36.8231093,284,116,59,3050
8218,12357,972,3,Business,25,4,65585,25,4,65604,25,4,66290,25,4,66414,25,4,67552,5,23.25888921888938,-1.2862033,36.8152966,-1.2785902,36.7931582,612,1138,19,810
8219,9147,3365,2,Personal,31,2,45083,31,2,45097,31,2,45461,31,2,45544,31,2,46459,5,18.6,-1.2795796,36.819062,-1.304078,36.83014,933,915,14,447
8220,24535,3222,3,Business,25,4,58396,25,4,58491,25,4,58907,25,4,59337,25,4,60054,1,23.25888921888938,-1.2551895,36.7822034,-1.2549259,36.7919494,205,717,95,846
8221,8593,1724,3,Business,20,1,47623,20,1,47637,20,1,48408,20,1,48571,20,1,49505,6,23.25888921888938,-1.2551895,36.7822034,-1.279395,36.825364,448,934,14,934
8222,13859,2987,3,Business,8,3,59103,8,3,59137,8,3,59679,8,3,60087,8,3,60679,3,24.1,-1.270212,36.8210877,-1.2649605,36.7981777,427,592,34,950
8223,5077,2523,3,Business,25,4,52075,25,4,52100,25,4,52121,25,4,52802,25,4,53731,10,23.25888921888938,-1.2551895,36.7822034,-1.2287282,36.8115304,291,929,25,702
8224,25750,53,3,Business,10,1,55801,10,1,56707,10,1,57460,10,1,58841,10,1,60196,8,18.4,-1.2770708,36.8231093,-1.276954,36.765926,910,1355,906,2134
8225,11964,635,3,Business,10,5,35144,10,5,35197,10,5,36238,10,5,36417,10,5,37325,7,13.7,-1.2599563,36.7993439,-1.269656,36.767011,574,908,53,1220
8226,16846,3689,3,Business,26,1,40131,26,1,41309,26,1,41792,26,1,42070,26,1,43669,9,22.9,-1.2765736,36.8513646,-1.2527958,36.8003131,629,1599,1178,761
8227,26596,3222,3,Business,21,4,39024,21,4,39041,21,4,39106,21,4,39352,21,4,43372,19,27.9,-1.2551895,36.7822034,-1.334474,36.88389,793,4020,17,311
8228,4516,136,3,Business,20,5,47125,20,5,47130,20,5,47708,20,5,48901,20,5,50579,12,20.6,-1.2738338,36.782403,-1.3326173,36.7146233,844,1678,5,1771
8229,16849,28,3,Business,12,5,50692,12,5,50916,12,5,52244,12,5,53146,12,5,55273,13,27.3,-1.3022899,36.869332,-1.2917868,36.7872675,882,2127,224,2230
8230,18084,393,3,Business,9,3,49645,9,3,49664,9,3,49669,9,3,51230,9,3,52377,11,25.5,-1.3167113,36.8301563,-1.2574219,36.7927073,62,1147,19,1566
8231,9867,2330,3,Business,19,2,51776,19,2,51848,19,2,53295,19,2,53409,19,2,54478,8,29.4,-1.2325706,36.8083923,-1.2637057,36.80517,318,1069,72,1561
8232,14256,909,3,Business,10,3,48835,10,3,48942,10,3,49543,10,3,50758,10,3,51599,8,30.7,-1.225322,36.80855,-1.2675238,36.8127148,291,841,107,1816
8233,26173,1467,3,Personal,2,2,54615,2,2,54656,2,2,55298,2,2,55507,2,2,55876,2,26.0,-1.2984591,36.7855438,-1.2892529,36.7740575,312,369,41,851
8234,25299,868,3,Business,21,6,41963,21,6,41981,21,6,42424,21,6,43243,21,6,44283,6,16.3,-1.307143,36.825009,-1.265715,36.823815,670,1040,18,1262
8235,27708,3647,3,Business,6,2,56433,6,2,57779,6,2,59008,6,2,59290,6,2,60543,7,27.6,-1.272639,36.794723,-1.2981625,36.8130142,854,1253,1346,1511
8236,27643,391,3,Business,27,6,39265,27,6,40033,27,6,40470,27,6,40678,27,6,41584,5,23.25888921888938,-1.2784063,36.8222933,-1.3081376,36.8329772,341,906,768,645
8237,18236,2412,3,Business,3,4,57525,3,4,57549,3,4,58506,3,4,58601,3,4,59388,5,26.2,-1.2285835,36.8826468,-1.2156006,36.8916865,854,787,24,1052
8238,17386,2195,3,Business,20,6,47525,20,6,47543,20,6,48571,20,6,48913,20,6,49809,9,23.25888921888938,-1.265715,36.823815,-1.228911,36.881876,309,896,18,1370
8239,27850,2013,3,Personal,18,1,31843,18,1,31915,18,1,33113,18,1,33260,18,1,34729,12,15.2,-1.2840461,36.7934021,-1.238874,36.807889,808,1469,72,1345
8240,19911,3091,3,Business,11,2,44719,11,2,47132,11,2,47790,11,2,48630,11,2,50668,9,19.2,-1.3052491,36.8223899,-1.3025826,36.7670807,665,2038,2413,1498
8241,13931,3222,3,Business,24,4,36443,24,4,36493,24,4,36531,24,4,36932,24,4,39632,16,19.2,-1.2551895,36.7822034,-1.3312488,36.8801409,268,2700,50,439
8242,10082,1245,3,Business,9,4,32366,9,4,32376,9,4,34906,9,4,36397,9,4,40655,16,17.0,-1.3878505,36.7692885,-1.300921,36.828195,939,4258,10,4021
8243,15333,2814,2,Personal,5,2,35038,5,2,35098,5,2,35479,5,2,36692,5,2,36937,1,17.7,-1.2909043,36.7907801,-1.2899,36.7794355,24,245,60,1594
8244,15121,2310,3,Business,10,4,57164,10,4,57998,10,4,59232,10,4,59898,10,4,60790,6,22.1,-1.2765736,36.8513646,-1.2859912,36.8756811,668,892,834,1900
8245,3925,432,3,Business,24,5,51037,24,5,51548,24,5,51845,24,5,52113,24,5,53378,8,22.8,-1.3012008,36.764868,-1.2819054,36.8237089,404,1265,511,565
8246,1397,2216,3,Business,25,4,42909,25,4,42926,25,4,43107,25,4,43433,25,4,44423,5,19.9,-1.2551895,36.7822034,-1.2731645,36.7900343,464,990,17,507
8247,18116,3557,3,Business,3,3,57666,3,3,57761,3,3,57865,3,3,59316,3,3,59922,2,26.8,-1.2523599,36.8017648,-1.2546732,36.8086796,574,606,95,1555
8248,12133,1141,3,Business,24,3,43779,24,3,43908,24,3,44341,24,3,45295,24,3,46474,7,19.9,-1.2951297,36.8335521,-1.2684319,36.8165853,210,1179,129,1387
8249,4798,346,3,Business,12,2,45395,12,2,45491,12,2,45711,12,2,46756,12,2,47826,5,24.4,-1.2620912,36.8013562,-1.28878,36.8168312,379,1070,96,1265
8250,13298,1209,3,Business,8,1,53676,8,1,54039,8,1,54807,8,1,55004,8,1,55810,4,29.6,-1.2770708,36.8231093,-1.3004062,36.829741,855,806,363,965
8251,13793,1882,3,Business,4,1,29332,4,1,29348,4,1,29693,4,1,31507,4,1,32550,6,22.0,-1.2958783,36.7928125,-1.2588775,36.8079744,715,1043,16,2159
8252,9915,1471,3,Business,30,2,40372,30,2,41036,30,2,41840,30,2,42064,30,2,45529,17,23.25888921888938,-1.2551895,36.7822034,-1.3323949,36.8915219,96,3465,664,1028
8253,16880,2801,3,Business,4,1,29343,4,1,30968,4,1,31589,4,1,31651,4,1,33972,9,22.1,-1.2595422,36.7871178,-1.307726,36.839117,452,2321,1625,683
8254,8271,1500,3,Business,27,6,30260,27,6,30333,27,6,33073,27,6,33149,27,6,34921,8,23.25888921888938,-1.3004062,36.829741,-1.2638185,36.7930057,309,1772,73,2816
8255,2465,1959,3,Business,2,2,51835,2,2,51932,2,2,52606,2,2,57693,2,2,60156,10,29.5,-1.2551895,36.7822034,-1.2664227,36.7453671,850,2463,97,5761
8256,2003,2436,3,Business,31,5,63606,31,5,63633,31,5,63918,31,5,64625,31,5,67619,18,19.7,-1.2551895,36.7822034,-1.2198413,36.9054958,720,2994,27,992
8257,19692,909,3,Business,24,3,56555,24,3,56580,24,3,57894,24,3,58468,24,3,60067,14,23.25888921888938,-1.225322,36.80855,-1.2413316,36.8785525,607,1599,25,1888
8258,9672,63,2,Personal,2,7,57318,2,7,59509,2,7,60212,2,7,60757,2,7,65431,14,23.25888921888938,-1.2647469,36.8157706,-1.2846933,36.9059033,654,4674,2191,1248
8259,11028,435,3,Business,14,5,51931,14,5,51991,14,5,53325,14,5,53885,14,5,56772,16,23.2,-1.300921,36.828195,-1.2094552,36.8073286,149,2887,60,1894
8260,26671,1721,3,Business,23,2,42233,23,2,42250,23,2,42386,23,2,42830,23,2,43403,4,23.25888921888938,-1.2551895,36.7822034,-1.2728947,36.8079426,438,573,17,580
8261,18880,457,3,Personal,11,1,56112,11,1,56124,11,1,56308,11,1,56537,11,1,57136,6,27.9,-1.2985749,36.8088,-1.2697893,36.8124106,250,599,12,413
8262,14130,635,3,Business,3,5,41010,3,5,41428,3,5,43926,3,5,46784,3,5,48521,9,23.25888921888938,-1.300921,36.828195,-1.2708331,36.7904193,292,1737,418,5356
8263,17176,1245,3,Business,15,5,55437,15,5,55479,15,5,55488,15,5,57648,15,5,60197,18,18.0,-1.300921,36.828195,-1.3090489,36.7065907,267,2549,42,2169
8264,21579,1527,3,Business,28,2,42265,28,2,42290,28,2,42297,28,2,42817,28,2,43812,9,21.3,-1.2638185,36.7930057,-1.3004062,36.829741,576,995,25,527
8265,23535,2523,3,Business,6,4,50617,6,4,50660,6,4,51570,6,4,51843,6,4,52197,3,21.1,-1.2551895,36.7822034,-1.2560455,36.7800867,570,354,43,1183
8266,8220,1557,3,Business,28,5,37873,28,5,38656,28,5,39094,28,5,39778,28,5,41666,5,25.0,-1.3147074,36.811722,-1.3054934,36.8042267,713,1888,783,1122
8267,6089,1469,3,Business,13,3,57427,13,3,57540,13,3,57821,13,3,58148,13,3,60061,7,29.3,-1.2551895,36.7822034,-1.2995738,36.8199719,276,1913,113,608
8268,21342,3426,3,Business,12,6,50911,12,6,50926,12,6,51623,12,6,51767,12,6,53189,9,24.9,-1.3012008,36.764868,-1.2594539,36.8067841,817,1422,15,841
8269,623,1402,3,Business,21,4,51932,21,4,52015,21,4,53210,21,4,54369,21,4,54914,1,31.2,-1.2793686,36.8259233,-1.2813012,36.8323962,61,545,83,2354
8270,21186,3470,3,Business,29,4,42560,29,4,44443,29,4,46162,29,4,48112,29,4,48942,2,21.3,-1.290894,36.822971,-1.28878,36.8168312,362,830,1883,3669
8271,14183,2542,3,Personal,30,6,45203,30,6,46017,30,6,47609,30,6,48874,30,6,52688,5,23.9,-1.2883158,36.8199114,-1.2899816,36.7846439,95,3814,814,2857
8272,23058,2271,3,Business,18,1,47308,18,1,47344,18,1,48233,18,1,49258,18,1,50983,11,30.9,-1.228911,36.881876,-1.293515,36.897607,75,1725,36,1914
8273,23297,1329,3,Business,28,2,44431,28,2,44465,28,2,45550,28,2,45682,28,2,46800,6,21.1,-1.311452,36.82182,-1.273056,36.811298,591,1118,34,1217
8274,12320,1162,3,Business,8,5,48765,8,5,49662,8,5,50374,8,5,51414,8,5,53368,8,27.1,-1.2618811,36.8041786,-1.312261,36.794658,953,1954,897,1752
8275,1458,265,3,Business,15,5,49564,15,5,50418,15,5,52366,15,5,52696,15,5,55312,7,28.0,-1.2642978,36.819261,-1.300921,36.828195,611,2616,854,2278
8276,2460,2523,3,Business,5,2,43276,5,2,43302,5,2,43778,5,2,44062,5,2,47154,28,25.6,-1.2551895,36.7822034,-1.1429062,36.9300994,154,3092,26,760
8277,27650,3647,3,Business,31,4,46263,31,4,46563,31,4,47052,31,4,47478,31,4,48337,8,26.5,-1.272639,36.794723,-1.2698168,36.7421898,247,859,300,915
8278,7859,517,3,Business,4,5,37488,4,5,40359,4,5,40492,4,5,41105,4,5,41549,4,17.3,-1.3167113,36.8301563,-1.3004062,36.829741,523,444,2871,746
8279,6037,136,3,Business,1,3,63495,1,3,63522,1,3,64437,1,3,64652,1,3,66970,16,23.5,-1.3326173,36.7146233,-1.2649605,36.7981777,334,2318,27,1130
8280,3317,633,3,Business,26,2,54214,26,2,54261,26,2,55180,26,2,55517,26,2,57276,12,30.8,-1.2991441,36.7528804,-1.3004062,36.829741,306,1759,47,1256
8281,18853,1145,2,Personal,11,3,61747,11,3,62124,11,3,62644,11,3,63282,11,3,64720,14,20.0,-1.2934657,36.8212737,-1.2061844,36.7922321,629,1438,377,1158
8282,22490,2987,3,Business,5,1,50775,5,1,51600,5,1,52037,5,1,52163,5,1,53119,7,26.1,-1.270212,36.8210877,-1.3043821,36.7840586,551,956,825,563
8283,23795,2587,3,Business,10,6,42838,10,6,42994,10,6,44057,10,6,47142,10,6,47146,16,23.8,-1.207546,36.7913976,-1.28878,36.8168312,928,4,156,4148
8284,12023,1402,3,Business,6,3,39639,6,3,39890,6,3,41235,6,3,41568,6,3,42939,6,22.3,-1.2571472,36.7950633,-1.2813012,36.8323962,679,1371,251,1678
8285,10723,3283,3,Business,16,1,49922,16,1,50027,16,1,51826,16,1,52595,16,1,53583,5,22.6,-1.2600926,36.8088685,-1.2628473,36.781805,951,988,105,2568
8286,11416,3194,3,Business,4,2,53591,4,2,56515,4,2,56874,4,2,58026,4,2,61229,4,20.3,-1.2571472,36.7950633,-1.28164,36.816867,651,3203,2924,1511
8287,27676,1934,2,Personal,20,6,39869,20,6,39901,20,6,40073,20,6,40442,20,6,41489,9,25.4,-1.304033,36.7848695,-1.2502923,36.7887568,917,1047,32,541
8288,25250,393,3,Business,21,4,43378,21,4,43386,21,4,43390,21,4,45658,21,4,45660,14,25.2,-1.3167113,36.8301563,-1.306378,36.7519845,619,2,8,2272
8289,742,3599,3,Business,6,1,38252,6,1,40680,6,1,41008,6,1,41659,6,1,43579,14,23.25888921888938,-1.3302996,36.8707935,-1.2868736,36.7805882,581,1920,2428,979
8290,26569,1402,3,Business,18,6,36411,18,6,36435,18,6,37835,18,6,38171,18,6,41109,12,21.4,-1.2242729,36.8880921,-1.2813012,36.8323962,158,2938,24,1736
8291,18327,3420,3,Business,13,3,55683,13,3,55718,13,3,55796,13,3,55862,13,3,59000,6,27.2,-1.3046007,36.8211743,-1.265981,36.7936121,143,3138,35,144
8292,1170,640,3,Business,18,4,58127,18,4,58375,18,4,59439,18,4,59976,18,4,61187,5,23.25888921888938,-1.2969741,36.7856612,-1.296965,36.8065678,177,1211,248,1601
8293,25346,136,3,Business,4,2,42508,4,2,42532,4,2,42849,4,2,43476,4,2,44770,4,20.7,-1.2965045,36.7913036,-1.3009676,36.7657189,155,1294,24,944
8294,27787,3147,3,Business,31,3,47324,31,3,47361,31,3,47639,31,3,48633,31,3,49849,10,24.8,-1.3169591,36.7000029,-1.3472066,36.7692638,24,1216,37,1272
8295,17012,1207,3,Business,10,1,72769,10,1,72837,10,1,72955,10,1,74195,10,1,76913,13,16.7,-1.2629666,36.8068369,-1.2162532,36.7095449,907,2718,68,1358
8296,2048,1849,3,Business,30,5,39572,30,5,42834,30,5,43639,30,5,44663,30,5,48378,5,23.8,-1.290894,36.822971,-1.2836583,36.7886014,101,3715,3262,1829
8297,23054,198,3,Business,25,1,43758,25,1,43787,25,1,44192,25,1,44442,25,1,47035,13,25.6,-1.3091799,36.8313272,-1.3396256,36.8863135,26,2593,29,655
8298,11510,3106,1,Personal,22,5,33518,22,5,33528,22,5,34909,22,5,35400,22,5,38654,22,16.5,-1.276312,36.882742,-1.1850563,36.768693,549,3254,10,1872
8299,4394,1172,3,Personal,29,3,42415,29,3,42475,29,3,43146,29,3,43583,29,3,44809,8,23.25888921888938,-1.32256,36.8396386,-1.2922364,36.7895538,99,1226,60,1108
8300,3103,3291,3,Business,30,4,43608,30,4,43656,30,4,44255,30,4,44741,30,4,45672,4,23.25888921888938,-1.2663631,36.8163329,-1.2600926,36.8088685,245,931,48,1085
8301,12521,3647,3,Business,5,5,34539,5,5,34631,5,5,35468,5,5,35917,5,5,39799,4,19.6,-1.272639,36.794723,-1.2760462,36.8074697,155,3882,92,1286
8302,4351,71,3,Business,24,1,63878,24,1,63975,24,1,64976,24,1,65254,24,1,66761,9,24.7,-1.2891922,36.825189,-1.3014461,36.7661381,263,1507,97,1279
8303,20570,868,3,Business,15,4,51881,15,4,54975,15,4,55983,15,4,56169,15,4,57363,8,27.7,-1.303596,36.778378,-1.265715,36.823815,343,1194,3094,1194
8304,12439,1329,3,Business,16,6,37838,16,6,37886,16,6,38126,16,6,38386,16,6,39958,8,25.9,-1.273056,36.811298,-1.2949439,36.7604214,25,1572,48,500
8305,650,3226,3,Personal,14,2,38538,14,2,38555,14,2,38952,14,2,39735,14,2,40383,8,21.4,-1.2669026,36.8445273,-1.2567464,36.7915273,414,648,17,1180
8306,6868,3470,3,Business,29,4,40720,29,4,42205,29,4,42971,29,4,43674,29,4,45787,5,21.4,-1.2584143,36.8048002,-1.28878,36.8168312,539,2113,1485,1469
8307,3613,914,3,Business,6,2,53193,6,2,53211,6,2,53959,6,2,54375,6,2,55205,3,27.6,-1.2670213,36.7994482,-1.2630521,36.8068019,503,830,18,1164
8308,3816,286,3,Business,30,5,57133,30,5,57178,30,5,57834,30,5,58153,30,5,61700,24,24.7,-1.2551895,36.7822034,-1.364732,36.658943,205,3547,45,975
8309,7168,3291,3,Business,8,5,46369,8,5,46858,8,5,47070,8,5,48132,8,5,49595,12,23.25888921888938,-1.331619,36.847976,-1.2600926,36.8088685,312,1463,489,1274
8310,6904,633,3,Business,5,3,47696,5,3,53362,5,3,54269,5,3,56051,5,3,57221,9,24.9,-1.2574219,36.7927073,-1.3004062,36.829741,523,1170,5666,2689
8311,12649,3686,3,Business,8,4,57772,8,4,57813,8,4,58337,8,4,58653,8,4,59079,3,27.5,-1.2551895,36.7822034,-1.25537,36.7756,620,426,41,840
8312,2225,1357,1,Personal,17,5,47062,17,5,47256,17,5,47527,17,5,48006,17,5,48838,5,17.4,-1.2663525,36.8128337,-1.2897215,36.7945959,857,832,194,750
8313,26430,1075,3,Business,7,2,39158,7,2,39200,7,2,39367,7,2,39922,7,2,41575,7,23.25888921888938,-1.2527958,36.8003131,-1.3012173,36.8093987,575,1653,42,722
8314,11976,2691,3,Business,30,2,37646,30,2,37781,30,2,38858,30,2,39798,30,2,41074,8,23.25888921888938,-1.2551895,36.7822034,-1.2857671,36.7875614,57,1276,135,2017
8315,24414,3452,2,Personal,24,1,63108,24,1,63116,24,1,63752,24,1,64315,24,1,66484,11,24.7,-1.3196809,36.8410572,-1.308217,36.77413,857,2169,8,1199
8316,17572,1724,3,Business,23,2,37291,23,2,38221,23,2,39380,23,2,39712,23,2,41318,9,18.1,-1.303976,36.8159211,-1.2551895,36.7822034,662,1606,930,1491
8317,8708,633,3,Business,15,5,38399,15,5,38464,15,5,38908,15,5,39086,15,5,39598,4,26.5,-1.3077869,36.8443207,-1.3004062,36.829741,289,512,65,622
8318,19016,2763,3,Business,8,5,33665,8,5,33760,8,5,34259,8,5,34719,8,5,37826,14,20.7,-1.2551895,36.7822034,-1.3015998,36.8764939,937,3107,95,959
8319,11556,3030,3,Business,24,5,42504,24,5,43084,24,5,43673,24,5,45404,24,5,46029,5,20.9,-1.263441,36.840808,-1.2866012,36.8195691,229,625,580,2320
8320,22398,3495,1,Personal,26,4,53423,26,4,53447,26,4,53984,26,4,54182,26,4,54651,3,22.2,-1.2866305,36.7754914,-1.2765492,36.7669809,844,469,24,735
8321,21735,3599,3,Business,28,4,51977,28,4,52001,28,4,53721,28,4,55157,28,4,56835,7,27.5,-1.3302996,36.8707935,-1.3094481,36.8652486,218,1678,24,3156
8322,8698,1976,3,Business,23,5,52221,23,5,53992,23,5,54324,23,5,54593,23,5,56040,16,26.3,-1.257028,36.7810435,-1.2230709,36.8374011,38,1447,1771,601
8323,10930,635,3,Business,21,1,53928,21,1,53964,21,1,54579,21,1,55501,21,1,56883,8,27.6,-1.3081376,36.8329772,-1.2602337,36.7990548,674,1382,36,1537
8324,11950,1882,3,Business,3,4,49346,3,4,51606,3,4,52385,3,4,52616,3,4,53664,7,25.8,-1.2273427,36.7994683,-1.26307,36.796969,26,1048,2260,1010
8325,14782,2900,3,Business,18,3,70609,18,3,70621,18,3,70681,18,3,70912,18,3,72562,14,16.9,-1.296797,36.7764525,-1.3711733,36.7319722,813,1650,12,291
8326,24312,3498,2,Personal,5,3,49930,5,3,49970,5,3,52476,5,3,53072,5,3,53609,5,23.7,-1.2753902,36.808223,-1.2551895,36.7822034,795,537,40,3102
8327,7268,867,3,Business,15,5,33102,15,5,34314,15,5,34333,15,5,36135,15,5,36349,11,19.0,-1.2770708,36.8231093,-1.2991441,36.7528804,472,214,1212,1821
8328,388,2008,3,Business,14,3,54691,14,3,54717,14,3,55429,14,3,56681,14,3,58892,16,25.6,-1.2508229,36.7895263,-1.33924,36.7607362,764,2211,26,1964
8329,13797,1927,3,Business,12,2,41344,12,2,41406,12,2,43746,12,2,44394,12,2,45681,9,24.4,-1.3014461,36.7661381,-1.3472066,36.7692638,800,1287,62,2988
8330,6633,3307,3,Personal,29,1,36768,29,1,36794,29,1,37315,29,1,37633,29,1,38266,4,23.25888921888938,-1.30983,36.819618,-1.2933302,36.8298015,343,633,26,839
8331,23764,1352,3,Personal,8,1,31841,8,1,32408,8,1,33014,8,1,33477,8,1,34347,4,19.8,-1.2655306,36.828148,-1.2753109,36.8130185,932,870,567,1069
8332,8372,3735,1,Personal,21,5,51497,21,5,51580,21,5,53410,21,5,54214,21,5,55352,7,27.1,-1.2886771,36.8735531,-1.3296282,36.8580804,532,1138,83,2634
8333,9502,2804,3,Business,30,2,55022,30,2,55404,30,2,55597,30,2,57511,30,2,57650,3,23.25888921888938,-1.2571472,36.7950633,-1.2657469,36.8028228,206,139,382,2107
8334,5311,635,3,Business,6,6,35441,6,6,35582,6,6,36102,6,6,37909,6,6,39182,10,19.9,-1.3081376,36.8329772,-1.2602337,36.7990548,760,1273,141,2327
8335,11801,3318,3,Business,24,3,41968,24,3,42036,24,3,42922,24,3,43070,24,3,43080,4,23.25888921888938,-1.3004062,36.829741,-1.2825816,36.8092346,19,10,68,1034
8336,24532,3660,1,Personal,11,2,56179,11,2,56409,11,2,57505,11,2,57783,11,2,58604,4,25.6,-1.2833335,36.8260084,-1.292163,36.8000995,338,821,230,1374
8337,7373,346,3,Business,29,2,47860,29,2,47953,29,2,48100,29,2,49107,29,2,49199,2,27.2,-1.290894,36.822971,-1.28878,36.8168312,828,92,93,1154
8338,11841,3606,3,Business,25,2,41932,25,2,41998,25,2,42707,25,2,42970,25,2,44522,6,24.0,-1.291623,36.81421,-1.2628638,36.8070399,88,1552,66,972
8339,23899,255,2,Personal,11,4,57819,11,4,57847,11,4,58389,11,4,58777,11,4,59944,5,26.7,-1.3014461,36.7661381,-1.2694398,36.7624483,328,1167,28,930
8340,6853,1994,3,Business,10,1,42338,10,1,43663,10,1,44236,10,1,44347,10,1,45355,7,18.5,-1.3031412,36.7610533,-1.288167,36.8181484,344,1008,1325,684
8341,8612,1304,3,Business,26,5,35485,26,5,36402,26,5,36848,26,5,37091,26,5,39151,10,23.25888921888938,-1.2551895,36.7822034,-1.2304909,36.821691,519,2060,917,689
8342,16323,478,3,Business,2,2,40082,2,2,40713,2,2,43587,2,2,44562,2,2,47271,4,26.1,-1.2844516,36.8245932,-1.2571472,36.7950633,819,2709,631,3849
8343,1636,1721,3,Business,24,1,34387,24,1,34413,24,1,35210,24,1,35710,24,1,36633,8,15.8,-1.2551895,36.7822034,-1.287428,36.7800821,881,923,26,1297
8344,27252,3222,3,Business,8,5,51785,8,5,51875,8,5,52812,8,5,53429,8,5,56291,8,30.5,-1.2551895,36.7822034,-1.2985749,36.8088,76,2862,90,1554
8345,27081,510,3,Business,19,6,39862,19,6,39906,19,6,40846,19,6,41163,19,6,43662,11,25.2,-1.2885029,36.825605,-1.2860183,36.8975338,456,2499,44,1257
8346,7196,1787,3,Business,12,2,47763,12,2,47857,12,2,48563,12,2,49349,12,2,56125,11,23.25888921888938,-1.2789477,36.8122359,-1.2283403,36.8822756,267,6776,94,1492
8347,23320,517,3,Business,27,4,38904,27,4,41724,27,4,41980,27,4,42786,27,4,43676,4,23.1,-1.3167113,36.8301563,-1.3004062,36.829741,523,890,2820,1062
8348,24613,960,1,Personal,4,2,48741,4,2,48825,4,2,48836,4,2,49872,4,2,51581,16,20.5,-1.26467,36.778734,-1.3287648,36.7445732,874,1709,84,1047
8349,8982,1710,3,Personal,15,2,38591,15,2,38604,15,2,38650,15,2,39120,15,2,40072,5,24.1,-1.2963097,36.7688221,-1.2950041,36.8143583,958,952,13,516
8350,23398,3560,3,Business,24,1,49712,24,1,49760,24,1,50887,24,1,51048,24,1,52251,2,24.7,-1.279395,36.825364,-1.281754,36.8324229,362,1203,48,1288
8351,3370,1724,3,Business,23,2,45377,23,2,45417,23,2,45463,23,2,45846,23,2,47096,4,23.25888921888938,-1.2551895,36.7822034,-1.2728058,36.8049903,422,1250,40,429
8352,5313,391,3,Business,19,1,44283,19,1,45279,19,1,46691,19,1,46838,19,1,50170,20,24.5,-1.319613,36.711055,-1.2867454,36.8259017,250,3332,996,1559
8353,22503,2066,3,Business,18,1,43566,18,1,43613,18,1,44382,18,1,44660,18,1,46210,11,26.7,-1.3210189,36.8410551,-1.3124537,36.925365,675,1550,47,1047
8354,22827,1225,2,Personal,19,2,31715,19,2,32471,19,2,32611,19,2,33249,19,2,34637,9,15.2,-1.2551895,36.7822034,-1.2951297,36.8335521,726,1388,756,778
8355,4480,733,3,Business,3,1,42311,3,1,42347,3,1,42753,3,1,42950,3,1,43518,4,21.4,-1.2551895,36.7822034,-1.2638801,36.7715842,167,568,36,603
8356,17228,972,3,Business,4,2,38085,4,2,39830,4,2,41061,4,2,41128,4,2,42335,4,19.5,-1.2862033,36.8152966,-1.3084722,36.8224665,88,1207,1745,1298
8357,22320,2788,2,Personal,16,1,38138,16,1,38283,16,1,39781,16,1,40032,16,1,40875,3,19.5,-1.2856017,36.8129897,-1.293973,36.80169,848,843,145,1749
8358,1539,496,3,Business,27,5,57415,27,5,57576,27,5,59699,27,5,59967,27,5,60987,8,17.7,-1.2551895,36.7822034,-1.2994217,36.8009779,616,1020,161,2391
8359,6952,3149,3,Business,1,5,45410,1,5,46011,1,5,46418,1,5,46487,1,5,47189,7,26.3,-1.3077869,36.8443207,-1.3167113,36.8301563,576,702,601,476
8360,7892,3372,3,Business,6,5,33184,6,5,33213,6,5,34246,6,5,34529,6,5,34892,2,15.0,-1.2901638,36.7787225,-1.304033,36.7848695,116,363,29,1316
8361,7438,1075,3,Business,3,5,47602,3,5,47622,3,5,49891,3,5,50214,3,5,50532,1,23.25888921888938,-1.2649605,36.7981777,-1.2527958,36.8003131,106,318,20,2592
8362,26848,2105,1,Personal,23,1,47474,23,1,47481,23,1,48109,23,1,48549,23,1,49607,8,18.6,-1.2463211,36.789487,-1.2883829,36.8177296,144,1058,7,1068
8363,18014,1500,3,Business,25,1,29619,25,1,29636,25,1,31616,25,1,31844,25,1,33337,10,21.2,-1.2991441,36.7528804,-1.2638185,36.7930057,831,1493,17,2208
8364,5101,60,3,Business,12,1,55444,12,1,56454,12,1,58073,12,1,58224,12,1,61638,12,26.9,-1.307143,36.825009,-1.2296618,36.8438272,633,3414,1010,1770
8365,626,887,2,Personal,24,4,58705,24,4,58754,24,4,59432,24,4,59814,24,4,60631,4,21.1,-1.2606381,36.8028749,-1.2595422,36.7871178,147,817,49,1060
8366,7870,540,3,Business,10,1,35451,10,1,36107,10,1,36117,10,1,36495,10,1,38003,7,18.4,-1.2551895,36.7822034,-1.289498,36.818878,268,1508,656,388
8367,6956,391,3,Business,23,2,33597,23,2,33639,23,2,34140,23,2,37530,23,2,37534,5,23.25888921888938,-1.300921,36.828195,-1.2784063,36.8222933,613,4,42,3891
8368,5622,2124,1,Personal,12,2,36946,12,2,37196,12,2,37502,12,2,37983,12,2,39221,10,21.0,-1.2655477,36.8001682,-1.2379585,36.875789,820,1238,250,787
8369,20621,2509,3,Business,28,4,46908,28,4,47026,28,4,48592,28,4,49433,28,4,50780,6,27.4,-1.2571472,36.7950633,-1.2933789,36.8087535,177,1347,118,2407
8370,16490,3175,3,Business,8,5,52818,8,5,53061,8,5,53576,8,5,53750,8,5,56885,15,21.3,-1.2612417,36.7958868,-1.3169591,36.7000029,474,3135,243,689
8371,20004,2008,3,Business,8,3,41134,8,3,41234,8,3,42109,8,3,42385,8,3,43735,10,23.25888921888938,-1.2921818,36.8101931,-1.2508229,36.7895263,831,1350,100,1151
8372,22020,822,1,Personal,18,5,31846,18,5,32005,18,5,32629,18,5,32792,18,5,33968,8,17.8,-1.3039425,36.7855361,-1.269534,36.80697,449,1176,159,787
8373,25391,2212,3,Business,11,1,51519,11,1,51628,11,1,51666,11,1,52090,11,1,54012,14,28.1,-1.2571472,36.7950633,-1.3291155,36.8861,293,1922,109,462
8374,27687,1011,1,Personal,1,1,42236,1,1,42242,1,1,42346,1,1,43784,1,1,45126,10,24.2,-1.2915307,36.7905865,-1.2321733,36.7974377,648,1342,6,1542
8375,5138,1500,3,Business,7,5,46080,7,5,46219,7,5,46632,7,5,47237,7,5,48416,8,23.25888921888938,-1.3004062,36.829741,-1.2638185,36.7930057,36,1179,139,1018
8376,20931,1667,3,Business,22,5,54052,22,5,54343,22,5,55339,22,5,56760,22,5,58192,6,27.4,-1.2624531,36.8228476,-1.2908945,36.8246514,21,1432,291,2417
8377,11825,2044,2,Personal,5,6,62814,5,6,62848,5,6,63844,5,6,64213,5,6,64550,1,22.6,-1.2615584,36.8149506,-1.2517392,36.8249608,56,337,34,1365
8378,20903,984,1,Personal,5,6,43659,5,6,43702,5,6,44574,5,6,45613,5,6,46585,8,22.2,-1.3021315,36.8215557,-1.2659149,36.8054322,543,972,43,1911
8379,11952,843,3,Personal,13,4,36165,13,4,36183,13,4,36282,13,4,36644,13,4,37290,8,18.0,-1.300722,36.7882234,-1.2652279,36.8020159,216,646,18,461
8380,8898,2041,1,Business,5,2,56597,5,2,56633,5,2,56701,5,2,56954,5,2,56959,3,22.9,-1.290894,36.822971,-1.2677588,36.8169359,586,5,36,321
8381,19879,2174,3,Business,21,3,38241,21,3,38249,21,3,38477,21,3,39195,21,3,40476,10,22.0,-1.2482781,36.884092,-1.2782261,36.8225009,307,1281,8,946
8382,3020,2658,3,Business,1,1,77283,1,1,77314,1,1,77394,1,1,78183,1,1,80340,11,23.4,-1.2963097,36.7688221,-1.25843,36.69036,202,2157,31,869
8383,25061,3711,3,Business,24,4,64317,24,4,64351,24,4,64913,24,4,65372,24,4,67421,3,26.1,-1.3012008,36.764868,-1.2765492,36.7669809,246,2049,34,1021
8384,17457,627,3,Business,1,3,37669,1,3,37679,1,3,37897,1,3,38475,1,3,39908,6,19.7,-1.2571472,36.7950633,-1.3001813,36.811122,882,1433,10,796
8385,16886,647,3,Business,15,1,58120,15,1,58437,15,1,59339,15,1,60142,15,1,61447,12,23.25888921888938,-1.2991441,36.7528804,-1.3004062,36.829741,678,1305,317,1705
8386,16643,1268,1,Personal,23,4,53427,23,4,53450,23,4,54448,23,4,54617,23,4,55918,9,20.6,-1.293554,36.763113,-1.2983805,36.8198439,465,1301,23,1167
8387,21829,3647,3,Business,31,4,46834,31,4,46916,31,4,47896,31,4,48486,31,4,49714,10,26.5,-1.272639,36.794723,-1.3231001,36.8283559,267,1228,82,1570
8388,22766,3291,3,Business,11,6,33573,11,6,33592,11,6,34179,11,6,34655,11,6,35670,4,23.25888921888938,-1.272828,36.816608,-1.2600926,36.8088685,309,1015,19,1063
8389,11779,3147,3,Business,19,1,53227,19,1,53245,19,1,53505,19,1,53717,19,1,55949,15,25.0,-1.3472066,36.7692638,-1.2591019,36.800577,519,2232,18,472
8390,13344,1259,2,Business,8,1,35846,8,1,35858,8,1,37147,8,1,37771,8,1,41059,25,19.8,-1.2359565,36.7622728,-1.3478563,36.8935824,865,3288,12,1913
8391,23003,2208,2,Personal,31,2,39772,31,2,39830,31,2,40480,31,2,43016,31,2,44485,3,18.5,-1.2738167,36.8157821,-1.2874292,36.823314,882,1469,58,3186
8392,20342,3291,3,Business,23,2,48234,23,2,48247,23,2,48548,23,2,49352,23,2,51763,5,23.25888921888938,-1.2628473,36.781805,-1.2600926,36.8088685,695,2411,13,1105
8393,6380,2436,3,Business,4,1,51392,4,1,51413,4,1,52538,4,1,52747,4,1,53638,5,23.25888921888938,-1.2551895,36.7822034,-1.2696908,36.81519,147,891,21,1334
8394,50,3218,3,Business,23,3,59811,23,3,61924,23,3,62426,23,3,64474,23,3,66196,16,20.6,-1.3404187,36.7614685,-1.2765736,36.8513646,478,1722,2113,2550
8395,24170,1329,3,Business,6,4,36642,6,4,36697,6,4,37388,6,4,37855,6,4,40081,18,19.0,-1.273056,36.811298,-1.3189979,36.7104076,222,2226,55,1158
8396,15237,2801,3,Business,10,3,39143,10,3,39174,10,3,40276,10,3,41237,10,3,44475,15,27.9,-1.3104506,36.8687235,-1.2595422,36.7871178,218,3238,31,2063
8397,6167,939,2,Personal,17,5,59365,17,5,59377,17,5,59818,17,5,60650,17,5,63069,13,19.2,-1.3254094,36.7084902,-1.277783,36.7816464,858,2419,12,1273
8398,8514,2330,3,Business,27,1,37285,27,1,37330,27,1,37453,27,1,37535,27,1,38934,9,18.1,-1.3015197,36.7658456,-1.2645318,36.7981775,344,1399,45,205
8399,16070,559,3,Personal,10,2,42191,10,2,42404,10,2,43129,10,2,43460,10,2,44870,8,20.2,-1.2668071,36.8068157,-1.3117439,36.8108257,937,1410,213,1056
8400,4562,2451,1,Personal,23,6,46379,23,6,46477,23,6,47071,23,6,47919,23,6,49132,4,23.25888921888938,-1.2795261,36.8260185,-1.3034072,36.8218035,531,1213,98,1442
8401,19876,971,1,Personal,6,4,58607,6,4,58629,6,4,59676,6,4,59918,6,4,62203,11,22.4,-1.3193233,36.840991,-1.257309,36.8060084,548,2285,22,1289
8402,11700,393,3,Business,13,4,50471,13,4,50503,13,4,51142,13,4,52034,13,4,52754,4,23.0,-1.3228003,36.8306435,-1.3004062,36.829741,538,720,32,1531
8403,27445,3234,1,Business,15,6,61551,15,6,63186,15,6,63747,15,6,66179,15,6,67205,8,24.9,-1.3196809,36.8410572,-1.2977387,36.8031447,539,1026,1635,2993
8404,25553,2803,3,Business,6,1,39831,6,1,39887,6,1,40619,6,1,41169,6,1,43030,5,20.4,-1.2765736,36.8513646,-1.2951169,36.823896,700,1861,56,1282
8405,21952,186,3,Business,31,5,59605,31,5,60747,31,5,61658,31,5,62514,31,5,64632,4,23.7,-1.2571472,36.7950633,-1.2825816,36.8092346,582,2118,1142,1767
8406,5985,2195,3,Business,16,7,38232,16,7,38302,16,7,40386,16,7,40506,16,7,41934,12,21.3,-1.2600926,36.8088685,-1.228911,36.881876,201,1428,70,2204
8407,2476,2260,1,Personal,19,5,58376,19,5,58579,19,5,59434,19,5,59961,19,5,61858,7,24.5,-1.2562797,36.8075858,-1.2981352,36.8213822,432,1897,203,1382
8408,5397,3291,3,Business,2,2,43271,2,2,43640,2,2,44747,2,2,45280,2,2,46354,5,26.3,-1.2783849,36.8163445,-1.2600926,36.8088685,907,1074,369,1640
8409,12462,391,3,Business,25,5,52841,25,5,53092,25,5,53588,25,5,56116,25,5,56302,7,29.2,-1.300921,36.828195,-1.2908072,36.7860517,925,186,251,3024
8410,14575,1075,3,Business,28,1,49581,28,1,49602,28,1,50159,28,1,50366,28,1,52153,15,26.3,-1.2156006,36.8916865,-1.2534301,36.8000983,691,1787,21,764
8411,8026,2200,3,Business,28,5,60065,28,5,60115,28,5,60740,28,5,61371,28,5,62025,2,23.25888921888938,-1.279395,36.825364,-1.290894,36.822971,532,654,50,1256
8412,26161,136,3,Business,9,4,45392,9,4,45481,9,4,45816,9,4,46275,9,4,47880,17,23.25888921888938,-1.2531983,36.8069669,-1.3254522,36.7216584,438,1605,89,794
8413,15512,1578,3,Business,4,4,39973,4,4,40138,4,4,42065,4,4,42587,4,4,44279,10,23.25888921888938,-1.225322,36.80855,-1.28878,36.8168312,532,1692,165,2449
8414,7820,393,3,Business,14,4,31801,14,4,31817,14,4,31823,14,4,32852,14,4,34097,11,19.1,-1.3167113,36.8301563,-1.2638185,36.7930057,111,1245,16,1035
8415,20062,2079,3,Personal,30,3,38645,30,3,38693,30,3,40939,30,3,41806,30,3,45449,21,24.8,-1.333148,36.922453,-1.2681004,36.7952081,404,3643,48,3113
8416,25987,1882,3,Business,3,3,67473,3,3,67514,3,3,68035,3,3,69205,3,3,70328,8,23.7,-1.2268871,36.8073946,-1.2591019,36.800577,257,1123,41,1691
8417,27491,3077,3,Business,7,4,35908,7,4,37453,7,4,38920,7,4,39386,7,4,41129,14,16.9,-1.2241193,36.88199198,-1.2672588,36.8000252,900,1743,1545,1933
8418,19093,1890,1,Personal,29,2,28999,29,2,29556,29,2,30274,29,2,31099,29,2,33038,21,16.5,-1.3855778,36.9269619,-1.276312,36.882742,932,1939,557,1543
8419,24276,2159,3,Business,22,2,46959,22,2,47013,22,2,47778,22,2,48057,22,2,50492,6,19.3,-1.304735,36.7846054,-1.2953659,36.8249462,680,2435,54,1044
8420,3071,867,3,Business,24,3,41453,24,3,41662,24,3,42714,24,3,43165,24,3,45316,10,23.25888921888938,-1.2996533,36.8292629,-1.2991441,36.7528804,448,2151,209,1503
8421,27764,496,3,Business,26,5,60778,26,5,64360,26,5,64836,26,5,65031,26,5,66656,9,23.25888921888938,-1.2551895,36.7822034,-1.2976559,36.7914147,336,1625,3582,671
8422,8921,3356,3,Business,3,1,46027,3,1,46050,3,1,47932,3,1,48002,3,1,50057,19,21.3,-1.2036664,36.8192622,-1.2973364,36.7916296,7,2055,23,1952
8423,3110,3599,3,Business,20,1,52276,20,1,52292,20,1,54569,20,1,55315,20,1,58899,14,23.25888921888938,-1.3302996,36.8707935,-1.2825952,36.7871705,675,3584,16,3023
8424,2168,269,3,Business,30,3,55760,30,3,58317,30,3,59069,30,3,59246,30,3,62109,10,25.2,-1.3332749,36.8708147,-1.2810586,36.8838294,742,2863,2557,929
8425,20744,3355,3,Business,24,2,40825,24,2,40872,24,2,41886,24,2,42121,24,2,43066,6,17.4,-1.2765736,36.8513646,-1.3052491,36.8223899,174,945,47,1249
8426,25428,3186,3,Business,13,4,34308,13,4,34364,13,4,35044,13,4,35302,13,4,36391,5,18.3,-1.2854406,36.789409,-1.2981352,36.8213822,176,1089,56,938
8427,26217,1557,3,Business,26,4,36732,26,4,37312,26,4,39217,26,4,39980,26,4,41309,10,19.0,-1.3147074,36.811722,-1.3038645,36.8684596,101,1329,580,2668
8428,19781,1500,3,Business,29,4,59430,29,4,61506,29,4,62493,29,4,62563,29,4,64535,10,21.0,-1.2991441,36.7528804,-1.2574219,36.7927073,523,1972,2076,1057
8429,2400,2658,3,Business,10,1,54637,10,1,56067,10,1,56072,10,1,56962,10,1,58886,7,18.2,-1.2924639,36.7795798,-1.2813012,36.8323962,89,1924,1430,895
8430,8562,878,1,Personal,2,3,49340,2,3,50048,2,3,51399,2,3,51492,2,3,54077,12,23.3,-1.2859912,36.8756811,-1.3041129,36.8104939,900,2585,708,1444
8431,4316,111,3,Business,2,3,42627,2,3,42642,2,3,42653,2,3,43023,2,3,45132,18,24.2,-1.2551895,36.7822034,-1.319048,36.8943118,518,2109,15,381
8432,21182,3567,3,Business,28,2,37792,28,2,39299,28,2,40767,28,2,40873,28,2,44208,17,21.5,-1.3339943,36.7263409,-1.2863663,36.8243643,831,3335,1507,1574
8433,4051,3035,3,Business,1,4,44703,1,4,45044,1,4,46007,1,4,46264,1,4,47477,8,23.25888921888938,-1.2853965,36.8183118,-1.2963097,36.7688221,477,1213,341,1220
8434,27027,2651,3,Business,11,6,34106,11,6,34171,11,6,34868,11,6,35544,11,6,36804,8,23.25888921888938,-1.2872136,36.8181901,-1.3014497,36.7582475,341,1260,65,1373
8435,682,2330,3,Business,29,1,59460,29,1,59498,29,1,59928,29,1,60280,29,1,62382,10,23.25888921888938,-1.2124582,36.802894,-1.2685423,36.8078703,7,2102,38,782
8436,9310,2789,3,Business,20,3,43828,20,3,43868,20,3,45517,20,3,45828,20,3,52819,14,26.3,-1.304735,36.7846054,-1.2333023,36.7794194,362,6991,40,1960
8437,27134,391,3,Business,26,2,33276,26,2,33367,26,2,34762,26,2,36007,26,2,37390,5,23.25888921888938,-1.2755752,36.8535746,-1.300921,36.828195,408,1383,91,2640
8438,5546,3599,3,Business,5,3,46399,5,3,47951,5,3,47955,5,3,49815,5,3,50530,11,25.0,-1.3302996,36.8707935,-1.2985749,36.8088,406,715,1552,1864
8439,26823,3647,3,Business,7,4,42954,7,4,43038,7,4,43650,7,4,47263,7,4,47286,12,27.7,-1.272639,36.794723,-1.3065272,36.8604986,436,23,84,4225
8440,7070,391,3,Business,30,6,42201,30,6,42250,30,6,43583,30,6,45593,30,6,49341,5,26.7,-1.300921,36.828195,-1.2784063,36.8222933,507,3748,49,3343
8441,8426,1075,3,Business,16,7,50887,16,7,50906,16,7,51136,16,7,51445,16,7,51791,1,24.0,-1.2649605,36.7981777,-1.2527958,36.8003131,103,346,19,539
8442,25377,2091,3,Personal,23,4,37704,23,4,37778,23,4,38312,23,4,39310,23,4,40679,10,18.6,-1.2731645,36.7902246,-1.3047606,36.7361825,279,1369,74,1532
8443,16372,1809,3,Business,25,2,36120,25,2,36159,25,2,36854,25,2,39257,25,2,40057,15,23.6,-1.2283403,36.8822756,-1.2646084,36.8028645,771,800,39,3098
8444,6204,2579,3,Business,31,4,52816,31,4,52862,31,4,53705,31,4,54492,31,4,54848,3,28.6,-1.2944424,36.7797938,-1.2804664,36.7701111,246,356,46,1630
8445,22941,3560,3,Business,24,1,31861,24,1,31881,24,1,32177,24,1,33113,24,1,33985,1,19.7,-1.290894,36.822971,-1.279395,36.825364,933,872,20,1232
8446,23026,2362,3,Personal,22,5,55065,22,5,55082,22,5,56027,22,5,56414,22,5,59788,21,27.2,-1.3447657,36.9009653,-1.238018,36.870424,145,3374,17,1332
8447,27446,955,2,Personal,10,5,50890,10,5,50952,10,5,51944,10,5,54166,10,5,54821,3,21.6,-1.3142701,36.8537693,-1.322764,36.861414,329,655,62,3214
8448,7361,393,3,Business,31,3,56111,31,3,56140,31,3,56147,31,3,58113,31,3,59449,14,27.1,-1.3177547,36.8303703,-1.306378,36.7519845,39,1336,29,1973
8449,12878,1850,3,Business,9,4,40127,9,4,40345,9,4,41603,9,4,43138,9,4,44425,5,23.25888921888938,-1.2571472,36.7950633,-1.289498,36.818878,764,1287,218,2793
8450,12365,3521,3,Business,9,2,51875,9,2,51916,9,2,52685,9,2,53104,9,2,56557,4,30.4,-1.2696908,36.81519,-1.2643694,36.7854135,523,3453,41,1188
8451,10081,3291,3,Business,29,2,52292,29,2,52327,29,2,53883,29,2,56669,29,2,59473,18,27.1,-1.3393547,36.8910035,-1.2600926,36.8088685,328,2804,35,4342
8452,14811,2330,3,Business,22,3,49632,22,3,53661,22,3,53994,22,3,54273,22,3,55527,9,24.5,-1.2642903,36.8002137,-1.2328823,36.8436797,740,1254,4029,612
8453,23347,3669,3,Business,21,3,59728,21,3,59812,21,3,60416,21,3,60726,21,3,63278,10,23.25888921888938,-1.2615888,36.7928732,-1.3149767,36.8447159,920,2552,84,914
8454,16764,3701,3,Business,18,2,36031,18,2,36627,18,2,36979,18,2,37204,18,2,39357,11,19.6,-1.2684239,36.7952462,-1.3111885,36.7364015,379,2153,596,577
8455,24371,867,3,Business,26,2,55267,26,2,55690,26,2,56962,26,2,57802,26,2,62453,9,31.1,-1.2638185,36.7930057,-1.2991441,36.7528804,267,4651,423,2112
8456,1234,391,3,Business,20,4,50405,20,4,50903,20,4,50926,20,4,53409,20,4,57699,18,25.4,-1.3882008,36.7699445,-1.2867454,36.8259017,728,4290,498,2506
8457,6891,1281,3,Business,2,2,42007,2,2,42049,2,2,44375,2,2,46938,2,2,47810,11,20.8,-1.2558953,36.7339105,-1.2706815,36.7646286,578,872,42,4889
8458,6906,867,3,Business,10,1,35609,10,1,35727,10,1,36355,10,1,36545,10,1,39644,13,16.7,-1.3077869,36.8443207,-1.2991441,36.7528804,864,3099,118,818
8459,2645,2150,3,Business,25,4,50323,25,4,50342,25,4,50490,25,4,51059,25,4,52037,11,23.25888921888938,-1.303596,36.778378,-1.344446,36.756597,438,978,19,717
8460,17494,3097,3,Personal,7,1,43285,7,1,43304,7,1,43367,7,1,45968,7,1,48808,28,24.8,-1.280549,36.8292442,-1.4242042,36.717817,124,2840,19,2664
8461,5570,1245,3,Business,29,3,39316,29,3,39344,29,3,39682,29,3,41218,29,3,42466,5,23.25888921888938,-1.300921,36.828195,-1.3234104,36.7989459,863,1248,28,1874
8462,6359,928,3,Business,30,3,36293,30,3,36334,30,3,36846,30,3,37108,30,3,37605,4,19.6,-1.2551895,36.7822034,-1.2585521,36.7945765,822,497,41,774
8463,7818,633,3,Business,25,1,36506,25,1,36522,25,1,37420,25,1,37700,25,1,39310,12,23.25888921888938,-1.2991441,36.7528804,-1.3004062,36.829741,545,1610,16,1178
8464,18504,100,1,Personal,31,5,34227,31,5,34280,31,5,34829,31,5,35343,31,5,37221,10,15.0,-1.2472823,36.7728468,-1.2962832,36.7849683,882,1878,53,1063
8465,183,635,3,Business,5,2,50895,5,2,51003,5,2,51892,5,2,53056,5,2,54453,6,22.6,-1.2857764,36.8236622,-1.278197,36.7842562,616,1397,108,2053
8466,11924,1642,3,Business,17,4,40553,17,4,40604,17,4,41478,17,4,41835,17,4,43158,6,22.3,-1.2728069,36.7962362,-1.2914681,36.8012887,782,1323,51,1231
8467,14634,1363,3,Business,6,5,37079,6,5,37110,6,5,37118,6,5,37322,6,5,38037,3,15.2,-1.3004062,36.829741,-1.2872899,36.820434,531,715,31,212
8468,13734,913,3,Personal,10,5,64334,10,5,65195,10,5,66079,10,5,66166,10,5,66883,4,23.25888921888938,-1.2823747,36.8258855,-1.2617028,36.7983849,843,717,861,971
8469,16015,2858,3,Business,17,3,28587,17,3,28638,17,3,30995,17,3,33134,17,3,34763,16,23.25888921888938,-1.2884243,36.8207248,-1.3164106,36.6952197,99,1629,51,4496
8470,19932,936,2,Personal,4,5,46072,4,5,46092,4,5,48738,4,5,50396,4,5,53011,16,24.2,-1.2833695,36.8551524,-1.2702053,36.7467916,581,2615,20,4304
8471,26293,2956,3,Business,6,1,39183,6,1,39193,6,1,39631,6,1,40230,6,1,41801,6,20.6,-1.290894,36.822971,-1.2584143,36.8048002,19,1571,10,1037
8472,21468,53,3,Business,7,4,41553,7,4,41581,7,4,41913,7,4,42940,7,4,43765,5,24.2,-1.3004062,36.829741,-1.2770708,36.8231093,462,825,28,1359
8473,7176,3647,3,Business,28,3,49652,28,3,49660,28,3,49958,28,3,50226,28,3,54002,19,23.25888921888938,-1.272639,36.794723,-1.3443917,36.6700333,393,3776,8,566
8474,8113,2200,3,Business,25,2,38417,25,2,39572,25,2,39942,25,2,41786,25,2,42398,6,23.6,-1.2584143,36.8048002,-1.290894,36.822971,216,612,1155,2214
8475,12615,3647,3,Business,11,4,44524,11,4,44588,11,4,46324,11,4,46690,11,4,48609,17,25.5,-1.272639,36.794723,-1.287047,36.890427,205,1919,64,2102
8476,13296,357,3,Business,30,3,36131,30,3,36522,30,3,37414,30,3,37940,30,3,38687,5,25.1,-1.3052605,36.8043094,-1.2945179,36.7685349,24,747,391,1418
8477,14763,3710,1,Business,5,4,56972,5,4,57623,5,4,58986,5,4,59359,5,4,60695,4,22.4,-1.2551895,36.7822034,-1.2740396,36.7993518,467,1336,651,1736
8478,18812,1281,3,Business,29,5,44883,29,5,45061,29,5,46377,29,5,46545,29,5,47981,12,19.7,-1.275442,36.7660207,-1.2767064,36.8227148,808,1436,178,1484
8479,13372,868,3,Business,31,2,47343,31,2,47360,31,2,47694,31,2,48997,31,2,50555,7,22.2,-1.2628473,36.781805,-1.265715,36.823815,519,1558,17,1637
8480,3275,2115,1,Personal,18,5,40716,18,5,41033,18,5,41645,18,5,42047,18,5,43292,9,21.5,-1.3001926,36.7659299,-1.3373345,36.7118861,543,1245,317,1014
8481,20235,228,3,Business,11,4,45717,11,4,45792,11,4,46993,11,4,47297,11,4,48667,12,25.6,-1.2842665,36.7967626,-1.238874,36.807889,8,1370,75,1505
8482,10220,111,3,Business,21,3,54985,21,3,55896,21,3,56638,21,3,57304,21,3,58089,3,23.0,-1.2551895,36.7822034,-1.2715686,36.8023526,57,785,911,1408
8483,11455,3127,3,Business,15,5,50191,15,5,50314,15,5,51898,15,5,52047,15,5,53256,5,28.0,-1.2918246,36.801585,-1.2964348,36.8182757,468,1209,123,1733
8484,28202,3283,3,Business,29,5,45758,29,5,46258,29,5,47997,29,5,48259,29,5,49247,5,26.7,-1.266837,36.799249,-1.2628473,36.781805,435,988,500,2001
8485,15355,2200,3,Business,16,3,48098,16,3,48769,16,3,50053,16,3,51167,16,3,54110,10,25.4,-1.2859912,36.8756811,-1.279395,36.825364,676,2943,671,2398
8486,16803,2066,3,Business,2,4,47661,2,4,47709,2,4,49322,2,4,49406,2,4,51096,17,23.25888921888938,-1.3210189,36.8410551,-1.3339943,36.7263409,410,1690,48,1697
8487,6323,2271,3,Business,11,5,57416,11,5,57429,11,5,57434,11,5,58316,11,5,59277,11,22.4,-1.331619,36.847976,-1.293515,36.897607,397,961,13,887
8488,25485,2899,3,Personal,6,6,70043,6,6,70062,6,6,70585,6,6,70751,6,6,71377,5,23.6,-1.2978607,36.7783638,-1.272704,36.7931279,855,626,19,689
8489,10719,302,3,Business,3,7,58101,3,7,58254,3,7,59013,3,7,59522,3,7,61762,10,27.4,-1.2649605,36.7981777,-1.3116592,36.8046699,311,2240,153,1268
8490,2409,3621,3,Business,9,4,32374,9,4,32656,9,4,33810,9,4,34012,9,4,35433,6,23.25888921888938,-1.2836583,36.7886014,-1.286268,36.8272182,291,1421,282,1356
8491,15715,3282,3,Personal,6,1,55567,6,1,56389,6,1,58512,6,1,58665,6,1,60847,8,24.7,-1.290059,36.7703475,-1.2861765,36.8209086,250,2182,822,2276
8492,27697,2200,3,Business,1,4,50101,1,4,50891,1,4,51460,1,4,52003,1,4,52844,6,23.25888921888938,-1.2584143,36.8048002,-1.290894,36.822971,878,841,790,1112
8493,21751,2945,2,Personal,11,5,74759,11,5,74997,11,5,75005,11,5,75964,11,5,76439,2,18.1,-1.2892766,36.8122848,-1.2824577,36.7967953,886,475,238,967
8494,19871,2956,3,Business,17,3,51044,17,3,52346,17,3,53393,17,3,54291,17,3,56809,6,28.6,-1.2584143,36.8048002,-1.290894,36.822971,88,2518,1302,1945
8495,22461,1787,3,Business,19,5,38392,19,5,38435,19,5,38856,19,5,39014,19,5,39575,3,23.25888921888938,-1.2232123,36.8932547,-1.2283403,36.8822756,691,561,43,579
8496,23882,867,3,Business,21,3,27986,21,3,29423,21,3,30764,21,3,30867,21,3,32037,9,17.0,-1.2574219,36.7927073,-1.306378,36.7519845,762,1170,1437,1444
8497,10181,1081,3,Business,18,1,45775,18,1,45801,18,1,46586,18,1,47256,18,1,49829,9,26.9,-1.3014461,36.7661381,-1.290894,36.822971,448,2573,26,1455
8498,8591,868,3,Business,20,3,34502,20,3,34536,20,3,34819,20,3,36649,20,3,37610,8,20.9,-1.303596,36.778378,-1.265715,36.823815,299,961,34,2113
8499,13497,1308,1,Business,10,5,53193,10,5,53200,10,5,53980,10,5,54269,10,5,55821,8,21.6,-1.263194,36.797624,-1.2944381,36.773762,400,1552,7,1069
8500,6935,3501,1,Personal,13,3,48084,13,3,48867,13,3,49087,13,3,49714,13,3,51298,6,23.4,-1.2658335,36.8042867,-1.2944292,36.7793569,726,1584,783,847
8501,745,265,3,Business,19,2,42343,19,2,42379,19,2,42835,19,2,42944,19,2,45840,10,27.3,-1.2960899,36.7606947,-1.300921,36.828195,865,2896,36,565
8502,14456,1478,3,Personal,24,4,59068,24,4,59943,24,4,61228,24,4,61702,24,4,63827,9,21.4,-1.2769975,36.8139588,-1.2545665,36.7597819,208,2125,875,1759
8503,3458,540,3,Business,7,5,50621,7,5,50687,7,5,51324,7,5,52157,7,5,53245,6,26.8,-1.2571472,36.7950633,-1.2967702,36.8040381,147,1088,66,1470
8504,3033,3599,3,Business,15,3,41893,15,3,41910,15,3,43081,15,3,43882,15,3,45597,14,23.25888921888938,-1.3302996,36.8707935,-1.2935549,36.7703935,675,1715,17,1972
8505,2009,393,3,Business,10,1,60041,10,1,60640,10,1,61513,10,1,62140,10,1,63966,14,18.9,-1.3228003,36.8306435,-1.306378,36.7519845,623,1826,599,1500
8506,17076,867,3,Business,5,2,35147,5,2,35171,5,2,35734,5,2,36373,5,2,38178,14,21.0,-1.3228003,36.8306435,-1.2991441,36.7528804,148,1805,24,1202
8507,24726,3689,3,Business,2,5,59084,2,5,59155,2,5,60433,2,5,60680,2,5,61343,3,24.1,-1.2527958,36.8003131,-1.2551895,36.7822034,237,663,71,1525
8508,12725,3688,3,Business,12,5,61621,12,5,61706,12,5,61770,12,5,63074,12,5,63913,8,26.4,-1.2551895,36.7822034,-1.2856826,36.8255265,291,839,85,1368
8509,15777,53,3,Business,7,5,45134,7,5,45224,7,5,46405,7,5,46819,7,5,48395,8,23.25888921888938,-1.3167113,36.8301563,-1.2770708,36.8231093,133,1576,90,1595
8510,19661,483,1,Personal,20,3,54386,20,3,54427,20,3,54810,20,3,55333,20,3,56242,12,23.1,-1.2689559,36.8097614,-1.2156006,36.8916865,589,909,41,906
8511,4786,2733,3,Business,5,5,46862,5,5,46868,5,5,46973,5,5,47196,5,5,47935,3,24.5,-1.2963097,36.7688221,-1.2886166,36.7836803,24,739,6,328
8512,5185,3647,3,Business,18,5,57961,18,5,58798,18,5,60523,18,5,60833,18,5,62077,5,25.4,-1.272639,36.794723,-1.2797536,36.8223726,725,1244,837,2035
8513,10016,3385,1,Personal,17,5,47961,17,5,47988,17,5,48392,17,5,48688,17,5,49920,9,17.7,-1.2590031,36.8078168,-1.2248308,36.8012573,726,1232,27,700
8514,5797,2412,3,Business,31,4,31663,31,4,31690,31,4,32329,31,4,32623,31,4,34376,14,17.5,-1.2297202,36.8745508,-1.2553615,36.7895376,95,1753,27,933
8515,7778,357,3,Business,15,1,44237,15,1,44355,15,1,45179,15,1,47018,15,1,48032,7,23.25888921888938,-1.304127,36.805743,-1.2945179,36.7685349,708,1014,118,2663
8516,12658,914,3,Business,24,3,50153,24,3,50236,24,3,50722,24,3,51183,24,3,52010,3,18.2,-1.2670213,36.7994482,-1.2630521,36.8068019,722,827,83,947
8517,12209,1500,3,Business,24,3,34649,24,3,35091,24,3,36463,24,3,36652,24,3,37553,6,23.25888921888938,-1.2770708,36.8231093,-1.2638185,36.7930057,306,901,442,1561
8518,7959,3557,3,Business,12,5,34381,12,5,34460,12,5,35010,12,5,35165,12,5,36665,7,18.6,-1.2546732,36.8086796,-1.266264,36.762418,379,1500,79,705
8519,27191,2801,3,Business,25,1,37033,25,1,37044,25,1,37505,25,1,37907,25,1,38858,7,15.2,-1.2809847,36.8274169,-1.2595422,36.7871178,88,951,11,863
8520,25637,3291,3,Business,8,5,42667,8,5,42760,8,5,46325,8,5,46921,8,5,48008,4,28.3,-1.272828,36.816608,-1.2600926,36.8088685,690,1087,93,4161
8521,26118,111,3,Business,17,3,40140,17,3,40198,17,3,40904,17,3,42209,17,3,44857,8,25.4,-1.2551895,36.7822034,-1.2868736,36.7805882,857,2648,58,2011
8522,18682,3283,3,Business,26,2,38681,26,2,38698,26,2,38802,26,2,39156,26,2,39729,5,27.7,-1.2600926,36.8088685,-1.2628473,36.781805,607,573,17,458
8523,18390,2956,3,Business,31,3,31410,31,3,31430,31,3,32349,31,3,32741,31,3,33059,3,19.1,-1.2584143,36.8048002,-1.2551895,36.7822034,655,318,20,1311
8524,8534,2104,3,Business,2,1,58544,2,1,60306,2,1,60509,2,1,60873,2,1,62332,7,19.5,-1.2527958,36.8003131,-1.305716,36.809882,192,1459,1762,567
8525,27418,2279,3,Business,18,1,30280,18,1,30686,18,1,31555,18,1,32125,18,1,33781,6,22.2,-1.2897368,36.8226783,-1.2969741,36.7856612,451,1656,406,1439
8526,11378,2030,3,Business,15,2,52739,15,2,52748,15,2,53063,15,2,53371,15,2,53913,2,24.4,-1.257309,36.8060084,-1.2601197,36.7985271,453,542,9,623
8527,17990,3560,3,Business,23,3,46890,23,3,46948,23,3,47666,23,3,49065,23,3,49735,1,27.5,-1.290894,36.822971,-1.279395,36.825364,26,670,58,2117
8528,14893,991,2,Personal,23,3,30002,23,3,30036,23,3,30745,23,3,30929,23,3,31435,3,16.6,-1.2455165,36.7909394,-1.2626765,36.795599,103,506,34,893
8529,21145,3450,3,Business,10,4,29736,10,4,29768,10,4,29778,10,4,30457,10,4,32053,10,19.3,-1.2551895,36.7822034,-1.304023,36.788389,579,1596,32,689
8530,14135,2733,3,Business,29,3,58350,29,3,58527,29,3,58697,29,3,59551,29,3,59847,2,21.0,-1.3039695,36.7838267,-1.2963097,36.7688221,310,296,177,1024
8531,4736,2869,3,Business,11,4,34318,11,4,34344,11,4,34423,11,4,37059,11,4,40935,9,22.2,-1.290894,36.822971,-1.3014461,36.7661381,61,3876,26,2715
8532,7252,1363,3,Business,29,1,34089,29,1,34102,29,1,34130,29,1,34693,29,1,36637,13,23.25888921888938,-1.3004062,36.829741,-1.238805,36.884373,206,1944,13,591
8533,23163,1963,1,Personal,28,5,40910,28,5,41196,28,5,41935,28,5,42159,28,5,42886,4,25.2,-1.2740396,36.7993518,-1.2560455,36.7800867,453,727,286,963
8534,2388,1594,3,Business,26,5,47050,26,5,47061,26,5,48068,26,5,50276,26,5,52443,14,23.25888921888938,-1.207546,36.7913976,-1.2156006,36.8916865,411,2167,11,3215
8535,24789,948,3,Business,16,4,45611,16,4,45668,16,4,48065,16,4,48252,16,4,48748,2,23.25888921888938,-1.2594474,36.8089122,-1.2696908,36.81519,435,496,57,2584
8536,276,1831,3,Business,23,3,42934,23,3,43399,23,3,43748,23,3,44260,23,3,46427,21,21.9,-1.3562374,36.9042954,-1.2553615,36.7895376,408,2167,465,861
8537,4996,3127,3,Business,21,5,53631,21,5,58888,21,5,59760,21,5,59871,21,5,61162,6,25.1,-1.2918246,36.801585,-1.269534,36.80697,38,1291,5257,983
8538,2736,2789,3,Business,15,5,43605,15,5,43629,15,5,44106,15,5,44519,15,5,46453,13,25.8,-1.304735,36.7846054,-1.3024388,36.859699,468,1934,24,890
8539,23612,3115,3,Business,30,3,52280,30,3,52286,30,3,52312,30,3,52938,30,3,55283,11,28.8,-1.2963097,36.7688221,-1.3108783,36.8392726,6,2345,6,652
8540,12136,295,3,Business,14,3,43166,14,3,48071,14,3,49538,14,3,49698,14,3,50718,6,25.9,-1.2967108,36.7871135,-1.286925,36.821916,284,1020,4905,1627
8541,21435,136,3,Business,7,5,40044,7,5,40119,7,5,41568,7,5,41656,7,5,43558,2,23.25888921888938,-1.2654716,36.7983635,-1.2760462,36.8074697,577,1902,75,1537
8542,27642,1663,1,Personal,23,3,42874,23,3,43031,23,3,44630,23,3,44881,23,3,47366,8,21.6,-1.2798711,36.8207118,-1.3205669,36.8362168,87,2485,157,1850
8543,1392,393,3,Business,13,3,48906,13,3,48916,13,3,48920,13,3,51660,13,3,51672,14,29.1,-1.3167113,36.8301563,-1.306378,36.7519845,515,12,10,2744
8544,5701,3647,3,Business,15,2,41511,15,2,41526,15,2,42139,15,2,42815,15,2,43787,8,24.4,-1.272639,36.794723,-1.257537,36.843066,801,972,15,1289
8545,26016,972,3,Business,4,4,41101,4,4,46177,4,4,46759,4,4,46883,4,4,47887,6,23.25888921888938,-1.2862033,36.8152966,-1.3127304,36.8189817,844,1004,5076,706
8546,28060,478,3,Business,12,3,47272,12,3,47560,12,3,48739,12,3,49116,12,3,51927,8,20.9,-1.3045333,36.8228072,-1.2603403,36.7998848,155,2811,288,1556
8547,999,3291,3,Business,13,2,41614,13,2,41818,13,2,42078,13,2,42198,13,2,42645,2,22.1,-1.2673935,36.8030328,-1.2600926,36.8088685,663,447,204,380
8548,22170,393,3,Business,28,4,37770,28,4,37898,28,4,37902,28,4,40494,28,4,40496,6,28.2,-1.3167113,36.8301563,-1.3077869,36.8443207,515,2,128,2596
8549,5257,2956,3,Business,17,2,58066,17,2,58253,17,2,59264,17,2,59740,17,2,62364,20,23.9,-1.2860183,36.8975338,-1.2584143,36.8048002,698,2624,187,1487
8550,7329,1250,1,Personal,24,5,44139,24,5,44188,24,5,44793,24,5,44950,24,5,46532,14,20.8,-1.2699442,36.8206553,-1.3324865,36.8938303,676,1582,49,762
8551,9501,633,3,Business,14,1,53895,14,1,54053,14,1,54059,14,1,54903,14,1,54907,4,25.9,-1.3077869,36.8443207,-1.3004062,36.829741,239,4,158,850
8552,20038,2987,3,Business,22,1,55002,22,1,56409,22,1,56964,22,1,57078,22,1,58753,9,26.1,-1.270212,36.8210877,-1.3280091,36.8524146,482,1675,1407,669
8553,13724,1281,3,Business,31,5,37869,31,5,37876,31,5,38931,31,5,42279,31,5,44071,20,17.2,-1.2854453,36.8188363,-1.348697,36.710527,45,1792,7,4403
8554,4065,1209,3,Business,13,4,29766,13,4,30696,13,4,31837,13,4,32444,13,4,32984,4,18.0,-1.3077869,36.8443207,-1.3004062,36.829741,656,540,930,1748
8555,18912,393,3,Business,14,2,49070,14,2,49084,14,2,49090,14,2,50335,14,2,50338,4,23.25888921888938,-1.3167113,36.8301563,-1.3004062,36.829741,515,3,14,1251
8556,7764,2521,3,Business,30,6,31731,30,6,31744,30,6,31774,30,6,32481,30,6,33535,11,23.25888921888938,-1.3167113,36.8301563,-1.2638185,36.7930057,349,1054,13,737
8557,24983,60,3,Business,28,4,49724,28,4,49746,28,4,49941,28,4,50553,28,4,52310,15,27.2,-1.303596,36.778378,-1.2296618,36.8438272,484,1757,22,807
8558,503,53,3,Business,12,6,32103,12,6,32150,12,6,32155,12,6,34223,12,6,34257,6,23.25888921888938,-1.3077869,36.8443207,-1.2770708,36.8231093,619,34,47,2073
8559,6358,978,1,Personal,7,4,50123,7,4,50889,7,4,52486,7,4,52758,7,4,54320,5,20.1,-1.3084067,36.8345014,-1.2805312,36.8326687,669,1562,766,1869
8560,2571,1874,3,Business,5,1,40552,5,1,40595,5,1,41012,5,1,46795,5,1,46818,18,24.3,-1.2571472,36.7950633,-1.3258631,36.9038477,284,23,43,6200
8561,26765,1245,3,Business,6,3,35048,6,3,35063,6,3,35101,6,3,37133,6,3,38710,17,23.25888921888938,-1.300921,36.828195,-1.3198615,36.7110323,167,1577,15,2070
8562,9234,2804,3,Business,12,2,37356,12,2,37392,12,2,37804,12,2,38437,12,2,38694,4,24.3,-1.2551895,36.7822034,-1.255956,36.772901,770,257,36,1045
8563,17799,1803,1,Personal,6,6,41350,6,6,41569,6,6,42666,6,6,42958,6,6,43865,5,24.5,-1.2857929,36.8240829,-1.2966785,36.7896469,844,907,219,1389
8564,24765,1394,3,Personal,30,1,56766,30,1,56794,30,1,57565,30,1,58131,30,1,60158,21,20.4,-1.2710687,36.8142839,-1.3463429,36.9069888,561,2027,28,1337
8565,25327,3636,1,Personal,7,7,33285,7,7,33324,7,7,33880,7,7,34037,7,7,36161,18,20.0,-1.2991247,36.7642354,-1.2240292,36.8156884,846,2124,39,713
8566,8082,2330,3,Business,27,1,42557,27,1,42957,27,1,43515,27,1,43595,27,1,45488,10,20.8,-1.3015197,36.7658456,-1.2687407,36.7373043,599,1893,400,638
8567,6613,2330,3,Business,3,3,61050,3,3,61107,3,3,61588,3,3,61916,3,3,62221,2,27.4,-1.2671943,36.8062533,-1.2536275,36.7987932,205,305,57,809
8568,2951,1260,3,Business,31,4,39668,31,4,39693,31,4,39731,31,4,39813,31,4,41691,12,26.3,-1.2551895,36.7822034,-1.3270716,36.8406371,518,1878,25,120
8569,18120,3095,3,Personal,13,3,55368,13,3,55381,13,3,55835,13,3,57278,13,3,58469,10,29.1,-1.30157,36.7871,-1.2633397,36.7454238,678,1191,13,1897
8570,926,1246,3,Business,8,2,56349,8,2,57444,8,2,57894,8,2,58619,8,2,61103,23,25.4,-1.3700383,36.9190174,-1.275612,36.7637978,441,2484,1095,1175
8571,1834,1402,3,Business,3,1,53143,3,1,54304,3,1,54936,3,1,55672,3,1,57120,6,23.4,-1.2527958,36.7976244,-1.2813012,36.8323962,491,1448,1161,1368
8572,23607,2833,2,Personal,12,5,60213,12,5,60247,12,5,60329,12,5,61408,12,5,65333,22,25.8,-1.26919,36.79907,-1.392674,36.750337,680,3925,34,1161
8573,9838,178,2,Personal,11,4,66079,11,4,66224,11,4,66932,11,4,67270,11,4,69269,12,24.0,-1.315797,36.8436497,-1.304842,36.90576,734,1999,145,1046
8574,25532,3331,3,Business,18,3,56866,18,3,56876,18,3,57424,18,3,57552,18,3,59173,9,20.6,-1.2551895,36.7822034,-1.2359565,36.7622728,620,1621,10,676
8575,1221,517,3,Business,29,4,39340,29,4,39678,29,4,40377,29,4,40575,29,4,41463,5,21.7,-1.3177547,36.8303703,-1.3077869,36.8443207,581,888,338,897
8576,13254,20,3,Business,11,3,38641,11,3,38703,11,3,39114,11,3,39643,11,3,41658,6,18.9,-1.2628638,36.8070399,-1.300722,36.816865,726,2015,62,940
8577,6679,2509,3,Business,27,3,40366,27,3,40380,27,3,40419,27,3,41040,27,3,44528,20,26.0,-1.2571472,36.7950633,-1.3700383,36.9190174,470,3488,14,660
8578,14403,3264,3,Business,22,2,50484,22,2,50526,22,2,52757,22,2,52865,22,2,53760,6,21.4,-1.2626906,36.7827022,-1.2707742,36.7578609,770,895,42,2339
8579,24834,1959,3,Business,25,4,65465,25,4,65525,25,4,66811,25,4,66985,25,4,68393,10,23.25888921888938,-1.2551895,36.7822034,-1.2664227,36.7453671,263,1408,60,1460
8580,13929,1892,2,Personal,25,2,40411,25,2,40616,25,2,41297,25,2,41625,25,2,43230,3,23.8,-1.3081007,36.839635,-1.3112653,36.8269197,38,1605,205,1009
8581,24065,3692,2,Personal,13,5,62908,13,5,62989,13,5,63646,13,5,63813,13,5,64725,9,19.1,-1.2738936,36.8035805,-1.240218,36.766816,379,912,81,824
8582,2902,2066,3,Business,2,5,47647,2,5,47703,2,5,48595,2,5,50829,2,5,50833,10,24.9,-1.316961,36.820337,-1.256522,36.7864132,854,4,56,3126
8583,19448,2956,3,Business,1,6,60664,1,6,61752,1,6,62084,1,6,62361,1,6,62912,4,20.7,-1.2584143,36.8048002,-1.2597367,36.7848482,647,551,1088,609
8584,16367,20,3,Business,28,1,55102,28,1,55217,28,1,56409,28,1,56775,28,1,59502,12,24.7,-1.2629666,36.8068369,-1.313616,36.8629657,480,2727,115,1558
8585,12323,3674,3,Business,8,2,34057,8,2,34368,8,2,37260,8,2,38729,8,2,40065,7,23.4,-1.2551895,36.7822034,-1.2817196,36.822194,362,1336,311,4361
8586,19696,1932,3,Business,9,1,49900,9,1,49999,9,1,50548,9,1,51014,9,1,52211,7,20.9,-1.3102963,36.8212746,-1.2922857,36.7813274,844,1197,99,1015
8587,10506,248,3,Business,7,3,38834,7,3,38848,7,3,39307,7,3,39798,7,3,40638,9,24.9,-1.304735,36.7846054,-1.2635089,36.7887337,88,840,14,950
8588,25940,1329,3,Business,18,1,39189,18,1,39203,18,1,40210,18,1,40308,18,1,41720,6,28.2,-1.273056,36.811298,-1.3012173,36.8093987,343,1412,14,1105
8589,24693,824,3,Business,13,2,48603,13,2,49439,13,2,49683,13,2,50926,13,2,52246,17,26.1,-1.207546,36.7913976,-1.2896399,36.8124498,49,1320,836,1487
8590,22772,2988,3,Personal,29,3,59744,29,3,60476,29,3,60897,29,3,61071,29,3,62436,7,21.0,-1.2802803,36.8271747,-1.2567409,36.7798977,183,1365,732,595
8591,26860,2763,3,Business,27,3,51800,27,3,51818,27,3,51896,27,3,52681,27,3,54977,14,29.0,-1.2551895,36.7822034,-1.3015998,36.8764939,579,2296,18,863
8592,7726,3326,3,Business,12,3,56407,12,3,57242,12,3,59210,12,3,59393,12,3,63935,22,21.0,-1.2551895,36.7822034,-1.3433296,36.9106128,155,4542,835,2151
8593,995,1502,1,Business,8,1,43170,8,1,43648,8,1,44347,8,1,45269,8,1,46484,17,24.5,-1.2156006,36.8916865,-1.2551895,36.7822034,731,1215,478,1621
8594,15166,393,3,Business,3,5,34762,3,5,34797,3,5,35285,3,5,35574,3,5,38273,14,23.25888921888938,-1.3167113,36.8301563,-1.2991441,36.7528804,591,2699,35,777
8595,15097,3091,3,Business,26,1,30567,26,1,30802,26,1,34639,26,1,34901,26,1,39381,8,17.8,-1.3012008,36.764868,-1.2615888,36.7928732,322,4480,235,4099
8596,15887,1075,3,Business,28,4,42999,28,4,43021,28,4,43538,28,4,45630,28,4,45632,1,23.9,-1.2649605,36.7981777,-1.2527958,36.8003131,167,2,22,2609
8597,20757,3565,3,Business,18,7,50670,18,7,50803,18,7,51188,18,7,53945,18,7,55712,16,27.3,-1.3275382,36.8468107,-1.2861046,36.7407181,675,1767,133,3142
8598,14241,3420,3,Business,21,5,52716,21,5,54621,21,5,54975,21,5,55778,21,5,57731,7,24.4,-1.265981,36.7936121,-1.3046007,36.8211743,607,1953,1905,1157
8599,26887,948,3,Business,3,5,46429,3,5,46445,3,5,47343,3,5,47699,3,5,52391,17,23.25888921888938,-1.207546,36.7913976,-1.2696908,36.81519,190,4692,16,1254
8600,7742,1500,3,Business,5,5,56039,5,5,56174,5,5,56182,5,5,58336,5,5,59561,8,27.7,-1.3004062,36.829741,-1.2638185,36.7930057,842,1225,135,2162
8601,24117,338,1,Personal,18,6,39409,18,6,39441,18,6,39808,18,6,40239,18,6,40621,4,19.1,-1.3041099,36.7867709,-1.282986,36.767414,676,382,32,798
8602,22720,867,3,Business,28,1,33209,28,1,35418,28,1,35423,28,1,36797,28,1,38212,10,19.5,-1.3004062,36.829741,-1.2991441,36.7528804,523,1415,2209,1379
8603,6108,302,3,Business,1,3,44492,1,3,44533,1,3,44937,1,3,45819,1,3,46707,6,23.25888921888938,-1.2649605,36.7981777,-1.2909634,36.7813995,72,888,41,1286
8604,5043,1273,2,Personal,3,2,55346,3,2,55372,3,2,56376,3,2,56748,3,2,57152,4,20.0,-1.2933467,36.7810385,-1.2687974,36.7960339,312,404,26,1376
8605,15582,3201,3,Business,19,1,54818,19,1,54828,19,1,55208,19,1,56113,19,1,56115,1,25.1,-1.2571472,36.7950633,-1.2584143,36.8048002,647,2,10,1285
8606,25258,3442,1,Personal,18,4,58194,18,4,61114,18,4,61910,18,4,63300,18,4,64070,6,23.4,-1.2877304,36.8294383,-1.2611642,36.7949932,213,770,2920,2186
8607,9947,2330,3,Business,5,2,43946,5,2,43995,5,2,44484,5,2,44664,5,2,45769,6,23.5,-1.2921463,36.8029626,-1.2649605,36.7981777,958,1105,49,669
8608,27056,700,3,Business,20,2,39280,20,2,45514,20,2,46249,20,2,46887,20,2,47975,7,19.9,-1.3205164,36.8098882,-1.2872282,36.7675014,726,1088,6234,1373
8609,16962,2063,3,Business,8,2,42221,8,2,42483,8,2,43193,8,2,43322,8,2,45392,9,21.2,-1.255956,36.789867,-1.3018758,36.7590863,782,2070,262,839
8610,21406,3331,3,Business,14,4,40079,14,4,40260,14,4,42055,14,4,42523,14,4,44436,7,23.5,-1.2551895,36.7822034,-1.2896399,36.8124498,19,1913,181,2263
8611,27156,2987,3,Business,12,1,45025,12,1,45162,12,1,45787,12,1,45993,12,1,47651,10,23.8,-1.270212,36.8210877,-1.3014461,36.7661381,399,1658,137,831
8612,17979,649,1,Business,12,4,38848,12,4,38861,12,4,38899,12,4,40433,12,4,42773,11,18.8,-1.2551895,36.7822034,-1.2964396,36.7760609,103,2340,13,1572
8613,15833,2279,3,Business,18,1,48533,18,1,48814,18,1,51411,18,1,51952,18,1,52842,1,30.9,-1.2897368,36.8226783,-1.2824535,36.8265153,686,890,281,3138
8614,18887,3560,3,Business,11,1,42872,11,1,51325,11,1,51568,11,1,51758,11,1,54229,10,27.9,-1.2859912,36.8756811,-1.279395,36.825364,803,2471,8453,433
8615,9130,3718,3,Business,7,5,53553,7,5,53587,7,5,54948,7,5,55015,7,5,55611,2,26.8,-1.2650027,36.8126242,-1.2649605,36.7981777,685,596,34,1428
8616,10042,2610,3,Business,10,4,56895,10,4,57101,10,4,57754,10,4,58074,10,4,58944,6,21.8,-1.3038377,36.787937,-1.3075445,36.8236687,749,870,206,973
8617,7200,1754,3,Business,16,4,55310,16,4,56512,16,4,57428,16,4,58016,16,4,60133,19,18.9,-1.2860183,36.8975338,-1.2551895,36.7822034,589,2117,1202,1504
8618,21077,3403,3,Business,2,1,52013,2,1,52205,2,1,53366,2,1,53431,2,1,56223,15,19.9,-1.2551895,36.7822034,-1.3192808,36.7121888,105,2792,192,1226
8619,24111,2216,3,Business,19,5,56742,19,5,58938,19,5,60336,19,5,61585,19,5,63165,8,24.3,-1.2551895,36.7822034,-1.2966203,36.817837,328,1580,2196,2647
8620,5879,113,3,Business,19,4,33134,19,4,33154,19,4,34737,19,4,34915,19,4,36722,8,14.4,-1.2844653,36.8206676,-1.2963097,36.7688221,174,1807,20,1761
8621,20513,23,2,Personal,28,2,48045,28,2,48054,28,2,48783,28,2,50101,28,2,52632,21,19.7,-1.2914795,36.8248973,-1.3254522,36.7216584,320,2531,9,2047
8622,8969,2762,1,Personal,28,5,53947,28,5,55738,28,5,57157,28,5,58330,28,5,62025,22,25.7,-1.2842286,36.8150609,-1.2454779,36.9490919,96,3695,1791,2592
8623,25985,706,3,Business,7,5,30502,7,5,30731,7,5,32246,7,5,32993,7,5,33309,4,20.4,-1.3004062,36.829741,-1.3077869,36.8443207,477,316,229,2262
8624,17620,1880,3,Business,28,3,48198,28,3,48239,28,3,50251,28,3,50686,28,3,52215,11,23.25888921888938,-1.3004998,36.8041558,-1.2571472,36.7950633,612,1529,41,2447
8625,6909,1724,3,Business,6,4,47457,6,4,48057,6,4,50252,6,4,50916,6,4,51449,3,23.25888921888938,-1.259382,36.807205,-1.2551895,36.7822034,379,533,600,2859
8626,22012,2987,3,Business,29,1,47287,29,1,47872,29,1,48479,29,1,48613,29,1,49434,3,23.25888921888938,-1.270212,36.8210877,-1.2805757,36.8223948,522,821,585,741
8627,11475,3727,3,Business,11,2,53079,11,2,55185,11,2,55200,11,2,55538,11,2,56627,6,22.5,-1.2963097,36.7688221,-1.2904993,36.8043877,848,1089,2106,353
8628,15963,1500,3,Business,30,2,29485,30,2,29538,30,2,30245,30,2,30377,30,2,31490,5,23.25888921888938,-1.2638185,36.7930057,-1.282937,36.7816984,247,1113,53,839
8629,16776,627,3,Business,28,5,43956,28,5,44061,28,5,44874,28,5,45221,28,5,46671,7,25.1,-1.2571472,36.7950633,-1.2876155,36.7868444,96,1450,105,1160
8630,11203,393,3,Business,13,4,46855,13,4,48035,13,4,48340,13,4,48589,13,4,49487,5,22.3,-1.3228003,36.8306435,-1.3077869,36.8443207,538,898,1180,554
8631,15464,2271,3,Business,17,1,40872,17,1,40880,17,1,40888,17,1,42104,17,1,42739,14,25.1,-1.272828,36.816608,-1.293515,36.897607,408,635,8,1224
8632,25743,867,3,Business,7,5,44041,7,5,44373,7,5,44858,7,5,46778,7,5,50449,10,23.25888921888938,-1.2996533,36.8292629,-1.2991441,36.7528804,821,3671,332,2405
8633,13349,226,3,Personal,9,4,34181,9,4,35171,9,4,37134,9,4,37555,9,4,40321,22,23.25888921888938,-1.2300428,36.6683516,-1.2929796,36.8329533,299,2766,990,2384
8634,22216,1687,3,Business,18,1,44598,18,1,44715,18,1,45642,18,1,46073,18,1,48689,5,23.25888921888938,-1.2733004,36.7943468,-1.2772438,36.8264231,444,2616,117,1358
8635,19330,1927,3,Business,1,6,58942,1,6,60467,1,6,60988,1,6,61766,1,6,64301,21,21.1,-1.3463042,36.768164,-1.2685865,36.8850792,345,2535,1525,1299
8636,24801,1271,3,Business,9,5,48907,9,5,48944,9,5,51285,9,5,51808,9,5,55782,22,26.3,-1.3244885,36.897792,-1.3107918,36.761794,63,3974,37,2864
8637,8458,1389,3,Business,28,5,44819,28,5,45537,28,5,45608,28,5,46840,28,5,48406,12,23.7,-1.2494503,36.8531852,-1.207546,36.7913976,664,1566,718,1303
8638,23053,1329,3,Business,4,5,36043,4,5,36078,4,5,37420,4,5,37611,4,5,38542,6,17.2,-1.273056,36.811298,-1.2652706,36.7652464,332,931,35,1533
8639,22430,3291,3,Business,19,6,33404,19,6,33452,19,6,33894,19,6,34397,19,6,35247,5,21.6,-1.2783849,36.8163445,-1.2600926,36.8088685,89,850,48,945
8640,11286,2457,3,Business,15,2,56698,15,2,57426,15,2,58273,15,2,58344,15,2,59519,8,24.7,-1.2626906,36.7827022,-1.2995132,36.8043032,782,1175,728,918
8641,9955,1244,3,Business,30,6,40726,30,6,40834,30,6,41014,30,6,42099,30,6,43862,11,21.9,-1.318062,36.849326,-1.303596,36.778378,654,1763,108,1265
8642,13428,265,3,Business,6,3,45779,6,3,46395,6,3,47708,6,3,51826,6,3,53287,6,22.0,-1.300921,36.828195,-1.327371,36.840591,526,1461,616,5431
8643,7069,2987,3,Business,1,3,48736,1,3,48743,1,3,48768,1,3,50839,1,3,51928,12,23.7,-1.270212,36.8210877,-1.2156006,36.8916865,406,1089,7,2096
8644,10441,3300,3,Business,6,1,61611,6,1,61634,6,1,61815,6,1,62625,6,1,63973,9,23.25888921888938,-1.2600926,36.8088685,-1.303596,36.778378,72,1348,23,991
8645,24172,3186,3,Business,16,4,35923,16,4,35950,16,4,37650,16,4,37796,16,4,39409,5,23.25888921888938,-1.2881005,36.8184914,-1.2854406,36.789409,548,1613,27,1846
8646,14367,2292,3,Business,20,6,47145,20,6,47207,20,6,48082,20,6,48308,20,6,50009,21,23.25888921888938,-1.2790196,36.8160867,-1.375192,36.9361554,276,1701,62,1101
8647,22415,1389,3,Business,31,3,35798,31,3,35872,31,3,37342,31,3,38090,31,3,42609,18,24.9,-1.2914308,36.8018867,-1.207546,36.7913976,289,4519,74,2218
8648,28028,2956,3,Business,15,3,40144,15,3,40183,15,3,41087,15,3,41292,15,3,43748,7,23.25888921888938,-1.2584143,36.8048002,-1.3008433,36.8036256,660,2456,39,1109
8649,23966,868,3,Business,20,3,47093,20,3,47114,20,3,47528,20,3,47990,20,3,49026,8,27.4,-1.303596,36.778378,-1.265715,36.823815,952,1036,21,876
8650,8381,3201,3,Business,5,2,31670,5,2,31735,5,2,32345,5,2,32879,5,2,34380,10,20.9,-1.2584143,36.8048002,-1.2413316,36.8785525,708,1501,65,1144
8651,1266,2330,3,Business,7,4,55409,7,4,55484,7,4,56549,7,4,56649,7,4,58042,9,27.9,-1.2324923,36.8363775,-1.293082,36.8278578,206,1393,75,1165
8652,13007,3203,3,Business,28,1,35983,28,1,36067,28,1,36768,28,1,37193,28,1,38104,7,18.0,-1.22978,36.836215,-1.228911,36.881876,852,911,84,1126
8653,11735,1500,3,Business,10,1,31026,10,1,31073,10,1,31121,10,1,33879,10,1,34713,8,16.3,-1.3004062,36.829741,-1.2638185,36.7930057,2,834,47,2806
8654,21166,3698,3,Business,23,4,34525,23,4,34542,23,4,35217,23,4,35955,23,4,38770,22,23.25888921888938,-1.3244885,36.897792,-1.3014461,36.7661381,675,2815,17,1413
8655,18223,3239,3,Personal,19,6,50781,19,6,54377,19,6,54898,19,6,55286,19,6,56613,7,24.4,-1.2839322,36.8292426,-1.2855921,36.7788349,281,1327,3596,909
8656,21266,1600,3,Business,19,2,34635,19,2,34649,19,2,34681,19,2,35061,19,2,36172,11,23.25888921888938,-1.3169591,36.7000029,-1.2961607,36.7788292,647,1111,14,412
8657,19293,3547,3,Business,15,1,46186,15,1,46260,15,1,48319,15,1,48843,15,1,49697,3,23.25888921888938,-1.2761408,36.7710839,-1.270424,36.779289,523,854,74,2583
8658,4670,1402,3,Business,23,2,42638,23,2,50913,23,2,50921,23,2,51870,23,2,52726,1,23.25888921888938,-1.279395,36.825364,-1.2813012,36.8323962,79,856,8275,957
8659,16791,3560,3,Business,13,4,51774,13,4,51837,13,4,53073,13,4,53838,13,4,55067,5,23.3,-1.2527958,36.7976244,-1.279395,36.825364,868,1229,63,2001
8660,25271,186,3,Business,8,3,54467,8,3,54475,8,3,54494,8,3,54688,8,3,57025,23,23.25888921888938,-1.3700383,36.9190174,-1.2571472,36.7950633,875,2337,8,213
8661,17754,111,3,Business,16,3,36265,16,3,36325,16,3,36347,16,3,36945,16,3,38165,10,19.8,-1.2551895,36.7822034,-1.2295205,36.8120426,108,1220,60,620
8662,27078,3356,3,Business,9,4,39272,9,4,39314,9,4,41545,9,4,41898,9,4,44356,16,23.25888921888938,-1.2036664,36.8192622,-1.2980085,36.8044778,7,2458,42,2584
8663,21184,2587,3,Business,12,1,38124,12,1,39484,12,1,40254,12,1,40837,12,1,43886,8,23.8,-1.3014461,36.7661381,-1.28878,36.8168312,436,3049,1360,1353
8664,13902,3326,3,Business,16,2,36938,16,2,36999,16,2,37411,16,2,37853,16,2,39119,8,23.25888921888938,-1.2571472,36.7950633,-1.3090727,36.8315262,85,1266,61,854
8665,22401,2828,3,Business,3,5,45818,3,5,45937,3,5,46869,3,5,47024,3,5,49673,8,23.25888921888938,-1.2615888,36.7928732,-1.289556,36.797317,147,2649,119,1087
8666,22962,1754,3,Business,25,4,43613,25,4,43629,25,4,44369,25,4,44651,25,4,46973,14,20.2,-1.3562374,36.9042954,-1.2860183,36.8975338,532,2322,16,1022
8667,7527,3300,3,Business,11,2,47086,11,2,47248,11,2,47462,11,2,48364,11,2,49448,9,19.6,-1.259478,36.8017813,-1.303596,36.778378,484,1084,162,1116
8668,21627,478,3,Business,12,3,45870,12,3,46156,12,3,46322,12,3,46447,12,3,48385,11,19.3,-1.2551895,36.7822034,-1.3142701,36.8537693,168,1938,286,291
8669,12308,2986,3,Personal,11,5,57264,11,5,57319,11,5,57959,11,5,59520,11,5,61850,4,24.4,-1.2906604,36.8318242,-1.2903886,36.8063847,237,2330,55,2201
8670,5406,2150,3,Business,20,1,52739,20,1,57093,20,1,57946,20,1,59060,20,1,61154,12,23.25888921888938,-1.331619,36.847976,-1.344446,36.756597,2,2094,4354,1967
8671,4125,246,3,Business,28,2,49515,28,2,49520,28,2,49523,28,2,51994,28,2,53604,17,19.3,-1.3169591,36.7000029,-1.2584143,36.8048002,406,1610,5,2474
8672,4294,1724,3,Business,7,2,46420,7,2,47184,7,2,47229,7,2,47996,7,2,48290,4,23.0,-1.2658373,36.8018598,-1.2551895,36.7822034,51,294,764,812
8673,26247,1850,3,Business,2,4,58638,2,4,58654,2,4,59265,2,4,59464,2,4,59468,3,23.25888921888938,-1.2551895,36.7822034,-1.259919,36.808244,291,4,16,810
8674,24418,3355,3,Business,26,2,45567,26,2,45726,26,2,47431,26,2,47837,26,2,48882,8,23.25888921888938,-1.3052491,36.8223899,-1.2551895,36.7822034,101,1045,159,2111
8675,24318,323,1,Business,12,3,37764,12,3,38943,12,3,39823,12,3,40143,12,3,40658,4,23.4,-1.3632162,36.9108253,-1.3861826,36.9349923,343,515,1179,1200
8676,2515,3283,3,Business,12,2,38424,12,2,38450,12,2,38987,12,2,39998,12,2,41393,6,24.6,-1.272828,36.816608,-1.2628473,36.781805,332,1395,26,1548
8677,6305,1194,3,Personal,12,4,46904,12,4,46963,12,4,47465,12,4,47661,12,4,48900,7,18.7,-1.3040899,36.7842136,-1.3099584,36.7323644,951,1239,59,698
8678,20123,1271,3,Business,29,2,57855,29,2,59723,29,2,60979,29,2,61347,29,2,61986,9,23.25888921888938,-1.3244885,36.897792,-1.3323107,36.8692616,79,639,1868,1624
8679,21684,346,3,Business,18,5,59458,18,5,59519,18,5,59622,18,5,60247,18,5,60426,1,25.3,-1.28878,36.8168312,-1.279395,36.825364,237,179,61,728
8680,1375,867,3,Business,18,4,39911,18,4,39941,18,4,39956,18,4,42965,18,4,44886,10,23.25888921888938,-1.2996533,36.8292629,-1.2991441,36.7528804,855,1921,30,3024
8681,9228,1363,3,Business,1,5,34066,1,5,34083,1,5,34284,1,5,34521,1,5,36079,7,23.25888921888938,-1.3004062,36.829741,-1.2546732,36.8086796,206,1558,17,438
8682,19608,2495,1,Personal,25,3,62785,25,3,62822,25,3,63184,25,3,64056,25,3,64812,4,17.7,-1.266294,36.8057971,-1.2655306,36.828148,648,756,37,1234
8683,1024,186,3,Business,3,1,45035,3,1,45125,3,1,45408,3,1,46305,3,1,48095,20,21.5,-1.2571472,36.7950633,-1.3700383,36.9190174,168,1790,90,1180
8684,5243,2601,3,Personal,31,5,44547,31,5,44930,31,5,46402,31,5,47280,31,5,48729,2,21.6,-1.3014461,36.7661381,-1.2963097,36.7688221,255,1449,383,2350
8685,18152,1341,3,Business,15,3,35510,15,3,35562,15,3,36353,15,3,38744,15,3,39491,10,17.9,-1.3393547,36.8910035,-1.3313643,36.8577422,116,747,52,3182
8686,12764,3147,3,Business,29,1,51769,29,1,51792,29,1,51895,29,1,52361,29,1,53936,17,23.25888921888938,-1.2551895,36.7822034,-1.3472066,36.7692638,695,1575,23,569
8687,11704,408,1,Personal,16,2,36057,16,2,36349,16,2,37283,16,2,39673,16,2,40275,4,23.6,-1.2791714,36.8255997,-1.2736095,36.8011282,208,602,292,3324
8688,5003,3148,2,Personal,19,3,52413,19,3,52417,19,3,53311,19,3,53532,19,3,54845,5,25.7,-1.2788027,36.7939088,-1.2868973,36.8232984,785,1313,4,1115
8689,2421,2330,3,Business,31,4,41997,31,4,42069,31,4,43086,31,4,43394,31,4,44351,8,26.3,-1.2324923,36.8363775,-1.2524916,36.8656196,377,957,72,1325
8690,5983,496,3,Business,14,4,60861,14,4,60978,14,4,61587,14,4,63275,14,4,64399,6,25.9,-1.2551895,36.7822034,-1.280753,36.8191175,281,1124,117,2297
8691,6992,1075,3,Business,13,3,44273,13,3,44336,13,3,45803,13,3,48547,13,3,49000,19,24.6,-1.2527958,36.8003131,-1.2422942,36.6669445,805,453,63,4211
8692,509,2789,3,Business,8,1,42759,8,1,42775,8,1,43511,8,1,43838,8,1,45550,7,27.9,-1.304735,36.7846054,-1.265432,36.795034,166,1712,16,1063
8693,16450,2330,3,Business,16,3,37614,16,3,37645,16,3,37959,16,3,38390,16,3,39116,6,22.7,-1.3015197,36.7658456,-1.2915247,36.8055757,246,726,31,745
8694,21635,968,2,Personal,26,2,56582,26,2,56618,26,2,57952,26,2,58809,26,2,59370,3,23.25888921888938,-1.2584143,36.8048002,-1.2615888,36.7928732,840,561,36,2191
8695,24804,1880,3,Business,30,4,42663,30,4,42725,30,4,43333,30,4,43628,30,4,45271,13,23.25888921888938,-1.2571472,36.7950633,-1.302453,36.8668919,96,1643,62,903
8696,2839,2763,3,Business,7,4,43606,7,4,43633,7,4,44478,7,4,44570,7,4,45075,5,24.2,-1.2551895,36.7822034,-1.2711982,36.8240199,383,505,27,937
8697,3770,640,3,Business,2,5,54353,2,5,54421,2,5,54539,2,5,56474,2,5,56882,3,25.2,-1.3016431,36.7620068,-1.304033,36.7848695,568,408,68,2053
8698,23021,867,3,Business,28,2,51483,28,2,51491,28,2,51502,28,2,51652,28,2,54281,14,19.5,-1.306378,36.7519845,-1.3177547,36.8303703,748,2629,8,161
8699,12700,59,3,Business,23,2,52446,23,2,52483,23,2,53331,23,2,53916,23,2,55718,18,19.0,-1.290894,36.822971,-1.1933233,36.9354943,148,1802,37,1433
8700,25205,2057,2,Personal,3,2,35253,3,2,35372,3,2,36492,3,2,37035,3,2,41494,9,15.5,-1.2630521,36.8068019,-1.2976368,36.7519827,379,4459,119,1663
8701,6219,1741,1,Personal,11,6,57988,11,6,57997,11,6,58693,11,6,61133,11,6,63533,10,20.9,-1.297694,36.749788,-1.2864396,36.8307935,105,2400,9,3136
8702,20380,868,3,Business,2,2,42080,2,2,42314,2,2,42814,2,2,44551,2,2,47062,9,26.3,-1.331619,36.847976,-1.265715,36.823815,233,2511,234,2237
8703,5475,2154,3,Business,26,2,41430,26,2,41491,26,2,42603,26,2,43234,26,2,43950,5,27.5,-1.290894,36.822971,-1.2765736,36.8513646,293,716,61,1743
8704,16045,788,3,Business,11,2,43282,11,2,48317,11,2,48374,11,2,49475,11,2,50869,8,22.1,-1.225322,36.80855,-1.259697,36.800802,596,1394,5035,1158
8705,8488,2154,3,Business,26,6,46614,26,6,46785,26,6,47263,26,6,47826,26,6,48678,6,25.9,-1.2765736,36.8513646,-1.2878913,36.8089253,510,852,171,1041
8706,5262,3404,3,Business,7,4,44589,7,4,44658,7,4,45134,7,4,45472,7,4,48680,5,24.3,-1.2584143,36.8048002,-1.279395,36.825364,727,3208,69,814
8707,15736,3147,3,Business,25,1,48449,25,1,48459,25,1,48804,25,1,49684,25,1,51687,17,27.9,-1.2551895,36.7822034,-1.3472066,36.7692638,854,2003,10,1225
8708,13940,1976,3,Business,18,3,34273,18,3,34330,18,3,35283,18,3,35513,18,3,37809,10,14.8,-1.257028,36.7810435,-1.2812601,36.7340272,234,2296,57,1183
8709,27532,517,3,Business,5,3,34335,5,3,34732,5,3,35730,5,3,38945,5,3,40800,14,22.5,-1.3177547,36.8303703,-1.306378,36.7519845,188,1855,397,4213
8710,5398,2779,1,Personal,11,3,62479,11,3,66364,11,3,66604,11,3,67091,11,3,69303,10,19.8,-1.3198867,36.798424,-1.276245,36.8363293,103,2212,3885,727
8711,17434,733,3,Business,21,5,38858,21,5,38889,21,5,38895,21,5,39255,21,5,40751,16,22.8,-1.2551895,36.7822034,-1.324282,36.86625,41,1496,31,366
8712,12659,3354,3,Business,3,3,40021,3,3,40346,3,3,40779,3,3,40973,3,3,41948,12,24.1,-1.3700383,36.9190174,-1.3234709,36.8493194,890,975,325,627
8713,11201,265,3,Business,29,1,47638,29,1,48365,29,1,49853,29,1,50558,29,1,51759,7,23.25888921888938,-1.300921,36.828195,-1.2817426,36.7846148,787,1201,727,2193
8714,930,2382,1,Personal,21,4,46045,21,4,46615,21,4,48604,21,4,48789,21,4,49684,8,22.5,-1.3188148,36.8092478,-1.2736095,36.8011282,312,895,570,2174
8715,25381,517,3,Business,3,4,29704,3,4,29726,3,4,29878,3,4,30334,3,4,31849,14,20.2,-1.3167113,36.8301563,-1.306378,36.7519845,523,1515,22,608
8716,12609,2546,1,Personal,18,6,38224,18,6,38240,18,6,38598,18,6,38851,18,6,39772,12,19.0,-1.2840605,36.8191699,-1.3343129,36.8637112,414,921,16,611
8717,7146,1927,3,Business,3,3,41581,3,3,41623,3,3,41941,3,3,42617,3,3,44259,16,27.2,-1.2620912,36.8013562,-1.3472066,36.7692638,937,1642,42,994
8718,13494,3718,3,Business,19,3,42509,19,3,42896,19,3,43261,19,3,43551,19,3,44956,5,22.0,-1.2650027,36.8126242,-1.2906618,36.8131222,206,1405,387,655
8719,518,3201,3,Business,31,4,48431,31,4,48492,31,4,49567,31,4,50126,31,4,51332,3,28.9,-1.2584143,36.8048002,-1.2551895,36.7822034,467,1206,61,1634
8720,6726,2521,3,Business,30,6,31669,30,6,31680,30,6,32064,30,6,32519,30,6,32991,4,23.25888921888938,-1.3167113,36.8301563,-1.3004062,36.829741,15,472,11,839
8721,8014,1246,3,Business,4,1,56142,4,1,57145,4,1,58080,4,1,58385,4,1,60883,22,23.25888921888938,-1.3700383,36.9190174,-1.2591485,36.7891335,883,2498,1003,1240
8722,14963,2200,3,Business,1,4,36563,1,4,36571,1,4,36779,1,4,36900,1,4,38973,4,23.25888921888938,-1.2765736,36.8513646,-1.290894,36.822971,171,2073,8,329
8723,23508,3064,3,Business,12,3,55823,12,3,56076,12,3,56513,12,3,56777,12,3,57242,3,20.9,-1.2622145,36.8087391,-1.2571472,36.7950633,205,465,253,701
8724,13843,633,3,Business,15,1,29297,15,1,29335,15,1,30675,15,1,30737,15,1,31353,4,23.25888921888938,-1.3077869,36.8443207,-1.3004062,36.829741,208,616,38,1402
8725,1317,1527,3,Business,2,4,47709,2,4,48044,2,4,49184,2,4,49616,2,4,52060,3,23.25888921888938,-1.3004062,36.829741,-1.2977627,36.8150388,211,2444,335,1572
8726,14247,2521,3,Business,5,6,33881,5,6,33909,5,6,34049,5,6,34198,5,6,35801,14,17.9,-1.3167113,36.8301563,-1.306378,36.7519845,523,1603,28,289
8727,4002,1469,3,Business,8,3,54186,8,3,54240,8,3,54341,8,3,55753,8,3,57048,15,23.25888921888938,-1.2551895,36.7822034,-1.2343236,36.8861,411,1295,54,1513
8728,25914,1209,3,Business,18,2,34690,18,2,35197,18,2,35975,18,2,36595,18,2,37948,9,19.6,-1.2574219,36.7927073,-1.3004062,36.829741,496,1353,507,1398
8729,3832,3222,3,Business,8,1,54771,8,1,55078,8,1,57643,8,1,57706,8,1,58609,8,24.8,-1.2551895,36.7822034,-1.295156,36.8094306,857,903,307,2628
8730,25254,3727,3,Business,13,3,58590,13,3,58605,13,3,58657,13,3,58944,13,3,60427,10,27.3,-1.2963097,36.7688221,-1.2659149,36.8054322,354,1483,15,339
8731,18789,393,3,Business,16,2,34125,16,2,34133,16,2,34334,16,2,35215,16,2,35711,4,23.25888921888938,-1.3167113,36.8301563,-1.3004062,36.829741,168,496,8,1082
8732,5641,635,3,Business,30,4,45777,30,4,45807,30,4,48826,30,4,49104,30,4,50481,5,23.25888921888938,-1.2549476,36.8269576,-1.2602337,36.7990548,27,1377,30,3297
8733,9356,60,3,Business,19,6,38349,19,6,38483,19,6,39409,19,6,39878,19,6,41772,8,25.4,-1.272828,36.816608,-1.2296618,36.8438272,857,1894,134,1395
8734,20094,1482,3,Business,15,4,52013,15,4,53987,15,4,54857,15,4,56382,15,4,57337,10,27.7,-1.3122474,36.8728544,-1.338579,36.8963038,675,955,1974,2395
8735,22220,3175,3,Business,1,4,45947,1,4,46004,1,4,46251,1,4,46515,1,4,48192,16,23.25888921888938,-1.2681004,36.7952081,-1.207546,36.7913976,167,1677,57,511
8736,15267,1280,3,Business,9,4,32253,9,4,32302,9,4,32739,9,4,33023,9,4,34512,8,23.25888921888938,-1.2551895,36.7822034,-1.3038156,36.8122733,953,1489,49,721
8737,12028,3660,1,Personal,24,2,44407,24,2,44522,24,2,45394,24,2,45618,24,2,46816,5,17.3,-1.283362,36.8260149,-1.2655477,36.8001682,88,1198,115,1096
8738,14602,1500,3,Business,27,2,55059,27,2,55346,27,2,55670,27,2,57859,27,2,59192,8,25.5,-1.3004062,36.829741,-1.2574219,36.7927073,660,1333,287,2513
8739,27501,2436,3,Business,10,1,49667,10,1,52407,10,1,52952,10,1,56337,10,1,57497,9,18.7,-1.2571472,36.7950633,-1.2295205,36.8120426,685,1160,2740,3930
8740,1357,136,3,Business,30,2,38523,30,2,39062,30,2,39775,30,2,41829,30,2,41838,10,23.25888921888938,-1.3254522,36.7216584,-1.2971024,36.7836598,831,9,539,2767
8741,13517,3283,3,Business,26,5,57849,26,5,57864,26,5,59151,26,5,59687,26,5,61306,13,23.25888921888938,-1.318062,36.849326,-1.2628473,36.781805,168,1619,15,1823
8742,28098,1787,3,Business,13,3,56355,13,3,56378,13,3,57506,13,3,58392,13,3,61173,18,29.2,-1.3014461,36.7661381,-1.2283403,36.8822756,708,2781,23,2014
8743,20153,3283,3,Business,30,2,54532,30,2,55001,30,2,55438,30,2,56015,30,2,58891,6,23.25888921888938,-1.272828,36.816608,-1.2628473,36.781805,843,2876,469,1014
8744,12744,2691,3,Business,19,1,44849,19,1,46253,19,1,46941,19,1,47079,19,1,48124,6,24.6,-1.2857671,36.7875614,-1.2810205,36.8248105,194,1045,1404,826
8745,3723,2685,1,Personal,18,4,38761,18,4,38780,18,4,39107,18,4,43072,18,4,45116,22,25.5,-1.3433181,36.9138018,-1.2899,36.7794355,120,2044,19,4292
8746,24773,1675,1,Personal,15,3,35913,15,3,36047,15,3,36691,15,3,36974,15,3,39320,8,16.3,-1.296797,36.7764525,-1.2850639,36.8179454,674,2346,134,927
8747,9516,2154,3,Business,6,2,48260,6,2,50636,6,2,51986,6,2,52195,6,2,53059,6,27.3,-1.28878,36.8168312,-1.2765736,36.8513646,878,864,2376,1559
8748,16614,2946,2,Personal,27,1,46049,27,1,46185,27,1,47092,27,1,47430,27,1,48494,8,24.1,-1.289521,36.8190724,-1.2749662,36.7658781,74,1064,136,1245
8749,2228,633,3,Business,13,3,50050,13,3,50098,13,3,50797,13,3,51541,13,3,52217,4,29.3,-1.3077869,36.8443207,-1.3004062,36.829741,233,676,48,1443
8750,5212,1642,3,Business,12,5,46095,12,5,48734,12,5,49950,12,5,50021,12,5,51512,5,27.0,-1.2728069,36.7962362,-1.2887076,36.8254658,844,1491,2639,1287
8751,5053,635,3,Business,25,1,49232,25,1,49250,25,1,49530,25,1,51212,25,1,52340,7,28.2,-1.3081376,36.8329772,-1.2602337,36.7990548,550,1128,18,1962
8752,20510,3080,3,Business,10,3,60967,10,3,60979,10,3,61161,10,3,61266,10,3,63707,13,27.5,-1.2551895,36.7822034,-1.3261306,36.850596,709,2441,12,287
8753,7420,1603,1,Personal,15,5,37115,15,5,37137,15,5,38057,15,5,38393,15,5,39640,6,19.9,-1.2830603,36.8298283,-1.3220191,36.8400166,444,1247,22,1256
8754,14714,2587,3,Business,2,3,42071,2,3,42165,2,3,43262,2,3,43522,2,3,44190,1,23.9,-1.279395,36.825364,-1.28878,36.8168312,362,668,94,1357
8755,38,3673,1,Personal,5,5,48371,5,5,49948,5,5,50610,5,5,53449,5,5,54183,6,26.5,-1.300405,36.8356262,-1.32571,36.805533,263,734,1577,3501
8756,11200,3116,1,Personal,4,1,56475,4,1,56496,4,1,57451,4,1,57901,4,1,58891,10,22.8,-1.270766,36.810988,-1.2353665,36.8128044,116,990,21,1405
8757,8885,3264,3,Business,18,2,44297,18,2,45224,18,2,45244,18,2,45674,18,2,47500,9,23.25888921888938,-1.2551895,36.7822034,-1.3080696,36.8237191,518,1826,927,450
8758,3606,2069,3,Business,24,5,37128,24,5,37197,24,5,37848,24,5,38242,24,5,39812,14,21.6,-1.3033561,36.8163631,-1.228911,36.881876,591,1570,69,1045
8759,12701,867,3,Business,8,1,51417,8,1,51530,8,1,52075,8,1,52341,8,1,53931,9,29.4,-1.2638185,36.7930057,-1.2991441,36.7528804,166,1590,113,811
8760,4947,2553,1,Personal,15,1,57465,15,1,58594,15,1,58831,15,1,59478,15,1,62256,9,23.25888921888938,-1.2918239,36.8235665,-1.284382,36.7746045,674,2778,1129,884
8761,8039,1500,3,Business,22,3,40826,22,3,40845,22,3,40871,22,3,43193,22,3,43212,10,23.1,-1.2991441,36.7528804,-1.2638185,36.7930057,515,19,19,2348
8762,2716,2330,3,Business,13,1,44422,13,1,44561,13,1,45665,13,1,45735,13,1,47171,5,23.25888921888938,-1.294597,36.7742999,-1.2915247,36.8055757,831,1436,139,1174
8763,20248,718,3,Business,13,3,35348,13,3,35377,13,3,36221,13,3,36455,13,3,38168,9,20.0,-1.2551895,36.7822034,-1.3090727,36.8315262,76,1713,29,1078
8764,4553,248,3,Business,27,3,53032,27,3,53080,27,3,53906,27,3,54930,27,3,56448,3,29.3,-1.2929747,36.7646358,-1.304735,36.7846054,682,1518,48,1850
8765,10834,294,1,Personal,5,4,43068,5,4,43117,5,4,44666,5,4,44854,5,4,46212,14,23.25888921888938,-1.2996373,36.7693721,-1.2522271,36.7772267,74,1358,49,1737
8766,1099,496,3,Business,17,3,59555,17,3,63277,17,3,64171,17,3,64496,17,3,65300,6,24.8,-1.2551895,36.7822034,-1.2785434,36.8215327,208,804,3722,1219
8767,14704,2186,1,Personal,28,1,54190,28,1,54278,28,1,55245,28,1,55946,28,1,57644,11,24.3,-1.2795197,36.8168287,-1.328128,36.8719,432,1698,88,1668
8768,23526,3291,3,Business,29,6,43468,29,6,43489,29,6,44376,29,6,44874,29,6,45613,4,23.8,-1.272828,36.816608,-1.2600926,36.8088685,456,739,21,1385
8769,1006,1584,3,Business,5,3,42456,5,3,42473,5,3,42561,5,3,43273,5,3,45585,4,22.0,-1.304033,36.7848695,-1.2973654,36.8105527,851,2312,17,800
8770,3476,393,3,Business,13,1,34036,13,1,34048,13,1,34055,13,1,37055,13,1,37057,11,23.25888921888938,-1.3167113,36.8301563,-1.2638185,36.7930057,515,2,12,3007
8771,1380,3391,1,Personal,25,2,57987,25,2,58324,25,2,59924,25,2,60123,25,2,61324,7,24.1,-1.2998789,36.8168963,-1.2747045,36.8406383,88,1201,337,1799
8772,555,412,3,Business,28,4,31415,28,4,31449,28,4,33440,28,4,34802,28,4,36638,10,19.6,-1.303596,36.778378,-1.266837,36.799249,306,1836,34,3353
8773,24646,2112,3,Business,26,2,62560,26,2,62582,26,2,63031,26,2,64500,26,2,65131,5,28.5,-1.2285835,36.8826468,-1.2156006,36.8916865,8,631,22,1918
8774,2008,2956,3,Business,7,4,66335,7,4,66441,7,4,67148,7,4,67426,7,4,69000,9,25.5,-1.3014461,36.7661381,-1.2584143,36.8048002,541,1574,106,985
8775,13221,2066,3,Business,12,6,31989,12,6,31996,12,6,33013,12,6,33628,12,6,35338,12,23.25888921888938,-1.3210189,36.8410551,-1.3692201,36.9252718,26,1710,7,1632
8776,10264,2869,3,Business,4,1,31462,4,1,31492,4,1,31801,4,1,31950,4,1,33456,9,22.0,-1.3025826,36.7670807,-1.2551895,36.7822034,330,1506,30,458
8777,3593,835,3,Business,3,3,48710,3,3,48738,3,3,49320,3,3,49429,3,3,50922,12,28.2,-1.2917868,36.7872675,-1.24188,36.76523,99,1493,28,691
8778,16830,2200,3,Business,29,1,45051,29,1,45372,29,1,46272,29,1,47791,29,1,48526,5,23.25888921888938,-1.290894,36.822971,-1.2545163,36.8243717,336,735,321,2419
8779,13459,1929,3,Personal,15,7,41000,15,7,41574,15,7,41930,15,7,43160,15,7,45414,17,18.1,-1.2022049,36.8000124,-1.2879179,36.7903517,101,2254,574,1586
8780,22105,391,3,Business,29,2,51321,29,2,51547,29,2,53870,29,2,55575,29,2,57587,5,26.8,-1.300921,36.828195,-1.2867454,36.8259017,696,2012,226,4028
8781,19996,2423,3,Business,18,4,47508,18,4,47750,18,4,48211,18,4,48897,18,4,50259,7,23.25888921888938,-1.2571472,36.7950633,-1.3028118,36.8174764,61,1362,242,1147
8782,14435,3711,3,Business,24,4,60510,24,4,60535,24,4,60821,24,4,61380,24,4,62292,1,26.0,-1.3012008,36.764868,-1.2943746,36.7687604,445,912,25,845
8783,10663,1582,1,Business,25,2,56095,25,2,59668,25,2,60334,25,2,60429,25,2,62578,6,23.8,-1.285244,36.832159,-1.2508229,36.7895263,532,2149,3573,761
8784,18070,478,3,Business,15,2,38096,15,2,38199,15,2,38498,15,2,39008,15,2,40047,6,24.4,-1.2551895,36.7822034,-1.2897368,36.8226783,903,1039,103,809
8785,6397,2136,1,Personal,4,3,52948,4,3,60004,4,3,60359,4,3,60944,4,3,61873,6,23.25888921888938,-1.2672588,36.8000252,-1.2939816,36.8118469,427,929,7056,940
8786,8501,2956,3,Business,15,4,48356,15,4,48376,15,4,49738,15,4,50151,15,4,50778,3,27.4,-1.2584143,36.8048002,-1.2551895,36.7822034,287,627,20,1775
8787,19682,733,3,Business,12,2,47128,12,2,47143,12,2,47167,12,2,47480,12,2,50169,21,24.6,-1.2551895,36.7822034,-1.3407764,36.9100521,630,2689,15,337
8788,8370,3579,3,Business,6,1,41802,6,1,41881,6,1,42511,6,1,42732,6,1,44971,22,23.25888921888938,-1.2615584,36.8149506,-1.1479335,36.8841725,205,2239,79,851
8789,11848,2194,1,Personal,6,4,42261,6,4,42420,6,4,44403,6,4,45115,6,4,46308,7,22.1,-1.3211235,36.7765164,-1.2994217,36.8009779,447,1193,159,2695
8790,27281,53,3,Business,15,5,38030,15,5,38232,15,5,38447,15,5,39913,15,5,42692,5,26.1,-1.3004062,36.829741,-1.2770708,36.8231093,763,2779,202,1681
8791,21049,3149,3,Business,9,6,35271,9,6,35334,9,6,35890,9,6,36768,9,6,38279,5,20.3,-1.3004062,36.829741,-1.3167113,36.8301563,311,1511,63,1434
8792,6634,238,3,Business,22,5,35365,22,5,35389,22,5,36193,22,5,36421,22,5,38969,11,22.4,-1.3077869,36.8443207,-1.2574219,36.7927073,127,2548,24,1032
8793,21575,494,1,Personal,25,5,59208,25,5,59786,25,5,61127,25,5,61748,25,5,64355,3,21.4,-1.2824911,36.8218042,-1.303664,36.818777,192,2607,578,1962
8794,19242,2801,3,Business,28,4,51790,28,4,51830,28,4,51880,28,4,52293,28,4,53736,10,29.9,-1.2674274,36.7870827,-1.3108386,36.7555239,576,1443,40,463
8795,20287,3557,3,Business,14,4,56632,14,4,56749,14,4,57256,14,4,57926,14,4,59350,10,27.8,-1.2546732,36.8086796,-1.2892762,36.764129,854,1424,117,1177
8796,9325,2125,2,Personal,28,5,60133,28,5,60217,28,5,61712,28,5,62667,28,5,64980,8,23.25888921888938,-1.3066189,36.7805505,-1.2835073,36.8275282,328,2313,84,2450
8797,2590,2733,3,Business,29,5,69188,29,5,69461,29,5,69741,29,5,72178,29,5,73976,6,23.25888921888938,-1.2963097,36.7688221,-1.2825422,36.73247,71,1798,273,2717
8798,3068,1927,3,Business,23,5,56755,23,5,57485,23,5,58449,23,5,59823,23,5,61640,17,24.7,-1.3472066,36.7692638,-1.2551895,36.7822034,101,1817,730,2338
8799,6597,3496,3,Business,30,2,45981,30,2,47028,30,2,47356,30,2,47674,30,2,49427,16,23.25888921888938,-1.3882008,36.7699445,-1.300921,36.828195,263,1753,1047,646
8800,7514,2423,3,Business,22,5,49888,22,5,49919,22,5,50622,22,5,50856,22,5,51824,5,23.25888921888938,-1.2551895,36.7822034,-1.2658315,36.809049,140,968,31,937
8801,9962,3091,3,Business,6,6,44023,6,6,44134,6,6,44483,6,6,45007,6,6,45437,1,26.5,-1.2813012,36.8323962,-1.290894,36.822971,378,430,111,873
8802,18894,1856,3,Business,16,2,55279,16,2,55311,16,2,56046,16,2,56329,16,2,58137,4,23.25888921888938,-1.273009,36.802807,-1.2684319,36.8165853,161,1808,32,1018
8803,16356,3085,1,Personal,25,2,37744,25,2,37795,25,2,38502,25,2,39160,25,2,39864,6,23.6,-1.3012014,36.8043289,-1.2789683,36.8284768,88,704,51,1365
8804,4507,3752,3,Business,15,3,48571,15,3,48624,15,3,49042,15,3,49412,15,3,52082,12,26.0,-1.2963097,36.7688221,-1.2919683,36.8500706,854,2670,53,788
8805,27613,186,3,Business,26,5,47143,26,5,47662,26,5,49312,26,5,49657,26,5,52564,25,23.25888921888938,-1.3700383,36.9190174,-1.2622851,36.7893989,547,2907,519,1995
8806,7134,1245,3,Business,30,5,31238,30,5,31281,30,5,31298,30,5,34153,30,5,34676,17,18.8,-1.300921,36.828195,-1.3198615,36.7110323,472,523,43,2872
8807,9679,391,3,Business,28,4,57823,28,4,58205,28,4,58698,28,4,58885,28,4,59838,5,23.25888921888938,-1.2777924,36.8231577,-1.3010429,36.8353335,752,953,382,680
8808,23188,2154,3,Business,11,2,55381,11,2,58270,11,2,58848,11,2,61832,11,2,63624,8,21.3,-1.2571472,36.7950633,-1.2765736,36.8513646,399,1792,2889,3562
8809,9199,2112,3,Business,31,4,55363,31,4,55371,31,4,55391,31,4,56375,31,4,57918,13,28.6,-1.2156006,36.8916865,-1.207546,36.7913976,248,1543,8,1004
8810,20280,3201,3,Business,7,5,30764,7,5,30816,7,5,31181,7,5,31943,7,5,35365,11,23.25888921888938,-1.2584143,36.8048002,-1.3053578,36.8607913,72,3422,52,1127
8811,7257,3727,3,Business,21,4,46359,21,4,46528,21,4,47053,21,4,47140,21,4,48951,8,25.3,-1.2963097,36.7688221,-1.2600616,36.7870182,269,1811,169,612
8812,19975,33,3,Personal,16,2,27083,16,2,32798,16,2,32867,16,2,33191,16,2,36879,5,23.25888921888938,-1.2544051,36.7982934,-1.2814609,36.8265932,303,3688,5715,393
8813,19114,2685,1,Personal,18,1,32010,18,1,32032,18,1,32323,18,1,33282,18,1,36307,21,15.0,-1.2972817,36.7795831,-1.3433181,36.9138018,354,3025,22,1250
8814,15938,84,3,Business,14,4,54333,14,4,55461,14,4,55888,14,4,55953,14,4,57387,15,28.2,-1.2551895,36.7822034,-1.2283403,36.8822756,14,1434,1128,492
8815,4287,3108,3,Business,19,5,37497,19,5,37506,19,5,37563,19,5,43417,19,5,48016,20,24.9,-1.2551895,36.7822034,-1.3251247,36.8995926,101,4599,9,5911
8816,13840,3560,3,Business,9,4,52126,9,4,52198,9,4,52815,9,4,53363,9,4,55233,12,25.6,-1.2860183,36.8975338,-1.279395,36.825364,174,1870,72,1165
8817,1877,3647,3,Business,19,1,58459,19,1,58638,19,1,59198,19,1,59467,19,1,60546,4,25.0,-1.272639,36.794723,-1.2669451,36.8033576,536,1079,179,829
8818,22748,970,3,Business,6,3,45852,6,3,45872,6,3,46052,6,3,46193,6,3,47045,2,22.5,-1.2551895,36.7822034,-1.2546732,36.7923244,91,852,20,321
8819,25114,1594,3,Business,22,1,50677,22,1,50695,22,1,51086,22,1,52085,22,1,52752,5,23.25888921888938,-1.2285835,36.8826468,-1.2156006,36.8916865,691,667,18,1390
8820,1963,661,3,Business,6,5,44434,6,5,44607,6,5,45199,6,5,45726,6,5,47265,4,20.5,-1.2950044,36.7512209,-1.2963097,36.7688221,549,1539,173,1119
8821,11344,1615,3,Personal,3,1,32213,3,1,32281,3,1,33731,3,1,33935,3,1,34897,4,18.2,-1.2686893,36.8096032,-1.2793859,36.8218002,106,962,68,1654
8822,20667,733,3,Business,17,3,60203,17,3,61422,17,3,61427,17,3,61850,17,3,63281,15,23.25888921888938,-1.2551895,36.7822034,-1.207546,36.7913976,576,1431,1219,428
8823,2415,3291,3,Business,8,6,49494,8,6,52494,8,6,53532,8,6,54515,8,6,55136,4,23.25888921888938,-1.265715,36.823815,-1.2600926,36.8088685,427,621,3000,2021
8824,17160,868,3,Business,2,4,34818,2,4,34839,2,4,36031,2,4,36149,2,4,36717,4,23.25888921888938,-1.2600926,36.8088685,-1.265715,36.823815,205,568,21,1310
8825,26773,3521,3,Business,19,3,28296,19,3,35900,19,3,37494,19,3,37848,19,3,38944,4,23.25888921888938,-1.2768326,36.8073804,-1.2956951,36.8129242,565,1096,7604,1948
8826,20788,2587,3,Business,27,4,55286,27,4,55325,27,4,55485,27,4,55781,27,4,58710,5,23.8,-1.2584143,36.8048002,-1.28878,36.8168312,86,2929,39,456
8827,18579,3117,1,Personal,22,3,39306,22,3,39402,22,3,40435,22,3,40576,22,3,41610,9,22.9,-1.2850644,36.8343657,-1.2295205,36.8120426,754,1034,96,1174
8828,23867,2200,3,Business,18,1,46026,18,1,46099,18,1,46104,18,1,47252,18,1,47256,1,27.8,-1.290894,36.822971,-1.279395,36.825364,906,4,73,1153
8829,11287,1081,3,Business,5,2,52521,5,2,53021,5,2,53738,5,2,54081,5,2,56185,9,27.6,-1.291768,36.8297208,-1.3025826,36.7670807,906,2104,500,1060
8830,4542,3291,3,Business,14,4,48485,14,4,48580,14,4,50713,14,4,51076,14,4,51846,5,27.8,-1.2628473,36.781805,-1.2600926,36.8088685,228,770,95,2496
8831,24554,1500,3,Business,24,4,37791,24,4,37969,24,4,38004,24,4,39129,24,4,39137,7,24.7,-1.2574219,36.7927073,-1.2916738,36.7901057,10,8,178,1160
8832,19648,1105,3,Business,7,3,52286,7,3,53156,7,3,54186,7,3,54580,7,3,56741,16,28.1,-1.3322618,36.8045412,-1.3196979,36.7009845,914,2161,870,1424
8833,12797,3426,3,Business,16,5,61401,16,5,61487,16,5,61964,16,5,62455,16,5,63487,5,26.1,-1.3014461,36.7661381,-1.2835228,36.7437619,276,1032,86,968
8834,2989,909,3,Business,15,1,52972,15,1,52998,15,1,54377,15,1,54569,15,1,56838,16,23.25888921888938,-1.225322,36.80855,-1.2949439,36.7604214,547,2269,26,1571
8835,3363,3194,3,Business,6,3,47016,6,3,47066,6,3,48938,6,3,49503,6,3,50779,7,23.25888921888938,-1.2738397,36.8186697,-1.2551895,36.7822034,119,1276,50,2437
8836,23133,190,3,Business,3,1,32778,3,1,32849,3,1,34531,3,1,35002,3,1,35416,6,18.4,-1.3278522,36.8711134,-1.3270347,36.8667362,611,414,71,2153
8837,4552,3283,3,Business,25,5,49376,25,5,49505,25,5,49700,25,5,50690,25,5,53539,6,23.2,-1.272828,36.816608,-1.2628473,36.781805,116,2849,129,1185
8838,10501,1245,3,Business,20,2,29655,20,2,29659,20,2,29870,20,2,30526,20,2,32553,17,18.9,-1.2599563,36.7993439,-1.3198615,36.7110323,401,2027,4,867
8839,4180,1030,1,Personal,5,2,55292,5,2,55526,5,2,57785,5,2,59580,5,2,60462,6,21.7,-1.2553615,36.7895376,-1.2886923,36.8241519,820,882,234,4054
8840,5802,248,3,Business,17,3,33467,17,3,33559,17,3,35226,17,3,35597,17,3,39712,12,23.25888921888938,-1.304735,36.7846054,-1.313266,36.6935289,327,4115,92,2038
8841,15468,1578,3,Business,5,5,33338,5,5,33381,5,5,33484,5,5,35750,5,5,36482,6,18.0,-1.2551895,36.7822034,-1.28878,36.8168312,74,732,43,2369
8842,14036,190,3,Business,6,2,38562,6,2,40293,6,2,40759,6,2,41285,6,2,41932,3,24.9,-1.3270347,36.8667362,-1.3385185,36.8725654,559,647,1731,992
8843,11013,136,3,Business,23,4,37055,23,4,37377,23,4,37780,23,4,38009,23,4,39547,14,23.3,-1.3254522,36.7216584,-1.2950408,36.8098172,855,1538,322,632
8844,19159,2676,3,Business,25,1,53442,25,1,53452,25,1,53459,25,1,54378,25,1,58068,2,28.1,-1.2963097,36.7688221,-1.3014461,36.7661381,425,3690,10,926
8845,8266,3613,3,Business,7,5,33748,7,5,33781,7,5,34161,7,5,34340,7,5,37479,3,23.25888921888938,-1.2802043,36.7650079,-1.2601873,36.7559637,161,3139,33,559
8846,8300,2733,3,Business,5,3,54040,5,3,54046,5,3,54131,5,3,54256,5,3,56157,5,24.8,-1.2963097,36.7688221,-1.2995132,36.8043032,445,1901,6,210
8847,17594,2271,3,Business,30,2,42381,30,2,42878,30,2,44053,30,2,44607,30,2,46583,12,23.25888921888938,-1.293515,36.897607,-1.228911,36.881876,883,1976,497,1729
8848,18212,2546,1,Personal,8,1,55777,8,1,55864,8,1,56570,8,1,56882,8,1,59154,18,24.8,-1.3021558,36.8106865,-1.3664581,36.9177807,449,2272,87,1018
8849,6488,3222,3,Business,18,2,54140,18,2,54171,18,2,54339,18,2,54573,18,2,55137,4,25.7,-1.2551895,36.7822034,-1.2617028,36.7983849,575,564,31,402
8850,1451,647,3,Business,14,5,48782,14,5,48895,14,5,49153,14,5,49909,14,5,50882,4,22.9,-1.3004062,36.829741,-1.292163,36.8000995,243,973,113,1014
8851,4029,3441,3,Business,5,2,43771,5,2,43796,5,2,44742,5,2,45314,5,2,46472,8,25.4,-1.300722,36.7882234,-1.2551895,36.7822034,19,1158,25,1518
8852,28011,1500,3,Business,29,1,40744,29,1,41012,29,1,41540,29,1,43556,29,1,44712,8,23.25888921888938,-1.3004062,36.829741,-1.2638185,36.7930057,573,1156,268,2544
8853,22682,3619,2,Personal,11,4,61506,11,4,61538,11,4,62113,11,4,62505,11,4,64844,8,23.8,-1.2989758,36.7753577,-1.278612,36.8195876,105,2339,32,967
8854,27700,2169,2,Personal,2,6,36325,2,6,36410,2,6,37032,2,6,38032,2,6,39160,6,23.8,-1.3205164,36.8098882,-1.3019352,36.8167681,208,1128,85,1622
8855,13641,1271,3,Business,25,1,59123,25,1,59216,25,1,61864,25,1,62557,25,1,63647,12,27.6,-1.3244885,36.897792,-1.3166679,36.824763,26,1090,93,3341
8856,6346,2828,3,Business,14,3,59517,14,3,59760,14,3,60637,14,3,61308,14,3,62590,7,23.4,-1.308819,36.8421201,-1.3280558,36.8816781,708,1282,243,1548
8857,3528,2981,1,Personal,2,2,54243,2,2,56175,2,2,58731,2,2,59129,2,2,61521,10,26.3,-1.2750798,36.8451936,-1.2571472,36.7950633,755,2392,1932,2954
8858,25367,173,3,Business,10,6,55180,10,6,55306,10,6,55329,10,6,55860,10,6,56934,7,24.8,-1.2993231,36.7753372,-1.2611642,36.7949932,282,1074,126,554
8859,20743,3447,1,Personal,25,5,44860,25,5,45349,25,5,47697,25,5,48227,25,5,51052,13,21.2,-1.3221449,36.8565652,-1.2562674,36.8191447,116,2825,489,2878
8860,17417,2358,4,Business,4,4,45793,4,4,47332,4,4,48210,4,4,48321,4,4,50871,36,23.25888921888938,-1.3256904,36.8747943,-1.2540899,36.7042728,31,2550,1539,989
8861,26801,1753,2,Business,5,5,64127,5,5,64135,5,5,64496,5,5,64914,5,5,66273,11,24.9,-1.2551895,36.7822034,-1.3107918,36.761794,648,1359,8,779
8862,18839,3069,1,Personal,17,4,61176,17,4,61283,17,4,62338,17,4,62683,17,4,64815,13,22.2,-1.2786894,36.8032321,-1.329568,36.8520825,340,2132,107,1400
8863,12249,136,3,Business,21,1,55592,21,1,56768,21,1,58465,21,1,58860,21,1,61406,14,21.8,-1.3326173,36.7146233,-1.3233496,36.8139159,791,2546,1176,2092
8864,11963,2987,3,Business,11,2,40353,11,2,40583,11,2,41976,11,2,42051,11,2,43004,12,24.0,-1.270212,36.8210877,-1.2156006,36.8916865,598,953,230,1468
8865,6658,366,2,Personal,1,3,49794,1,3,49802,1,3,49812,1,3,50634,1,3,51318,5,24.1,-1.2857671,36.7875614,-1.268027,36.8037005,260,684,8,832
8866,24277,635,3,Business,10,1,37611,10,1,37625,10,1,37730,10,1,40563,10,1,42420,10,23.25888921888938,-1.3016417,36.8271679,-1.240299,36.795942,595,1857,14,2938
8867,5045,3391,1,Personal,6,6,40382,6,6,40758,6,6,42452,6,6,43236,6,6,44351,7,24.1,-1.2998789,36.8168963,-1.3314446,36.8264081,328,1115,376,2478
8868,22894,928,3,Business,30,3,35147,30,3,35164,30,3,36860,30,3,38366,30,3,40917,18,25.2,-1.3319467,36.7766998,-1.2551895,36.7822034,328,2551,17,3202
8869,12350,3295,3,Business,7,5,52115,7,5,52127,7,5,52448,7,5,53033,7,5,54090,7,24.7,-1.2571472,36.7950633,-1.2966203,36.817837,882,1057,12,906
8870,14509,598,2,Business,28,5,57501,28,5,57527,28,5,57573,28,5,57714,28,5,59638,10,25.7,-1.2536797,36.7995085,-1.2108864,36.7807022,882,1924,26,187
8871,11020,1724,3,Business,24,5,35829,24,5,35930,24,5,36821,24,5,37216,24,5,37939,8,18.2,-1.2843061,36.82294,-1.2551895,36.7822034,204,723,101,1286
8872,21440,2335,3,Business,25,2,57557,25,2,57568,25,2,58098,25,2,58404,25,2,61130,22,27.0,-1.2551895,36.7822034,-1.3562374,36.9042954,228,2726,11,836
8873,24889,1469,3,Business,29,2,41234,29,2,41576,29,2,42169,29,2,42424,29,2,43539,8,23.5,-1.2551895,36.7822034,-1.2854174,36.7951152,345,1115,342,848
8874,19253,1329,3,Business,11,1,44180,11,1,44246,11,1,44254,11,1,44472,11,1,45026,3,24.0,-1.273056,36.811298,-1.2567464,36.7915273,315,554,66,226
8875,28185,3647,3,Business,10,3,57282,10,3,57292,10,3,57962,10,3,58128,10,3,59391,8,30.6,-1.272639,36.794723,-1.2981102,36.8293513,92,1263,10,836
8876,831,3686,3,Business,16,1,38989,16,1,39000,16,1,39094,16,1,39348,16,1,40320,14,19.1,-1.2551895,36.7822034,-1.242902,36.870334,726,972,11,348
8877,2521,733,3,Business,26,1,39655,26,1,39671,26,1,40316,26,1,40393,26,1,41208,7,23.2,-1.2551895,36.7822034,-1.2795549,36.7627011,274,815,16,722
8878,3737,2207,3,Business,15,5,51276,15,5,51353,15,5,52046,15,5,52462,15,5,56095,9,28.1,-1.2325706,36.8083923,-1.2696908,36.81519,244,3633,77,1109
8879,23199,3149,3,Business,7,4,35447,7,4,35480,7,4,35795,7,4,38055,7,4,38823,5,27.8,-1.3004062,36.829741,-1.3167113,36.8301563,849,768,33,2575
8880,25534,2216,3,Business,14,1,58815,14,1,59556,14,1,59727,14,1,59841,14,1,60934,5,23.3,-1.255956,36.789867,-1.2650523,36.7866798,633,1093,741,285
8881,15672,2655,1,Personal,18,1,31116,18,1,31576,18,1,32417,18,1,32624,18,1,33198,2,14.9,-1.260039,36.8159152,-1.2515167,36.812185,56,574,460,1048
8882,17234,1990,3,Business,8,3,41378,8,3,41421,8,3,42927,8,3,43827,8,3,46366,10,23.25888921888938,-1.2558721,36.722296,-1.275442,36.7660207,165,2539,43,2406
8883,27779,3684,2,Personal,30,7,45487,30,7,45506,30,7,46553,30,7,47727,30,7,50201,16,24.6,-1.3039695,36.7838267,-1.2294985,36.8775495,612,2474,19,2221
8884,19451,3599,3,Business,26,1,39420,26,1,40655,26,1,44233,26,1,44531,26,1,48094,15,23.0,-1.3302996,36.8707935,-1.2912772,36.7734495,660,3563,1235,3876
8885,7524,1882,3,Business,30,3,42143,30,3,42309,30,3,42973,30,3,44467,30,3,45701,7,25.0,-1.2958783,36.7928125,-1.2588775,36.8079744,246,1234,166,2158
8886,3641,517,3,Business,3,1,43988,3,1,44221,3,1,45085,3,1,45522,3,1,47917,14,22.4,-1.3177547,36.8303703,-1.306378,36.7519845,878,2395,233,1301
8887,21189,2741,1,Personal,3,5,38754,3,5,38792,3,5,39896,3,5,40125,3,5,41482,11,21.6,-1.322999,36.7832633,-1.2884066,36.7866984,207,1357,38,1333
8888,596,2763,3,Business,2,2,40174,2,2,40350,2,2,40427,2,2,41209,2,2,41914,5,26.2,-1.2551895,36.7822034,-1.2711982,36.8240199,377,705,176,859
8889,19282,1484,3,Business,6,4,53823,6,4,54003,6,4,54275,6,4,54675,6,4,55671,4,23.25888921888938,-1.2551895,36.7822034,-1.2764851,36.8007126,518,996,180,672
8890,3193,1234,2,Personal,28,1,40152,28,1,41158,28,1,41777,28,1,42860,28,1,44044,6,22.7,-1.2738167,36.8157821,-1.3041129,36.8104939,752,1184,1006,1702
8891,22238,3091,3,Business,24,3,56087,24,3,57162,24,3,57995,24,3,58342,24,3,59479,4,23.25888921888938,-1.2765736,36.8513646,-1.290894,36.822971,531,1137,1075,1180
8892,6259,1329,3,Business,20,4,60453,20,4,60973,20,4,61853,20,4,62054,20,4,63047,7,22.9,-1.273056,36.811298,-1.2957031,36.7654104,86,993,520,1081
8893,20841,635,3,Business,5,2,37297,5,2,37307,5,2,37360,5,2,37439,5,2,39087,6,17.9,-1.2599563,36.7993439,-1.2824577,36.7967953,100,1648,10,132
8894,4538,3647,3,Business,13,4,47720,13,4,47779,13,4,48903,13,4,49358,13,4,49666,2,23.2,-1.272639,36.794723,-1.2746436,36.803682,168,308,59,1579
8895,23877,302,3,Business,19,3,67187,19,3,68754,19,3,69293,19,3,69589,19,3,71092,7,23.3,-1.2649605,36.7981777,-1.2696795,36.8640088,38,1503,1567,835
8896,26412,1927,3,Business,7,1,54273,7,1,57654,7,1,58598,7,1,59197,7,1,61578,11,20.4,-1.3404187,36.7614685,-1.2965679,36.8158653,874,2381,3381,1543
8897,19165,635,3,Business,5,3,35395,5,3,35404,5,3,35774,5,3,38531,5,3,39287,6,22.4,-1.300921,36.828195,-1.3229345,36.8566974,857,756,9,3127
8898,15492,453,1,Personal,22,3,54370,22,3,54387,22,3,54654,22,3,56069,22,3,56975,5,25.9,-1.275075,36.766391,-1.2970281,36.7903141,898,906,17,1682
8899,13109,2869,3,Business,3,3,43845,3,3,44047,3,3,44678,3,3,44845,3,3,48040,9,27.3,-1.28878,36.8168312,-1.3025826,36.7670807,441,3195,202,798
8900,26230,1792,3,Business,20,2,56711,20,2,57035,20,2,57388,20,2,57646,20,2,61624,13,24.1,-1.2809121,36.7852524,-1.256055,36.7695771,268,3978,324,611
8901,216,1363,3,Business,30,6,33417,30,6,33440,30,6,33448,30,6,33581,30,6,34522,4,23.25888921888938,-1.3004062,36.829741,-1.2819608,36.8109939,111,941,23,141
8902,5763,302,3,Business,8,6,63112,8,6,63138,8,6,63504,8,6,64199,8,6,65338,7,22.2,-1.2649605,36.7981777,-1.2510147,36.7522023,112,1139,26,1061
8903,19065,71,3,Business,6,5,52174,6,5,52494,6,5,53498,6,5,54157,6,5,55673,10,22.6,-1.2891922,36.825189,-1.293886,36.7596951,629,1516,320,1663
8904,12819,2557,1,Personal,19,5,36235,19,5,36994,19,5,37339,19,5,37565,19,5,38529,3,20.0,-1.2944457,36.7923516,-1.2969293,36.8027733,299,964,759,571
8905,26269,868,3,Business,8,1,51088,8,1,51118,8,1,51735,8,1,51819,8,1,54275,7,29.6,-1.2628473,36.781805,-1.265715,36.823815,106,2456,30,701
8906,18782,3300,3,Business,30,4,33720,30,4,33787,30,4,34538,30,4,34865,30,4,36410,9,19.5,-1.259478,36.8017813,-1.303596,36.778378,341,1545,67,1078
8907,19156,3213,1,Personal,10,2,34212,10,2,34242,10,2,34987,10,2,36444,10,2,37078,3,16.1,-1.2854174,36.7951152,-1.3007534,36.7964576,465,634,30,2202
8908,19038,3295,3,Business,19,2,42712,19,2,42785,19,2,43609,19,2,44044,19,2,45452,14,27.6,-1.2571472,36.7950633,-1.2706945,36.8786243,404,1408,73,1259
8909,9311,2330,3,Business,31,5,62156,31,5,62292,31,5,62568,31,5,63069,31,5,64183,12,23.9,-1.2642903,36.8002137,-1.2284323,36.8757058,247,1114,136,777
8910,914,286,3,Business,22,4,52927,22,4,53005,22,4,53751,22,4,53982,22,4,55838,12,26.2,-1.2551895,36.7822034,-1.3223238,36.8320056,250,1856,78,977
8911,23111,3626,2,Personal,22,3,54294,22,3,54299,22,3,55678,22,3,56018,22,3,60419,32,25.6,-1.3216456,36.7145156,-1.349287,36.9390989,226,4401,5,1719
8912,19553,3326,3,Business,29,2,47718,29,2,47743,29,2,48057,29,2,48642,29,2,48645,3,23.7,-1.2551895,36.7822034,-1.2560455,36.7800867,647,3,25,899
8913,21331,1178,3,Business,30,4,48685,30,4,48740,30,4,49540,30,4,50009,30,4,50892,7,20.7,-1.2866544,36.784311,-1.2627203,36.7929743,536,883,55,1269
8914,20950,2931,3,Business,28,4,37363,28,4,38628,28,4,42189,28,4,45293,28,4,50729,11,23.6,-1.3433181,36.9138018,-1.287957,36.9550037,507,5436,1265,6665
8915,3204,2066,3,Business,13,4,48948,13,4,49247,13,4,49883,13,4,50034,13,4,51096,8,26.5,-1.316961,36.820337,-1.3332749,36.8708147,189,1062,299,787
8916,10559,81,3,Business,28,1,53649,28,1,54045,28,1,54567,28,1,54965,28,1,55840,4,26.1,-1.2641496,36.7914139,-1.258606,36.800887,880,875,396,920
8917,22548,2399,1,Personal,24,5,47537,24,5,47547,24,5,47792,24,5,47901,24,5,50685,12,20.8,-1.2551895,36.7822034,-1.3097713,36.849494,668,2784,10,354
8918,11242,1389,3,Business,18,5,50901,18,5,50987,18,5,52002,18,5,53078,18,5,54556,15,26.8,-1.2551895,36.7822034,-1.207546,36.7913976,902,1478,86,2091
8919,7324,2783,2,Personal,6,3,28232,6,3,28711,6,3,30211,6,3,30690,6,3,31514,6,15.9,-1.272704,36.7931279,-1.2989758,36.7753577,116,824,479,1979
8920,23315,2457,3,Business,30,2,53697,30,2,54443,30,2,55080,30,2,55393,30,2,56631,7,27.2,-1.2551895,36.7822034,-1.2915484,36.8297516,462,1238,746,950
8921,24673,3123,1,Personal,20,5,62074,20,5,62096,20,5,62264,20,5,62974,20,5,65646,16,20.0,-1.2859576,36.8197604,-1.3169591,36.7000029,648,2672,22,878
8922,4905,2801,3,Business,15,4,33048,15,4,33134,15,4,34251,15,4,34390,15,4,35120,7,19.8,-1.2595422,36.7871178,-1.2684319,36.8165853,103,730,86,1256
8923,16757,2689,1,Business,26,6,64671,26,6,64874,26,6,65460,26,6,65755,26,6,67025,9,22.3,-1.2675979,36.8155653,-1.3095666,36.7698746,186,1270,203,881
8924,12759,91,3,Personal,5,2,32792,5,2,32871,5,2,34528,5,2,36798,5,2,37236,9,20.8,-1.2775276,36.8140021,-1.2990731,36.8488058,436,438,79,3927
8925,10110,3291,3,Business,14,2,42215,14,2,42306,14,2,42653,14,2,43412,14,2,44135,5,23.25888921888938,-1.2566689,36.7796952,-1.2600926,36.8088685,379,723,91,1106
8926,22337,1075,3,Business,4,4,54614,4,4,54628,4,4,55707,4,4,55942,4,4,57808,1,27.4,-1.2649605,36.7981777,-1.2527958,36.8003131,205,1866,14,1314
8927,4183,3557,3,Business,25,1,54895,25,1,54922,25,1,55121,25,1,55217,25,1,55730,5,30.3,-1.2575407,36.7868197,-1.2546732,36.8086796,280,513,27,295
8928,2731,1271,3,Business,1,1,48752,1,1,49895,1,1,54469,1,1,54849,1,1,58297,16,23.25888921888938,-1.2927792,36.9053492,-1.2649605,36.7981777,404,3448,1143,4954
8929,11347,635,3,Business,12,5,46374,12,5,46546,12,5,47453,12,5,47783,12,5,48180,2,26.7,-1.2679514,36.8095213,-1.2599563,36.7993439,394,397,172,1237
8930,6409,3686,3,Business,26,2,35962,26,2,35977,26,2,36051,26,2,36617,26,2,37363,3,22.0,-1.2551895,36.7822034,-1.2546732,36.8086796,876,746,15,640
8931,21719,2412,3,Business,16,4,61116,16,4,61898,16,4,64581,16,4,65039,16,4,66635,12,19.4,-1.2248308,36.8012573,-1.2297202,36.8819507,102,1596,782,3141
8932,5962,718,3,Business,3,5,54429,3,5,54490,3,5,54872,3,5,55378,3,5,58619,8,23.25888921888938,-1.2551895,36.7822034,-1.3047132,36.8089553,161,3241,61,888
8933,18765,1342,3,Business,25,4,46280,25,4,47734,25,4,48404,25,4,48466,25,4,49888,9,20.2,-1.2551895,36.7822034,-1.3025826,36.7670807,263,1422,1454,732
8934,19312,844,1,Personal,3,2,45654,3,2,53059,3,2,53146,3,2,53810,3,2,56399,19,20.0,-1.2343087,36.84749,-1.2513529,36.752172,101,2589,7405,751
8935,18407,3711,3,Business,7,1,40539,7,1,40547,7,1,41425,7,1,41731,7,1,42666,3,24.7,-1.3012008,36.764868,-1.2979147,36.7857814,846,935,8,1184
8936,6863,393,3,Business,4,4,35753,4,4,36665,4,4,37475,4,4,38373,4,4,40491,14,23.25888921888938,-1.3177547,36.8303703,-1.306378,36.7519845,208,2118,912,1708
8937,4934,496,3,Business,20,4,52290,20,4,52320,20,4,52723,20,4,53488,20,4,55136,7,27.8,-1.2551895,36.7822034,-1.2853938,36.8095554,848,1648,30,1168
8938,23182,2676,1,Business,29,3,30661,29,3,30701,29,3,31382,29,3,32528,29,3,32993,2,15.3,-1.304033,36.7848695,-1.2963097,36.7688221,88,465,40,1827
8939,26245,1008,3,Personal,3,5,42470,3,5,42536,3,5,42727,3,5,43286,3,5,45007,5,23.25888921888938,-1.2868973,36.8232984,-1.3039934,36.8180494,831,1721,66,750
8940,26097,2956,3,Business,26,2,26709,26,2,28270,26,2,28988,26,2,29972,26,2,33870,6,21.8,-1.2584143,36.8048002,-1.2931121,36.8224572,119,3898,1561,1702
8941,19462,3291,3,Business,14,5,34955,14,5,34976,14,5,36963,14,5,37859,14,5,40029,16,18.0,-1.293515,36.897607,-1.2600926,36.8088685,297,2170,21,2883
8942,11785,1959,3,Business,25,4,40567,25,4,40576,25,4,41253,25,4,42247,25,4,43806,19,23.25888921888938,-1.2560455,36.7800867,-1.3207349,36.8819157,438,1559,9,1671
8943,9209,928,3,Business,8,5,46903,8,5,47194,8,5,47331,8,5,53249,8,5,55511,12,27.2,-1.2551895,36.7822034,-1.3127877,36.8481987,451,2262,291,6055
8944,1303,2064,2,Personal,31,5,30716,31,5,30736,31,5,30873,31,5,32339,31,5,33022,3,14.8,-1.2649605,36.7981777,-1.2676593,36.8103939,446,683,20,1603
8945,21648,2030,3,Business,7,4,44396,7,4,44409,7,4,44843,7,4,45413,7,4,45592,2,27.5,-1.2495931,36.8065087,-1.2601197,36.7985271,489,179,13,1004
8946,25666,706,3,Business,27,4,40127,27,4,40300,27,4,40939,27,4,41608,27,4,42101,4,23.0,-1.3004062,36.829741,-1.3077869,36.8443207,659,493,173,1308
8947,1069,1271,3,Business,19,2,59066,19,2,59177,19,2,59829,19,2,60739,19,2,63840,29,28.2,-1.3244885,36.897792,-1.1838303,36.9543295,675,3101,111,1562
8948,19322,1269,3,Personal,10,5,65583,10,5,65594,10,5,66795,10,5,66934,10,5,68826,14,21.0,-1.3271155,36.733289,-1.2817426,36.7846148,144,1892,11,1340
8949,15194,231,1,Personal,28,5,47216,28,5,47551,28,5,47845,28,5,48228,28,5,49061,3,24.9,-1.2872652,36.8267613,-1.2956951,36.8129242,698,833,335,677
8950,20569,3201,3,Business,30,2,52403,30,2,54040,30,2,54471,30,2,55054,30,2,55581,3,23.25888921888938,-1.2584143,36.8048002,-1.2551895,36.7822034,484,527,1637,1014
8951,7256,2587,3,Business,23,3,52782,23,3,53023,23,3,55199,23,3,55412,23,3,59831,7,27.4,-1.28878,36.8168312,-1.2551895,36.7822034,268,4419,241,2389
8952,27837,1329,3,Business,10,5,46091,10,5,46424,10,5,49243,10,5,49379,10,5,50034,4,21.7,-1.2795183,36.8238089,-1.273056,36.811298,229,655,333,2955
8953,19509,868,3,Business,20,4,38835,20,4,38876,20,4,39141,20,4,39481,20,4,42075,7,22.3,-1.2628473,36.781805,-1.265715,36.823815,268,2594,41,605
8954,12520,2989,3,Business,31,1,47901,31,1,47933,31,1,48687,31,1,49106,31,1,50377,12,23.7,-1.279395,36.825364,-1.3472066,36.7692638,26,1271,32,1173
8955,13766,3677,1,Personal,5,4,54780,5,4,54979,5,4,55448,5,4,57012,5,4,58116,6,22.2,-1.2925792,36.79069,-1.2717851,36.8105363,379,1104,199,2033
8956,10331,3635,1,Business,25,2,39104,25,2,39126,25,2,39383,25,2,40293,25,2,40763,3,23.8,-1.2584143,36.8048002,-1.2615888,36.7928732,647,470,22,1167
8957,10427,248,3,Business,26,5,38117,26,5,38140,26,5,38572,26,5,38861,26,5,40440,10,23.25888921888938,-1.304735,36.7846054,-1.2623332,36.8091055,168,1579,23,721
8958,8052,3686,3,Business,17,3,47927,17,3,47947,17,3,47975,17,3,48408,17,3,50474,10,23.25888921888938,-1.2551895,36.7822034,-1.2940111,36.7966518,854,2066,20,461
8959,22143,2066,3,Business,30,6,50335,30,6,50356,30,6,51005,30,6,51246,30,6,53421,12,28.7,-1.3210189,36.8410551,-1.3664581,36.9177807,843,2175,21,890
8960,12795,3689,3,Business,20,4,34103,20,4,34113,20,4,34272,20,4,35096,20,4,35345,1,18.5,-1.2584143,36.8048002,-1.2527958,36.8003131,56,249,10,983
8961,2706,3669,3,Business,8,4,41147,8,4,41173,8,4,41335,8,4,42349,8,4,42817,2,26.3,-1.2669099,36.7977433,-1.2615888,36.7928732,647,468,26,1176
8962,6792,1699,3,Business,12,5,35408,12,5,35515,12,5,36557,12,5,36715,12,5,37649,8,18.6,-1.3108674,36.795817,-1.269534,36.80697,299,934,107,1200
8963,12972,1874,3,Business,11,1,41201,11,1,41212,11,1,42097,11,1,42418,11,1,44291,20,23.9,-1.2571472,36.7950633,-1.3700383,36.9190174,28,1873,11,1206
8964,2446,2174,3,Business,12,5,55933,12,5,55955,12,5,55964,12,5,59868,12,5,59920,15,26.5,-1.2482781,36.884092,-1.214071,36.7985052,86,52,22,3913
8965,23263,3521,3,Business,8,1,51408,8,1,51472,8,1,52473,8,1,53335,8,1,54060,7,29.5,-1.2874648,36.8271985,-1.32589,36.831679,790,725,64,1863
8966,1101,1473,3,Business,20,1,53206,20,1,53231,20,1,53567,20,1,53897,20,1,56551,19,23.25888921888938,-1.2682478,36.8072852,-1.3700383,36.9190174,183,2654,25,666
8967,18328,2112,3,Business,27,3,43677,27,3,43736,27,3,44662,27,3,46395,27,3,46397,14,26.2,-1.2571472,36.7950633,-1.2156006,36.8916865,953,2,59,2659
8968,9576,3695,1,Personal,18,2,38074,18,2,38177,18,2,38958,18,2,40713,18,2,41877,3,22.6,-1.2782978,36.8273238,-1.2894917,36.8056192,857,1164,103,2536
8969,18767,2583,3,Personal,20,1,56510,20,1,56605,20,1,56986,20,1,57190,20,1,57969,6,23.25888921888938,-1.26249,36.799715,-1.2607569,36.7747575,959,779,95,585
8970,1831,3647,3,Business,31,3,38076,31,3,38139,31,3,38611,31,3,38830,31,3,39717,4,24.9,-1.272639,36.794723,-1.2609186,36.7938342,620,887,63,691
8971,11485,635,3,Business,7,4,55873,7,4,55977,7,4,56385,7,4,57787,7,4,58711,6,20.1,-1.2599563,36.7993439,-1.264621,36.778904,726,924,104,1810
8972,27023,1469,3,Business,4,4,55356,4,4,55375,4,4,56981,4,4,57124,4,4,58797,15,24.7,-1.2551895,36.7822034,-1.2343236,36.8861,755,1673,19,1749
8973,6946,3383,1,Personal,1,3,34127,1,3,34144,1,3,34372,1,3,34858,1,3,35276,2,23.25888921888938,-1.2586742,36.8016438,-1.2632534,36.7993427,726,418,17,714
8974,26736,2701,3,Business,24,1,48860,24,1,48910,24,1,49735,24,1,50499,24,1,52387,12,23.25888921888938,-1.303031,36.758577,-1.2765736,36.8513646,88,1888,50,1589
8975,4089,3435,1,Business,3,3,43717,3,3,44866,3,3,46981,3,3,48519,3,3,51400,24,24.1,-1.3454328,36.6647806,-1.2696341,36.8042045,88,2881,1149,3653
8976,24107,1527,3,Business,4,4,36952,4,4,37015,4,4,37016,4,4,37535,4,4,38320,4,21.9,-1.3077869,36.8443207,-1.3004062,36.829741,943,785,63,520
8977,7162,1995,3,Business,31,5,45538,31,5,46034,31,5,47177,31,5,48078,31,5,48083,4,21.8,-1.2764568,36.7939953,-1.2615888,36.7928732,344,5,496,2044
8978,23994,2154,3,Business,19,1,49621,19,1,49734,19,1,49746,19,1,50285,19,1,52419,8,25.0,-1.2584143,36.8048002,-1.2765736,36.8513646,928,2134,113,551
8979,6209,1758,2,Personal,1,6,30188,1,6,30403,1,6,30794,1,6,31274,1,6,32335,7,15.1,-1.280753,36.8191175,-1.2896722,36.7712409,726,1061,215,871
8980,7397,3647,3,Business,2,5,55144,2,5,55273,2,5,55674,2,5,56018,2,5,58946,8,25.2,-1.272639,36.794723,-1.308217,36.77413,726,2928,129,745
8981,968,3602,3,Business,13,3,52844,13,3,52879,13,3,54044,13,3,56197,13,3,56800,2,29.4,-1.304033,36.7848695,-1.2963097,36.7688221,205,603,35,3318
8982,13999,1165,1,Personal,10,5,43402,10,5,43423,10,5,43952,10,5,44418,10,5,45218,6,19.0,-1.264917,36.8150651,-1.2846575,36.7883974,414,800,21,995
8983,26378,2940,3,Personal,6,3,55220,6,3,55404,6,3,57844,6,3,58150,6,3,59017,8,23.25888921888938,-1.2993556,36.8146776,-1.326825,36.864345,459,867,184,2746
8984,4965,393,3,Business,15,5,38879,15,5,38904,15,5,39286,15,5,40275,15,5,40830,4,25.9,-1.3167113,36.8301563,-1.3004062,36.829741,233,555,25,1371
8985,5425,496,3,Business,21,4,58507,21,4,58626,21,4,59353,21,4,60016,21,4,60605,5,23.25888921888938,-1.2551895,36.7822034,-1.284256,36.8124863,156,589,119,1390
8986,23441,3562,2,Personal,13,1,50439,13,1,50490,13,1,50729,13,1,51768,13,1,52486,8,19.5,-1.2995132,36.8043032,-1.2551895,36.7822034,101,718,51,1278
8987,19664,1958,3,Business,6,4,54950,6,4,54978,6,4,55568,6,4,56817,6,4,59693,22,21.3,-1.2464366,36.8170136,-1.3700383,36.9190174,291,2876,28,1839
8988,721,2609,1,Business,27,1,34557,27,1,34618,27,1,35563,27,1,35767,27,1,37496,14,16.4,-1.32189,36.8589727,-1.2551895,36.7822034,848,1729,61,1149
8989,1546,1500,3,Business,4,5,54608,4,5,57776,4,5,57878,4,5,58015,4,5,59271,10,23.25888921888938,-1.2991441,36.7528804,-1.2574219,36.7927073,555,1256,3168,239
8990,4155,1280,3,Business,15,4,32849,15,4,32859,15,4,33501,15,4,33963,15,4,34761,4,19.6,-1.2551895,36.7822034,-1.269534,36.80697,290,798,10,1104
8991,5685,3434,3,Business,1,3,47837,1,3,47882,1,3,48448,1,3,50477,1,3,51831,12,23.8,-1.3049935,36.8572897,-1.2963097,36.7688221,414,1354,45,2595
8992,7147,3661,3,Business,21,4,49790,21,4,52523,21,4,52910,21,4,53224,21,4,54885,15,22.7,-1.2207911,36.8681762,-1.3090727,36.8315262,851,1661,2733,701
8993,10160,1271,3,Business,12,2,39944,12,2,40554,12,2,41812,12,2,42506,12,2,44753,23,24.7,-1.3107918,36.761794,-1.3244885,36.897792,240,2247,610,1952
8994,21119,3517,3,Business,13,2,44504,13,2,44520,13,2,46143,13,2,47185,13,2,48664,15,22.1,-1.300921,36.828195,-1.3882008,36.7699445,550,1479,16,2665
8995,6046,1004,3,Business,19,3,45366,19,3,45947,19,3,46331,19,3,47761,19,3,49140,10,22.4,-1.3681253,36.9155298,-1.3323107,36.8692616,419,1379,581,1814
8996,14604,1754,1,Business,3,5,48842,3,5,53821,3,5,53826,3,5,54024,3,5,55517,13,25.0,-1.2860183,36.8975338,-1.3189252,36.8617269,900,1493,4979,203
8997,5531,1469,3,Business,8,1,57374,8,1,57400,8,1,57618,8,1,58163,8,1,59951,4,29.8,-1.2551895,36.7822034,-1.2627937,36.8156957,166,1788,26,763
8998,4409,1458,1,Personal,28,2,46324,28,2,46392,28,2,49537,28,2,50296,28,2,51015,7,19.5,-1.2643343,36.7447423,-1.263499,36.8014548,65,719,68,3904
8999,27564,3547,3,Business,11,2,46871,11,2,49029,11,2,49037,11,2,53456,11,2,54499,7,22.2,-1.300921,36.828195,-1.3194518,36.869396,260,1043,2158,4427
9000,11132,553,3,Business,21,5,60483,21,5,61832,21,5,62370,21,5,62726,21,5,65278,14,23.2,-1.2551895,36.7822034,-1.2279357,36.8680021,519,2552,1349,894
9001,1569,551,2,Personal,3,4,33416,3,4,34051,3,4,35317,3,4,35710,3,4,36782,7,17.4,-1.3191045,36.7946621,-1.2977387,36.8031447,543,1072,635,1659
9002,3393,3647,3,Business,16,2,38694,16,2,38717,16,2,39163,16,2,39561,16,2,40246,4,23.25888921888938,-1.272639,36.794723,-1.2569503,36.7834728,520,685,23,844
9003,20953,718,3,Business,26,2,45101,26,2,45141,26,2,46307,26,2,46516,26,2,47799,9,23.25888921888938,-1.2551895,36.7822034,-1.2956171,36.7888097,832,1283,40,1375
9004,8045,1724,3,Business,11,4,33155,11,4,33183,11,4,33834,11,4,34694,11,4,36082,6,22.0,-1.2551895,36.7822034,-1.2655306,36.828148,155,1388,28,1511
9005,1658,1081,3,Business,6,3,36926,6,3,36955,6,3,38115,6,3,38868,6,3,40504,10,22.6,-1.2584143,36.8048002,-1.3025826,36.7670807,681,1636,29,1913
9006,7956,2691,2,Business,1,1,36833,1,1,38113,1,1,38879,1,1,39275,1,1,40873,17,23.9,-1.362319,36.743983,-1.2857671,36.7875614,449,1598,1280,1162
9007,20660,3232,3,Business,26,5,37693,26,5,44966,26,5,45577,26,5,45786,26,5,48569,6,23.25888921888938,-1.2551895,36.7822034,-1.28878,36.8168312,101,2783,7273,820
9008,21530,718,3,Business,14,4,54817,14,4,56123,14,4,57078,14,4,57280,14,4,58810,8,28.1,-1.2551895,36.7822034,-1.2856664,36.7559838,940,1530,1306,1157
9009,27425,649,3,Business,4,4,29964,4,4,29980,4,4,31971,4,4,32466,4,4,35252,25,18.3,-1.2551895,36.7822034,-1.3798624,36.945458,478,2786,16,2486
9010,13242,1248,3,Personal,3,5,50311,3,5,50352,3,5,51065,3,5,51253,3,5,52536,9,25.1,-1.288086,36.821116,-1.3061514,36.8612054,754,1283,41,901
9011,21658,2195,1,Business,9,2,36099,9,2,36743,9,2,37724,9,2,38069,9,2,40880,14,22.2,-1.344446,36.756597,-1.3313643,36.8577422,844,2811,644,1326
9012,21668,1882,3,Business,12,6,46164,12,6,46273,12,6,49383,12,6,53173,12,6,55756,9,25.2,-1.2475028,36.8774697,-1.277512,36.820013,75,2583,109,6900
9013,5924,2700,1,Business,28,1,49580,28,1,50374,28,1,51181,28,1,51841,28,1,53085,7,24.7,-1.293973,36.80169,-1.2562249,36.7868661,103,1244,794,1467
9014,8658,635,3,Business,23,5,31096,23,5,31163,23,5,31745,23,5,33107,23,5,34430,8,20.0,-1.3016417,36.8271679,-1.2599563,36.7993439,322,1323,67,1944
9015,4991,718,3,Business,10,5,39380,10,5,40054,10,5,40641,10,5,41058,10,5,43455,8,23.25888921888938,-1.2551895,36.7822034,-1.2824911,36.8218042,591,2397,674,1004
9016,25120,3517,3,Business,22,5,56141,22,5,56261,22,5,56340,22,5,58527,22,5,60892,20,31.0,-1.300921,36.828195,-1.3813339,36.7377273,829,2365,120,2266
9017,24428,1342,3,Business,15,1,44983,15,1,45386,15,1,46057,15,1,46975,15,1,48254,11,23.25888921888938,-1.3025826,36.7670807,-1.2905979,36.8442582,86,1279,403,1589
9018,5202,2175,3,Business,17,3,55310,17,3,55355,17,3,55605,17,3,56598,17,3,59615,6,23.25888921888938,-1.2551895,36.7822034,-1.2775227,36.8174812,709,3017,45,1243
9019,3100,393,3,Business,18,1,32805,18,1,32836,18,1,32840,18,1,33367,18,1,35519,14,21.8,-1.3167113,36.8301563,-1.306378,36.7519845,111,2152,31,531
9020,10960,3557,3,Business,13,3,33605,13,3,33615,13,3,34454,13,3,34722,13,3,36010,10,20.4,-1.2546732,36.8086796,-1.3014468,36.7720335,205,1288,10,1107
9021,21888,2596,3,Business,14,1,46785,14,1,46795,14,1,46823,14,1,47518,14,1,49500,19,23.5,-1.2963097,36.7688221,-1.3379799,36.8835453,906,1982,10,723
9022,12755,2174,3,Business,16,4,47595,16,4,47844,16,4,47996,16,4,49572,16,4,54451,10,18.8,-1.2482781,36.884092,-1.2782261,36.8225009,307,4879,249,1728
9023,24649,2150,3,Business,12,3,37236,12,3,37279,12,3,40417,12,3,41129,12,3,43016,14,19.3,-1.2783849,36.8163445,-1.344446,36.756597,341,1887,43,3850
9024,398,1417,3,Business,7,2,47066,7,2,47210,7,2,47773,7,2,48349,7,2,48922,4,23.25888921888938,-1.2884243,36.8207248,-1.2741728,36.7969108,942,573,144,1139
9025,9542,2132,3,Business,20,3,33334,20,3,33361,20,3,33416,20,3,36297,20,3,40302,37,20.9,-1.2384056,36.8718698,-1.0546336,36.7739108,86,4005,27,2936
9026,21205,1500,3,Business,8,5,62810,8,5,62818,8,5,62824,8,5,62973,8,5,64248,9,25.2,-1.2638185,36.7930057,-1.3004062,36.829741,523,1275,8,155
9027,1724,3647,3,Business,20,5,36908,20,5,37649,20,5,37962,20,5,38062,20,5,39511,6,18.3,-1.272639,36.794723,-1.2872899,36.820434,616,1449,741,413
9028,19916,3683,3,Business,5,3,56331,5,3,56359,5,3,56465,5,3,57319,5,3,58940,11,23.7,-1.2897368,36.8226783,-1.2391616,36.8101823,726,1621,28,960
9029,23856,1500,3,Business,31,4,55785,31,4,56162,31,4,56337,31,4,57072,31,4,58362,8,28.7,-1.3004062,36.829741,-1.2636051,36.7850995,576,1290,377,910
9030,17067,635,3,Business,19,1,43344,19,1,43441,19,1,43523,19,1,44272,19,1,44849,4,24.6,-1.3016417,36.8271679,-1.3134524,36.8064495,669,577,97,831
9031,1042,867,3,Business,1,5,38157,1,5,38166,1,5,38192,1,5,38337,1,5,40111,10,28.6,-1.2996533,36.8292629,-1.2991441,36.7528804,248,1774,9,171
9032,10281,972,3,Business,5,6,42593,5,6,42612,5,6,43280,5,6,43405,5,6,44481,6,22.4,-1.2862033,36.8152966,-1.308819,36.8421201,100,1076,19,793
9033,634,167,2,Personal,24,4,56700,24,4,56725,24,4,57359,24,4,57564,24,4,58790,13,22.7,-1.3339943,36.7263409,-1.3157973,36.815148,312,1226,25,839
9034,23460,3647,3,Business,7,5,52060,7,5,52077,7,5,52559,7,5,52688,7,5,53576,4,26.7,-1.272639,36.794723,-1.2569503,36.7834728,467,888,17,611
9035,1502,3221,3,Business,15,5,46236,15,5,46327,15,5,46780,15,5,47761,15,5,48450,4,26.4,-1.2811172,36.8156831,-1.2738522,36.7992818,906,689,91,1434
9036,19671,1886,2,Personal,6,3,48814,6,3,49296,6,3,52106,6,3,52524,6,3,54282,12,22.0,-1.2868973,36.8232984,-1.3145553,36.7493849,116,1758,482,3228
9037,2360,3264,3,Business,31,3,59803,31,3,59917,31,3,60798,31,3,61228,31,3,62674,8,24.5,-1.2551895,36.7822034,-1.2962618,36.7929334,208,1446,114,1311
9038,24240,3222,3,Business,8,3,55863,8,3,56026,8,3,56759,8,3,56915,8,3,57403,3,23.25888921888938,-1.2551895,36.7822034,-1.2629594,36.8077626,337,488,163,889
9039,26225,3283,3,Business,30,2,37158,30,2,37212,30,2,37693,30,2,38003,30,2,39015,7,23.25888921888938,-1.303596,36.778378,-1.2628473,36.781805,315,1012,54,791
9040,9260,1450,3,Personal,11,1,56131,11,1,56396,11,1,57154,11,1,57336,11,1,59154,12,28.8,-1.3108386,36.7555239,-1.2663351,36.8099425,445,1818,265,940
9041,1693,391,3,Business,18,4,55625,18,4,55730,18,4,56525,18,4,58038,18,4,60579,5,23.25888921888938,-1.300921,36.828195,-1.2867454,36.8259017,843,2541,105,2308
9042,10537,1073,3,Business,22,5,59219,22,5,59469,22,5,60319,22,5,61062,22,5,61933,6,28.7,-1.2561964,36.7885001,-1.2566689,36.7796952,177,871,250,1593
9043,8929,857,1,Personal,25,6,59514,25,6,59525,25,6,60063,25,6,62630,25,6,64077,19,23.25888921888938,-1.2850644,36.8343657,-1.1986098,36.9491943,648,1447,11,3105
9044,3672,3718,3,Business,5,1,52247,5,1,52313,5,1,52944,5,1,53011,5,1,53547,2,26.1,-1.2650027,36.8126242,-1.2670614,36.8077774,38,536,66,698
9045,26083,635,3,Business,30,4,49801,30,4,49841,30,4,51116,30,4,52064,30,4,53565,10,23.25888921888938,-1.3081376,36.8329772,-1.2602337,36.7990548,686,1501,40,2223
9046,18790,2174,3,Business,22,4,37554,22,4,37572,22,4,38508,22,4,39944,22,4,42229,21,22.5,-1.2482781,36.884092,-1.3205111,36.7801016,12,2285,18,2372
9047,6244,868,3,Business,23,6,51682,23,6,51758,23,6,52532,23,6,53120,23,6,53836,5,23.25888921888938,-1.2600926,36.8088685,-1.265715,36.823815,268,716,76,1362
9048,4867,391,3,Business,3,5,49460,3,5,50940,3,5,51660,3,5,52995,3,5,54268,5,23.25888921888938,-1.300921,36.828195,-1.2839729,36.8115146,591,1273,1480,2055
9049,27450,763,2,Personal,2,4,57537,2,4,57560,2,4,58191,2,4,58921,2,4,59606,3,26.2,-1.2875013,36.8171787,-1.270054,36.815164,754,685,23,1361
9050,7139,419,3,Business,13,5,50406,13,5,50418,13,5,51390,13,5,52030,13,5,54168,20,19.1,-1.2571472,36.7950633,-1.3700383,36.9190174,806,2138,12,1612
9051,26650,3647,3,Business,18,4,43098,18,4,43155,18,4,43708,18,4,43861,18,4,44477,4,23.25888921888938,-1.2569503,36.7834728,-1.272639,36.794723,937,616,57,706
9052,15991,3647,3,Business,18,5,60680,18,5,60697,18,5,61403,18,5,61657,18,5,61750,2,25.5,-1.272639,36.794723,-1.2741728,36.7969108,881,93,17,960
9053,17719,238,3,Business,3,6,37889,3,6,37908,3,6,38298,3,6,38783,3,6,40593,15,23.6,-1.3177547,36.8303703,-1.362953,36.904214,487,1810,19,875
9054,10704,627,3,Business,19,5,46822,19,5,46907,19,5,49364,19,5,50256,19,5,52236,6,27.4,-1.2571472,36.7950633,-1.3001813,36.811122,751,1980,85,3349
9055,9654,2457,3,Business,13,1,46281,13,1,46307,13,1,46320,13,1,46560,13,1,47485,6,23.25888921888938,-1.2551895,36.7822034,-1.2425149,36.7890137,576,925,26,253
9056,12585,2212,3,Business,13,3,41329,13,3,41391,13,3,41836,13,3,42419,13,3,43766,6,24.6,-1.2551895,36.7822034,-1.2850638,36.813096,411,1347,62,1028
9057,4317,380,2,Personal,27,3,38113,27,3,38934,27,3,39931,27,3,40117,27,3,43541,28,23.25888921888938,-1.3864951,36.6841026,-1.2615888,36.7928732,844,3424,821,1183
9058,19237,3420,3,Business,28,4,54202,28,4,54289,28,4,55800,28,4,61246,28,4,61439,7,25.7,-1.265981,36.7936121,-1.3046007,36.8211743,291,193,87,6957
9059,27723,552,3,Business,9,4,54498,9,4,54503,9,4,54525,9,4,55477,9,4,57642,15,25.6,-1.3562374,36.9042954,-1.3173869,36.8112044,539,2165,5,974
9060,2984,1075,3,Business,4,1,46696,4,1,46766,4,1,48027,4,1,48269,4,1,48778,2,25.5,-1.2527958,36.8003131,-1.2658335,36.8042867,379,509,70,1503
9061,8343,868,3,Business,29,5,32316,29,5,35100,29,5,36984,29,5,37417,29,5,39292,9,20.9,-1.331619,36.847976,-1.265715,36.823815,787,1875,2784,2317
9062,26223,269,3,Business,19,3,32574,19,3,33769,19,3,34694,19,3,35840,19,3,37073,8,19.7,-1.3562374,36.9042954,-1.3226302,36.8719901,300,1233,1195,2071
9063,7340,2668,3,Personal,29,2,55462,29,2,55556,29,2,56110,29,2,56239,29,2,57836,15,26.8,-1.2878216,36.799598,-1.331707,36.877913,79,1597,94,683
9064,27490,2209,3,Business,27,2,46906,27,2,47209,27,2,47921,27,2,48061,27,2,49688,18,23.6,-1.2551895,36.7822034,-1.2701894,36.90246,933,1627,303,852
9065,25011,391,3,Business,5,3,53695,5,3,54822,5,3,56657,5,3,57226,5,3,60486,21,25.0,-1.2847613,36.967084,-1.2867454,36.8259017,345,3260,1127,2404
9066,21338,1792,3,Business,22,1,37903,22,1,37945,22,1,38803,22,1,38958,22,1,41578,14,25.1,-1.2809121,36.7852524,-1.3339943,36.7263409,565,2620,42,1013
9067,9596,246,3,Business,27,2,47800,27,2,48521,27,2,48631,27,2,49325,27,2,50161,4,25.8,-1.2584143,36.8048002,-1.2866012,36.8195691,521,836,721,804
9068,26751,3108,3,Business,16,2,53311,16,2,53400,16,2,53855,16,2,54769,16,2,56246,16,27.4,-1.2551895,36.7822034,-1.3167553,36.869485,116,1477,89,1369
9069,24510,1469,3,Business,5,2,43443,5,2,43489,5,2,43977,5,2,44253,5,2,44907,3,25.6,-1.2551895,36.7822034,-1.2607765,36.8080021,956,654,46,764
9070,14498,609,2,Personal,6,3,37550,6,3,37559,6,3,38801,6,3,39002,6,3,40034,15,19.8,-1.3302996,36.8707935,-1.3677142,36.9136314,543,1032,9,1443
9071,27529,3237,2,Personal,3,2,68219,3,2,68432,3,2,68988,3,2,69164,3,2,70083,5,18.8,-1.2786894,36.8032321,-1.2902539,36.8211322,951,919,213,732
9072,9251,3201,3,Business,1,3,43143,1,3,43152,1,3,43468,1,3,43658,1,3,44227,2,20.0,-1.2649605,36.7981777,-1.2675613,36.8133001,882,569,9,506
9073,11482,1688,3,Business,13,4,42339,13,4,42374,13,4,42403,13,4,43390,13,4,45780,18,21.9,-1.300921,36.828195,-1.3855778,36.9269619,686,2390,35,1016
9074,13163,2423,3,Business,21,4,52139,21,4,52354,21,4,52542,21,4,53002,21,4,53781,8,26.2,-1.2551895,36.7822034,-1.2964348,36.8182757,801,779,215,648
9075,11272,421,3,Business,19,3,44321,19,3,44880,19,3,45679,19,3,46126,19,3,47839,8,22.0,-1.2975066,36.7689423,-1.3004062,36.829741,708,1713,559,1246
9076,10353,3420,3,Business,26,5,45269,26,5,45409,26,5,46161,26,5,46233,26,5,47076,6,23.25888921888938,-1.3046007,36.8211743,-1.265981,36.7936121,848,843,140,824
9077,4925,1085,3,Business,22,6,40961,22,6,40988,22,6,41358,22,6,42538,22,6,44134,17,23.1,-1.2628638,36.8070399,-1.316539,36.7068562,489,1596,27,1550
9078,8799,2828,1,Business,9,1,57552,9,1,57599,9,1,58329,9,1,61236,9,1,61779,10,20.2,-1.297694,36.749788,-1.2644742,36.8083457,541,543,47,3637
9079,10512,2330,3,Business,18,1,46287,18,1,46311,18,1,47516,18,1,47924,18,1,48718,13,27.8,-1.2680363,36.7990466,-1.2524916,36.8656196,205,794,24,1613
9080,12980,1931,3,Personal,13,3,45185,13,3,47351,13,3,47981,13,3,48066,13,3,49312,6,20.1,-1.299813,36.7871392,-1.283362,36.8260149,698,1246,2166,715
9081,1915,393,3,Business,28,3,30918,28,3,30942,28,3,31103,28,3,31746,28,3,34304,14,20.6,-1.3177547,36.8303703,-1.306378,36.7519845,523,2558,24,804
9082,3263,3547,3,Business,24,3,43783,24,3,43805,24,3,44784,24,3,45762,24,3,47964,16,23.25888921888938,-1.3189252,36.8617269,-1.2856319,36.7672998,377,2202,22,1957
9083,12956,3326,3,Business,12,3,40722,12,3,41158,12,3,42447,12,3,42591,12,3,43929,9,19.3,-1.2551895,36.7822034,-1.3017794,36.8240888,394,1338,436,1433
9084,20851,1667,1,Business,30,4,40983,30,4,41007,30,4,42027,30,4,42451,30,4,43901,9,20.2,-1.2808075,36.8317585,-1.2894256,36.7620285,74,1450,24,1444
9085,15018,1341,3,Business,23,6,45156,23,6,45170,23,6,45254,23,6,45507,23,6,46907,13,23.25888921888938,-1.303596,36.778378,-1.331619,36.847976,952,1400,14,337
9086,21472,2066,3,Business,27,5,48749,27,5,48778,27,5,49945,27,5,50173,27,5,51228,9,24.0,-1.316961,36.820337,-1.2655306,36.828148,105,1055,29,1395
9087,14751,2701,3,Business,6,3,50123,6,3,50180,6,3,51638,6,3,52090,6,3,53219,7,22.0,-1.279395,36.825364,-1.2553615,36.7895376,531,1129,57,1910
9088,27718,3689,3,Business,24,7,39675,24,7,41665,24,7,42255,24,7,42908,24,7,44130,10,23.25888921888938,-1.28878,36.8168312,-1.225322,36.80855,26,1222,1990,1243
9089,9605,42,3,Business,9,5,52063,9,5,52704,9,5,53977,9,5,57205,9,5,58325,5,26.4,-1.2564152,36.7792803,-1.2705336,36.7943509,774,1120,641,4501
9090,8391,393,3,Business,4,6,31264,4,6,31358,4,6,31754,4,6,32211,4,6,33454,8,23.25888921888938,-1.3167113,36.8301563,-1.2770708,36.8231093,448,1243,94,853
9091,16321,1642,3,Business,27,3,50348,27,3,50371,27,3,51275,27,3,51804,27,3,52702,5,29.3,-1.2726506,36.7960153,-1.2789469,36.7796691,855,898,23,1433
9092,3600,3091,3,Business,31,4,47360,31,4,47393,31,4,47593,31,4,50399,31,4,51706,9,28.7,-1.3012008,36.764868,-1.2571472,36.7950633,40,1307,33,3006
9093,12199,393,3,Business,23,4,37951,23,4,38003,23,4,38906,23,4,40596,23,4,41743,11,23.5,-1.3228003,36.8306435,-1.2638185,36.7930057,96,1147,52,2593
9094,18405,3355,3,Business,4,2,43860,4,2,47192,4,2,47574,4,2,47890,4,2,48667,10,19.6,-1.3472066,36.7692638,-1.3052491,36.8223899,932,777,3332,698
9095,10731,2154,3,Business,8,1,41696,8,1,41780,8,1,41983,8,1,42299,8,1,43470,8,28.1,-1.2527958,36.8003131,-1.2765736,36.8513646,576,1171,84,519
9096,21439,2767,3,Business,14,3,41437,14,3,42039,14,3,43128,14,3,43433,14,3,46537,9,24.4,-1.257773,36.795486,-1.2332276,36.8008923,66,3104,602,1394
9097,26557,567,3,Business,3,1,39868,3,1,40060,3,1,41424,3,1,41862,3,1,43474,8,21.7,-1.2766906,36.8202151,-1.2963097,36.7688221,2,1612,192,1802
9098,10862,2789,3,Business,19,2,61321,19,2,61366,19,2,62323,19,2,62718,19,2,64259,6,28.4,-1.304735,36.7846054,-1.2896399,36.8124498,678,1541,45,1352
9099,13502,527,2,Personal,29,6,47743,29,6,47777,29,6,48472,29,6,50314,29,6,51911,12,28.1,-1.2861765,36.8209086,-1.3319425,36.8944709,465,1597,34,2537
9100,18243,1996,3,Business,10,3,51642,10,3,51740,10,3,52575,10,3,53972,10,3,55477,6,30.7,-1.2946359,36.8352718,-1.3272104,36.8528418,613,1505,98,2232
9101,25245,1004,3,Business,14,2,33007,14,2,33082,14,2,34326,14,2,34444,14,2,35868,10,23.25888921888938,-1.3250048,36.8697188,-1.2983805,36.8198439,910,1424,75,1362
9102,18896,3517,3,Business,16,4,52164,16,4,52177,16,4,52179,16,4,54759,16,4,56374,16,23.25888921888938,-1.300921,36.828195,-1.3882008,36.7699445,450,1615,13,2582
9103,9899,3426,3,Business,29,1,63191,29,1,63218,29,1,63620,29,1,64118,29,1,65397,10,23.2,-1.2584143,36.8048002,-1.3014461,36.7661381,854,1279,27,900
9104,27301,187,3,Business,11,1,50959,11,1,51003,11,1,51936,11,1,52388,11,1,53945,10,28.2,-1.303031,36.758577,-1.3169591,36.7000029,46,1557,44,1385
9105,25496,1249,3,Business,10,3,36030,10,3,36036,10,3,36065,10,3,36472,10,3,39077,19,21.8,-1.2551895,36.7822034,-1.2860183,36.8975338,831,2605,6,436
9106,3778,20,3,Business,30,3,37347,30,3,37368,30,3,38030,30,3,38296,30,3,39007,4,22.7,-1.2629666,36.8068369,-1.2730516,36.8135448,208,711,21,928
9107,9683,1687,3,Business,16,3,42861,16,3,42910,16,3,43289,16,3,43591,16,3,44875,7,22.7,-1.2626574,36.8014034,-1.3014732,36.7781201,576,1284,49,681
9108,3077,1899,3,Business,10,1,53610,10,1,53852,10,1,55459,10,1,56106,10,1,57896,13,23.25888921888938,-1.293515,36.897607,-1.331619,36.847976,548,1790,242,2254
9109,26221,439,3,Business,22,3,51998,22,3,52054,22,3,53082,22,3,53503,22,3,57379,24,24.1,-1.2558953,36.7339105,-1.3323107,36.8692616,868,3876,56,1449
9110,20273,382,1,Personal,19,2,55731,19,2,55885,19,2,56805,19,2,57568,19,2,59173,8,18.5,-1.2967218,36.8089787,-1.2655306,36.828148,340,1605,154,1683
9111,12095,393,3,Business,8,4,55650,8,4,55669,8,4,56116,8,4,56614,8,4,57663,10,27.4,-1.3177547,36.8303703,-1.2574219,36.7927073,878,1049,19,945
9112,11830,517,3,Business,31,5,45864,31,5,46359,31,5,46436,31,5,47022,31,5,49090,14,21.5,-1.3228003,36.8306435,-1.2991441,36.7528804,349,2068,495,663
9113,707,1075,3,Business,23,7,50682,23,7,50823,23,7,51479,23,7,53420,23,7,54433,9,25.0,-1.289654,36.7838999,-1.2527958,36.8003131,206,1013,141,2597
9114,5891,868,3,Business,20,1,55121,20,1,55261,20,1,55597,20,1,56479,20,1,56721,5,23.25888921888938,-1.2600926,36.8088685,-1.265715,36.823815,61,242,140,1218
9115,14014,3426,3,Business,5,1,58253,5,1,58283,5,1,59165,5,1,59348,5,1,61165,5,26.0,-1.3014461,36.7661381,-1.2817426,36.7846148,343,1817,30,1065
9116,7710,1341,3,Business,13,3,52815,13,3,52844,13,3,52845,13,3,55118,13,3,55298,15,29.4,-1.2628473,36.781805,-1.331619,36.847976,669,180,29,2274
9117,21380,3557,3,Business,24,3,56654,24,3,56701,24,3,57622,24,3,58295,24,3,58313,3,18.3,-1.2655306,36.828148,-1.2546732,36.8086796,847,18,47,1594
9118,21545,2029,1,Personal,21,5,53791,21,5,53824,21,5,54156,21,5,54628,21,5,55665,8,26.9,-1.238874,36.807889,-1.2566889,36.7930784,882,1037,33,804
9119,14692,1329,3,Business,17,4,40266,17,4,40651,17,4,40720,17,4,41156,17,4,42547,6,25.5,-1.273056,36.811298,-1.2338121,36.7968279,215,1391,385,505
9120,7794,2894,3,Business,19,5,59905,19,5,59935,19,5,60818,19,5,61378,19,5,62437,6,24.6,-1.2974913,36.8054296,-1.2621576,36.8103473,755,1059,30,1443
9121,27609,1482,3,Business,18,1,50806,18,1,51782,18,1,51836,18,1,52530,18,1,56591,17,30.8,-1.2941752,36.7705608,-1.338579,36.8963038,800,4061,976,748
9122,11994,1370,3,Personal,10,4,40984,10,4,43083,10,4,43730,10,4,43792,10,4,44463,4,23.25888921888938,-1.261692,36.80161,-1.2867201,36.8187204,923,671,2099,709
9123,3651,2825,2,Personal,13,1,34818,13,1,34822,13,1,35130,13,1,35303,13,1,36544,13,15.1,-1.2615048,36.8116724,-1.2156006,36.8916865,754,1241,4,481
9124,10088,1724,3,Business,17,3,56732,17,3,56880,17,3,56917,17,3,57785,17,3,58754,7,23.25888921888938,-1.2551895,36.7822034,-1.2821883,36.8269611,291,969,148,905
9125,24308,265,3,Business,7,4,53160,7,4,53172,7,4,53192,7,4,54062,7,4,55345,10,27.5,-1.3014461,36.7661381,-1.300921,36.828195,623,1283,12,890
9126,9592,3727,3,Business,28,1,56107,28,1,56130,28,1,56650,28,1,56809,28,1,61219,8,26.1,-1.2963097,36.7688221,-1.3004062,36.829741,571,4410,23,679
9127,11983,3291,3,Business,25,1,58461,25,1,58519,25,1,58527,25,1,59731,25,1,60718,4,28.3,-1.272828,36.816608,-1.2600926,36.8088685,828,987,58,1212
9128,23077,3331,3,Business,12,3,54317,12,3,54454,12,3,54701,12,3,54850,12,3,55124,2,20.8,-1.2551895,36.7822034,-1.2566586,36.7929682,894,274,137,396
9129,25786,393,3,Business,17,3,31254,17,3,31261,17,3,31406,17,3,34219,17,3,34228,14,23.25888921888938,-1.3167113,36.8301563,-1.2991441,36.7528804,10,9,7,2958
9130,8473,1417,3,Business,23,3,33025,23,3,33061,23,3,33202,23,3,35262,23,3,36241,7,23.25888921888938,-1.2590946,36.7607115,-1.2741728,36.7969108,880,979,36,2201
9131,23771,652,1,Personal,19,4,38362,19,4,38446,19,4,38764,19,4,39006,19,4,40250,4,20.2,-1.2982033,36.8092632,-1.2808159,36.8160545,174,1244,84,560
9132,17370,893,3,Business,12,1,46350,12,1,46524,12,1,48401,12,1,48775,12,1,48779,3,27.1,-1.2664491,36.8102685,-1.2663778,36.8076024,486,4,174,2251
9133,3529,598,2,Business,24,1,64576,24,1,64645,24,1,65777,24,1,66038,24,1,67809,12,24.3,-1.2329501,36.8083852,-1.299299,36.807308,612,1771,69,1393
9134,26252,859,2,Personal,15,1,57600,15,1,59408,15,1,61360,15,1,61548,15,1,62289,5,23.25888921888938,-1.2939373,36.7807916,-1.3159617,36.8117934,565,741,1808,2140
9135,14706,1874,3,Business,5,3,35105,5,3,35110,5,3,35432,5,3,35845,5,3,39329,20,18.2,-1.2571472,36.7950633,-1.3700383,36.9190174,620,3484,5,735
9136,645,627,3,Business,4,4,58894,4,4,58931,4,4,60205,4,4,60270,4,4,63210,19,23.25888921888938,-1.2551895,36.7822034,-1.32943,36.894243,751,2940,37,1339
9137,27481,3149,3,Business,21,3,45703,21,3,45772,21,3,45778,21,3,48732,21,3,48735,5,23.4,-1.3004062,36.829741,-1.3177547,36.8303703,10,3,69,2960
9138,18558,961,1,Personal,21,1,47953,21,1,49493,21,1,52618,21,1,52742,21,1,53777,5,21.5,-1.2769486,36.8261591,-1.2918495,36.82844,874,1035,1540,3249
9139,14740,3560,3,Business,4,1,59883,4,1,59890,4,1,59931,4,1,60146,4,1,61177,12,27.8,-1.2860183,36.8975338,-1.279395,36.825364,195,1031,7,256
9140,1140,3064,3,Business,2,2,42146,2,2,42164,2,2,42188,2,2,42522,2,2,44942,13,20.9,-1.2571472,36.7950633,-1.303924,36.8758792,6,2420,18,358
9141,14757,241,3,Business,23,3,41095,23,3,41184,23,3,41536,23,3,42256,23,3,42927,5,21.7,-1.2695287,36.7981777,-1.2895261,36.8164407,726,671,89,1072
9142,21054,3571,3,Business,17,1,43349,17,1,44680,17,1,45823,17,1,46392,17,1,49878,17,23.5,-1.2271998,36.8084905,-1.3163815,36.8542784,205,3486,1331,1712
9143,5027,393,3,Business,25,1,53645,25,1,53656,25,1,53664,25,1,54570,25,1,55142,6,30.3,-1.3167113,36.8301563,-1.3077869,36.8443207,239,572,11,914
9144,7477,393,3,Business,28,2,31913,28,2,32119,28,2,32928,28,2,35761,28,2,37115,11,18.6,-1.3228003,36.8306435,-1.2638185,36.7930057,849,1354,206,3642
9145,1260,800,1,Personal,27,4,48713,27,4,48726,27,4,49070,27,4,49587,27,4,50962,11,25.2,-1.2602044,36.7871719,-1.3091686,36.7429678,38,1375,13,861
9146,5339,3557,3,Business,29,1,49153,29,1,49185,29,1,49684,29,1,50338,29,1,51621,9,24.5,-1.2981352,36.8213822,-1.2546732,36.8086796,219,1283,32,1153
9147,13924,2867,1,Personal,20,1,53463,20,1,53515,20,1,54375,20,1,55955,20,1,56979,6,21.3,-1.288285,36.815912,-1.2635485,36.7904656,338,1024,52,2440
9148,10552,1882,3,Business,9,3,50247,9,3,51361,9,3,52282,9,3,52492,9,3,54061,12,25.1,-1.277018,36.820337,-1.2160907,36.8851949,576,1569,1114,1131
9149,15667,391,3,Business,15,5,48551,15,5,49549,15,5,51287,15,5,55081,15,5,55298,19,17.9,-1.3204931,36.7043102,-1.2867454,36.8259017,314,217,998,5532
9150,24514,2982,3,Business,21,1,44806,21,1,44845,21,1,44937,21,1,48504,21,1,50691,18,25.3,-1.300921,36.828195,-1.177202,36.8351183,607,2187,39,3659
9151,15706,2587,3,Business,6,3,56132,6,3,56543,6,3,57382,6,3,57762,6,3,59100,6,23.25888921888938,-1.28878,36.8168312,-1.2561334,36.7990458,291,1338,411,1219
9152,7446,484,3,Personal,21,1,51296,21,1,51335,21,1,53127,21,1,53983,21,1,55806,9,21.8,-1.29387,36.7907813,-1.3271684,36.8173021,417,1823,39,2648
9153,10985,2837,3,Personal,4,5,51471,4,5,51486,4,5,53629,4,5,53709,4,5,58501,18,23.25888921888938,-1.3457877,36.8811894,-1.2534301,36.8000983,48,4792,15,2223
9154,28024,1584,3,Business,1,1,53968,1,1,54503,1,1,56910,1,1,57336,1,1,59136,7,23.25888921888938,-1.2842021,36.8281144,-1.2969741,36.7856612,507,1800,535,2833
9155,19887,1148,3,Business,2,2,52560,2,2,54015,2,2,54271,2,2,55559,2,2,56669,8,26.4,-1.3100586,36.8500329,-1.298598,36.7953396,848,1110,1455,1544
9156,24781,175,3,Personal,10,5,54045,10,5,54059,10,5,54374,10,5,54557,10,5,55482,7,22.0,-1.2850644,36.8343657,-1.2937529,36.7894339,414,925,14,498
9157,15693,635,3,Business,12,5,52333,12,5,52396,12,5,52426,12,5,56927,12,5,57625,10,23.25888921888938,-1.300921,36.828195,-1.2602337,36.7990548,828,698,63,4531
9158,22537,446,3,Personal,6,3,57120,6,3,57624,6,3,58506,6,3,58789,6,3,61085,7,21.9,-1.289498,36.818878,-1.2562249,36.7868661,208,2296,504,1165
9159,24722,635,3,Business,4,1,59056,4,1,59082,4,1,59612,4,1,59826,4,1,61366,8,27.8,-1.2602337,36.7990548,-1.2786124,36.7678061,786,1540,26,744
9160,9438,704,3,Business,18,1,48473,18,1,48480,18,1,48484,18,1,49377,18,1,52343,17,17.4,-1.2860183,36.8975338,-1.2592428,36.7894541,397,2966,7,897
9161,7969,934,2,Personal,29,6,59567,29,6,60338,29,6,61157,29,6,61503,29,6,62294,7,23.8,-1.280431,36.8333272,-1.2343087,36.84749,208,791,771,1165
9162,8927,3686,3,Business,15,5,55432,15,5,55458,15,5,55700,15,5,55775,15,5,57620,5,17.9,-1.2551895,36.7822034,-1.2655953,36.7915464,690,1845,26,317
9163,5208,136,3,Business,16,3,58218,16,3,59133,16,3,60162,16,3,60435,16,3,64091,24,20.2,-1.3326173,36.7146233,-1.2248308,36.8012573,742,3656,915,1302
9164,3795,868,3,Business,26,5,47628,26,5,47644,26,5,47944,26,5,48801,26,5,49993,7,23.25888921888938,-1.2628473,36.781805,-1.265715,36.823815,349,1192,16,1157
9165,14761,2102,3,Business,26,1,45665,26,1,45734,26,1,46203,26,1,47786,26,1,48932,11,23.0,-1.291623,36.81421,-1.3323107,36.8692616,573,1146,69,2052
9166,27004,3565,3,Business,25,5,36239,25,5,36270,25,5,36935,25,5,38154,25,5,40968,35,21.1,-1.2844665,36.7866113,-1.1140488,37.0120302,908,2814,31,1884
9167,10592,3669,3,Business,10,4,36357,10,4,38688,10,4,40141,10,4,40535,10,4,41913,6,24.5,-1.2615888,36.7928732,-1.2897368,36.8226783,489,1378,2331,1847
9168,2635,1341,3,Business,18,1,36929,18,1,37054,18,1,37600,18,1,39218,18,1,40618,7,28.1,-1.307143,36.825009,-1.331619,36.847976,311,1400,125,2164
9169,14766,970,3,Business,17,1,45695,17,1,46236,17,1,47771,17,1,47857,17,1,50145,9,23.9,-1.2551895,36.7822034,-1.3041129,36.8104939,847,2288,541,1621
9170,6172,517,3,Business,27,4,31095,27,4,31102,27,4,31252,27,4,31452,27,4,33022,14,17.7,-1.3167113,36.8301563,-1.306378,36.7519845,523,1570,7,350
9171,13866,1500,3,Business,8,1,33746,8,1,33797,8,1,33814,8,1,36662,8,1,36683,11,21.8,-1.3077869,36.8443207,-1.2638185,36.7930057,239,21,51,2865
9172,5133,123,3,Business,5,6,44193,5,6,44251,5,6,45434,5,6,45821,5,6,47001,11,22.5,-1.2482465,36.8889062,-1.2954275,36.8996685,124,1180,58,1570
9173,23268,2143,3,Business,6,4,44363,6,4,44437,6,4,45058,6,4,45971,6,4,46786,2,24.2,-1.3016513,36.7649321,-1.2975066,36.7689423,527,815,74,1534
9174,27899,393,3,Business,2,4,44229,2,4,44239,2,4,44243,2,4,49023,2,4,49025,14,23.25888921888938,-1.3167113,36.8301563,-1.2991441,36.7528804,619,2,10,4784
9175,15799,2828,3,Business,16,1,36580,16,1,36597,16,1,38064,16,1,38339,16,1,39533,7,19.1,-1.2966453,36.8191342,-1.2615888,36.7928732,764,1194,17,1742
9176,24159,1027,3,Personal,4,2,56553,4,2,57171,4,2,57494,4,2,58005,4,2,58006,4,22.4,-1.2728425,36.791039,-1.2734594,36.8170558,539,1,618,834
9177,161,970,3,Business,12,3,51311,12,3,51460,12,3,52221,12,3,53191,12,3,53855,1,21.0,-1.2571472,36.7950633,-1.2629594,36.8077626,147,664,149,1731
9178,17797,2956,3,Business,2,2,61668,2,2,61714,2,2,62513,2,2,63136,2,2,64259,7,28.3,-1.225322,36.80855,-1.2584143,36.8048002,330,1123,46,1422
9179,12715,393,3,Business,4,4,31816,4,4,31834,4,4,32073,4,4,34669,4,4,36188,10,18.3,-1.3177547,36.8303703,-1.2574219,36.7927073,731,1519,18,2835
9180,23168,3193,1,Personal,5,3,59118,5,3,59233,5,3,60088,5,3,61315,5,3,63243,7,22.0,-1.3139279,36.8208897,-1.2668611,36.7956387,447,1928,115,2082
9181,10583,2174,3,Business,5,2,51533,5,2,51570,5,2,52190,5,2,53899,5,2,55851,19,22.6,-1.2482781,36.884092,-1.3205111,36.7801016,408,1952,37,2329
9182,11554,3291,3,Business,10,4,39314,10,4,39339,10,4,39504,10,4,40423,10,4,41340,11,24.8,-1.303596,36.778378,-1.2600926,36.8088685,24,917,25,1084
9183,7591,2733,3,Business,13,4,35542,13,4,35574,13,4,35880,13,4,37471,13,4,37474,2,18.5,-1.304033,36.7848695,-1.2963097,36.7688221,831,3,32,1897
9184,14299,3149,3,Business,7,2,35570,7,2,35670,7,2,36481,7,2,37370,7,2,38990,11,23.25888921888938,-1.2520537,36.8300678,-1.3167113,36.8301563,864,1620,100,1700
9185,22987,827,1,Personal,3,3,35829,3,3,37097,3,3,38238,3,3,39057,3,3,40190,5,24.0,-1.2740396,36.7993518,-1.2940473,36.8270407,88,1133,1268,1960
9186,8743,3283,3,Business,26,2,46139,26,2,46187,26,2,46317,26,2,46594,26,2,48140,9,27.6,-1.2999309,36.8307998,-1.2628473,36.781805,519,1546,48,407
9187,2617,1033,3,Personal,28,4,39295,28,4,39366,28,4,40267,28,4,40459,28,4,41810,9,23.7,-1.233018,36.8004477,-1.2736771,36.8123141,634,1351,71,1093
9188,5666,2956,3,Business,21,3,50028,21,3,50956,21,3,52598,21,3,52768,21,3,55145,8,23.4,-1.2584143,36.8048002,-1.296485,36.7931959,685,2377,928,1812
9189,10504,1334,2,Personal,1,1,25682,1,1,26496,1,1,29272,1,1,29442,1,1,30699,6,18.2,-1.3086326,36.8080886,-1.304033,36.7848695,208,1257,814,2946
9190,17156,2066,3,Business,21,4,56989,21,4,58342,21,4,58841,21,4,59311,21,4,61517,10,26.3,-1.3210189,36.8410551,-1.2655953,36.7915464,436,2206,1353,969
9191,4607,3517,3,Business,26,2,49245,26,2,49295,26,2,49804,26,2,50900,26,2,52540,15,30.8,-1.300921,36.828195,-1.3882008,36.7699445,218,1640,50,1605
9192,10261,3147,3,Business,26,3,50181,26,3,50289,26,3,50577,26,3,50831,26,3,53271,11,27.0,-1.3472066,36.7692638,-1.2852142,36.7940293,623,2440,108,542
9193,26345,2783,2,Personal,11,3,41749,11,3,41792,11,3,43397,11,3,43909,11,3,44200,2,18.8,-1.2959749,36.7770396,-1.2952109,36.7757064,103,291,43,2117
9194,27875,1280,3,Business,11,1,29355,11,1,29546,11,1,30028,11,1,30341,11,1,31915,8,17.8,-1.2551895,36.7822034,-1.2993556,36.8146776,854,1574,191,795
9195,8728,1271,3,Business,7,1,58964,7,1,59543,7,1,60392,7,1,60555,7,1,63622,23,24.4,-1.3244885,36.897792,-1.3107918,36.761794,654,3067,579,1012
9196,13237,1072,1,Personal,23,6,39934,23,6,39981,23,6,40737,23,6,41084,23,6,42985,9,23.25888921888938,-1.261849,36.808254,-1.3234472,36.8416613,427,1901,47,1103
9197,27013,674,1,Personal,19,5,53948,19,5,53957,19,5,54384,19,5,54478,19,5,55088,2,27.2,-1.2676164,36.8075243,-1.264917,36.8150651,407,610,9,521
9198,4863,2154,3,Business,17,4,42283,17,4,42517,17,4,42961,17,4,43801,17,4,45159,5,25.6,-1.290894,36.822971,-1.2765736,36.8513646,812,1358,234,1284
9199,9178,186,3,Business,27,3,41824,27,3,41901,27,3,41926,27,3,42528,27,3,42530,5,25.9,-1.2902869,36.8085396,-1.2571472,36.7950633,779,2,77,627
9200,27571,3283,3,Business,3,1,33201,3,1,33234,3,1,33688,3,1,34288,3,1,35916,16,18.2,-1.2628473,36.781805,-1.228911,36.881876,310,1628,33,1054
9201,3331,635,3,Business,21,2,38578,21,2,38608,21,2,38741,21,2,39356,21,2,40300,3,22.6,-1.257069,36.81467,-1.2602337,36.7990548,445,944,30,748
9202,6870,1087,3,Business,3,3,41174,3,3,41262,3,3,41877,3,3,42000,3,3,44483,16,24.2,-1.2679971,36.8088937,-1.3277669,36.8975169,38,2483,88,738
9203,9660,3283,3,Business,2,2,53905,2,2,53942,2,2,54640,2,2,55591,2,2,56004,5,26.3,-1.2600926,36.8088685,-1.2628473,36.781805,882,413,37,1649
9204,10252,1642,3,Business,28,4,52708,28,4,52823,28,4,53272,28,4,54076,28,4,54373,5,27.5,-1.2817058,36.8191058,-1.2726506,36.7960153,365,297,115,1253
9205,21332,1103,3,Business,29,1,53132,29,1,53259,29,1,54286,29,1,54536,29,1,55701,7,24.6,-1.290894,36.822971,-1.2551895,36.7822034,878,1165,127,1277
9206,2155,1363,3,Business,12,2,56463,12,2,56617,12,2,56620,12,2,57080,12,2,58476,8,23.25888921888938,-1.3004062,36.829741,-1.2638185,36.7930057,925,1396,154,463
9207,8085,3404,3,Business,23,5,49893,23,5,50011,23,5,52548,23,5,53617,23,5,54296,1,26.2,-1.290894,36.822971,-1.279395,36.825364,268,679,118,3606
9208,10963,2523,3,Business,4,1,53639,4,1,53678,4,1,54093,4,1,54281,4,1,56553,12,28.7,-1.2551895,36.7822034,-1.3184779,36.8373109,953,2272,39,603
9209,10035,2040,3,Personal,30,6,34541,30,6,34566,30,6,35222,30,6,37113,30,6,39691,21,17.9,-1.3321944,36.8892329,-1.248519,36.783656,74,2578,25,2547
9210,17350,1329,3,Business,7,2,39287,7,2,39394,7,2,39870,7,2,39986,7,2,41534,12,23.25888921888938,-1.273056,36.811298,-1.2672045,36.7172069,228,1548,107,592
9211,19725,2953,3,Business,23,2,54269,23,2,54675,23,2,57134,23,2,58732,23,2,60194,8,23.25888921888938,-1.3223238,36.8320056,-1.30157,36.7871,233,1462,406,4057
9212,21350,1961,3,Business,8,3,52080,8,3,52142,8,3,52744,8,3,54386,8,3,56502,19,23.25888921888938,-1.307143,36.825009,-1.3181159,36.7101559,591,2116,62,2244
9213,21196,3599,3,Business,18,4,44185,18,4,46486,18,4,47783,18,4,49707,18,4,51049,7,23.25888921888938,-1.3302996,36.8707935,-1.305349,36.829708,690,1342,2301,3221
9214,664,3525,3,Business,30,5,46190,30,5,48295,30,5,48815,30,5,51319,30,5,52500,10,24.6,-1.2886923,36.8241519,-1.303924,36.8758792,812,1181,2105,3024
9215,26710,3647,3,Business,31,4,33383,31,4,33488,31,4,35279,31,4,35343,31,4,37301,5,20.6,-1.272639,36.794723,-1.2548773,36.8077319,953,1958,105,1855
9216,8075,2165,1,Personal,6,3,38284,6,3,38324,6,3,39909,6,3,40637,6,3,43261,16,19.9,-1.2966785,36.7896469,-1.2161475,36.8828534,334,2624,40,2313
9217,23369,3291,3,Business,31,1,35593,31,1,35607,31,1,35659,31,1,37953,31,1,39087,12,20.8,-1.228911,36.881876,-1.2600926,36.8088685,669,1134,14,2346
9218,12163,2955,1,Personal,17,5,47050,17,5,47068,17,5,47473,17,5,48208,17,5,50363,10,17.8,-1.2943371,36.8267,-1.2332989,36.8130698,387,2155,18,1140
9219,11172,1500,3,Business,1,1,31438,1,1,31532,1,1,32246,1,1,32521,1,1,33831,8,21.2,-1.2879248,36.7546388,-1.2638185,36.7930057,306,1310,94,989
9220,11958,2724,3,Personal,18,4,36265,18,4,36306,18,4,36786,18,4,37372,18,4,38494,9,23.25888921888938,-1.2665327,36.8108799,-1.3239488,36.8316835,68,1122,41,1066
9221,15517,2596,3,Business,18,5,46208,18,5,46220,18,5,46236,18,5,47470,18,5,51122,18,20.3,-1.326304,36.8665245,-1.2482465,36.8889062,191,3652,12,1250
9222,16104,393,3,Business,28,4,33955,28,4,33965,28,4,33981,28,4,34941,28,4,36938,14,19.4,-1.3167113,36.8301563,-1.306378,36.7519845,349,1997,10,976
9223,20101,136,3,Business,22,5,59128,22,5,59427,22,5,60033,22,5,60124,22,5,64643,16,28.4,-1.3254522,36.7216584,-1.2654716,36.7983635,326,4519,299,697
9224,12239,3201,3,Business,20,2,39458,20,2,39544,20,2,39970,20,2,40641,20,2,41589,3,19.9,-1.2584143,36.8048002,-1.2551895,36.7822034,926,948,86,1097
9225,4521,2015,3,Personal,12,3,51986,12,3,52054,12,3,52708,12,3,53020,12,3,54527,10,26.3,-1.2918688,36.7603541,-1.267522,36.827995,465,1507,68,966
9226,22314,3674,3,Business,19,3,35918,19,3,37000,19,3,37567,19,3,38083,19,3,39191,8,22.3,-1.2551895,36.7822034,-1.2944292,36.7793569,105,1108,1082,1083
9227,16302,3232,3,Business,6,1,45425,6,1,45497,6,1,46286,6,1,46923,6,1,48236,8,20.4,-1.2551895,36.7822034,-1.2846195,36.7958316,520,1313,72,1426
9228,26854,2714,1,Personal,17,4,64494,17,4,67584,17,4,69953,17,4,70021,17,4,71734,17,21.8,-1.3518598,36.7324661,-1.2813498,36.7930729,919,1713,3090,2437
9229,14334,2054,1,Personal,25,5,48539,25,5,48551,25,5,50755,25,5,50846,25,5,52601,14,23.6,-1.350736,36.8960004,-1.3016151,36.8117354,543,1755,12,2295
9230,23623,2335,3,Business,2,4,34884,2,4,34890,2,4,35911,2,4,36142,2,4,38375,17,13.2,-1.2551895,36.7822034,-1.2859912,36.8756811,452,2233,6,1252
9231,16301,1280,3,Business,4,5,38525,4,5,38585,4,5,38882,4,5,40521,4,5,41481,8,22.4,-1.255956,36.789867,-1.293297,36.760739,446,960,60,1936
9232,17297,3291,3,Business,23,2,45821,23,2,45922,23,2,46581,23,2,47120,23,2,47462,2,23.25888921888938,-1.266837,36.799249,-1.2600926,36.8088685,205,342,101,1198
9233,2517,3647,3,Business,18,4,48929,18,4,48996,18,4,49689,18,4,50403,18,4,50722,2,23.25888921888938,-1.272639,36.794723,-1.2741728,36.7969108,161,319,67,1407
9234,9633,3517,3,Business,18,4,48877,18,4,48894,18,4,49975,18,4,52128,18,4,52978,16,23.25888921888938,-1.300921,36.828195,-1.3882008,36.7699445,137,850,17,3234
9235,5223,1719,3,Business,6,4,48704,6,4,48935,6,4,50534,6,4,51429,6,4,53280,15,21.4,-1.2825379,36.843502,-1.23966,36.75258,829,1851,231,2494
9236,23870,136,3,Business,22,5,54240,22,5,54300,22,5,55078,22,5,55324,22,5,56795,7,23.25888921888938,-1.2536042,36.8064895,-1.2505657,36.8211047,549,1471,60,1024
9237,24448,3525,3,Business,15,4,37383,15,4,37428,15,4,37707,15,4,38265,15,4,40582,13,24.5,-1.3700383,36.9190174,-1.3239488,36.8316835,593,2317,45,837
9238,6621,302,3,Business,21,5,74062,21,5,75444,21,5,75959,21,5,76961,21,5,77760,3,18.2,-1.2649605,36.7981777,-1.2763916,36.8246826,607,799,1382,1517
9239,8845,3599,3,Business,4,2,44806,4,2,44872,4,2,45393,4,2,46702,4,2,48628,17,19.3,-1.3302996,36.8707935,-1.2912918,36.758141,130,1926,66,1830
9240,24897,635,3,Business,27,2,44555,27,2,44844,27,2,45039,27,2,45419,27,2,46395,7,23.9,-1.2599563,36.7993439,-1.300921,36.828195,19,976,289,575
9241,15152,3728,2,Personal,2,3,53499,2,3,54870,2,3,55925,2,3,56156,2,3,57045,3,23.3,-1.2814037,36.8150313,-1.2890399,36.8164942,219,889,1371,1286
9242,1609,3214,3,Business,7,4,53326,7,4,53413,7,4,55802,7,4,56811,7,4,58523,12,31.2,-1.2315181,36.8140543,-1.289795,36.7957132,52,1712,87,3398
9243,19056,2216,3,Business,10,1,52419,10,1,52478,10,1,52850,10,1,53248,10,1,53675,1,18.4,-1.2551895,36.7822034,-1.2549259,36.7919494,205,427,59,770
9244,14647,1500,3,Business,5,2,53871,5,2,53941,5,2,55576,5,2,57217,5,2,59339,8,27.3,-1.3004062,36.829741,-1.2638185,36.7930057,311,2122,70,3276
9245,14051,2200,3,Business,8,6,43843,8,6,46983,8,6,47452,8,6,47865,8,6,48216,2,18.1,-1.290894,36.822971,-1.2848174,36.826163,781,351,3140,882
9246,14948,238,3,Business,31,3,34554,31,3,34565,31,3,35352,31,3,35584,31,3,36439,3,19.2,-1.3077869,36.8443207,-1.3080092,36.8284543,206,855,11,1019
9247,21084,3647,3,Business,8,3,50389,8,3,50463,8,3,51410,8,3,52063,8,3,53782,6,23.25888921888938,-1.272639,36.794723,-1.2944584,36.7614555,427,1719,74,1600
9248,5249,3647,3,Business,15,3,41715,15,3,41747,15,3,42044,15,3,42491,15,3,44838,15,23.25888921888938,-1.272639,36.794723,-1.3339943,36.7263409,710,2347,32,744
9249,22358,391,3,Business,29,5,39461,29,5,39643,29,5,40205,29,5,40813,29,5,43489,5,26.7,-1.2602337,36.7990548,-1.2784063,36.8222933,96,2676,182,1170
9250,3638,1660,1,Personal,30,4,66594,30,4,66602,30,4,66663,30,4,68571,30,4,71503,15,20.5,-1.2694178,36.8126928,-1.3337097,36.7659945,329,2932,8,1969
9251,723,2676,3,Business,8,5,61816,8,5,61838,8,5,62106,8,5,62871,8,5,63910,6,25.1,-1.2963097,36.7688221,-1.2812549,36.7236622,829,1039,22,1033
9252,3678,3201,3,Business,20,3,55199,20,3,55212,20,3,55221,20,3,55283,20,3,59347,9,29.4,-1.3014461,36.7661381,-1.2584143,36.8048002,613,4064,13,71
9253,11693,2494,3,Business,9,2,38341,9,2,38370,9,2,40221,9,2,40300,9,2,42858,17,22.0,-1.329449,36.890451,-1.2963097,36.7688221,532,2558,29,1930
9254,10540,627,3,Business,7,4,53974,7,4,54044,7,4,56096,7,4,56559,7,4,57592,11,30.9,-1.2571472,36.7950633,-1.2416156,36.8736721,216,1033,70,2515
9255,1771,844,1,Personal,7,4,39052,7,4,40009,7,4,40634,7,4,41089,7,4,43421,12,16.8,-1.2343087,36.84749,-1.2551895,36.7822034,852,2332,957,1080
9256,13423,1724,3,Business,24,5,32991,24,5,33009,24,5,33866,24,5,34460,24,5,35001,7,15.6,-1.293393,36.790237,-1.2551895,36.7822034,56,541,18,1451
9257,2505,3264,3,Business,24,3,32612,24,3,32693,24,3,34122,24,3,34186,24,3,37656,12,23.25888921888938,-1.2551895,36.7822034,-1.3174857,36.8019937,793,3470,81,1493
9258,1683,3098,1,Business,4,5,33158,4,5,34756,4,5,35655,4,5,36055,4,5,37572,8,19.4,-1.2777926,36.8215788,-1.2963097,36.7688221,676,1517,1598,1299
9259,26673,3291,3,Business,1,1,50838,1,1,50859,1,1,50873,1,1,51793,1,1,52752,11,23.25888921888938,-1.303596,36.778378,-1.2600926,36.8088685,854,959,21,934
9260,2627,3470,3,Business,9,5,41633,9,5,45684,9,5,46583,9,5,47841,9,5,48850,6,25.5,-1.2551895,36.7822034,-1.28878,36.8168312,477,1009,4051,2157
9261,2021,2169,2,Personal,2,1,62009,2,1,62028,2,1,62919,2,1,63619,2,1,65457,11,19.5,-1.311208,36.778743,-1.3634667,36.7389097,449,1838,19,1591
9262,7173,1188,3,Personal,21,1,49385,21,1,49793,21,1,50843,21,1,51341,21,1,52751,13,21.4,-1.1884386,36.9350507,-1.2494637,36.8705482,444,1410,408,1548
9263,25655,75,2,Personal,15,3,39813,15,3,39820,15,3,43343,15,3,43966,15,3,47656,29,18.1,-1.1923911,36.9447333,-1.3014462,36.7607695,734,3690,7,4146
9264,568,2154,3,Business,3,3,52739,3,3,53690,3,3,54243,3,3,57641,3,3,59859,12,28.4,-1.3014461,36.7661381,-1.2765736,36.8513646,96,2218,951,3951
9265,22000,1642,3,Business,16,2,57133,16,2,57418,16,2,60820,16,2,61728,16,2,63994,6,24.9,-1.295162,36.8115914,-1.2728069,36.7962362,726,2266,285,4310
9266,16390,865,3,Business,16,4,35766,16,4,36749,16,4,38708,16,4,39198,16,4,41138,22,23.25888921888938,-1.174484,36.914608,-1.2456412,36.7955298,484,1940,983,2449
9267,16353,564,3,Business,9,3,46351,9,3,47007,9,3,47326,9,3,47513,9,3,48563,6,25.3,-1.2960774,36.8190048,-1.2688224,36.7944062,848,1050,656,506
9268,27824,3355,3,Business,24,1,41265,24,1,41279,24,1,41959,24,1,42690,24,1,43833,15,22.6,-1.2283403,36.8822756,-1.3052491,36.8223899,812,1143,14,1411
9269,15380,3201,3,Business,11,4,56168,11,4,56187,11,4,56556,11,4,56933,11,4,57306,1,26.9,-1.2584143,36.8048002,-1.2527958,36.8003131,880,373,19,746
9270,17166,635,3,Business,11,1,55785,11,1,56042,11,1,57017,11,1,58178,11,1,58456,4,28.8,-1.2602337,36.7990548,-1.2691495,36.7928193,86,278,257,2136
9271,11282,1342,3,Business,17,3,46655,17,3,46811,17,3,48592,17,3,51957,17,3,52013,11,28.5,-1.3472066,36.7692638,-1.3025826,36.7670807,65,56,156,5146
9272,2510,534,3,Personal,26,6,41442,26,6,41451,26,6,42224,26,6,42692,26,6,45816,16,26.2,-1.2866298,36.8227916,-1.3103985,36.9114173,758,3124,9,1241
9273,1611,2412,3,Business,3,4,30751,3,4,30761,3,4,30839,3,4,33766,3,4,35269,14,20.3,-1.2285835,36.8826468,-1.2551895,36.7822034,779,1503,10,3005
9274,25896,3283,3,Business,27,3,58068,27,3,58087,27,3,58448,27,3,59565,27,3,59587,5,27.7,-1.2600926,36.8088685,-1.2628473,36.781805,318,22,19,1478
9275,14728,608,3,Business,20,3,37293,20,3,37346,20,3,38038,20,3,38493,20,3,39490,7,26.6,-1.2658373,36.8018598,-1.2706041,36.8303142,276,997,53,1147
9276,9125,1271,3,Business,14,2,47352,14,2,48296,14,2,53240,14,2,56472,14,2,58933,28,23.8,-1.3899636,36.7482377,-1.3244885,36.897792,431,2461,944,8176
9277,17655,2066,3,Business,7,1,57102,7,1,57129,7,1,58204,7,1,58494,7,1,60864,16,26.7,-1.3210189,36.8410551,-1.3916459,36.9305892,457,2370,27,1365
9278,1666,2913,3,Personal,5,5,63466,5,5,64179,5,5,64528,5,5,64610,5,5,66117,6,24.6,-1.300663,36.790907,-1.2791714,36.8255997,614,1507,713,431
9279,19363,829,3,Business,15,1,38307,15,1,40835,15,1,42040,15,1,42243,15,1,44351,16,23.25888921888938,-1.2967108,36.7871135,-1.293274,36.9044706,692,2108,2528,1408
9280,16127,2200,3,Business,28,4,48030,28,4,52909,28,4,54448,28,4,55334,28,4,57769,17,29.9,-1.3700383,36.9190174,-1.290894,36.822971,19,2435,4879,2425
9281,15292,1527,3,Business,3,1,41760,3,1,41828,3,1,42251,3,1,43552,3,1,43912,4,21.5,-1.3077869,36.8443207,-1.3004062,36.829741,790,360,68,1724
9282,8107,203,3,Business,22,5,53816,22,5,53851,22,5,55092,22,5,55946,22,5,57790,4,31.0,-1.2852908,36.7557439,-1.295908,36.791433,118,1844,35,2095
9283,15509,2112,3,Business,9,2,49268,9,2,49280,9,2,51287,9,2,51646,9,2,53313,17,30.4,-1.2156006,36.8916865,-1.2551895,36.7822034,8,1667,12,2366
9284,23437,868,3,Business,31,3,56797,31,3,56902,31,3,57550,31,3,57802,31,3,57807,3,27.0,-1.2783849,36.8163445,-1.265715,36.823815,456,5,105,900
9285,15526,816,3,Business,23,5,41569,23,5,46127,23,5,46806,23,5,47652,23,5,49544,6,24.3,-1.2534301,36.8000983,-1.290894,36.822971,477,1892,4558,1525
9286,13540,393,3,Business,19,3,35405,19,3,35983,19,3,35989,19,3,37637,19,3,38998,11,19.8,-1.3167113,36.8301563,-1.2574219,36.7927073,619,1361,578,1654
9287,12603,3647,3,Business,3,4,52055,3,4,52117,3,4,53189,3,4,53562,3,4,53920,5,25.9,-1.272639,36.794723,-1.2628638,36.8070399,932,358,62,1445
9288,5268,2271,3,Business,27,3,45716,27,3,50031,27,3,50315,27,3,50570,27,3,52512,14,29.3,-1.272828,36.816608,-1.293515,36.897607,306,1942,4315,539
9289,13437,868,3,Business,13,4,57129,13,4,57158,13,4,57275,13,4,57869,13,4,58588,4,23.2,-1.266837,36.799249,-1.2663631,36.8163329,427,719,29,711
9290,11472,816,3,Business,15,4,34863,15,4,37766,15,4,39181,15,4,39494,15,4,40768,10,24.5,-1.290894,36.822971,-1.2413316,36.8785525,878,1274,2903,1728
9291,10979,635,3,Business,18,1,35601,18,1,37847,18,1,38256,18,1,39847,18,1,40645,7,27.9,-1.3081376,36.8329772,-1.2602337,36.7990548,463,798,2246,2000
9292,27769,2602,3,Personal,25,1,54082,25,1,54147,25,1,54747,25,1,55306,25,1,56629,7,30.2,-1.270766,36.810988,-1.304735,36.7846054,763,1323,65,1159
9293,12594,478,3,Business,18,1,34863,18,1,34896,18,1,35553,18,1,36122,18,1,36338,2,21.3,-1.2650459,36.8079893,-1.2571472,36.7950633,383,216,33,1226
9294,8688,1215,2,Personal,5,7,37420,5,7,37438,5,7,38214,5,7,38473,5,7,40189,11,19.3,-1.3049101,36.7873232,-1.3254094,36.7084902,105,1716,18,1035
9295,4364,3355,3,Business,14,1,39479,14,1,39511,14,1,41700,14,1,42580,14,1,44215,13,23.6,-1.32943,36.894243,-1.3052491,36.8223899,837,1635,32,3069
9296,26966,265,3,Business,28,4,46543,28,4,47359,28,4,48761,28,4,49346,28,4,52384,16,30.0,-1.300921,36.828195,-1.3882008,36.7699445,275,3038,816,1987
9297,12967,640,3,Business,18,4,65296,18,4,65342,18,4,65664,18,4,66666,18,4,68264,8,23.25888921888938,-1.2969741,36.7856612,-1.2709035,36.8168523,815,1598,46,1324
9298,25799,3147,3,Business,19,3,39875,19,3,39893,19,3,41075,19,3,43536,19,3,44965,17,22.1,-1.2551895,36.7822034,-1.3472066,36.7692638,216,1429,18,3643
9299,507,2132,3,Business,3,4,36226,3,4,36276,3,4,38082,3,4,38745,3,4,42917,27,23.3,-1.2384056,36.8718698,-1.3858142,36.7641498,925,4172,50,2469
9300,8360,393,3,Business,23,3,49557,23,3,49564,23,3,49720,23,3,50380,23,3,50802,4,27.2,-1.3167113,36.8301563,-1.3004062,36.829741,523,422,7,816
9301,17872,635,3,Business,1,5,41087,1,5,42039,1,5,42059,1,5,43805,1,5,44912,7,26.6,-1.3012141,36.826224,-1.2599563,36.7993439,669,1107,952,1766
9302,14400,867,3,Business,5,1,47301,5,1,48136,5,1,49116,5,1,49278,5,1,51381,10,26.0,-1.2996533,36.8292629,-1.306378,36.7519845,661,2103,835,1142
9303,25129,2423,3,Business,19,3,44804,19,3,50385,19,3,50970,19,3,51616,19,3,54732,6,24.2,-1.2571472,36.7950633,-1.2967702,36.8040381,147,3116,5581,1231
9304,5229,53,3,Business,20,3,46064,20,3,46475,20,3,47261,20,3,47332,20,3,48333,2,26.5,-1.2770708,36.8231093,-1.279858,36.8245976,747,1001,411,857
9305,18911,3149,3,Business,13,4,53575,13,4,53624,13,4,53838,13,4,54516,13,4,54912,5,23.1,-1.3004062,36.829741,-1.3167113,36.8301563,863,396,49,892
9306,1387,3283,3,Business,22,5,34462,22,5,34488,22,5,34493,22,5,38110,22,5,39560,14,28.4,-1.228911,36.881876,-1.2628473,36.781805,260,1450,26,3622
9307,1193,391,3,Business,24,1,47039,24,1,47082,24,1,48138,24,1,48702,24,1,50436,13,22.7,-1.2867454,36.8259017,-1.2054954,36.8985954,726,1734,43,1620
9308,23939,633,3,Business,16,6,36812,16,6,36867,16,6,37147,16,6,38684,16,6,39444,5,25.5,-1.3004062,36.829741,-1.3228003,36.8306435,206,760,55,1817
9309,19113,421,3,Business,20,4,61270,20,4,62243,20,4,63222,20,4,63304,20,4,64581,5,22.8,-1.2975066,36.7689423,-1.2745551,36.7979797,576,1277,973,1061
9310,1012,3647,3,Business,27,4,34219,27,4,34271,27,4,34774,27,4,35450,27,4,37480,6,19.0,-1.2951243,36.8281344,-1.272639,36.794723,726,2030,52,1179
9311,5975,2330,3,Business,23,4,54796,23,4,54882,23,4,55803,23,4,56095,23,4,57331,9,24.4,-1.2687407,36.7373043,-1.3015197,36.7658456,240,1236,86,1213
9312,17274,478,3,Business,2,4,37519,2,4,40697,2,4,41405,2,4,42119,2,4,43288,9,22.7,-1.2551895,36.7822034,-1.29387,36.7907813,101,1169,3178,1422
9313,10031,1329,3,Business,30,2,53672,30,2,55372,30,2,55613,30,2,55895,30,2,58377,4,23.25888921888938,-1.273056,36.811298,-1.2646569,36.7809444,119,2482,1700,523
9314,12723,1363,3,Business,3,5,54605,3,5,54773,3,5,55639,3,5,55705,3,5,58619,7,23.25888921888938,-1.3004062,36.829741,-1.3272104,36.8528418,292,2914,168,932
9315,17008,2030,3,Business,13,3,50050,13,3,50063,13,3,50632,13,3,51217,13,3,51797,1,29.0,-1.2628638,36.8070399,-1.2601197,36.7985271,575,580,13,1154
9316,5500,1856,3,Business,8,4,45340,8,4,45638,8,4,46559,8,4,46847,8,4,47892,6,26.1,-1.3001813,36.811122,-1.273009,36.802807,615,1045,298,1209
9317,6526,1880,3,Business,11,2,51492,11,2,60952,11,2,61158,11,2,62221,11,2,64028,10,20.9,-1.311173,36.827569,-1.2551895,36.7822034,671,1807,9460,1269
9318,12667,2529,1,Personal,4,4,68313,4,4,69126,4,4,70715,4,4,71198,4,4,72815,11,23.25888921888938,-1.2242979,36.7647642,-1.2000518,36.7805946,101,1617,813,2072
9319,6942,20,3,Business,12,1,43639,12,1,43679,12,1,44145,12,1,44551,12,1,46053,18,23.6,-1.2628638,36.8070399,-1.3244885,36.897792,501,1502,40,872
9320,15739,677,3,Business,7,2,46256,7,2,46369,7,2,47243,7,2,49004,7,2,52240,9,23.25888921888938,-1.290894,36.822971,-1.3025826,36.7670807,843,3236,113,2635
9321,5119,2563,1,Personal,18,4,50765,18,4,50777,18,4,50790,18,4,51742,18,4,53255,12,26.9,-1.3108386,36.7555239,-1.2598589,36.7470168,105,1513,12,965
9322,4256,516,3,Business,14,1,38199,14,1,38220,14,1,38761,14,1,38845,14,1,42098,20,23.4,-1.2551895,36.7822034,-1.3195936,36.9161697,620,3253,21,625
9323,5697,246,3,Business,4,2,52360,4,2,57045,4,2,59131,4,2,59276,4,2,60701,10,23.8,-1.2584143,36.8048002,-1.2413316,36.8785525,685,1425,4685,2231
9324,25700,2030,3,Business,14,5,41988,14,5,42031,14,5,42075,14,5,42181,14,5,43016,3,24.2,-1.2963097,36.7688221,-1.295908,36.791433,786,835,43,150
9325,22903,2030,3,Business,17,3,38605,17,3,38635,17,3,39346,17,3,39450,17,3,40440,3,23.25888921888938,-1.2963097,36.7688221,-1.295908,36.791433,548,990,30,815
9326,17151,3547,3,Business,9,2,44677,9,2,44685,9,2,45335,9,2,45628,9,2,48925,22,27.0,-1.2761408,36.7710839,-1.3160977,36.9131642,306,3297,8,943
9327,607,635,3,Business,4,5,42055,4,5,42494,4,5,45073,4,5,46564,4,5,47784,7,22.7,-1.300921,36.828195,-1.2599563,36.7993439,589,1220,439,4070
9328,19864,1363,3,Business,11,2,45325,11,2,45468,11,2,45726,11,2,46038,11,2,46734,3,19.6,-1.3004062,36.829741,-1.2936429,36.8277508,868,696,143,570
9329,9021,2330,3,Business,9,3,55952,9,3,55970,9,3,56407,9,3,56879,9,3,59651,17,25.4,-1.2642903,36.8002137,-1.2927792,36.9053492,512,2772,18,909
9330,20999,867,3,Business,18,4,30211,18,4,30301,18,4,30797,18,4,32635,18,4,33754,9,23.25888921888938,-1.2638185,36.7930057,-1.2991441,36.7528804,166,1119,90,2334
9331,9144,111,3,Business,16,1,49023,16,1,49040,16,1,49135,16,1,49280,16,1,50523,6,22.2,-1.2551895,36.7822034,-1.2765641,36.793782,103,1243,17,240
9332,11661,1568,3,Business,31,4,61270,31,4,61534,31,4,62695,31,4,63649,31,4,65212,13,22.5,-1.2897368,36.8226783,-1.2441325,36.8962053,116,1563,264,2115
9333,20044,3496,3,Business,30,2,60030,30,2,60518,30,2,61265,30,2,61777,30,2,63143,12,23.25888921888938,-1.300921,36.828195,-1.3347899,36.7391053,328,1366,488,1259
9334,13617,2727,3,Personal,23,3,37898,23,3,37910,23,3,39066,23,3,40225,23,3,41714,15,23.25888921888938,-1.2375779,36.8649718,-1.2925556,36.7903149,124,1489,12,2315
9335,19172,186,3,Business,25,4,41009,25,4,41025,25,4,41771,25,4,41967,25,4,43737,17,23.25888921888938,-1.2902869,36.8085396,-1.3700383,36.9190174,622,1770,16,942
9336,15576,3689,3,Business,9,3,54712,9,3,54747,9,3,55067,9,3,55393,9,3,56722,6,25.3,-1.2527958,36.8003131,-1.2623805,36.7805404,205,1329,35,646
9337,7600,2412,3,Business,30,4,38104,30,4,38143,30,4,38636,30,4,39805,30,4,40928,11,23.25888921888938,-1.2728947,36.8079426,-1.2283403,36.8822756,245,1123,39,1662
9338,13433,2587,3,Business,21,5,38920,21,5,42562,21,5,43111,21,5,43585,21,5,44639,8,22.7,-1.3014461,36.7661381,-1.28878,36.8168312,456,1054,3642,1023
9339,2397,1796,3,Business,2,2,38181,2,2,38262,2,2,38283,2,2,38782,2,2,40409,21,26.1,-1.331619,36.847976,-1.3181159,36.7101559,61,1627,81,520
9340,4549,426,3,Business,18,1,54323,18,1,54337,18,1,54932,18,1,55254,18,1,57999,18,17.4,-1.3323107,36.8692616,-1.2600616,36.7870182,192,2745,14,917
9341,12664,2523,3,Business,19,2,34495,19,2,34540,19,2,34900,19,2,35318,19,2,35875,4,23.25888921888938,-1.2551895,36.7822034,-1.2722283,36.805013,720,557,45,778
9342,3861,830,3,Business,24,5,62720,24,5,62807,24,5,63240,24,5,63487,24,5,64685,3,20.2,-1.2584143,36.8048002,-1.2551895,36.7822034,697,1198,87,680
9343,3287,1500,3,Business,6,3,39261,6,3,39345,6,3,39861,6,3,40071,6,3,40730,6,23.25888921888938,-1.2836832,36.8306719,-1.2638185,36.7930057,728,659,84,726
9344,12259,3331,3,Business,1,5,62914,1,5,62992,1,5,63172,1,5,63490,1,5,65117,8,26.6,-1.2551895,36.7822034,-1.2821378,36.7740428,523,1627,78,498
9345,18854,3147,3,Business,12,2,48940,12,2,48950,12,2,49295,12,2,49621,12,2,51673,12,26.9,-1.3472066,36.7692638,-1.2880129,36.8308097,584,2052,10,671
9346,2475,1792,3,Business,24,1,36958,24,1,36985,24,1,37348,24,1,37596,24,1,38031,4,15.4,-1.2809121,36.7852524,-1.2756467,36.8079895,446,435,27,611
9347,11863,1363,3,Business,29,5,33304,29,5,33383,29,5,34222,29,5,34498,29,5,35847,5,20.9,-1.3004062,36.829741,-1.28068,36.831155,907,1349,79,1115
9348,2140,2523,3,Business,30,3,34894,30,3,34991,30,3,35196,30,3,36110,30,3,37581,15,19.6,-1.2551895,36.7822034,-1.3231725,36.8640177,541,1471,97,1119
9349,14845,2587,3,Business,23,6,42714,23,6,42997,23,6,43111,23,6,43607,23,6,44624,5,26.5,-1.2584143,36.8048002,-1.28878,36.8168312,576,1017,283,610
9350,7525,510,3,Business,22,3,58660,22,3,58678,22,3,58888,22,3,59571,22,3,61767,17,23.8,-1.2571472,36.7950633,-1.2860183,36.8975338,96,2196,18,893
9351,23945,2801,3,Business,12,3,46868,12,3,47000,12,3,47733,12,3,47800,12,3,51133,16,19.5,-1.2674274,36.7870827,-1.3109801,36.8810758,521,3333,132,800
9352,24323,1984,3,Business,10,1,39571,10,1,39600,10,1,39636,10,1,43807,10,1,45625,8,23.25888921888938,-1.2830989,36.8165739,-1.2758945,36.7648661,402,1818,29,4207
9353,24527,1642,3,Business,21,1,53849,21,1,53875,21,1,54491,21,1,54701,21,1,58534,5,27.6,-1.2897399,36.8270975,-1.2726506,36.7960153,819,3833,26,826
9354,6357,540,3,Business,17,3,51315,17,3,51587,17,3,52363,17,3,55084,17,3,55226,5,23.25888921888938,-1.2571472,36.7950633,-1.2890893,36.8268633,436,142,272,3497
9355,2318,3091,3,Business,28,5,45194,28,5,45238,28,5,46549,28,5,46830,28,5,48749,5,25.2,-1.2894649,36.787753,-1.3012008,36.764868,431,1919,44,1592
9356,14224,2112,3,Business,18,1,32413,18,1,32451,18,1,33122,18,1,34686,18,1,35211,5,22.2,-1.2285835,36.8826468,-1.2156006,36.8916865,445,525,38,2235
9357,22972,868,3,Business,21,1,51029,21,1,51603,21,1,51702,21,1,52829,21,1,53900,8,27.4,-1.303596,36.778378,-1.265715,36.823815,86,1071,574,1226
9358,25175,393,3,Business,25,1,41880,25,1,41894,25,1,41901,25,1,43125,25,1,43126,4,27.1,-1.3167113,36.8301563,-1.3004062,36.829741,515,1,14,1231
9359,4554,3674,3,Business,14,4,34178,14,4,34193,14,4,34252,14,4,34643,14,4,37167,22,19.1,-1.2551895,36.7822034,-1.178201,36.9345516,576,2524,15,450
9360,6922,1687,3,Business,22,5,50431,22,5,50451,22,5,52201,22,5,52782,22,5,53451,4,31.0,-1.2626574,36.8014034,-1.2966453,36.8191342,76,669,20,2331
9361,5139,2987,3,Business,28,2,47423,28,2,47587,28,2,49538,28,2,50327,28,2,51936,9,19.5,-1.270212,36.8210877,-1.3014461,36.7661381,810,1609,164,2740
9362,24927,624,3,Business,26,1,40447,26,1,41487,26,1,42109,26,1,42951,26,1,44405,12,23.1,-1.307143,36.825009,-1.22978,36.836215,622,1454,1040,1464
9363,16374,2676,3,Business,6,1,36803,6,1,36821,6,1,37259,6,1,38486,6,1,39083,2,20.4,-1.3047482,36.7849672,-1.2963097,36.7688221,636,597,18,1665
9364,24802,3635,1,Business,12,5,48471,12,5,48533,12,5,48936,12,5,49762,12,5,50594,7,27.1,-1.2615888,36.7928732,-1.2896399,36.8124498,379,832,62,1229
9365,14878,2216,3,Business,18,5,42613,18,5,42623,18,5,42816,18,5,43623,18,5,44928,8,20.1,-1.2551895,36.7822034,-1.303658,36.8177075,958,1305,10,1000
9366,23652,1405,3,Business,27,4,43222,27,4,44459,27,4,44627,27,4,45547,27,4,46882,6,22.6,-1.327535,36.89546,-1.3478563,36.8935824,543,1335,1237,1088
9367,24578,633,3,Business,8,5,53341,8,5,53756,8,5,55056,8,5,55690,8,5,56254,4,27.3,-1.3077869,36.8443207,-1.3004062,36.829741,114,564,415,1934
9368,11690,3450,3,Business,5,3,55081,5,3,55457,5,3,55675,5,3,56587,5,3,58939,7,25.2,-1.2551895,36.7822034,-1.257537,36.843066,614,2352,376,1130
9369,8812,946,2,Personal,29,3,53581,29,3,54093,29,3,54317,29,3,54408,29,3,56632,17,19.0,-1.2844665,36.7866113,-1.2143387,36.7914548,536,2224,512,315
9370,18692,633,3,Business,23,2,53185,23,2,55372,23,2,56205,23,2,56318,23,2,57765,8,19.1,-1.3004062,36.829741,-1.2574219,36.7927073,518,1447,2187,946
9371,15230,635,3,Business,11,2,36259,11,2,36285,11,2,36560,11,2,37895,11,2,38858,10,16.8,-1.3081376,36.8329772,-1.2602337,36.7990548,399,963,26,1610
9372,23770,2956,3,Business,28,6,47735,28,6,47739,28,6,48260,28,6,48419,28,6,49732,9,23.9,-1.3052491,36.8223899,-1.2584143,36.8048002,229,1313,4,680
9373,26809,2866,3,Business,28,4,41796,28,4,42140,28,4,42146,28,4,42591,28,4,44568,11,28.1,-1.2551895,36.7822034,-1.3197323,36.8120386,518,1977,344,451
9374,8777,635,3,Business,4,4,53220,4,4,53466,4,4,55158,4,4,55482,4,4,55909,2,27.5,-1.2602337,36.7990548,-1.2618264,36.8141179,85,427,246,2016
9375,10369,2946,2,Personal,14,2,37744,14,2,37764,14,2,38403,14,2,38739,14,2,39753,7,21.4,-1.2749662,36.7658781,-1.289521,36.8190724,648,1014,20,975
9376,10553,893,3,Business,19,1,39515,19,1,39578,19,1,40320,19,1,40549,19,1,41605,5,24.6,-1.2594474,36.8089122,-1.2850523,36.7859591,547,1056,63,971
9377,9439,2801,3,Business,7,5,48092,7,5,48611,7,5,49917,7,5,50497,7,5,51664,8,26.9,-1.2595422,36.7871178,-1.291214,36.78577,178,1167,519,1886
9378,23740,1687,3,Business,10,4,39289,10,4,39328,10,4,39643,10,4,40269,10,4,41559,3,24.7,-1.2626574,36.8014034,-1.2701979,36.8138177,447,1290,39,941
9379,26479,1382,1,Personal,22,6,52936,22,6,53018,22,6,53844,22,6,54156,22,6,55649,10,23.25888921888938,-1.2985073,36.7493901,-1.3188148,36.8092478,328,1493,82,1138
9380,16660,1075,3,Business,22,2,57358,22,2,58022,22,2,58529,22,2,58796,22,2,60382,8,25.7,-1.2765736,36.8513646,-1.2527958,36.8003131,660,1586,664,774
9381,20364,393,3,Business,15,2,51570,15,2,51580,15,2,51646,15,2,52217,15,2,53400,11,24.7,-1.3167113,36.8301563,-1.2574219,36.7927073,62,1183,10,637
9382,9951,2801,3,Business,25,1,31053,25,1,31068,25,1,31341,25,1,36636,25,1,39291,15,23.25888921888938,-1.3104506,36.8687235,-1.2674274,36.7870827,26,2655,15,5568
9383,4392,2733,3,Business,24,5,45202,24,5,45293,24,5,46212,24,5,46486,24,5,52896,8,21.5,-1.2963097,36.7688221,-1.2813012,36.8323962,800,6410,91,1193
9384,11550,53,3,Business,7,4,48033,7,4,48143,7,4,51656,7,4,52075,7,4,53962,8,31.2,-1.3167113,36.8301563,-1.2770708,36.8231093,349,1887,110,3932
9385,6871,270,2,Personal,14,4,48321,14,4,48796,14,4,49204,14,4,50563,14,4,51105,4,21.6,-1.31522,36.837006,-1.3312467,36.8321722,890,542,475,1767
9386,1023,517,3,Business,27,6,37989,27,6,38039,27,6,38696,27,6,39178,27,6,40600,11,23.25888921888938,-1.3167113,36.8301563,-1.2638185,36.7930057,329,1422,50,1139
9387,25618,2330,3,Business,8,3,37825,8,3,37888,8,3,38200,8,3,38348,8,3,39594,17,23.25888921888938,-1.3015197,36.7658456,-1.2326041,36.8009029,205,1246,63,460
9388,3840,2978,3,Business,10,2,36009,10,2,36026,10,2,36387,10,2,36620,10,2,37596,9,16.4,-1.2551895,36.7822034,-1.2942764,36.7969749,103,976,17,594
9389,16702,608,3,Business,7,3,32084,7,3,32421,7,3,33862,7,3,34079,7,3,35639,8,23.25888921888938,-1.2569503,36.7834728,-1.2995738,36.8199719,219,1560,337,1658
9390,19304,314,2,Personal,28,5,48755,28,5,48795,28,5,49054,28,5,50472,28,5,51868,10,25.7,-1.25454,36.83922,-1.3064585,36.8119065,726,1396,40,1677
9391,5037,2066,3,Business,26,5,62128,26,5,62152,26,5,62870,26,5,62965,26,5,64206,9,23.25888921888938,-1.3210189,36.8410551,-1.2971024,36.7836598,448,1241,24,813
9392,13419,393,3,Business,23,2,57620,23,2,59648,23,2,59658,23,2,60275,23,2,62209,14,19.6,-1.3177547,36.8303703,-1.306378,36.7519845,10,1934,2028,627
9393,8584,3108,3,Business,11,2,30540,11,2,30565,11,2,30805,11,2,30978,11,2,32750,13,16.5,-1.2551895,36.7822034,-1.314962,36.865528,894,1772,25,413
9394,18389,3484,1,Personal,17,1,46645,17,1,46656,17,1,47143,17,1,47300,17,1,48478,15,24.9,-1.2343236,36.8861,-1.29276,36.783799,320,1178,11,644
9395,10425,1402,3,Business,29,5,45016,29,5,46388,29,5,47704,29,5,49133,29,5,52917,6,29.1,-1.2527958,36.8003131,-1.2813012,36.8323962,763,3784,1372,2745
9396,17649,393,3,Business,10,1,42815,10,1,47427,10,1,47465,10,1,49214,10,1,51286,11,18.9,-1.3228003,36.8306435,-1.2574219,36.7927073,39,2072,4612,1787
9397,5876,2523,3,Business,14,4,54776,14,4,56450,14,4,57235,14,4,57579,14,4,60148,23,27.8,-1.2551895,36.7822034,-1.343439,36.912065,862,2569,1674,1129
9398,11797,1996,3,Business,11,4,37837,11,4,37851,11,4,39140,11,4,40145,11,4,41165,6,25.4,-1.2946359,36.8352718,-1.3272104,36.8528418,507,1020,14,2294
9399,23491,1502,3,Business,6,3,49394,6,3,50209,6,3,50232,6,3,50445,6,3,52726,11,23.25888921888938,-1.2859912,36.8756811,-1.2232123,36.8932547,885,2281,815,236
9400,24586,2980,1,Personal,2,2,35694,2,2,35774,2,2,36507,2,2,36652,2,2,37137,7,15.1,-1.2669099,36.7977433,-1.2854789,36.8240689,731,485,80,878
9401,24070,2271,3,Business,2,4,38792,2,4,39445,2,4,40132,2,4,40757,2,4,41882,15,22.4,-1.2287314,36.8367354,-1.293515,36.897607,174,1125,653,1312
9402,24485,3108,3,Business,15,1,53916,15,1,54329,15,1,54766,15,1,54924,15,1,56264,6,23.25888921888938,-1.2551895,36.7822034,-1.2817351,36.8186929,692,1340,413,595
9403,2708,2330,3,Business,15,5,53696,15,5,53906,15,5,55248,15,5,56260,15,5,58385,15,27.9,-1.2284323,36.8757058,-1.2124582,36.802894,238,2125,210,2354
9404,25865,136,3,Business,17,3,34720,17,3,34733,17,3,35382,17,3,36492,17,3,38819,16,23.25888921888938,-1.2738073,36.8131173,-1.3254522,36.7216584,363,2327,13,1759
9405,23219,391,3,Business,12,3,42817,12,3,43384,12,3,43909,12,3,45225,12,3,48845,16,19.2,-1.319613,36.711055,-1.2784063,36.8222933,739,3620,567,1841
9406,10009,393,3,Business,4,4,35261,4,4,35352,4,4,35874,4,4,36911,4,4,37749,4,21.9,-1.3167113,36.8301563,-1.3004062,36.829741,245,838,91,1559
9407,9711,2346,1,Personal,7,4,56081,7,4,56307,7,4,58390,7,4,58518,7,4,59917,8,20.2,-1.3054537,36.8284768,-1.274716,36.789582,312,1399,226,2211
9408,10202,3557,3,Business,26,1,38347,26,1,43286,26,1,44796,26,1,45697,26,1,50227,5,22.8,-1.2830057,36.8175478,-1.2546732,36.8086796,260,4530,4939,2411
9409,10262,3285,2,Personal,18,1,55538,18,1,55704,18,1,56255,18,1,56499,18,1,58138,9,17.4,-1.2635425,36.8021963,-1.2940769,36.7491574,726,1639,166,795
9410,9221,788,3,Business,25,1,47519,25,1,47758,25,1,50651,25,1,51586,25,1,53713,10,28.1,-1.290894,36.822971,-1.225322,36.80855,863,2127,239,3828
9411,2506,1271,3,Business,17,3,43761,17,3,44101,17,3,45565,17,3,47049,17,3,47684,8,25.6,-1.3244885,36.897792,-1.3332749,36.8708147,946,635,340,2948
9412,11196,3326,3,Business,25,5,52143,25,5,52262,25,5,53413,25,5,53573,25,5,54462,8,29.0,-1.2571472,36.7950633,-1.3025667,36.7803495,862,889,119,1311
9413,26291,1926,3,Business,25,1,52099,25,1,52322,25,1,53146,25,1,53368,25,1,54325,6,23.25888921888938,-1.3332749,36.8708147,-1.3318059,36.8359596,663,957,223,1046
9414,343,1500,3,Business,30,5,34339,30,5,36910,30,5,37915,30,5,38181,30,5,39222,11,23.8,-1.3077869,36.8443207,-1.2574219,36.7927073,878,1041,2571,1271
9415,6969,2587,3,Business,4,1,47139,4,1,47347,4,1,49980,4,1,50105,4,1,52166,5,23.25888921888938,-1.2527958,36.8003131,-1.28878,36.8168312,885,2061,208,2758
9416,3844,1363,3,Business,12,2,46483,12,2,46636,12,2,46944,12,2,49176,12,2,51941,8,23.0,-1.3004062,36.829741,-1.2574219,36.7927073,297,2765,153,2540
9417,17077,393,3,Business,26,2,37373,26,2,37463,26,2,37848,26,2,38708,26,2,39448,4,27.3,-1.3167113,36.8301563,-1.3004062,36.829741,409,740,90,1245
9418,18569,302,3,Business,27,2,63800,27,2,64418,27,2,65104,27,2,65494,27,2,67034,8,22.5,-1.2649605,36.7981777,-1.3172395,36.839269,933,1540,618,1076
9419,1453,517,3,Business,3,4,45696,3,4,45748,3,4,45873,3,4,48311,3,4,48315,4,23.3,-1.3167113,36.8301563,-1.3004062,36.829741,619,4,52,2563
9420,553,867,3,Business,21,3,38829,21,3,39651,21,3,39885,21,3,40342,21,3,41468,9,21.9,-1.2574219,36.7927073,-1.306378,36.7519845,878,1126,822,691
9421,24093,3434,3,Business,23,2,40537,23,2,40586,23,2,42560,23,2,43320,23,2,45396,20,17.8,-1.3244885,36.897792,-1.2963097,36.7688221,498,2076,49,2734
9422,16460,3137,2,Personal,4,2,34897,4,2,34910,4,2,35285,4,2,35483,4,2,36027,7,16.6,-1.2923116,36.7916244,-1.302088,36.831162,249,544,13,573
9423,7890,1402,3,Business,17,1,38008,17,1,38178,17,1,39632,17,1,40028,17,1,41007,4,23.6,-1.2765736,36.8513646,-1.281754,36.8324229,511,979,170,1850
9424,27345,868,3,Business,14,2,54339,14,2,54388,14,2,57121,14,2,57880,14,2,59481,9,23.25888921888938,-1.318062,36.849326,-1.265715,36.823815,686,1601,49,3492
9425,24115,2523,3,Business,19,2,36958,19,2,37023,19,2,37476,19,2,37805,19,2,38931,4,21.2,-1.2551895,36.7822034,-1.2747247,36.8150014,131,1126,65,782
9426,19833,1527,3,Business,10,1,33633,10,1,33660,10,1,34091,10,1,34253,10,1,35440,9,16.6,-1.2638185,36.7930057,-1.3004062,36.829741,139,1187,27,593
9427,7029,970,3,Business,11,4,46998,11,4,47019,11,4,47071,11,4,47573,11,4,48317,4,25.4,-1.2551895,36.7822034,-1.2654228,36.8033218,709,744,21,554
9428,669,2532,3,Business,24,1,43431,24,1,43533,24,1,44137,24,1,44289,24,1,45667,8,22.6,-1.2551895,36.7822034,-1.298744,36.8178237,43,1378,102,756
9429,5813,2763,3,Business,4,1,33577,4,1,33587,4,1,34085,4,1,34689,4,1,36795,13,21.8,-1.2551895,36.7822034,-1.3270347,36.8667362,958,2106,10,1102
9430,4280,3686,3,Business,6,3,42974,6,3,43003,6,3,43068,6,3,43220,6,3,45471,8,22.5,-1.2551895,36.7822034,-1.2925919,36.8170577,771,2251,29,217
9431,11138,2869,3,Business,11,2,64444,11,2,64500,11,2,65557,11,2,65972,11,2,66892,3,20.7,-1.3025826,36.7670807,-1.2763494,36.7671783,55,920,56,1472
9432,11175,53,3,Business,28,2,34720,28,2,34764,28,2,35786,28,2,36690,28,2,37860,5,18.5,-1.3004062,36.829741,-1.2770708,36.8231093,448,1170,44,1926
9433,16913,2154,3,Business,29,5,47802,29,5,47938,29,5,48022,29,5,48364,29,5,50054,16,26.6,-1.339046,36.762596,-1.2765736,36.8513646,900,1690,136,426
9434,19545,246,3,Business,17,4,47501,17,4,47512,17,4,47851,17,4,48153,17,4,49335,7,25.5,-1.225322,36.80855,-1.2584143,36.8048002,428,1182,11,641
9435,16606,3669,3,Business,20,3,61268,20,3,61299,20,3,62780,20,3,63962,20,3,66135,7,27.7,-1.2615888,36.7928732,-1.2772389,36.7855864,510,2173,31,2663
9436,26222,893,3,Business,14,2,45193,14,2,45267,14,2,46111,14,2,46659,14,2,50921,7,21.7,-1.2973827,36.7942871,-1.2663194,36.809901,268,4262,74,1392
9437,8739,136,3,Business,31,4,40673,31,4,40702,31,4,41358,31,4,41530,31,4,43490,3,26.4,-1.2965045,36.7913036,-1.2906105,36.8053279,206,1960,29,828
9438,12132,2828,3,Business,17,5,41186,17,5,41210,17,5,41809,17,5,42733,17,5,45736,23,17.7,-1.2615888,36.7928732,-1.364732,36.658943,222,3003,24,1523
9439,13955,3517,3,Business,7,4,39118,7,4,40195,7,4,40605,7,4,41209,7,4,42584,14,24.2,-1.3198615,36.7110323,-1.3882008,36.7699445,805,1375,1077,1014
9440,24246,2987,3,Business,2,1,47319,2,1,47439,2,1,48308,2,1,49064,2,1,50311,10,20.0,-1.3043821,36.7840586,-1.2649605,36.7981777,192,1247,120,1625
9441,18808,111,3,Business,30,2,53570,30,2,53966,30,2,54628,30,2,54705,30,2,55849,4,23.25888921888938,-1.2551895,36.7822034,-1.2585521,36.7945765,131,1144,396,739
9442,24685,187,3,Business,25,7,46517,25,7,46534,25,7,47409,25,7,48342,25,7,51216,18,23.1,-1.2584143,36.8048002,-1.3169591,36.7000029,680,2874,17,1808
9443,8583,2423,3,Business,14,4,48495,14,4,56133,14,4,56270,14,4,57125,14,4,57971,6,27.8,-1.2551895,36.7822034,-1.2854989,36.8218183,513,846,7638,992
9444,16768,3283,3,Business,21,1,43368,21,1,43460,21,1,44197,21,1,44808,21,1,45525,7,25.3,-1.2628473,36.781805,-1.265715,36.823815,336,717,92,1348
9445,8510,1527,3,Business,2,4,53164,2,4,53195,2,4,53459,2,4,53525,2,4,57137,9,23.25888921888938,-1.2638185,36.7930057,-1.3004062,36.829741,411,3612,31,330
9446,10364,2436,3,Business,7,4,42302,7,4,42314,7,4,42559,7,4,42795,7,4,43372,4,27.4,-1.2551895,36.7822034,-1.2715686,36.8023526,523,577,12,481
9447,25263,3727,3,Business,8,5,49830,8,5,49878,8,5,50280,8,5,50577,8,5,51826,8,27.0,-1.2963097,36.7688221,-1.2600616,36.7870182,263,1249,48,699
9448,1890,1468,1,Personal,22,6,63486,22,6,63529,22,6,64333,22,6,65643,22,6,67333,16,23.2,-1.2675613,36.8133001,-1.3370737,36.74708,427,1690,43,2114
9449,17792,168,1,Personal,13,1,44261,13,1,44874,13,1,45875,13,1,46238,13,1,47607,8,17.2,-1.2977044,36.8645101,-1.2977768,36.8110285,213,1369,613,1364
9450,5404,640,3,Business,11,4,58651,11,4,58687,11,4,59152,11,4,59342,11,4,60092,3,26.7,-1.304033,36.7848695,-1.2945106,36.7728398,299,750,36,655
9451,27508,3601,3,Personal,19,4,54128,19,4,54206,19,4,54848,19,4,55369,19,4,56481,10,20.5,-1.2678485,36.8019541,-1.2746933,36.7396167,131,1112,78,1163
9452,17596,2330,3,Business,27,3,70203,27,3,71279,27,3,71849,27,3,72199,27,3,73107,8,22.0,-1.3015197,36.7658456,-1.3192789,36.7112991,452,908,1076,920
9453,295,2274,2,Personal,9,3,37433,9,3,38338,9,3,39915,9,3,40240,9,3,41315,5,20.9,-1.2657274,36.8273387,-1.2592148,36.7996449,782,1075,905,1902
9454,1781,73,1,Personal,11,3,47631,11,3,47648,11,3,48686,11,3,50355,11,3,52484,10,20.3,-1.2665774,36.8069908,-1.3075119,36.8527811,951,2129,17,2707
9455,8047,3295,3,Business,28,2,54405,28,2,54423,28,2,54451,28,2,55261,28,2,57056,4,19.5,-1.2615048,36.8116724,-1.2571472,36.7950633,875,1795,18,838
9456,25919,357,3,Business,4,4,52144,4,4,52403,4,4,54331,4,4,55072,4,4,56308,7,27.3,-1.2951833,36.8195615,-1.2945179,36.7685349,855,1236,259,2669
9457,26658,868,3,Business,20,3,36102,20,3,36124,20,3,39097,20,3,39364,20,3,41438,14,26.3,-1.293515,36.897607,-1.265715,36.823815,377,2074,22,3240
9458,26754,1369,2,Personal,14,1,38601,14,1,38615,14,1,39178,14,1,40012,14,1,41463,8,23.0,-1.2915307,36.7905865,-1.3145553,36.7493849,223,1451,14,1397
9459,25706,1244,3,Business,25,4,51421,25,4,51439,25,4,52646,25,4,53300,25,4,54724,13,23.25888921888938,-1.344446,36.756597,-1.303596,36.778378,940,1424,18,1861
9460,1917,470,1,Personal,24,5,50449,24,5,50518,24,5,53170,24,5,54791,24,5,56369,4,23.1,-1.2845766,36.8245168,-1.2583017,36.8023526,384,1578,69,4273
9461,16413,1384,3,Business,2,4,54848,2,4,54980,2,4,56097,2,4,56287,2,4,60372,22,23.25888921888938,-1.2517448,36.7924971,-1.25217,36.9303345,538,4085,132,1307
9462,9677,598,1,Business,1,3,36402,1,3,36411,1,3,36688,1,3,37063,1,3,38994,17,23.25888921888938,-1.2750257,36.8157165,-1.3178263,36.7141818,857,1931,9,652
9463,8476,59,3,Business,6,4,44725,6,4,46400,6,4,47449,6,4,47597,6,4,51889,6,24.2,-1.290894,36.822971,-1.2571472,36.7950633,928,4292,1675,1197
9464,7728,1402,3,Business,24,3,50047,24,3,51071,24,3,51683,24,3,51861,24,3,53616,5,23.25888921888938,-1.2584143,36.8048002,-1.2813012,36.8323962,411,1755,1024,790
9465,5656,3582,3,Business,13,3,58802,13,3,62062,13,3,63089,13,3,63648,13,3,65572,10,26.1,-1.2384056,36.8718698,-1.2906091,36.8405869,411,1924,3260,1586
9466,25230,2200,3,Business,31,1,62238,31,1,62262,31,1,64165,31,1,65095,31,1,65731,2,22.7,-1.279395,36.825364,-1.290894,36.822971,338,636,24,2833
9467,23047,11,1,Personal,31,2,68774,31,2,70421,31,2,71101,31,2,71399,31,2,72784,13,17.6,-1.2222024,36.8888065,-1.2800514,36.829403,886,1385,1647,978
9468,4781,1250,1,Personal,14,6,48109,14,6,48145,14,6,49590,14,6,51049,14,6,52571,9,19.1,-1.3014461,36.7661381,-1.2598589,36.7470168,648,1522,36,2904
9469,27887,248,3,Business,6,5,38626,6,5,38680,6,5,39395,6,5,39529,6,5,40567,4,20.4,-1.304735,36.7846054,-1.289379,36.792949,465,1038,54,849
9470,5270,2587,3,Business,6,4,39538,6,4,39553,6,4,41305,6,4,41783,6,4,43646,18,24.2,-1.3065979,36.7186349,-1.28878,36.8168312,647,1863,15,2230
9471,24496,3517,3,Business,28,5,57020,28,5,57162,28,5,57540,28,5,60947,28,5,65272,15,23.25888921888938,-1.300921,36.828195,-1.3882008,36.7699445,519,4325,142,3785
9472,10344,2216,3,Business,11,1,38431,11,1,39179,11,1,39460,11,1,39648,11,1,40892,3,18.1,-1.2551895,36.7822034,-1.26153,36.79111,322,1244,748,469
9473,26831,633,3,Business,18,5,41280,18,5,41406,18,5,41414,18,5,42006,18,5,42813,5,20.2,-1.2770708,36.8231093,-1.3004062,36.829741,725,807,126,600
9474,3376,3363,1,Personal,21,6,55377,21,6,55385,21,6,55730,21,6,57454,21,6,59886,18,18.5,-1.2536042,36.8064895,-1.307725,36.69941,858,2432,8,2069
9475,23310,635,3,Business,28,4,52071,28,4,52117,28,4,54905,28,4,55038,28,4,57208,8,30.2,-1.2780878,36.8469436,-1.2602337,36.7990548,439,2170,46,2921
9476,22587,2195,3,Business,3,3,51807,3,3,51825,3,3,52866,3,3,52978,3,3,53872,10,28.2,-1.228911,36.881876,-1.265715,36.823815,341,894,18,1153
9477,3314,2271,3,Business,11,1,44429,11,1,44451,11,1,45085,11,1,46269,11,1,50490,20,26.7,-1.2628473,36.781805,-1.293515,36.897607,269,4221,22,1818
9478,22835,3426,3,Business,18,2,35923,18,2,35955,18,2,36584,18,2,37822,18,2,39370,9,16.7,-1.290894,36.822971,-1.3014461,36.7661381,726,1548,32,1867
9479,14860,2587,3,Business,16,2,51736,16,2,55753,16,2,55767,16,2,57485,16,2,60570,16,23.25888921888938,-1.323615,36.700475,-1.28878,36.8168312,322,3085,4017,1732
9480,3486,517,3,Business,9,6,32010,9,6,32040,9,6,32062,9,6,33648,9,6,34740,7,19.9,-1.3167113,36.8301563,-1.3012842,36.8561033,842,1092,30,1608
9481,12333,3062,3,Personal,21,5,71399,21,5,71693,21,5,73110,21,5,73548,21,5,74452,4,18.1,-1.2913246,36.8019522,-1.277783,36.7816464,247,904,294,1855
9482,3429,238,3,Business,18,4,50885,18,4,51029,18,4,51767,18,4,52689,18,4,53106,5,23.25888921888938,-1.3004062,36.829741,-1.3077869,36.8443207,61,417,144,1660
9483,9091,2330,3,Business,2,4,44913,2,4,44941,2,4,44980,2,4,45632,2,4,45635,3,23.25888921888938,-1.3015197,36.7658456,-1.294597,36.7742999,99,3,28,691
9484,15262,2532,3,Business,27,2,55812,27,2,55977,27,2,56017,27,2,56527,27,2,57443,6,25.7,-1.2551895,36.7822034,-1.2868599,36.821542,268,916,165,550
9485,10124,1389,3,Business,3,4,59438,3,4,60037,3,4,60966,3,4,61343,3,4,62477,5,18.1,-1.281223,36.8239,-1.2668734,36.8054026,692,1134,599,1306
9486,11940,3222,3,Business,4,1,53488,4,1,53547,4,1,54021,4,1,54462,4,1,55270,6,23.25888921888938,-1.2551895,36.7822034,-1.2902869,36.8085396,75,808,59,915
9487,20863,3050,3,Business,1,5,53602,1,5,53668,1,5,54300,1,5,55136,1,5,57276,14,31.8,-1.2945074,36.8083195,-1.3169591,36.7000029,30,2140,66,1468
9488,14966,1564,1,Personal,16,2,35478,16,2,35515,16,2,35864,16,2,35948,16,2,36352,3,23.25888921888938,-1.2452735,36.7911588,-1.2670196,36.8077002,453,404,37,433
9489,15470,1946,1,Personal,25,3,47867,25,3,47987,25,3,48166,25,3,48626,25,3,49522,5,23.25888921888938,-1.2781519,36.8328741,-1.2913382,36.8018508,393,896,120,639
9490,5400,3288,3,Business,6,2,46207,6,2,55928,6,2,55945,6,2,56275,6,2,57856,4,27.3,-1.3080696,36.8237191,-1.2845766,36.8245168,445,1581,9721,347
9491,4610,393,3,Business,21,5,48206,21,5,48612,21,5,48617,21,5,49835,21,5,49839,4,24.7,-1.3167113,36.8301563,-1.3004062,36.829741,239,4,406,1223
9492,12618,393,3,Business,6,1,31913,6,1,31923,6,1,31928,6,1,34629,6,1,34633,11,23.25888921888938,-1.3167113,36.8301563,-1.2638185,36.7930057,10,4,10,2706
9493,23995,3487,3,Business,12,5,37312,12,5,37347,12,5,37849,12,5,38271,12,5,39445,9,26.7,-1.279395,36.825364,-1.2295205,36.8120426,341,1174,35,924
9494,9972,1410,3,Business,1,4,30685,1,4,30884,1,4,31765,1,4,32842,1,4,34236,6,23.25888921888938,-1.300921,36.828195,-1.2941024,36.79578,206,1394,199,1958
9495,25435,2701,3,Business,23,4,48380,23,4,48412,23,4,48874,23,4,49620,23,4,50323,1,21.0,-1.290894,36.822971,-1.279395,36.825364,89,703,32,1208
9496,20448,393,3,Business,20,1,46348,20,1,46789,20,1,48352,20,1,48927,20,1,50439,4,23.25888921888938,-1.3167113,36.8301563,-1.3004062,36.829741,163,1512,441,2138
9497,6263,2718,3,Business,29,2,56397,29,2,58210,29,2,60648,29,2,61232,29,2,66420,20,23.25888921888938,-1.3415467,36.6696294,-1.2668815,36.8017244,680,5188,1813,3022
9498,12170,1291,3,Personal,7,2,55614,7,2,55648,7,2,56847,7,2,57029,7,2,59510,9,24.6,-1.2580991,36.7941519,-1.2963097,36.7688221,726,2481,34,1381
9499,21729,1966,3,Business,28,4,55814,28,4,55894,28,4,56847,28,4,58659,28,4,61252,21,30.1,-1.3700383,36.9190174,-1.2917868,36.7872675,769,2593,80,2765
9500,5710,20,3,Business,12,3,30806,12,3,30851,12,3,31759,12,3,32017,12,3,33355,5,23.25888921888938,-1.2566689,36.7796952,-1.2629666,36.8068369,139,1338,45,1166
9501,19990,3147,3,Business,28,1,48578,28,1,48616,28,1,49381,28,1,49463,28,1,50382,10,26.5,-1.3052491,36.8223899,-1.3467389,36.7690312,581,919,38,847
9502,9140,706,3,Business,21,1,59455,21,1,59497,21,1,60177,21,1,60621,21,1,61291,4,23.25888921888938,-1.298331,36.822614,-1.3077869,36.8443207,116,670,42,1124
9503,19626,2701,3,Business,12,3,50224,12,3,50253,12,3,50682,12,3,50772,12,3,52982,8,26.3,-1.2527958,36.8003131,-1.2765736,36.8513646,407,2210,29,519
9504,2979,2330,3,Business,5,2,49587,5,2,53664,5,2,54783,5,2,58784,5,2,58795,11,27.3,-1.2326041,36.8009029,-1.293082,36.8278578,953,11,4077,5120
9505,19350,2200,3,Business,1,4,54109,1,4,54548,1,4,55256,1,4,55323,1,4,57139,9,23.25888921888938,-1.2859912,36.8756811,-1.290894,36.822971,31,1816,439,775
9506,4585,1544,3,Business,3,4,47570,3,4,49175,3,4,51689,3,4,52199,3,4,54469,8,24.8,-1.2786917,36.8252217,-1.3232881,36.8537357,196,2270,1605,3024
9507,25202,391,3,Business,18,1,49651,18,1,49741,18,1,53043,18,1,54390,18,1,55687,5,29.7,-1.300921,36.828195,-1.2867454,36.8259017,668,1297,90,4649
9508,21902,3291,3,Business,9,3,55925,9,3,56339,9,3,56714,9,3,57608,9,3,58639,11,25.5,-1.303596,36.778378,-1.2600926,36.8088685,101,1031,414,1269
9509,27408,295,3,Business,2,4,45840,2,4,54030,2,4,56742,2,4,56809,2,4,57422,6,23.25888921888938,-1.2967108,36.7871135,-1.286925,36.821916,845,613,8190,2779
9510,6159,1208,1,Personal,24,1,35083,24,1,35111,24,1,36733,24,1,38056,24,1,40352,15,22.3,-1.2100103,36.797424,-1.3003196,36.8171416,865,2296,28,2945
9511,20391,2582,3,Business,14,1,43145,14,1,43158,14,1,44189,14,1,44504,14,1,46608,22,23.6,-1.2551895,36.7822034,-1.333148,36.922453,205,2104,13,1346
9512,5255,2216,3,Business,25,1,62291,25,1,62309,25,1,62372,25,1,62657,25,1,63644,4,28.2,-1.2551895,36.7822034,-1.2617028,36.7983849,291,987,18,348
9513,8709,3560,3,Business,12,2,40599,12,2,41504,12,2,42115,12,2,42690,12,2,44969,7,24.6,-1.2657464,36.7801144,-1.2897368,36.8226783,504,2279,905,1186
9514,20176,647,3,Business,31,5,51603,31,5,51751,31,5,52134,31,5,52825,31,5,55034,9,24.5,-1.2574219,36.7927073,-1.3004062,36.829741,490,2209,148,1074
9515,1726,3147,3,Business,5,5,35834,5,5,35850,5,5,37198,5,5,37645,5,5,39358,14,19.9,-1.3014461,36.7661381,-1.3472066,36.7692638,4,1713,16,1795
9516,21488,1489,2,Personal,14,7,54669,14,7,54679,14,7,55406,14,7,55956,14,7,58032,17,28.6,-1.2902161,36.8936181,-1.1891303,36.896427,532,2076,10,1277
9517,18457,2931,3,Business,17,1,44163,17,1,44393,17,1,44959,17,1,45270,17,1,48807,22,23.7,-1.2452664,36.8028541,-1.3433181,36.9138018,107,3537,230,877
9518,11828,3557,3,Business,19,2,37563,19,2,37609,19,2,37835,19,2,38155,19,2,39151,6,26.7,-1.2596241,36.762407,-1.2546732,36.8086796,518,996,46,546
9519,14233,393,3,Business,10,4,51599,10,4,51610,10,4,51617,10,4,52230,10,4,53050,3,25.4,-1.3231001,36.8283559,-1.3004062,36.829741,518,820,11,620
9520,10742,1642,3,Business,30,3,50057,30,3,50126,30,3,51555,30,3,52037,30,3,53598,5,29.0,-1.278327,36.823771,-1.2728069,36.7962362,696,1561,69,1911
9521,3234,1329,3,Business,12,3,55533,12,3,57154,12,3,57438,12,3,58139,12,3,58832,4,20.8,-1.273056,36.811298,-1.2854453,36.8188363,291,693,1621,985
9522,7810,59,3,Business,26,2,62295,26,2,62358,26,2,63634,26,2,63871,26,2,65497,6,29.5,-1.2584143,36.8048002,-1.290894,36.822971,194,1626,63,1513
9523,6602,670,3,Personal,9,6,55424,9,6,55436,9,6,55463,9,6,58655,9,6,60201,6,27.0,-1.273056,36.811298,-1.294562,36.7877173,469,1546,12,3219
9524,23782,3500,3,Business,11,3,32338,11,3,32351,11,3,32941,11,3,33389,11,3,34870,13,15.5,-1.2621828,36.7949276,-1.3248423,36.8530567,752,1481,13,1038
9525,10254,605,2,Personal,6,4,47495,6,4,47531,6,4,48109,6,4,48542,6,4,51207,17,22.2,-1.301278,36.7934817,-1.3332754,36.880569,865,2665,36,1011
9526,9942,393,3,Business,25,4,60041,25,4,60071,25,4,60268,25,4,61882,25,4,64321,14,23.25888921888938,-1.3167113,36.8301563,-1.2991441,36.7528804,349,2439,30,1811
9527,20437,1245,3,Business,9,6,39511,9,6,41517,9,6,41885,9,6,42473,9,6,43471,7,17.1,-1.2599563,36.7993439,-1.300921,36.828195,844,998,2006,956
9528,19881,1961,3,Business,8,6,44720,8,6,45522,8,6,46779,8,6,48262,8,6,49736,9,19.8,-1.303596,36.778378,-1.3188359,36.7038526,427,1474,802,2740
9529,11290,1215,2,Personal,26,3,44199,26,3,44264,26,3,44282,26,3,44691,26,3,46369,8,24.0,-1.2655953,36.7915464,-1.2460004,36.8247116,747,1678,65,427
9530,13608,1527,3,Business,24,5,45069,24,5,45084,24,5,45110,24,5,47893,24,5,48427,10,21.2,-1.3004062,36.829741,-1.2555317,36.8562313,70,534,15,2809
9531,12756,3080,3,Business,14,2,55267,14,2,55345,14,2,56123,14,2,56489,14,2,60717,5,24.2,-1.2551895,36.7822034,-1.2620741,36.8158147,268,4228,78,1144
9532,10452,1754,3,Business,8,6,53095,8,6,53129,8,6,53755,8,6,54018,8,6,56863,16,23.5,-1.2584143,36.8048002,-1.2860183,36.8975338,547,2845,34,889
9533,24489,743,1,Personal,31,2,41490,31,2,41494,31,2,41959,31,2,43100,31,2,44382,13,18.6,-1.2668265,36.7680484,-1.2624935,36.8434339,229,1282,4,1606
9534,22644,2306,3,Business,9,4,50047,9,4,50176,9,4,53546,9,4,53858,9,4,55752,14,23.25888921888938,-1.2271998,36.8084905,-1.2962832,36.7849683,161,1894,129,3682
9535,28210,718,3,Business,30,4,40484,30,4,40656,30,4,41996,30,4,42086,30,4,43679,13,23.25888921888938,-1.2551895,36.7822034,-1.330593,36.848697,176,1593,172,1430
9536,13516,1120,3,Personal,29,2,46633,29,2,46756,29,2,47691,29,2,48174,29,2,48459,2,21.6,-1.2594753,36.806273,-1.2638788,36.7998462,103,285,123,1418
9537,4802,246,3,Business,21,6,56284,21,6,56330,21,6,56767,21,6,57496,21,6,57725,2,18.5,-1.2527958,36.8003131,-1.2584143,36.8048002,427,229,46,1166
9538,5556,1075,3,Business,24,1,61506,24,1,61516,24,1,61602,24,1,61930,24,1,62331,1,22.7,-1.2649605,36.7981777,-1.2527958,36.8003131,685,401,10,414
9539,12740,2030,3,Business,4,2,39088,4,2,40893,4,2,40946,4,2,41262,4,2,41968,3,19.5,-1.265715,36.823815,-1.2753109,36.8130185,878,706,1805,369
9540,23733,2700,3,Business,17,6,52351,17,6,53698,17,6,54833,17,6,55051,17,6,58081,8,23.7,-1.2987697,36.746851,-1.2845835,36.8079121,625,3030,1347,1353
9541,15118,3556,1,Personal,26,6,33894,26,6,33902,26,6,34228,26,6,34830,26,6,35327,2,18.6,-1.2792875,36.8228711,-1.286198,36.8193847,89,497,8,928
9542,1994,3283,3,Business,17,3,54014,17,3,54029,17,3,54265,17,3,55069,17,3,55546,5,23.25888921888938,-1.2600926,36.8088685,-1.2628473,36.781805,484,477,15,1040
9543,7233,2718,3,Business,6,4,54581,6,4,54708,6,4,55848,6,4,56461,6,4,56986,2,23.25888921888938,-1.2741118,36.8020094,-1.2657456,36.8087424,454,525,127,1753
9544,24564,2876,1,Personal,5,3,42627,5,3,42636,5,3,43329,5,3,43608,5,3,44536,6,22.0,-1.2684239,36.7952462,-1.2944292,36.7793569,16,928,9,972
9545,21156,3621,3,Business,1,3,33265,1,3,33285,1,3,34511,1,3,34736,1,3,37858,21,23.25888921888938,-1.2836583,36.7886014,-1.3559786,36.6547515,155,3122,20,1451
9546,20191,357,3,Business,23,5,35059,23,5,40065,23,5,41570,23,5,41702,23,5,43203,6,24.0,-1.2945179,36.7685349,-1.2848376,36.8027622,596,1501,5006,1637
9547,13154,1494,1,Personal,12,4,44953,12,4,44984,12,4,45111,12,4,46490,12,4,48102,10,18.8,-1.3047891,36.7739622,-1.331101,36.7566023,101,1612,31,1506
9548,13118,2804,3,Business,1,5,44894,1,5,44920,1,5,45247,1,5,46769,1,5,47212,1,26.6,-1.2571472,36.7950633,-1.2642903,36.8002137,822,443,26,1849
9549,4084,552,3,Business,3,4,56930,3,4,56970,3,4,57047,3,4,60786,3,4,62782,17,23.6,-1.290894,36.822971,-1.3632162,36.9108253,703,1996,40,3816
9550,12509,3283,3,Business,30,6,53909,30,6,53927,30,6,54022,30,6,55105,30,6,56300,14,28.4,-1.228911,36.881876,-1.2628473,36.781805,855,1195,18,1178
9551,22308,1106,1,Personal,28,1,54610,28,1,54656,28,1,55358,28,1,56848,28,1,58813,13,24.5,-1.3025043,36.7535329,-1.3529387,36.6642562,101,1965,46,2192
9552,16651,2956,3,Business,19,2,33055,19,2,33065,19,2,33095,19,2,33813,19,2,33816,2,23.25888921888938,-1.2551895,36.7822034,-1.2584143,36.8048002,523,3,10,748
9553,27847,1392,3,Business,2,2,44646,2,2,44728,2,2,45077,2,2,45280,2,2,46282,7,26.4,-1.2551895,36.7822034,-1.2898179,36.8270849,96,1002,82,552
9554,16140,3517,3,Business,10,3,38885,10,3,38900,10,3,39336,10,3,40117,10,3,42023,19,28.0,-1.3211824,36.8683873,-1.3882008,36.7699445,690,1906,15,1217
9555,16048,2830,1,Personal,8,3,33711,8,3,33731,8,3,34728,8,3,34986,8,3,36706,12,17.5,-1.2549476,36.8269576,-1.2718777,36.7503475,519,1720,20,1255
9556,8352,2703,3,Personal,20,4,43432,20,4,49173,20,4,49640,20,4,49856,20,4,50883,7,25.1,-1.2799997,36.8237091,-1.296797,36.7764525,576,1027,5741,683
9557,1756,111,3,Business,18,5,45661,18,5,45751,18,5,46331,18,5,46529,18,5,47857,8,20.0,-1.2551895,36.7822034,-1.2925508,36.8109381,764,1328,90,778
9558,24138,265,3,Business,16,2,53583,16,2,53606,16,2,55433,16,2,55657,16,2,57093,4,27.6,-1.300921,36.828195,-1.2956951,36.8129242,736,1436,23,2051
9559,8146,2042,3,Business,2,4,34781,2,4,34796,2,4,36437,2,4,37099,2,4,38752,13,13.2,-1.2860183,36.8975338,-1.3189252,36.8617269,297,1653,15,2303
9560,15610,2462,3,Personal,17,2,43176,17,2,43231,17,2,43698,17,2,43980,17,2,45127,8,19.2,-1.2778747,36.8831829,-1.3015998,36.8764939,618,1147,55,749
9561,27188,1243,1,Business,18,4,31542,18,4,31635,18,4,32074,18,4,33138,18,4,34446,10,20.4,-1.304524,36.775371,-1.2551895,36.7822034,571,1308,93,1503
9562,26318,18,1,Personal,28,4,54914,28,4,54962,28,4,55507,28,4,55976,28,4,57005,7,23.25888921888938,-1.2960302,36.7711317,-1.2895261,36.8164407,268,1029,48,1014
9563,4778,2587,3,Business,31,1,46706,31,1,46712,31,1,46754,31,1,48386,31,1,49095,6,21.2,-1.28878,36.8168312,-1.256522,36.7864132,449,709,6,1674
9564,771,3647,3,Business,10,5,49918,10,5,49944,10,5,50086,10,5,50576,10,5,52320,6,23.25888921888938,-1.2985749,36.8088,-1.272639,36.794723,778,1744,26,632
9565,7443,2226,1,Personal,14,4,39309,14,4,39953,14,4,40768,14,4,40945,14,4,41842,5,18.9,-1.298043,36.771853,-1.3104734,36.7363698,635,897,644,992
9566,5919,266,1,Personal,5,2,48277,5,2,48284,5,2,48980,5,2,49440,5,2,51291,19,22.7,-1.3278743,36.8868144,-1.3327068,36.7797238,543,1851,7,1156
9567,10866,2956,3,Business,13,3,51960,13,3,52015,13,3,52322,13,3,52469,13,3,53268,1,29.0,-1.2584143,36.8048002,-1.2594539,36.8067841,318,799,55,454
9568,24752,3404,3,Business,6,4,41014,6,4,41029,6,4,44272,6,4,45444,6,4,47617,16,24.2,-1.207546,36.7913976,-1.279395,36.825364,743,2173,15,4415
9569,18535,2439,3,Business,11,5,49616,11,5,54040,11,5,54437,11,5,56312,11,5,57445,6,26.4,-1.2615888,36.7928732,-1.2886923,36.8241519,489,1133,4424,2272
9570,4940,302,3,Business,16,2,70591,16,2,70630,16,2,71013,16,2,71331,16,2,72023,4,21.7,-1.2649605,36.7981777,-1.2821569,36.7984426,299,692,39,701
9571,1463,3647,3,Business,1,1,45870,1,1,46038,1,1,46668,1,1,46847,1,1,47663,7,24.2,-1.272639,36.794723,-1.301809,36.75643,45,816,168,809
9572,17934,3222,3,Business,18,5,52231,18,5,52268,18,5,52741,18,5,52936,18,5,53455,5,26.9,-1.2551895,36.7822034,-1.2592947,36.7698085,566,519,37,668
9573,11574,3547,3,Business,9,4,40070,9,4,40315,9,4,41534,9,4,43411,9,4,43417,11,23.25888921888938,-1.2901543,36.8316523,-1.2856319,36.7672998,921,6,245,3096
9574,12376,1329,3,Business,6,4,60773,6,4,61382,6,4,61388,6,4,61948,6,4,61952,3,21.8,-1.273056,36.811298,-1.256033,36.791845,75,4,609,566
9575,22158,1402,3,Business,27,4,54199,27,4,54281,27,4,54818,27,4,55286,27,4,56057,2,23.9,-1.279395,36.825364,-1.281754,36.8324229,793,771,82,1005
9576,22388,2829,3,Business,7,2,34181,7,2,34386,7,2,35107,7,2,35394,7,2,36030,6,23.25888921888938,-1.2571472,36.7950633,-1.2933789,36.8087535,119,636,205,1008
9577,24234,393,3,Business,14,2,44447,14,2,44509,14,2,45345,14,2,45972,14,2,46585,4,23.25888921888938,-1.3167113,36.8301563,-1.3004062,36.829741,349,613,62,1463
9578,24938,3091,3,Business,17,3,32631,17,3,32710,17,3,33433,17,3,35617,17,3,36006,2,23.25888921888938,-1.28878,36.8168312,-1.290894,36.822971,508,389,79,2907
9579,24035,3542,2,Personal,15,1,55274,15,1,55673,15,1,55895,15,1,56160,15,1,60037,8,23.25888921888938,-1.28164,36.816867,-1.311818,36.8638544,268,3877,399,487
9580,22212,552,3,Business,5,1,39222,5,1,39423,5,1,40646,5,1,41516,5,1,43382,22,24.6,-1.3472066,36.7692638,-1.3632162,36.9108253,548,1866,201,2093
9581,8348,3647,3,Business,29,3,44839,29,3,44885,29,3,44956,29,3,45649,29,3,47233,6,23.25888921888938,-1.2985749,36.8088,-1.272639,36.794723,146,1584,46,764
9582,13730,1342,3,Business,14,5,64111,14,5,64129,14,5,65210,14,5,65401,14,5,67634,9,21.8,-1.2597529,36.806629,-1.3025826,36.7670807,328,2233,18,1272
9583,15126,2330,3,Business,30,3,39998,30,3,40033,30,3,42770,30,3,43206,30,3,45150,14,24.9,-1.2994935,36.8908744,-1.2649605,36.7981777,48,1944,35,3173
9584,22318,2956,3,Business,5,5,43368,5,5,43393,5,5,45537,5,5,45822,5,5,46979,3,24.5,-1.2584143,36.8048002,-1.2551895,36.7822034,547,1157,25,2429
9585,5995,718,3,Business,16,4,45561,16,4,46059,16,4,46450,16,4,46736,16,4,48205,8,14.7,-1.2551895,36.7822034,-1.2964348,36.8182757,848,1469,498,677
9586,9136,1642,3,Business,29,4,46581,29,4,47417,29,4,48909,29,4,49117,29,4,50667,6,24.7,-1.2728069,36.7962362,-1.2516391,36.8114886,404,1550,836,1700
9587,23209,2828,3,Business,20,1,51965,20,1,51980,20,1,52177,20,1,52425,20,1,53246,5,21.4,-1.2696183,36.8021778,-1.2772389,36.7855864,434,821,15,445
9588,19118,419,3,Business,18,1,51268,18,1,51418,18,1,53897,18,1,54137,18,1,56444,5,29.4,-1.2571472,36.7950633,-1.2886923,36.8241519,118,2307,150,2719
9589,19012,1642,3,Business,27,2,43665,27,2,43678,27,2,43917,27,2,45083,27,2,45378,3,23.6,-1.2672782,36.8041436,-1.2726506,36.7960153,56,295,13,1405
9590,7889,3203,3,Business,9,3,40751,9,3,46365,9,3,46371,9,3,48660,9,3,49245,9,21.1,-1.265715,36.823815,-1.228911,36.881876,397,585,5614,2295
9591,28147,718,3,Business,4,2,37572,4,2,41165,4,2,41950,4,2,42141,4,2,43020,4,19.5,-1.2551895,36.7822034,-1.2718639,36.8060408,112,879,3593,976
9592,23099,1075,3,Business,18,4,41562,18,4,41850,18,4,43147,18,4,43450,18,4,44744,5,23.25888921888938,-1.2527958,36.8003131,-1.2885315,36.8230419,705,1294,288,1600
9593,11205,2365,3,Personal,31,4,58731,31,4,58799,31,4,61067,31,4,61993,31,4,64964,10,27.4,-1.3056005,36.7567122,-1.3154433,36.806386,303,2971,68,3194
9594,18580,3355,3,Business,28,5,53199,28,5,53280,28,5,53449,28,5,54438,28,5,55891,8,25.7,-1.3052491,36.8223899,-1.2615888,36.7928732,848,1453,81,1158
9595,25469,1610,1,Personal,19,2,38992,19,2,39001,19,2,39391,19,2,41103,19,2,43200,15,23.25888921888938,-1.2962832,36.7849683,-1.22589,36.7822548,148,2097,9,2102
9596,248,2430,1,Personal,23,6,40900,23,6,40926,23,6,41613,23,6,41828,23,6,42966,9,23.25888921888938,-1.2677646,36.8298466,-1.2372752,36.8885387,116,1138,26,902
9597,15449,1207,3,Business,15,4,57516,15,4,57529,15,4,57835,15,4,58690,15,4,59167,3,27.3,-1.2628638,36.8070399,-1.2681004,36.7952081,446,477,13,1161
9598,3379,1797,2,Personal,28,2,69842,28,2,69884,28,2,71688,28,2,71949,28,2,75713,13,17.5,-1.2827576,36.7830241,-1.2418,36.84778,578,3764,42,2065
9599,8663,3283,3,Business,23,3,58229,23,3,58742,23,3,60722,23,3,61147,23,3,62395,9,20.7,-1.303596,36.778378,-1.2628473,36.781805,116,1248,513,2405
9600,16292,2436,3,Business,28,4,57642,28,4,57688,28,4,59148,28,4,59208,28,4,61459,3,30.2,-1.2551895,36.7822034,-1.25537,36.7756,536,2251,46,1520
9601,3381,1329,3,Business,11,4,38253,11,4,38285,11,4,39331,11,4,39509,11,4,41149,19,25.8,-1.273056,36.811298,-1.1987505,36.9322761,404,1640,32,1224
9602,6626,1178,3,Business,22,4,52464,22,4,52770,22,4,53358,22,4,53980,22,4,58040,19,26.3,-1.2868515,36.7844247,-1.3712481,36.7467259,268,4060,306,1210
9603,25645,2523,3,Business,30,3,34714,30,3,34736,30,3,35686,30,3,36802,30,3,36861,4,19.8,-1.2551895,36.7822034,-1.255956,36.772901,14,59,22,2066
9604,11404,3420,3,Business,28,4,56906,28,4,56937,28,4,57331,28,4,57505,28,4,58465,7,27.3,-1.3046007,36.8211743,-1.3038645,36.8684596,206,960,31,568
9605,20476,3184,3,Business,12,1,32802,12,1,32812,12,1,33777,12,1,34334,12,1,35304,13,19.3,-1.3396256,36.8863135,-1.285908,36.8980126,31,970,10,1522
9606,22084,3529,1,Personal,28,1,53578,28,1,54626,28,1,55490,28,1,55857,28,1,56623,5,24.5,-1.298529,36.816482,-1.2791714,36.8255997,852,766,1048,1231
9607,22118,3283,3,Business,24,3,49627,24,3,50915,24,3,51915,24,3,52822,24,3,53918,13,18.3,-1.2296618,36.8438272,-1.2628473,36.781805,775,1096,1288,1907
9608,9046,3434,3,Business,2,2,46267,2,2,48634,2,2,48863,2,2,49531,2,2,50335,1,29.5,-1.311342,36.913268,-1.3123349,36.9152001,855,804,2367,897
9609,18183,2008,3,Business,8,5,35073,8,5,35130,8,5,35751,8,5,35992,8,5,38124,9,20.7,-1.2508229,36.7895263,-1.2380935,36.8072947,681,2132,57,862
9610,25573,251,1,Personal,4,1,36120,4,1,36129,4,1,36980,4,1,37662,4,1,40342,7,18.0,-1.3099145,36.8022774,-1.2695376,36.8032308,752,2680,9,1533
9611,23509,435,3,Business,21,2,50675,21,2,50731,21,2,51332,21,2,52142,21,2,53760,13,24.8,-1.300921,36.828195,-1.2271237,36.8253963,675,1618,56,1411
9612,20957,604,3,Business,20,3,30799,20,3,30823,20,3,31512,20,3,31579,20,3,33105,8,23.25888921888938,-1.2551895,36.7822034,-1.2995101,36.8185828,188,1526,24,756
9613,1367,1424,3,Business,28,3,40725,28,3,40741,28,3,41047,28,3,41219,28,3,42789,11,23.25888921888938,-1.30157,36.7871,-1.257984,36.745016,750,1570,16,478
9614,17279,2763,3,Business,22,2,52604,22,2,52610,22,2,54081,22,2,54261,22,2,54479,2,25.8,-1.2551895,36.7822034,-1.2561334,36.7990458,205,218,6,1651
9615,27036,13,3,Personal,12,3,55658,12,3,55879,12,3,57460,12,3,58481,12,3,61111,13,21.2,-1.3247683,36.85803,-1.3402212,36.7696184,119,2630,221,2602
9616,25048,1724,3,Business,17,5,56456,17,5,56508,17,5,57211,17,5,58738,17,5,58743,11,23.25888921888938,-1.32189,36.8589727,-1.2941648,36.7977315,921,5,52,2230
9617,3889,3621,3,Business,24,7,48827,24,7,50407,24,7,52115,24,7,52313,24,7,54322,8,22.8,-1.2836583,36.7886014,-1.276245,36.8363293,74,2009,1580,1906
9618,23110,3372,3,Business,10,5,59477,10,5,59507,10,5,60321,10,5,60826,10,5,64628,26,21.3,-1.2143387,36.7914548,-1.3169591,36.7000029,144,3802,30,1319
9619,10890,1865,1,Personal,20,6,42760,20,6,42774,20,6,43383,20,6,43682,20,6,45057,14,25.6,-1.2166078,36.882501,-1.2851761,36.8936402,343,1375,14,908
9620,21603,3315,3,Personal,16,1,50839,16,1,50923,16,1,52354,16,1,53115,16,1,54812,4,22.6,-1.2939186,36.8069693,-1.2845673,36.7801333,532,1697,84,2192
9621,22507,3404,3,Business,4,1,54150,4,1,54168,4,1,55049,4,1,55195,4,1,56840,2,28.5,-1.2882184,36.826346,-1.279395,36.825364,311,1645,18,1027
9622,27567,517,3,Business,30,3,40258,30,3,40695,30,3,41197,30,3,43030,30,3,43716,4,25.2,-1.3167113,36.8301563,-1.3004062,36.829741,436,686,437,2335
9623,12361,3426,3,Business,4,2,41383,4,2,42250,4,2,43819,4,2,43970,4,2,46378,9,19.4,-1.3014461,36.7661381,-1.2551895,36.7822034,382,2408,867,1720
9624,24762,1746,3,Business,10,5,41643,10,5,41654,10,5,44326,10,5,45177,10,5,47633,19,19.3,-1.2156006,36.8916865,-1.296797,36.7764525,384,2456,11,3523
9625,6522,2946,2,Personal,8,5,47869,8,5,48239,8,5,50337,8,5,50992,8,5,55017,8,21.7,-1.2983462,36.8139996,-1.2749662,36.7658781,431,4025,370,2753
9626,20387,718,3,Business,25,3,34665,25,3,34680,25,3,35062,25,3,35390,25,3,43036,22,13.7,-1.2551895,36.7822034,-1.3309482,36.9229943,519,7646,15,710
9627,11243,2330,3,Business,25,5,40255,25,5,40297,25,5,40715,25,5,40992,25,5,41632,3,26.5,-1.3015197,36.7658456,-1.2873232,36.7658572,246,640,42,695
9628,9047,972,3,Business,4,6,37680,4,6,37699,4,6,38655,4,6,38898,4,6,41645,12,23.25888921888938,-1.2862033,36.8152966,-1.3030532,36.8899952,448,2747,19,1199
9629,3788,517,3,Business,16,6,38316,16,6,38375,16,6,39202,16,6,39509,16,6,40511,4,25.7,-1.3167113,36.8301563,-1.3004062,36.829741,304,1002,59,1134
9630,9773,1578,3,Business,14,5,55274,14,5,61887,14,5,62085,14,5,64624,14,5,66005,7,22.8,-1.28878,36.8168312,-1.2551895,36.7822034,267,1381,6613,2737
9631,4649,1340,3,Business,5,2,38732,5,2,38767,5,2,39225,5,2,39489,5,2,41213,6,25.5,-1.2707179,36.7979713,-1.3017117,36.8149763,953,1724,35,722
9632,27127,3201,3,Business,6,4,58538,6,4,58564,6,4,58902,6,4,59587,6,4,61030,15,21.7,-1.2285835,36.8826468,-1.2584143,36.8048002,8,1443,26,1023
9633,22763,3222,3,Business,26,5,52919,26,5,53211,26,5,53872,26,5,53960,26,5,55613,8,23.25888921888938,-1.2551895,36.7822034,-1.295156,36.8094306,260,1653,292,749
9634,27752,867,3,Business,27,2,37825,27,2,37897,27,2,37910,27,2,38251,27,2,39407,9,23.8,-1.2574219,36.7927073,-1.306378,36.7519845,649,1156,72,354
9635,1003,1928,1,Business,27,3,46263,27,3,46378,27,3,47623,27,3,48494,27,3,49566,8,23.25888921888938,-1.289187,36.794845,-1.2579304,36.8019667,846,1072,115,2116
9636,2439,3291,3,Business,8,1,38043,8,1,38167,8,1,39084,8,1,40330,8,1,41418,11,27.8,-1.303596,36.778378,-1.2600926,36.8088685,576,1088,124,2163
9637,1826,1882,3,Business,15,5,39094,15,5,39116,15,5,39703,15,5,40572,15,5,41625,10,26.5,-1.2628638,36.8070399,-1.3014461,36.7661381,205,1053,22,1456
9638,27448,867,3,Business,19,2,44021,19,2,44052,19,2,44358,19,2,45676,19,2,47580,10,26.5,-1.2996533,36.8292629,-1.2991441,36.7528804,831,1904,31,1624
9639,24030,2457,3,Business,7,3,55988,7,3,57263,7,3,57294,7,3,57482,7,3,58826,8,28.2,-1.2551895,36.7822034,-1.2862436,36.791017,315,1344,1275,219
9640,26124,2658,3,Business,8,1,47564,8,1,47679,8,1,48451,8,1,49110,8,1,50559,7,29.5,-1.2924639,36.7795798,-1.2813012,36.8323962,378,1449,115,1431
9641,24335,868,3,Business,21,1,40547,21,1,40625,21,1,43046,21,1,44513,21,1,44928,5,25.6,-1.2600926,36.8088685,-1.265715,36.823815,489,415,78,3888
9642,1338,2764,3,Personal,14,2,52049,14,2,52170,14,2,55124,14,2,58672,14,2,59907,13,23.25888921888938,-1.2810889,36.8247135,-1.315194,36.9074428,61,1235,121,6502
9643,21775,3621,3,Business,16,6,62827,16,6,62889,16,6,63376,16,6,63707,16,6,64791,12,23.25888921888938,-1.2836583,36.7886014,-1.2533491,36.8615911,427,1084,62,818
9644,17148,3091,3,Business,17,5,48578,17,5,48584,17,5,49243,17,5,49588,17,5,50599,7,20.3,-1.3014461,36.7661381,-1.2902869,36.8085396,249,1011,6,1004
9645,16135,393,3,Business,29,1,46473,29,1,46525,29,1,46957,29,1,47409,29,1,47895,4,23.25888921888938,-1.3167113,36.8301563,-1.3004062,36.829741,438,486,52,884
9646,8943,3635,1,Business,18,4,64014,18,4,64054,18,4,64477,18,4,65025,18,4,67008,14,23.6,-1.2615888,36.7928732,-1.188126,36.7714175,105,1983,40,971
9647,20556,1527,3,Business,25,6,42356,25,6,42443,25,6,42703,25,6,43563,25,6,46059,4,23.25888921888938,-1.3077869,36.8443207,-1.3004062,36.829741,448,2496,87,1120
9648,8904,3517,3,Business,24,3,55272,24,3,55313,24,3,55355,24,3,58216,24,3,60078,16,23.25888921888938,-1.300921,36.828195,-1.3882008,36.7699445,206,1862,41,2903
9649,14201,1874,3,Business,12,2,39742,12,2,40683,12,2,41777,12,2,42025,12,2,43698,5,24.7,-1.2571472,36.7950633,-1.289925,36.820209,590,1673,941,1342
9650,9520,438,3,Personal,8,6,52052,8,6,52074,8,6,52266,8,6,53017,8,6,53212,3,23.25888921888938,-1.2603403,36.7998848,-1.2489719,36.7850262,839,195,22,943
9651,22651,3674,3,Business,1,4,51988,1,4,52271,1,4,52277,1,4,52854,1,4,54576,7,23.25888921888938,-1.2551895,36.7822034,-1.2537505,36.8326484,580,1722,283,583
9652,16178,3032,3,Business,10,1,40267,10,1,40276,10,1,40498,10,1,41011,10,1,42400,8,23.25888921888938,-1.2571472,36.7950633,-1.2946359,36.8352718,882,1389,9,735
9653,10507,2946,2,Personal,13,1,35169,13,1,35195,13,1,35764,13,1,36123,13,1,37296,8,15.0,-1.2749662,36.7658781,-1.2983462,36.8139996,74,1173,26,928
9654,28154,432,3,Business,10,1,49365,10,1,49464,10,1,50003,10,1,50941,10,1,54612,15,18.1,-1.3012008,36.764868,-1.3083777,36.8590077,161,3671,99,1477
9655,25692,186,3,Business,6,4,35427,6,4,35468,6,4,36258,6,4,36842,6,4,37729,5,18.6,-1.2890399,36.8164942,-1.2571472,36.7950633,477,887,41,1374
9656,15960,1363,3,Business,30,5,40869,30,5,41321,30,5,42239,30,5,42787,30,5,44570,16,23.7,-1.3004062,36.829741,-1.2216291,36.8935547,276,1783,452,1466
9657,8686,2344,3,Business,24,5,44455,24,5,44472,24,5,44529,24,5,45489,24,5,46242,4,20.8,-1.2571472,36.7950633,-1.27871,36.819573,648,753,17,1017
9658,8008,2358,4,Business,2,2,53318,2,2,53353,2,2,53986,2,2,54793,2,2,56537,18,26.3,-1.3256904,36.8747943,-1.2151769,36.8846524,207,1744,35,1440
9659,16701,3326,3,Business,23,5,47414,23,5,54436,23,5,55193,23,5,55738,23,5,56462,4,26.3,-1.2551895,36.7822034,-1.2681518,36.8098164,649,724,7022,1302
9660,21957,647,3,Business,21,2,45699,21,2,45757,21,2,46315,21,2,47584,21,2,48819,2,22.3,-1.3004062,36.829741,-1.2915199,36.8289158,2,1235,58,1827
9661,251,1969,1,Personal,6,5,66928,6,5,66947,6,5,68859,6,5,69111,6,5,70380,11,23.25888921888938,-1.3211235,36.7765164,-1.2799879,36.8114341,465,1269,19,2164
9662,948,3113,3,Personal,19,4,57284,19,4,57517,19,4,58134,19,4,58415,19,4,61588,8,20.3,-1.281614,36.8275424,-1.287428,36.7800821,174,3173,233,898
9663,16853,1077,1,Personal,6,4,31720,6,4,31928,6,4,33049,6,4,33530,6,4,34913,9,17.5,-1.2219929,36.8349924,-1.279032,36.8258482,882,1383,208,1602
9664,14000,3649,1,Personal,15,1,54601,15,1,54703,15,1,55984,15,1,56398,15,1,59968,11,23.25888921888938,-1.278279,36.827314,-1.2959724,36.7569331,328,3570,102,1695
9665,26239,3283,3,Business,4,4,39591,4,4,39806,4,4,40779,4,4,41289,4,4,41831,5,25.3,-1.2600926,36.8088685,-1.2628473,36.781805,770,542,215,1483
9666,2260,136,3,Business,28,1,34742,28,1,34769,28,1,35078,28,1,35671,28,1,37688,15,19.4,-1.2560874,36.7931031,-1.3254522,36.7216584,428,2017,27,902
9667,19243,432,3,Business,15,5,42414,15,5,42444,15,5,43153,15,5,43884,15,5,44918,7,26.5,-1.2968981,36.8118792,-1.3012008,36.764868,559,1034,30,1440
9668,9429,176,1,Personal,21,1,46333,21,1,46434,21,1,47943,21,1,48615,21,1,49455,4,20.2,-1.2854453,36.8188363,-1.2666695,36.8328283,116,840,101,2181
9669,2892,2825,2,Personal,15,1,54033,15,1,54079,15,1,54577,15,1,55012,15,1,57053,13,23.25888921888938,-1.2156006,36.8916865,-1.2599377,36.8117119,704,2041,46,933
9670,527,2804,3,Business,25,1,52762,25,1,52794,25,1,54508,25,1,55033,25,1,57254,3,28.1,-1.2669736,36.8040985,-1.2551895,36.7822034,434,2221,32,2239
9671,26431,1243,3,Business,13,3,42600,13,3,42640,13,3,42739,13,3,43266,13,3,45035,9,23.25888921888938,-1.2551895,36.7822034,-1.2857671,36.7875614,761,1769,40,626
9672,22952,3149,3,Business,5,2,37510,5,2,37520,5,2,37716,5,2,41090,5,2,41553,6,25.3,-1.3004062,36.829741,-1.3167113,36.8301563,448,463,10,3570
9673,24336,1927,3,Business,13,1,47198,13,1,47256,13,1,48353,13,1,50420,13,1,51875,12,23.25888921888938,-1.279395,36.825364,-1.3472066,36.7692638,728,1455,58,3164
9674,23890,412,3,Business,24,3,39791,24,3,39854,24,3,41676,24,3,42561,24,3,44818,11,23.25888921888938,-1.331619,36.847976,-1.266837,36.799249,675,2257,63,2707
9675,17225,3414,1,Personal,12,6,46449,12,6,46737,12,6,47204,12,6,47875,12,6,50707,7,22.9,-1.299539,36.827744,-1.2794985,36.8006196,207,2832,288,1138
9676,483,3606,3,Business,12,2,56681,12,2,56861,12,2,57721,12,2,57934,12,2,60477,17,23.25888921888938,-1.3175825,36.7004796,-1.2628638,36.8070399,691,2543,180,1073
9677,8186,3283,3,Business,6,3,34965,6,3,35699,6,3,36074,6,3,37034,6,3,38522,13,15.9,-1.331619,36.847976,-1.2628473,36.781805,379,1488,734,1335
9678,15955,2330,3,Business,6,3,47974,6,3,48021,6,3,48739,6,3,48954,6,3,49987,8,23.25888921888938,-1.2291477,36.8440295,-1.2325706,36.8083923,8,1033,47,933
9679,11817,3647,3,Business,17,5,34284,17,5,34330,17,5,34993,17,5,35204,17,5,35330,4,14.5,-1.272639,36.794723,-1.2676759,36.801804,882,126,46,874
9680,15314,1329,3,Business,19,3,39916,19,3,40010,19,3,40069,19,3,40580,19,3,41382,3,22.0,-1.273056,36.811298,-1.253966,36.7987692,107,802,94,570
9681,6128,1721,3,Business,11,2,36440,11,2,36480,11,2,36636,11,2,38483,11,2,41126,15,19.4,-1.2551895,36.7822034,-1.3194911,36.7200853,133,2643,40,2003
9682,6997,635,3,Business,13,1,38111,13,1,38130,13,1,38304,13,1,38601,13,1,40149,11,23.25888921888938,-1.2602337,36.7990548,-1.2105068,36.7859421,953,1548,19,471
9683,19627,2271,3,Business,16,2,58706,16,2,58727,16,2,59012,16,2,59860,16,2,62071,14,23.25888921888938,-1.272828,36.816608,-1.293515,36.897607,96,2211,21,1133
9684,1637,570,3,Business,13,3,33530,13,3,33558,13,3,34075,13,3,34484,13,3,35221,6,17.1,-1.2551895,36.7822034,-1.284382,36.7746045,762,737,28,926
9685,7483,2271,3,Business,24,4,49869,24,4,53047,24,4,53958,24,4,56871,24,4,59201,14,22.5,-1.272828,36.816608,-1.293515,36.897607,116,2330,3178,3824
9686,25385,1850,3,Business,18,1,44277,18,1,44305,18,1,44451,18,1,44971,18,1,45638,3,26.9,-1.2551895,36.7822034,-1.259919,36.808244,446,667,28,666
9687,23400,3521,3,Business,3,5,45408,3,5,45426,3,5,46171,3,5,49360,3,5,50352,2,25.2,-1.2682478,36.8072852,-1.2696908,36.81519,402,992,18,3934
9688,8911,3651,3,Business,14,4,29667,14,4,29694,14,4,29852,14,4,30015,14,4,31355,8,15.5,-1.2579304,36.8019667,-1.22556,36.80813,726,1340,27,321
9689,7465,3470,3,Business,22,4,44910,22,4,47328,22,4,48517,22,4,48688,22,4,49539,7,22.7,-1.28878,36.8168312,-1.2551895,36.7822034,714,851,2418,1360
9690,16678,3326,3,Business,5,5,38651,5,5,38756,5,5,39372,5,5,39648,5,5,42186,7,24.4,-1.2551895,36.7822034,-1.2989287,36.8163082,570,2538,105,892
9691,7305,3663,3,Personal,10,4,36458,10,4,36467,10,4,36591,10,4,38315,10,4,40819,18,23.25888921888938,-1.279285,36.8260574,-1.1691114,36.7616509,813,2504,9,1848
9692,10535,545,3,Business,11,2,32884,11,2,32907,11,2,34029,11,2,34201,11,2,36595,20,16.4,-1.2963097,36.7688221,-1.3197021,36.9092821,177,2394,23,1294
9693,23901,1244,3,Business,12,6,44740,12,6,44764,12,6,44774,12,6,45368,12,6,47224,6,23.25888921888938,-1.2628473,36.781805,-1.303596,36.778378,828,1856,24,604
9694,3252,2216,3,Business,3,1,53326,3,1,53654,3,1,54645,3,1,54964,3,1,54966,3,23.6,-1.2551895,36.7822034,-1.2640571,36.7883547,647,2,328,1310
9695,25908,552,3,Business,20,1,48450,20,1,48473,20,1,48751,20,1,49329,20,1,51340,23,23.25888921888938,-1.3472066,36.7692638,-1.335477,36.9308297,411,2011,23,856
9696,5428,633,3,Business,13,3,58842,13,3,58867,13,3,59629,13,3,60031,13,3,60847,4,27.4,-1.3228003,36.8306435,-1.3004062,36.829741,728,816,25,1164
9697,27920,84,3,Business,19,1,50467,19,1,50506,19,1,50768,19,1,51051,19,1,51877,3,25.3,-1.2551895,36.7822034,-1.2524976,36.8062935,509,826,39,545
9698,9236,393,3,Business,9,2,49903,9,2,49924,9,2,50784,9,2,51000,9,2,54060,8,30.7,-1.3167113,36.8301563,-1.2770708,36.8231093,155,3060,21,1076
9699,12197,2703,3,Personal,28,1,34362,28,1,34402,28,1,34853,28,1,34976,28,1,35930,3,19.3,-1.2963097,36.7688221,-1.2991116,36.7960658,548,954,40,574
9700,15365,393,3,Business,4,1,35033,4,1,35057,4,1,35172,4,1,38040,4,1,38062,14,25.6,-1.3167113,36.8301563,-1.306378,36.7519845,97,22,24,2983
9701,19279,3372,3,Business,27,5,55594,27,5,55651,27,5,56262,27,5,57335,27,5,58265,6,24.1,-1.2668611,36.7956387,-1.2969741,36.7856612,116,930,57,1684
9702,24960,1329,3,Business,20,4,56246,20,4,59271,20,4,60332,20,4,60404,20,4,61605,9,22.9,-1.3257661,36.8275149,-1.273056,36.811298,205,1201,3025,1133
9703,1707,1991,3,Personal,27,7,60978,27,7,61003,27,7,63469,27,7,63898,27,7,65976,14,23.25888921888938,-1.32189,36.8589727,-1.3047584,36.7739108,26,2078,25,2895
9704,15055,3565,3,Business,8,5,29330,8,5,29368,8,5,31161,8,5,31438,8,5,32700,18,20.4,-1.2844665,36.7866113,-1.207546,36.7913976,932,1262,38,2070
9705,9432,2884,2,Personal,6,3,61028,6,3,61101,6,3,62072,6,3,63286,6,3,64253,3,19.9,-1.2873232,36.7658572,-1.2764692,36.7580111,499,967,73,2185
9706,12277,3283,3,Business,2,2,41886,2,2,42841,2,2,42995,2,2,43526,2,2,44133,5,26.3,-1.2600926,36.8088685,-1.2628473,36.781805,103,607,955,685
9707,22184,1075,3,Business,16,2,60304,16,2,60619,16,2,62146,16,2,62385,16,2,64277,8,23.25888921888938,-1.2765736,36.8513646,-1.2527958,36.8003131,76,1892,315,1766
9708,25475,3517,3,Business,14,1,56441,14,1,56748,14,1,58045,14,1,62194,14,1,62198,5,24.5,-1.300921,36.828195,-1.2867454,36.8259017,26,4,307,5446
9709,260,1880,3,Business,28,1,54363,28,1,54635,28,1,54853,28,1,55403,28,1,57983,12,26.3,-1.2571472,36.7950633,-1.31553,36.863732,26,2580,272,768
9710,18904,928,3,Business,30,3,49672,30,3,49768,30,3,49773,30,3,50065,30,3,51707,6,29.0,-1.2551895,36.7822034,-1.2902552,36.8179349,876,1642,96,297
9711,8044,186,3,Business,2,2,34120,2,2,34167,2,2,34177,2,2,34488,2,2,35755,8,20.6,-1.2571472,36.7950633,-1.2765736,36.8513646,108,1267,47,321
9712,9852,733,3,Business,7,2,45643,7,2,45673,7,2,46325,7,2,46675,7,2,47816,6,23.1,-1.276245,36.8363293,-1.264865,36.810488,174,1141,30,1002
9713,23421,928,3,Business,2,4,61084,2,4,61290,2,4,62182,2,4,62487,2,4,65261,11,23.25888921888938,-1.2571472,36.7950633,-1.3039222,36.8534707,96,2774,206,1197
9714,17358,1687,3,Business,12,5,33216,12,5,33251,12,5,33309,12,5,33860,12,5,34622,2,18.4,-1.2649605,36.7981777,-1.2676176,36.7956644,647,762,35,609
9715,10286,1178,3,Business,15,6,41048,15,6,41069,15,6,41164,15,6,43940,15,6,44151,4,23.25888921888938,-1.261587,36.796781,-1.2868515,36.7844247,51,211,21,2871
9716,20043,3517,3,Business,26,6,37570,26,6,37598,26,6,37682,26,6,39344,26,6,42110,15,25.8,-1.300921,36.828195,-1.3882008,36.7699445,736,2766,28,1746
9717,24474,3727,3,Business,8,5,35636,8,5,35724,8,5,36333,8,5,36615,8,5,37858,6,22.8,-1.2638598,36.7808674,-1.293393,36.790237,245,1243,88,891
9718,17476,3282,2,Personal,14,5,43079,14,5,43106,14,5,43898,14,5,44811,14,5,46189,5,24.5,-1.2925374,36.7995411,-1.290059,36.7703475,805,1378,27,1705
9719,18863,1075,3,Business,31,4,47407,31,4,47475,31,4,47814,31,4,48862,31,4,50214,13,28.7,-1.2285835,36.8826468,-1.2527958,36.8003131,75,1352,68,1387
9720,4161,2112,3,Business,8,2,53495,8,2,53869,8,2,54915,8,2,55113,8,2,57371,12,25.2,-1.290894,36.822971,-1.2156006,36.8916865,150,2258,374,1244
9721,6485,2523,3,Business,4,5,45593,4,5,45620,4,5,46456,4,5,47289,4,5,47873,7,17.5,-1.2516167,36.8678844,-1.2867627,36.883446,320,584,27,1669
9722,5692,793,3,Personal,4,1,43980,4,1,44070,4,1,45079,4,1,45372,4,1,46560,6,25.4,-1.2651574,36.7474347,-1.256522,36.7864132,411,1188,90,1302
9723,2122,3641,3,Business,3,1,55639,3,1,55708,3,1,58090,3,1,59112,3,1,61688,17,23.0,-1.2551895,36.7822034,-1.2977643,36.8844591,116,2576,69,3404
9724,14116,3686,3,Business,18,4,52683,18,4,52725,18,4,52995,18,4,53336,18,4,55348,11,26.9,-1.2551895,36.7822034,-1.2217967,36.81099,770,2012,42,611
9725,4909,1389,3,Business,10,6,46669,10,6,46675,10,6,46684,10,6,47296,10,6,51171,15,23.8,-1.28878,36.8168312,-1.207546,36.7913976,391,3875,6,621
9726,5092,2700,3,Business,30,2,60199,30,2,60278,30,2,61949,30,2,62389,30,2,62857,2,23.6,-1.2885504,36.8066908,-1.2845835,36.8079121,80,468,79,2111
9727,26714,2804,3,Business,29,1,52615,29,1,56394,29,1,56773,29,1,57454,29,1,60424,28,24.5,-1.2551895,36.7822034,-1.4136642,36.957045,402,2970,3779,1060
9728,17332,909,3,Business,21,1,46946,21,1,47002,21,1,47226,21,1,48488,21,1,49875,7,25.3,-1.2527958,36.8003131,-1.225322,36.80855,803,1387,56,1486
9729,25966,265,3,Business,15,5,43011,15,5,43066,15,5,43951,15,5,44224,15,5,45885,14,25.7,-1.300921,36.828195,-1.3374394,36.7339115,675,1661,55,1158
9730,9269,2701,3,Business,24,4,38540,24,4,38835,24,4,39778,24,4,40338,24,4,41411,5,21.2,-1.2765736,36.8513646,-1.279395,36.825364,888,1073,295,1503
9731,749,240,2,Personal,23,4,40216,23,4,40237,23,4,41637,23,4,41891,23,4,44063,10,18.7,-1.2931446,36.7613971,-1.3094562,36.8167806,393,2172,21,1654
9732,5846,3696,1,Personal,16,6,34727,16,6,34991,16,6,35622,16,6,36711,16,6,38052,8,15.6,-1.2790653,36.7907262,-1.317899,36.8307061,88,1341,264,1720
9733,15677,393,3,Business,26,5,47118,26,5,48051,26,5,48574,26,5,50208,26,5,51579,10,23.25888921888938,-1.3177547,36.8303703,-1.2574219,36.7927073,731,1371,933,2157
9734,9066,1173,1,Personal,3,3,55530,3,3,55814,3,3,56246,3,3,56329,3,3,57594,8,26.8,-1.2931082,36.7822758,-1.261395,36.8263891,754,1265,284,515
9735,25030,1850,3,Business,10,1,51331,10,1,51363,10,1,51803,10,1,52900,10,1,53932,8,18.2,-1.2891116,36.810438,-1.2551895,36.7822034,907,1032,32,1537
9736,16870,1281,3,Business,1,3,44481,1,3,44534,1,3,47555,1,3,51473,1,3,52913,9,23.8,-1.2869041,36.8240057,-1.2707742,36.7578609,229,1440,53,6939
9737,27573,1008,3,Personal,15,3,55553,15,3,55652,15,3,56029,15,3,56625,15,3,57623,8,25.8,-1.3039934,36.8180494,-1.2615584,36.8149506,427,998,99,973
9738,2340,393,3,Business,28,4,31343,28,4,31360,28,4,31504,28,4,31760,28,4,33261,4,19.3,-1.3167113,36.8301563,-1.3004062,36.829741,349,1501,17,400
9739,23228,1075,3,Business,12,5,43569,12,5,43702,12,5,45079,12,5,45902,12,5,47833,15,26.4,-1.2156006,36.8916865,-1.2527958,36.8003131,8,1931,133,2200
9740,815,20,3,Business,13,2,55280,13,2,55302,13,2,55556,13,2,55623,13,2,55702,1,26.4,-1.2629666,36.8068369,-1.2648363,36.8023754,501,79,22,321
9741,1652,3426,3,Business,6,4,59991,6,4,60102,6,4,61165,6,4,61625,6,4,62896,9,22.6,-1.2551895,36.7822034,-1.3014461,36.7661381,762,1271,111,1523
9742,15265,1927,3,Business,13,3,51363,13,3,51393,13,3,52205,13,3,52813,13,3,54783,14,29.0,-1.3014461,36.7661381,-1.3467389,36.7690312,154,1970,30,1420
9743,15756,2347,1,Personal,25,5,50420,25,5,50553,25,5,51901,25,5,52468,25,5,54945,6,23.2,-1.292278,36.797718,-1.303723,36.7717155,805,2477,133,1915
9744,26992,1329,3,Business,24,5,51049,24,5,51129,24,5,51821,24,5,52118,24,5,52748,3,23.0,-1.273056,36.811298,-1.2655953,36.7915464,152,630,80,989
9745,11197,103,3,Business,27,6,31265,27,6,31321,27,6,32970,27,6,35197,27,6,37719,23,23.25888921888938,-1.2844665,36.7866113,-1.3922456,36.7372289,368,2522,56,3876
9746,8215,3557,3,Business,5,1,48084,5,1,48263,5,1,50233,5,1,52197,5,1,53798,9,26.2,-1.2981352,36.8213822,-1.2546732,36.8086796,112,1601,179,3934
9747,14232,3201,3,Business,15,5,53573,15,5,53601,15,5,53739,15,5,54866,15,5,55759,2,28.0,-1.2584143,36.8048002,-1.265715,36.808525,466,893,28,1265
9748,3448,3701,3,Business,25,5,57635,25,5,57642,25,5,58076,25,5,58730,25,5,58930,2,29.0,-1.2612574,36.7879622,-1.2643694,36.7854135,56,200,7,1088
9749,8690,3647,3,Business,20,3,61248,20,3,61322,20,3,61626,20,3,61798,20,3,62781,6,28.0,-1.272639,36.794723,-1.2876643,36.8248768,263,983,74,476
9750,19495,3689,3,Business,20,4,32079,20,4,32090,20,4,32539,20,4,34800,20,4,35611,6,18.7,-1.290894,36.822971,-1.2527958,36.8003131,404,811,11,2710
9751,24267,3557,3,Business,3,3,51002,3,3,51140,3,3,54422,3,3,55354,3,3,56818,7,26.9,-1.3076262,36.8325382,-1.2546732,36.8086796,731,1464,138,4214
9752,20058,2956,3,Business,4,1,55626,4,1,55684,4,1,56204,4,1,56389,4,1,57147,3,23.25888921888938,-1.2584143,36.8048002,-1.2615888,36.7928732,318,758,58,705
9753,19974,391,3,Business,25,4,42579,25,4,42642,25,4,43449,25,4,45883,25,4,45887,5,23.25888921888938,-1.300921,36.828195,-1.2784063,36.8222933,921,4,63,3241
9754,10582,2801,3,Business,22,3,55300,22,3,56346,22,3,56585,22,3,56758,22,3,57925,8,24.5,-1.2674274,36.7870827,-1.2944584,36.7614555,709,1167,1046,412
9755,11419,1588,3,Business,29,1,46190,29,1,46648,29,1,47118,29,1,48030,29,1,52567,9,23.25888921888938,-1.2551895,36.7822034,-1.306245,36.8192978,498,4537,458,1382
9756,4293,393,3,Business,12,2,40402,12,2,40411,12,2,40838,12,2,41383,12,2,43371,14,24.7,-1.3167113,36.8301563,-1.306378,36.7519845,523,1988,9,972
9757,18976,2112,3,Business,28,4,50904,28,4,50941,28,4,51359,28,4,52088,28,4,53774,14,30.0,-1.2156006,36.8916865,-1.2591019,36.800577,655,1686,37,1147
9758,17035,3560,3,Business,11,5,39710,11,5,39830,11,5,40384,11,5,41652,11,5,41925,2,21.2,-1.2813012,36.8323962,-1.279395,36.825364,124,273,120,1822
9759,22943,2956,3,Business,18,6,45570,18,6,45618,18,6,45677,18,6,46599,18,6,47853,5,19.0,-1.2584143,36.8048002,-1.2857548,36.819062,179,1254,48,981
9760,16202,914,3,Business,14,4,48646,14,4,48750,14,4,50377,14,4,51006,14,4,52176,11,27.5,-1.2670213,36.7994482,-1.2434453,36.8640044,52,1170,104,2256
9761,5322,1927,3,Business,23,4,51484,23,4,51499,23,4,52064,23,4,52273,23,4,54527,25,20.6,-1.2232123,36.8932547,-1.3472066,36.7692638,754,2254,15,774
9762,21725,432,3,Business,2,2,61984,2,2,62035,2,2,62239,2,2,63408,2,2,64991,9,28.4,-1.2584143,36.8048002,-1.3012008,36.764868,484,1583,51,1373
9763,3361,2383,3,Business,5,5,41398,5,5,41419,5,5,43377,5,5,43463,5,5,44438,2,24.4,-1.2608993,36.799246,-1.2724085,36.8062525,290,975,21,2044
9764,23660,1926,3,Business,24,3,56551,24,3,56576,24,3,57252,24,3,58521,24,3,59492,17,23.25888921888938,-1.3700383,36.9190174,-1.3050321,36.8843246,863,971,25,1945
9765,13282,867,3,Business,15,4,33002,15,4,33501,15,4,34415,15,4,35327,15,4,37147,10,19.8,-1.2996533,36.8292629,-1.306378,36.7519845,532,1820,499,1826
9766,24033,393,3,Business,15,1,35630,15,1,35639,15,1,35647,15,1,37273,15,1,39567,14,20.5,-1.3167113,36.8301563,-1.2991441,36.7528804,349,2294,9,1634
9767,515,1363,3,Business,3,4,54150,3,4,54715,3,4,55212,3,4,55466,3,4,56173,5,24.8,-1.3004062,36.829741,-1.3077869,36.8443207,479,707,565,751
9768,20875,1200,1,Personal,25,2,35055,25,2,35090,25,2,35909,25,2,36440,25,2,36986,6,17.8,-1.2703282,36.7642563,-1.2655477,36.8001682,116,546,35,1350
9769,5522,3201,3,Business,23,5,35283,23,5,35382,23,5,35836,23,5,36207,23,5,37099,6,20.1,-1.290894,36.822971,-1.2584143,36.8048002,878,892,99,825
9770,3467,111,3,Business,15,2,34570,15,2,35306,15,2,36353,15,2,37204,15,2,40936,8,18.1,-1.293399,36.7821943,-1.2626906,36.7827022,782,3732,736,1898
9771,22377,2691,3,Business,26,2,52371,26,2,52480,26,2,53128,26,2,53485,26,2,54487,8,23.25888921888938,-1.2857671,36.7875614,-1.2579304,36.8019667,355,1002,109,1005
9772,17667,1502,3,Business,15,5,51198,15,5,51525,15,5,51661,15,5,54083,15,5,55222,12,27.9,-1.279395,36.825364,-1.2232123,36.8932547,718,1139,327,2558
9773,10623,1075,3,Business,31,1,57189,31,1,60222,31,1,60871,31,1,61379,31,1,62221,1,22.5,-1.2649605,36.7981777,-1.2527958,36.8003131,216,842,3033,1157
9774,1895,3094,2,Personal,19,5,58861,19,5,58959,19,5,59628,19,5,60327,19,5,61781,2,24.3,-1.2763087,36.8170342,-1.2597529,36.806629,467,1454,98,1368
9775,1574,2692,3,Business,6,4,61635,6,4,61750,6,4,62146,6,4,62816,6,4,63843,6,22.7,-1.2842286,36.8150609,-1.3064585,36.8119065,940,1027,115,1066
9776,8629,945,3,Personal,30,3,60056,30,3,60067,30,3,60506,30,3,60749,30,3,62160,14,27.4,-1.3154524,36.7022978,-1.376634,36.7613498,105,1411,11,682
9777,18655,1451,1,Personal,23,1,40285,23,1,40295,23,1,40700,23,1,40957,23,1,42166,9,18.3,-1.3039695,36.7838267,-1.3192808,36.7121888,519,1209,10,662
9778,821,540,3,Business,27,3,41317,27,3,41360,27,3,41403,27,3,42104,27,3,43504,12,25.9,-1.2551895,36.7822034,-1.3076241,36.7879633,576,1400,43,744
9779,27317,867,3,Business,3,5,33327,3,5,33553,3,5,34113,3,5,34609,3,5,35584,9,23.25888921888938,-1.2638185,36.7930057,-1.2991441,36.7528804,783,975,226,1056
9780,12652,1473,3,Business,16,3,46580,16,3,46588,16,3,47197,16,3,47305,16,3,52181,23,24.1,-1.3700383,36.9190174,-1.2946581,36.7792921,89,4876,8,717
9781,455,2701,3,Business,20,3,38040,20,3,38441,20,3,40909,20,3,40979,20,3,41890,2,20.1,-1.279395,36.825364,-1.293082,36.8278578,786,911,401,2538
9782,26970,868,3,Business,28,5,35932,28,5,35960,28,5,36729,28,5,38277,28,5,39552,4,23.6,-1.2600926,36.8088685,-1.265715,36.823815,427,1275,28,2317
9783,10034,3381,3,Business,14,3,35127,14,3,36618,14,3,38760,14,3,38883,14,3,39682,4,24.6,-1.279662,36.814902,-1.2731645,36.7900343,477,799,1491,2265
9784,4424,1256,1,Personal,6,1,50480,6,1,50576,6,1,51357,6,1,51940,6,1,53923,9,24.6,-1.2684962,36.8079433,-1.2287314,36.8367354,519,1983,96,1364
9785,6683,286,3,Business,27,2,49153,27,2,49359,27,2,50124,27,2,50223,27,2,51708,12,25.7,-1.315611,36.8447339,-1.2551895,36.7822034,920,1485,206,864
9786,3597,787,1,Personal,29,5,52037,29,5,52628,29,5,53438,29,5,53942,29,5,54932,4,21.0,-1.2940713,36.7890758,-1.2914687,36.7692172,726,990,591,1314
9787,22520,3560,3,Business,27,3,55964,27,3,56811,27,3,57193,27,3,57500,27,3,63845,16,23.25888921888938,-1.3562374,36.9042954,-1.279395,36.825364,890,6345,847,689
9788,3212,635,3,Business,25,6,43579,25,6,43688,25,6,44709,25,6,45441,25,6,49834,13,23.25888921888938,-1.3081376,36.8329772,-1.2332536,36.8135721,416,4393,109,1753
9789,6841,1366,3,Business,4,2,39699,4,2,40310,4,2,40658,4,2,40760,4,2,42305,8,19.5,-1.3138647,36.811896,-1.2701385,36.8235208,933,1545,611,450
9790,27710,1500,3,Business,7,2,42405,7,2,42543,7,2,43120,7,2,45466,7,2,45471,8,23.25888921888938,-1.3004062,36.829741,-1.2638185,36.7930057,863,5,138,2923
9791,22141,136,3,Business,16,2,37563,16,2,37738,16,2,40083,16,2,40151,16,2,43567,15,23.25888921888938,-1.3254522,36.7216584,-1.2695287,36.7981777,572,3416,175,2413
9792,17202,1363,3,Business,14,2,41982,14,2,41997,14,2,42601,14,2,42712,14,2,43326,5,21.3,-1.3004062,36.829741,-1.3215394,36.836621,249,614,15,715
9793,11486,1724,3,Business,21,3,48035,21,3,48093,21,3,48822,21,3,49301,21,3,50727,7,23.4,-1.2861765,36.8209086,-1.2551895,36.7822034,477,1426,58,1208
9794,23980,186,3,Business,30,3,50147,30,3,51334,30,3,51966,30,3,52119,30,3,53697,20,24.9,-1.3700383,36.9190174,-1.2902869,36.8085396,520,1578,1187,785
9795,24407,295,3,Business,15,5,53953,15,5,56636,15,5,56642,15,5,57575,15,5,58436,6,27.9,-1.2967108,36.7871135,-1.286925,36.821916,942,861,2683,939
9796,10308,733,3,Business,29,1,54001,29,1,54074,29,1,54527,29,1,54722,29,1,56630,8,23.25888921888938,-1.2551895,36.7822034,-1.290641,36.812941,674,1908,73,648
9797,16213,1207,3,Business,14,4,44371,14,4,45527,14,4,48939,14,4,49109,14,4,52143,12,27.9,-1.2629666,36.8068369,-1.2351541,36.8748505,268,3034,1156,3582
9798,1573,1245,3,Business,24,3,44807,24,3,44901,24,3,45903,24,3,47119,24,3,49405,19,19.8,-1.300921,36.828195,-1.3198615,36.7110323,857,2286,94,2218
9799,23753,393,3,Business,12,5,36521,12,5,37652,12,5,37805,12,5,40606,12,5,41811,10,24.4,-1.3177547,36.8303703,-1.2574219,36.7927073,731,1205,1131,2954
9800,15543,2523,3,Business,6,1,35615,6,1,35832,6,1,36417,6,1,36679,6,1,38373,7,23.25888921888938,-1.2551895,36.7822034,-1.2995738,36.8199719,96,1694,217,847
9801,4119,412,3,Business,6,1,53517,6,1,53769,6,1,54145,6,1,54774,6,1,56027,5,23.25888921888938,-1.2783849,36.8163445,-1.266837,36.799249,531,1253,252,1005
9802,18354,978,1,Personal,18,2,52285,18,2,53564,18,2,53813,18,2,54930,18,2,56183,5,27.3,-1.3084067,36.8345014,-1.2805312,36.8326687,731,1253,1279,1366
9803,8032,972,3,Business,11,4,54383,11,4,56973,11,4,58009,11,4,58132,11,4,59376,5,26.8,-1.2862033,36.8152966,-1.2946581,36.7792921,208,1244,2590,1159
9804,3530,2457,3,Business,11,2,44525,13,4,48450,13,4,48758,13,4,50027,13,4,51881,8,22.5,-1.2915484,36.8297516,-1.2551895,36.7822034,247,1854,176725,1577
9805,1106,265,3,Business,23,6,42114,23,6,42176,23,6,42970,23,6,43200,23,6,44172,7,26.1,-1.2857117,36.7968296,-1.300921,36.828195,332,972,62,1024
9806,19642,3560,3,Business,1,3,36267,1,3,36278,1,3,36862,1,3,39340,1,3,40210,5,19.9,-1.2765736,36.8513646,-1.279395,36.825364,414,870,11,3062
9807,24191,2125,2,Personal,3,4,35063,3,4,35101,3,4,35296,3,4,36913,3,4,39713,15,17.5,-1.3053307,36.7768064,-1.2315379,36.8156795,493,2800,38,1812
9808,5047,496,3,Business,7,2,54182,7,2,54205,7,2,54213,7,2,54627,7,2,55581,3,23.25888921888938,-1.2551895,36.7822034,-1.273488,36.804158,856,954,23,422
9809,2835,2523,3,Business,1,5,44490,1,5,44499,1,5,44656,1,5,45018,1,5,49247,20,26.6,-1.2551895,36.7822034,-1.3176378,36.9006931,793,4229,9,519
9810,14748,2429,1,Personal,4,2,56694,4,2,56827,4,2,57468,4,2,57625,4,2,58281,5,20.5,-1.2789493,36.8192248,-1.276282,36.786422,857,656,133,798
9811,26114,2423,3,Business,4,1,43129,4,1,43273,4,1,44510,4,1,44776,4,1,46159,7,26.5,-1.2551895,36.7822034,-1.289498,36.818878,88,1383,144,1503
9812,23292,635,3,Business,26,2,55486,26,2,55559,26,2,56312,26,2,57890,26,2,57892,7,31.0,-1.2602337,36.7990548,-1.3081376,36.8329772,459,2,73,2331
9813,5869,393,3,Business,21,4,31247,21,4,33717,21,4,34438,21,4,34590,21,4,37939,14,21.7,-1.3167113,36.8301563,-1.2991441,36.7528804,314,3349,2470,873
9814,7515,2216,3,Business,10,1,52294,10,1,52312,10,1,52351,10,1,53014,10,1,54774,8,18.5,-1.2551895,36.7822034,-1.3040024,36.808297,168,1760,18,702
9815,23257,1329,3,Business,24,5,64312,24,5,64324,24,5,64369,24,5,64642,24,5,66309,13,20.0,-1.273056,36.811298,-1.215326,36.8919938,119,1667,12,318
9816,4010,53,3,Business,13,4,31779,13,4,32894,13,4,33698,13,4,34626,13,4,35878,5,18.4,-1.3004062,36.829741,-1.2770708,36.8231093,858,1252,1115,1732
9817,6428,1687,3,Business,30,3,35625,30,3,35642,30,3,36529,30,3,36756,30,3,37716,8,17.2,-1.28164,36.816867,-1.3129578,36.8463197,808,960,17,1114
9818,11040,72,1,Personal,7,5,34113,7,5,34136,7,5,34876,7,5,35666,7,5,37765,12,18.1,-1.3222489,36.7867025,-1.2918239,36.8235665,328,2099,23,1530
9819,8631,816,3,Business,14,4,62473,14,4,63459,14,4,63648,14,4,65038,14,4,66935,7,26.3,-1.290894,36.822971,-1.2546732,36.7923244,724,1897,986,1579
9820,4257,2183,3,Business,13,5,38217,13,5,38242,13,5,38714,13,5,39027,13,5,40234,8,23.25888921888938,-1.2551895,36.7822034,-1.2939912,36.8161329,726,1207,25,785
9821,1437,635,3,Business,14,4,51168,14,4,51523,14,4,52813,14,4,53190,14,4,54165,5,27.8,-1.2602337,36.7990548,-1.2793503,36.8039715,452,975,355,1667
9822,23673,646,2,Personal,24,4,54075,24,4,54235,24,4,55054,24,4,55122,24,4,55923,5,22.8,-1.2800815,36.7753524,-1.2661264,36.8030359,24,801,160,887
9823,17080,2700,1,Business,9,3,43471,9,3,43561,9,3,44342,9,3,45401,9,3,46276,4,20.9,-1.2814037,36.8150313,-1.292083,36.802646,751,875,90,1840
9824,14817,1316,3,Business,7,4,35916,7,4,35971,7,4,37014,7,4,37292,7,4,39038,11,23.25888921888938,-1.3173869,36.8112044,-1.2551895,36.7822034,863,1746,55,1321
9825,2434,867,3,Business,2,2,35965,2,2,36062,2,2,36082,2,2,38584,2,2,39800,10,26.1,-1.2996533,36.8292629,-1.2991441,36.7528804,15,1216,97,2522
9826,13005,932,1,Personal,3,3,44977,3,3,45136,3,3,45525,3,3,45938,3,3,46956,3,23.9,-1.2750247,36.7981039,-1.2671296,36.8125772,268,1018,159,802
9827,14638,3032,3,Business,18,5,52697,18,5,52734,18,5,53396,18,5,53971,18,5,56771,11,27.2,-1.2571472,36.7950633,-1.21488,36.8141238,660,2800,37,1237
9828,5700,2207,3,Business,22,1,31223,22,1,31265,22,1,32195,22,1,32583,22,1,34009,9,19.7,-1.2325706,36.8083923,-1.2768326,36.8073804,453,1426,42,1318
9829,19957,633,3,Business,28,3,37974,28,3,39163,28,3,39813,28,3,40044,28,3,41307,11,23.25888921888938,-1.306378,36.7519845,-1.3004062,36.829741,124,1263,1189,881
9830,26521,3560,3,Business,4,1,56472,4,1,60262,4,1,60581,4,1,62448,4,1,64093,18,27.7,-1.3705766,36.9120742,-1.279395,36.825364,48,1645,3790,2186
9831,532,1961,3,Business,4,6,31080,4,6,31092,4,6,31616,4,6,33530,4,6,36084,14,23.25888921888938,-1.2628473,36.781805,-1.3181159,36.7101559,155,2554,12,2438
9832,4493,3283,3,Business,4,2,43826,4,2,46687,4,2,47480,4,2,48839,4,2,50108,10,22.5,-1.307143,36.825009,-1.2628473,36.781805,591,1269,2861,2152
9833,18158,3560,3,Business,7,5,58637,7,5,62196,7,5,62502,7,5,63308,7,5,63311,1,23.0,-1.290894,36.822971,-1.279395,36.825364,928,3,3559,1112
9834,1495,60,3,Business,14,2,54659,14,2,54910,14,2,56218,14,2,56971,14,2,57943,7,23.25888921888938,-1.272828,36.816608,-1.22978,36.836215,660,972,251,2061
9835,6228,1405,3,Business,7,5,39679,7,5,41409,7,5,44556,7,5,47530,7,5,51068,13,25.3,-1.306219,36.8699124,-1.3478563,36.8935824,48,3538,1730,6121
9836,26657,393,3,Business,11,1,40560,11,1,40584,11,1,40604,11,1,41198,11,1,41911,5,26.8,-1.3167113,36.8301563,-1.3077869,36.8443207,154,713,24,614
9837,19365,2000,3,Business,4,1,37638,4,1,37657,4,1,39198,4,1,39425,4,1,41514,15,26.7,-1.2551895,36.7822034,-1.3226302,36.8719901,846,2089,19,1768
9838,19132,867,3,Business,4,6,39194,4,6,39243,4,6,41970,4,6,42594,4,6,44247,12,23.25888921888938,-1.2991441,36.7528804,-1.2996533,36.8292629,800,1653,49,3351
9839,7151,2066,3,Business,1,3,36478,1,3,36495,1,3,37140,1,3,37382,1,3,38076,5,23.25888921888938,-1.316961,36.820337,-1.303711,36.8154933,229,694,17,887
9840,4103,510,3,Business,1,1,54685,1,1,54782,1,1,55658,1,1,56448,1,1,58729,20,25.7,-1.3472066,36.7692638,-1.2860183,36.8975338,648,2281,97,1666
9841,11763,49,3,Business,29,6,39314,29,6,39362,29,6,39567,29,6,39842,29,6,42900,13,24.2,-1.2790196,36.8160867,-1.2155671,36.8898931,698,3058,48,480
9842,13446,269,3,Business,5,3,47504,5,3,51722,5,3,52317,5,3,53284,5,3,55840,15,25.0,-1.2551895,36.7822034,-1.3226302,36.8719901,596,2556,4218,1562
9843,1656,3686,3,Business,11,1,36817,11,1,36849,11,1,37039,11,1,37562,11,1,39028,7,20.7,-1.2551895,36.7822034,-1.2989934,36.8136694,378,1466,32,713
9844,3414,2801,3,Business,28,3,50878,28,3,50905,28,3,50944,28,3,52376,28,3,55386,15,23.25888921888938,-1.3104506,36.8687235,-1.2595422,36.7871178,595,3010,27,1471
9845,15183,1237,1,Personal,28,1,39578,28,1,39607,28,1,39828,28,1,40289,28,1,41470,3,22.7,-1.2786952,36.8244479,-1.2668611,36.7956387,852,1181,29,682
9846,9655,53,3,Business,30,4,42106,30,4,42171,30,4,44465,30,4,45649,30,4,45714,13,23.25888921888938,-1.2770708,36.8231093,-1.2257343,36.8933543,921,65,65,3478
9847,7470,1896,2,Personal,19,4,39237,19,4,39299,19,4,40097,19,4,40440,19,4,41168,6,20.2,-1.2950611,36.7947909,-1.3051284,36.8252627,465,728,62,1141
9848,5285,1544,3,Business,17,5,46676,17,5,49540,17,5,50764,17,5,51985,17,5,53757,15,23.25888921888938,-1.2813012,36.8323962,-1.2000932,36.7754458,76,1772,2864,2445
9849,23213,432,3,Business,8,1,52537,8,1,52602,8,1,54377,8,1,54699,8,1,56989,21,29.7,-1.2232123,36.8932547,-1.3012008,36.764868,8,2290,65,2097
9850,24747,1244,3,Business,29,5,45076,29,5,45176,29,5,45854,29,5,46293,29,5,47718,8,26.6,-1.303596,36.778378,-1.265715,36.823815,154,1425,100,1117
9851,27712,143,1,Personal,3,3,43857,3,3,43864,3,3,44653,3,3,44784,3,3,46587,10,23.9,-1.2736771,36.8123141,-1.3255855,36.8647627,755,1803,7,920
9852,7769,1874,3,Business,23,5,64051,23,5,64128,23,5,64905,23,5,67549,23,5,67731,7,24.4,-1.2571472,36.7950633,-1.2942232,36.7900236,649,182,77,3421
9853,3241,1959,3,Business,24,3,45241,24,3,45261,24,3,45343,24,3,45855,24,3,50218,21,23.25888921888938,-1.2551895,36.7822034,-1.2126245,36.6630919,168,4363,20,594
9854,25757,478,3,Business,2,1,42665,2,1,42725,2,1,42847,2,1,43722,2,1,44581,9,19.3,-1.3043821,36.7840586,-1.2551895,36.7822034,101,859,60,997
9855,24552,3194,3,Business,25,1,55884,25,1,55897,25,1,56116,25,1,56379,25,1,58180,7,30.3,-1.2551895,36.7822034,-1.2885504,36.8066908,784,1801,13,482
9856,24596,393,3,Business,12,2,43119,12,2,43168,12,2,43220,12,2,47195,12,2,47320,14,21.0,-1.3177547,36.8303703,-1.306378,36.7519845,927,125,49,4027
9857,11126,3669,3,Business,17,3,37988,17,3,38014,17,3,39170,17,3,39333,17,3,42348,10,23.25888921888938,-1.2825379,36.843502,-1.2615888,36.7928732,660,3015,26,1319
9858,3078,1500,3,Business,12,5,30150,12,5,30271,12,5,31687,12,5,31898,12,5,32982,9,21.6,-1.2638185,36.7930057,-1.3004062,36.829741,576,1084,121,1627
9859,17018,1346,3,Business,8,5,53839,8,5,54636,8,5,56093,8,5,56207,8,5,59361,6,27.1,-1.2695287,36.7981777,-1.2917868,36.7872675,26,3154,797,1571
9860,18353,53,3,Business,15,3,51331,15,3,51366,15,3,52025,15,3,52532,15,3,54536,5,25.8,-1.2770708,36.8231093,-1.2945074,36.8083195,204,2004,35,1166
9861,1835,2065,3,Personal,27,5,34613,27,5,34622,27,5,34881,27,5,35898,27,5,37469,15,16.1,-1.2883346,36.8148489,-1.1980111,36.834036,844,1571,9,1276
9862,15605,2330,3,Business,6,1,47515,6,1,47540,6,1,47677,6,1,47999,6,1,49284,9,23.25888921888938,-1.2642903,36.8002137,-1.2326041,36.8009029,96,1285,25,459
9863,12690,2154,3,Business,15,4,43259,15,4,43824,15,4,44035,15,4,44170,15,4,45477,11,24.2,-1.2765736,36.8513646,-1.2551895,36.7822034,72,1307,565,346
9864,4216,1004,3,Business,21,2,51090,21,2,51465,21,2,51906,21,2,52846,21,2,53534,9,24.9,-1.3250048,36.8697188,-1.333148,36.922453,404,688,375,1381
9865,12183,136,3,Business,7,4,32743,7,4,32751,7,4,32800,7,4,34111,7,4,36454,28,23.25888921888938,-1.3254522,36.7216584,-1.3524201,36.9045107,598,2343,8,1360
9866,2964,3647,3,Business,10,1,58606,10,1,58883,10,1,59695,10,1,60008,10,1,63068,9,19.0,-1.272639,36.794723,-1.282907,36.738903,706,3060,277,1125
9867,19891,2267,2,Personal,19,7,53170,19,7,53361,19,7,54340,19,7,54663,19,7,55071,2,21.0,-1.2965499,36.7850592,-1.2938713,36.7917214,148,408,191,1302
9868,3585,3686,3,Business,29,1,41246,29,1,41294,29,1,42218,29,1,42356,29,1,43412,9,23.25888921888938,-1.2551895,36.7822034,-1.3016653,36.8323628,208,1056,48,1062
9869,5157,661,3,Business,18,4,39280,18,4,39333,18,4,39780,18,4,40279,18,4,42680,17,25.7,-1.2963097,36.7688221,-1.2482465,36.8889062,749,2401,53,946
9870,12466,2330,3,Business,1,1,45863,1,1,46015,1,1,46418,1,1,46498,1,1,47543,8,23.25888921888938,-1.2890715,36.8157588,-1.3015197,36.7658456,855,1045,152,483
9871,13922,3080,3,Business,13,3,35856,13,3,35877,13,3,38774,13,3,38837,13,3,41734,12,23.25888921888938,-1.3282097,36.8473822,-1.2571472,36.7950633,349,2897,21,2960
9872,26375,540,3,Business,26,5,34386,26,5,34442,26,5,34795,26,5,35042,26,5,35601,5,23.25888921888938,-1.2551895,36.7822034,-1.270054,36.815164,306,559,56,600
9873,17902,3291,3,Business,16,6,43434,16,6,44015,16,6,44971,16,6,48544,16,6,48595,8,25.7,-1.303596,36.778378,-1.2600926,36.8088685,778,51,581,4529
9874,15247,2264,1,Personal,19,3,56570,19,3,56586,19,3,57218,19,3,57524,19,3,58415,6,25.6,-1.2943401,36.7965612,-1.2697141,36.7981777,754,891,16,938
9875,25964,893,3,Business,15,3,51681,15,3,51781,15,3,51847,15,3,53840,15,3,54738,6,21.6,-1.2938211,36.8270021,-1.2663194,36.809901,882,898,100,2059
9876,8386,20,3,Business,23,5,34947,23,5,38578,23,5,40361,23,5,40503,23,5,42551,7,24.0,-1.2648363,36.8023754,-1.3017611,36.8361973,114,2048,3631,1925
9877,19563,2112,3,Business,13,3,40781,13,3,40886,13,3,42985,13,3,43412,13,3,45486,16,20.2,-1.225322,36.80855,-1.2156006,36.8916865,543,2074,105,2526
9878,2053,2344,3,Business,28,1,54935,28,1,54946,28,1,55108,28,1,55313,28,1,58860,23,24.5,-1.2553615,36.7895376,-1.3447079,36.91105,103,3547,11,367
9879,5102,1363,3,Business,6,1,48592,6,1,48704,6,1,49157,6,1,49849,6,1,50816,4,24.5,-1.3004062,36.829741,-1.2904993,36.8043877,471,967,112,1145
9880,7868,1970,1,Personal,28,5,52534,28,5,52671,28,5,54161,28,5,55456,28,5,57835,6,25.7,-1.3099295,36.8436807,-1.2862033,36.8152966,399,2379,137,2785
9881,12476,3683,3,Business,19,5,39866,19,5,39902,19,5,40618,19,5,40747,19,5,43250,7,24.7,-1.2897368,36.8226783,-1.2765492,36.7669809,829,2503,36,845
9882,10770,1960,3,Personal,8,5,37238,8,5,37470,8,5,38504,8,5,38731,8,5,39816,3,23.25888921888938,-1.2886434,36.7709868,-1.3023756,36.7949276,844,1085,232,1261
9883,9898,3201,3,Business,23,3,51477,23,3,51692,23,3,51995,23,3,52490,23,3,53621,10,27.4,-1.2584143,36.8048002,-1.2413316,36.8785525,279,1131,215,798
9884,19609,1792,3,Business,21,4,54202,21,4,54283,21,4,54862,21,4,55124,21,4,56336,7,22.4,-1.2805537,36.7920739,-1.2629944,36.7998816,898,1212,81,841
9885,2141,2956,3,Business,5,2,47997,5,2,48031,5,2,48055,5,2,49058,5,2,49392,1,22.6,-1.2584143,36.8048002,-1.2601709,36.8002238,379,334,34,1027
9886,4350,3493,1,Personal,3,5,44668,3,5,44674,3,5,45660,3,5,45781,3,5,47021,8,21.5,-1.288922,36.814826,-1.2623805,36.7805404,857,1240,6,1107
9887,15452,1874,3,Business,8,5,50458,8,5,50533,8,5,53499,8,5,54455,8,5,59251,12,27.2,-1.2571472,36.7950633,-1.2369033,36.8699546,755,4796,75,3922
9888,12534,3326,3,Business,11,1,35754,11,1,35881,11,1,36124,11,1,36646,11,1,38194,9,21.1,-1.2551895,36.7822034,-1.3080696,36.8237191,108,1548,127,765
9889,11278,136,3,Business,19,2,45013,19,2,45046,19,2,47751,19,2,47968,19,2,49047,5,27.5,-1.2654716,36.7983635,-1.2549476,36.8269576,547,1079,33,2922
9890,3224,1453,3,Business,18,1,40948,18,1,41152,18,1,41872,18,1,43683,18,1,44651,8,23.25888921888938,-1.2268871,36.8073946,-1.2591019,36.800577,663,968,204,2531
9891,9554,517,3,Business,7,5,26866,7,5,35248,7,5,37280,7,5,37805,7,5,38187,4,20.5,-1.3177547,36.8303703,-1.3004062,36.829741,436,382,8382,2557
9892,10779,1081,3,Business,5,2,60337,5,2,60524,5,2,61658,5,2,62162,5,2,65520,21,25.2,-1.2860183,36.8975338,-1.3012008,36.764868,411,3358,187,1638
9893,22966,3647,3,Business,17,5,38043,17,5,38092,17,5,38851,17,5,39828,17,5,41526,6,23.25888921888938,-1.2985749,36.8088,-1.265432,36.795034,158,1698,49,1736
9894,20776,1263,2,Personal,9,6,38378,9,6,38437,9,6,39142,9,6,39398,9,6,41205,16,17.2,-1.2697859,36.7946203,-1.2962888,36.8892359,598,1807,59,961
9895,245,720,3,Personal,25,1,50242,25,1,50297,25,1,51159,25,1,53001,25,1,54568,13,29.9,-1.285355,36.795287,-1.2373977,36.7598693,678,1567,55,2704
9896,16507,803,3,Business,30,3,48287,30,3,48291,30,3,49332,30,3,50673,30,3,52659,20,24.9,-1.3321944,36.8892329,-1.248519,36.783656,543,1986,4,2382
9897,17445,478,3,Business,8,5,45831,8,5,47443,8,5,47949,8,5,48555,8,5,49206,3,24.2,-1.2551895,36.7822034,-1.2628638,36.8070399,210,651,1612,1112
9898,25664,2801,3,Business,19,5,42087,19,5,42134,19,5,42390,19,5,42506,19,5,44021,10,25.1,-1.2595422,36.7871178,-1.2983805,36.8198439,22,1515,47,372
9899,20681,2763,3,Business,13,1,50215,13,1,50230,13,1,50352,13,1,51027,13,1,53146,13,19.6,-1.2551895,36.7822034,-1.3270347,36.8667362,45,2119,15,797
9900,9003,646,3,Personal,9,2,67716,9,2,69487,9,2,70035,9,2,70290,9,2,71713,9,19.0,-1.2800815,36.7753524,-1.2521881,36.7537237,45,1423,1771,803
9901,25712,1882,3,Business,5,5,42011,5,5,42114,5,5,42283,5,5,42549,5,5,43992,4,24.3,-1.2958783,36.7928125,-1.3011335,36.7658946,460,1443,103,435
9902,25015,2049,1,Personal,3,4,54989,3,4,56194,3,4,56684,3,4,57159,3,4,58600,8,24.9,-1.2932803,36.774089,-1.285386,36.8304605,100,1441,1205,965
9903,26055,2982,3,Business,3,1,33115,3,1,34256,3,1,35378,3,1,37593,3,1,39604,18,18.2,-1.300921,36.828195,-1.177202,36.8351183,25,2011,1141,3337
9904,6838,389,1,Personal,22,5,47320,22,5,47381,22,5,47946,22,5,48628,22,5,48757,1,21.8,-1.3007534,36.7964576,-1.2889003,36.7844029,312,129,61,1247
9905,24310,1626,1,Personal,4,2,30198,4,2,30220,4,2,31601,4,2,31896,4,2,33774,13,16.3,-1.2365885,36.8898127,-1.2036664,36.8192622,216,1878,22,1676
9906,15172,2200,3,Business,24,1,47329,24,1,47521,24,1,48009,24,1,48309,24,1,49342,6,22.9,-1.290894,36.822971,-1.2571472,36.7950633,576,1033,192,788
9907,11743,1500,3,Business,5,2,43605,5,2,43713,5,2,44401,5,2,44676,5,2,45904,10,25.5,-1.2991441,36.7528804,-1.2638185,36.7930057,411,1228,108,963
9908,25145,1146,3,Business,9,3,42098,9,3,42136,9,3,42149,9,3,43434,9,3,43437,7,25.2,-1.3167113,36.8301563,-1.3083266,36.8494756,39,3,38,1298
9909,17068,2046,2,Personal,2,4,59982,2,4,60082,2,4,61112,2,4,61693,2,4,62929,4,23.7,-1.283994,36.773977,-1.2965169,36.793522,229,1236,100,1611
9910,3123,393,3,Business,5,2,37736,5,2,37801,5,2,38915,5,2,39483,5,2,40289,4,25.4,-1.3167113,36.8301563,-1.3004062,36.829741,167,806,65,1682
9911,17783,1353,3,Personal,26,5,56144,26,5,56239,26,5,57697,26,5,58374,26,5,59260,7,23.25888921888938,-1.2917868,36.7872675,-1.2753109,36.8130185,438,886,95,2135
9912,21994,3674,3,Business,28,2,53057,28,2,53144,28,2,53203,28,2,53403,28,2,56525,9,23.5,-1.2551895,36.7822034,-1.3073464,36.7975428,576,3122,87,259
9913,1302,3641,3,Business,4,4,55134,4,4,55147,4,4,55499,4,4,56059,4,4,58270,5,24.8,-1.2551895,36.7822034,-1.266164,36.8004608,178,2211,13,912
9914,24476,633,3,Business,21,3,39818,21,3,41051,21,3,41638,21,3,42745,21,3,44239,8,21.9,-1.3004062,36.829741,-1.2574219,36.7927073,260,1494,1233,1694
9915,17318,864,1,Personal,5,3,33815,5,3,33929,5,3,36554,5,3,37803,5,3,40475,12,18.5,-1.2409807,36.8144219,-1.3008471,36.8099068,937,2672,114,3874
9916,10276,755,1,Personal,9,6,53221,9,6,53296,9,6,54936,9,6,55079,9,6,57127,16,19.3,-1.282357,36.782501,-1.2300082,36.8867427,940,2048,75,1783
9917,2152,3367,3,Personal,1,1,42855,1,1,42874,1,1,44429,1,1,44622,1,1,47159,18,24.0,-1.1983542,36.8044245,-1.3043649,36.7816132,726,2537,19,1748
9918,2763,1211,2,Personal,18,4,45407,18,4,45475,18,4,46282,18,4,46443,18,4,49007,8,25.3,-1.286887,36.762098,-1.279051,36.817508,72,2564,68,968
9919,17038,2454,3,Business,14,1,54373,14,1,56291,14,1,59120,14,1,59389,14,1,63011,30,25.6,-1.3491979,36.9647412,-1.2993231,36.7753372,829,3622,1918,3098
9920,19483,2008,3,Business,4,6,35674,4,6,35685,4,6,36292,4,6,36722,4,6,38687,13,23.25888921888938,-1.2508229,36.7895263,-1.2417321,36.8886277,205,1965,11,1037
9921,13773,2330,3,Business,25,1,61857,25,1,61883,25,1,62271,25,1,62407,25,1,63888,9,27.3,-1.2671943,36.8062533,-1.3015197,36.7658456,795,1481,26,524
9922,15966,3184,3,Business,9,5,35947,9,5,35962,9,5,37294,9,5,37485,9,5,39199,13,20.1,-1.3090366,36.8804241,-1.3396256,36.8863135,237,1714,15,1523
9923,2146,3585,1,Personal,22,6,49386,22,6,49399,22,6,49956,22,6,50299,22,6,50943,6,23.25888921888938,-1.2823757,36.7935809,-1.3010476,36.7664421,612,644,13,900
9924,26509,1363,3,Business,10,3,55007,10,3,55049,10,3,55359,10,3,55925,10,3,57457,10,30.7,-1.3004062,36.829741,-1.2991441,36.7528804,728,1532,42,876
9925,7559,3261,2,Personal,29,2,46439,29,2,46587,29,2,48585,29,2,48706,29,2,51269,16,21.2,-1.2067441,36.8090189,-1.1742369,36.7071302,749,2563,148,2119
9926,3106,2439,3,Business,13,6,38029,13,6,42920,13,6,43551,13,6,43727,13,6,44956,8,25.9,-1.3014461,36.7661381,-1.2886923,36.8241519,843,1229,4891,807
9927,16030,1500,3,Business,21,4,50637,21,4,50732,21,4,51011,21,4,51256,21,4,52564,10,26.2,-1.2991441,36.7528804,-1.2638185,36.7930057,545,1308,95,524
9928,13791,393,3,Business,11,5,57783,11,5,57804,11,5,57952,11,5,58734,11,5,60608,11,26.3,-1.3167113,36.8301563,-1.2574219,36.7927073,523,1874,21,930
9929,21388,2523,3,Business,8,2,35027,8,2,35053,8,2,35293,8,2,35960,8,2,35961,6,19.1,-1.2551895,36.7822034,-1.270424,36.779289,647,1,26,907
9930,3408,496,3,Business,8,4,53547,8,4,54415,8,4,54433,8,4,56246,8,4,58074,12,27.4,-1.2551895,36.7822034,-1.3277532,36.8297901,684,1828,868,1831
9931,23947,2775,3,Business,5,5,50016,5,5,50110,5,5,50739,5,5,51263,5,5,51786,3,26.8,-1.2675332,36.808561,-1.26071,36.8206332,754,523,94,1153
9932,20251,3149,3,Business,9,3,46815,9,3,46840,9,3,46850,9,3,47887,9,3,48698,6,25.1,-1.3004062,36.829741,-1.3167113,36.8301563,518,811,25,1047
9933,9710,3283,3,Business,21,3,44295,21,3,44325,21,3,44837,21,3,46522,21,3,46994,6,21.9,-1.272828,36.816608,-1.2628473,36.781805,237,472,30,2197
9934,15768,3635,1,Business,22,3,57272,22,3,57290,22,3,57465,22,3,59120,22,3,61620,23,25.8,-1.2615888,36.7928732,-1.3592118,36.6717545,857,2500,18,1830
9935,24416,1482,3,Business,27,4,35909,27,4,35926,27,4,37118,27,4,37795,27,4,40831,30,18.9,-1.338579,36.8963038,-1.1627665,36.8216182,427,3036,17,1869
9936,17743,2931,3,Business,16,3,62294,16,3,62309,16,3,62888,16,3,63037,16,3,64940,13,23.2,-1.2452664,36.8028541,-1.2981858,36.747492,205,1903,15,728
9937,7338,2112,3,Business,22,4,55896,22,4,55923,22,4,56011,22,4,57359,22,4,58715,13,26.6,-1.2527958,36.8003131,-1.2156006,36.8916865,708,1356,27,1436
9938,14235,2330,3,Business,28,4,46163,28,4,47275,28,4,48671,28,4,48762,28,4,50258,4,29.8,-1.2642903,36.8002137,-1.2890715,36.8157588,511,1496,1112,1487
9939,21385,649,3,Business,4,1,34872,4,1,34900,4,1,35454,4,1,36092,4,1,37542,8,17.8,-1.2615888,36.7928732,-1.3034396,36.8329998,56,1450,28,1192
9940,8634,867,3,Business,10,3,47461,10,3,47505,10,3,47771,10,3,49317,10,3,52172,10,30.8,-1.2996533,36.8292629,-1.2991441,36.7528804,394,2855,44,1812
9941,1827,3291,3,Business,14,2,39761,14,2,40134,14,2,42140,14,2,43950,14,2,45699,12,21.3,-1.318062,36.849326,-1.2600926,36.8088685,179,1749,373,3816
9942,20338,391,3,Business,7,5,59931,7,5,60228,7,5,60838,7,5,62358,7,5,64062,4,21.4,-1.2867454,36.8259017,-1.300921,36.828195,916,1704,297,2130
9943,9376,1927,3,Business,13,3,36829,13,3,36850,13,3,38128,13,3,38648,13,3,40718,15,23.25888921888938,-1.2571472,36.7950633,-1.3472066,36.7692638,712,2070,21,1798
9944,6808,1927,3,Business,10,1,45221,10,1,45314,10,1,47301,10,1,47465,10,1,48389,5,18.6,-1.3223068,36.7929881,-1.3472066,36.7692638,643,924,93,2151
9945,17242,59,3,Business,14,4,55136,14,4,55657,14,4,57633,14,4,58596,14,4,61047,4,27.8,-1.290894,36.822971,-1.3047026,36.8172033,61,2451,521,2939
9946,9089,3291,3,Business,18,6,37697,18,6,37740,18,6,38278,18,6,39704,18,6,40330,5,19.2,-1.2628473,36.781805,-1.2600926,36.8088685,882,626,43,1964
9947,13763,2102,3,Business,28,4,59267,28,4,59306,28,4,60112,28,4,60351,28,4,62895,15,27.9,-1.3323107,36.8692616,-1.2613768,36.8019418,548,2544,39,1045
9948,24017,2801,3,Business,8,1,61915,8,1,61974,8,1,62210,8,1,62414,8,1,64341,11,28.8,-1.2595422,36.7871178,-1.307726,36.839117,933,1927,59,440
9949,4839,3729,1,Personal,9,3,51928,9,3,51936,9,3,51956,9,3,52828,9,3,55302,15,23.2,-1.2196545,36.8840194,-1.2733223,36.7951005,100,2474,8,892
9950,14393,3648,3,Personal,23,3,58109,23,3,58119,23,3,58705,23,3,59227,23,3,61135,17,27.4,-1.2038217,36.8794507,-1.3002554,36.8256566,377,1908,10,1108
9951,10098,497,1,Personal,4,3,38262,4,3,38364,4,3,38807,4,3,39067,4,3,39912,6,17.2,-1.266294,36.8057971,-1.2942892,36.7761329,379,845,102,703
9952,5736,3517,3,Business,17,4,30318,17,4,30342,17,4,30567,17,4,31904,17,4,33340,12,23.25888921888938,-1.300921,36.828195,-1.361923,36.770045,842,1436,24,1562
9953,27133,3283,3,Business,27,3,47534,27,3,47565,27,3,47698,27,3,48775,27,3,49222,5,29.3,-1.2600926,36.8088685,-1.2628473,36.781805,393,447,31,1210
9954,26278,868,3,Business,13,6,51008,13,6,51063,13,6,51518,13,6,52435,13,6,53202,5,28.1,-1.2600926,36.8088685,-1.265715,36.823815,383,767,55,1372
9955,27212,1346,3,Business,23,4,57286,23,4,57299,23,4,57651,23,4,58022,23,4,58913,5,20.9,-1.299813,36.7871392,-1.2764851,36.8007126,249,891,13,723
9956,2924,1681,1,Personal,25,5,57038,25,5,57058,25,5,58393,25,5,58903,25,5,61679,14,23.6,-1.2248308,36.8012573,-1.2924639,36.7795798,103,2776,20,1845
9957,2724,2654,1,Personal,4,4,53071,4,4,53120,4,4,53534,4,4,53621,4,4,54593,3,24.8,-1.2943818,36.7858765,-1.2963097,36.7688221,390,972,49,501
9958,7129,2030,3,Business,8,1,52531,8,1,55642,8,1,56748,8,1,57423,8,1,57693,8,29.5,-1.2279031,36.7875447,-1.232447,36.802205,411,270,3111,1781
9959,16002,1243,1,Business,28,5,47813,28,5,47888,28,5,48529,28,5,49446,28,5,52782,10,25.7,-1.304524,36.775371,-1.2551895,36.7822034,179,3336,75,1558
9960,17554,3647,3,Business,25,1,32171,25,1,32210,25,1,33339,25,1,33492,25,1,35185,13,15.0,-1.272639,36.794723,-1.3120931,36.7078029,449,1693,39,1282
9961,16156,2271,3,Business,29,5,36443,29,5,36528,29,5,37420,29,5,37868,29,5,39904,21,21.0,-1.344446,36.756597,-1.293515,36.897607,533,2036,85,1340
9962,28076,2394,3,Personal,16,4,41100,16,4,41107,16,4,41745,16,4,42014,16,4,42514,6,14.9,-1.2817856,36.7881009,-1.263987,36.798891,281,500,7,907
9963,24919,2112,3,Business,21,3,47959,21,3,48065,21,3,49145,21,3,49445,21,3,53267,17,23.0,-1.2156006,36.8916865,-1.3008656,36.845466,88,3822,106,1380
9964,27778,3205,1,Business,1,6,52850,1,6,52883,1,6,54380,1,6,54722,1,6,56234,11,19.6,-1.3087323,36.8570411,-1.2747671,36.8139951,622,1512,33,1839
9965,27566,1927,3,Business,11,2,58787,11,2,58974,11,2,59020,11,2,60376,11,2,62364,19,20.6,-1.3562374,36.9042954,-1.3472066,36.7692638,293,1988,187,1402
9966,15729,393,3,Business,9,3,44285,9,3,44295,9,3,44434,9,3,44936,9,3,45598,4,25.1,-1.3167113,36.8301563,-1.3004062,36.829741,523,662,10,641
9967,6743,1992,3,Business,18,4,80125,18,4,80136,18,4,80283,18,4,80355,18,4,80357,1,23.25888921888938,-1.3611971,36.6538278,-1.3620355,36.6533375,214,2,11,219
9968,27169,419,3,Business,7,2,49537,7,2,49632,7,2,50201,7,2,50510,7,2,51717,6,24.8,-1.2571472,36.7950633,-1.3001813,36.811122,414,1207,95,878
9969,24740,1754,3,Business,2,5,41098,2,5,41108,2,5,41704,2,5,41821,2,5,46438,21,23.4,-1.225322,36.80855,-1.2860183,36.8975338,866,4617,10,713
9970,27641,2154,3,Business,10,1,39478,10,1,39549,10,1,39807,10,1,40231,10,1,41551,13,18.5,-1.2156006,36.8916865,-1.2765736,36.8513646,60,1320,71,682
9971,16273,136,3,Business,16,6,36565,16,6,36746,16,6,38008,16,6,38255,16,6,41945,24,25.6,-1.3254522,36.7216584,-1.2313147,36.8016863,545,3690,181,1509
9972,17634,478,3,Business,24,3,55733,24,3,56068,24,3,56575,24,3,56912,24,3,58705,18,23.25888921888938,-1.2174537,36.8801909,-1.2551895,36.7822034,484,1793,335,844
9973,22157,3145,3,Business,6,4,38666,6,4,38738,6,4,39539,6,4,39742,6,4,42536,9,24.0,-1.272639,36.794723,-1.2835228,36.7437619,322,2794,72,1004
9974,6799,3674,3,Business,27,3,32792,27,3,32824,27,3,33509,27,3,34409,27,3,37397,22,21.5,-1.2551895,36.7822034,-1.3190102,36.9230693,177,2988,32,1585
9975,24530,3095,3,Personal,30,3,45320,30,3,45392,30,3,46019,30,3,46648,30,3,51440,14,24.9,-1.30157,36.7871,-1.2633397,36.7454238,101,4792,72,1256
9976,5296,968,2,Personal,26,2,33367,26,2,33375,26,2,33383,26,2,36138,26,2,36779,3,23.25888921888938,-1.2584143,36.8048002,-1.2615888,36.7928732,379,641,8,2763
9977,20855,1271,3,Business,18,5,44970,18,5,44989,18,5,45205,18,5,46524,18,5,48559,26,20.3,-1.3244885,36.897792,-1.3949989,36.7654761,510,2035,19,1535
9978,21127,186,3,Business,6,3,55565,6,3,55784,6,3,56731,6,3,57079,6,3,57981,9,22.0,-1.2975039,36.8110959,-1.2579304,36.8019667,742,902,219,1295
9979,14609,1341,3,Business,20,1,47495,20,1,47563,20,1,48425,20,1,48711,20,1,50073,13,23.25888921888938,-1.303596,36.778378,-1.331619,36.847976,709,1362,68,1148
9980,16176,2956,3,Business,16,4,50641,16,4,50653,16,4,51798,16,4,51959,16,4,54356,4,23.25888921888938,-1.2584143,36.8048002,-1.2551895,36.7822034,177,2397,12,1306
9981,12345,186,3,Business,1,5,43695,1,5,44247,1,5,44287,1,5,44724,1,5,46656,20,26.5,-1.2571472,36.7950633,-1.3700383,36.9190174,647,1932,552,477
9982,23691,111,3,Business,27,1,55995,27,1,56016,27,1,56021,27,1,56351,27,1,57143,5,23.3,-1.2551895,36.7822034,-1.2561398,36.8194374,576,792,21,335
9983,5456,393,3,Business,16,3,41361,16,3,42161,16,3,42188,16,3,42806,16,3,44409,11,22.6,-1.3167113,36.8301563,-1.2574219,36.7927073,623,1603,800,645
9984,6141,1637,3,Business,23,5,47040,23,5,47172,23,5,48098,23,5,48822,23,5,50159,8,26.4,-1.2615888,36.7928732,-1.225322,36.80855,733,1337,132,1650
9985,24568,60,3,Business,2,6,36249,2,6,37435,2,6,38081,2,6,38632,2,6,39341,8,23.25888921888938,-1.272828,36.816608,-1.2296618,36.8438272,383,709,1186,1197
9986,7567,246,3,Business,27,5,66280,27,5,67023,27,5,67553,27,5,67821,27,5,69059,2,17.6,-1.2584143,36.8048002,-1.2671296,36.8125772,519,1238,743,798
9987,26399,776,1,Personal,15,5,41830,15,5,43086,15,5,43114,15,5,43606,15,5,45076,8,19.9,-1.278967,36.8236745,-1.2907222,36.8843012,84,1470,1256,520
9988,11538,517,3,Business,13,2,30405,13,2,30497,13,2,30549,13,2,30947,13,2,32715,14,19.8,-1.3177547,36.8303703,-1.306378,36.7519845,10,1768,92,450
9989,10987,53,3,Business,25,1,50923,25,1,50980,25,1,51400,25,1,53488,25,1,54438,5,27.8,-1.3004062,36.829741,-1.2770708,36.8231093,341,950,57,2508
9990,19194,332,1,Personal,3,3,40061,3,3,40072,3,3,40512,3,3,40724,3,3,42336,22,24.1,-1.314193,36.916132,-1.3535477,36.7602697,449,1612,11,652
9991,3855,3686,3,Business,10,4,37269,10,4,37319,10,4,37918,10,4,38091,10,4,40394,10,23.25888921888938,-1.255956,36.789867,-1.2287282,36.8115304,729,2303,50,772
9992,10708,2462,3,Personal,28,5,53496,28,5,54346,28,5,54750,28,5,56494,28,5,57991,17,25.4,-1.2778747,36.8831829,-1.3211235,36.7765164,900,1497,850,2148
9993,11422,3283,3,Business,29,2,46731,29,2,46749,29,2,46935,29,2,47420,29,2,48087,5,23.6,-1.2600926,36.8088685,-1.2628473,36.781805,178,667,18,671
9994,14164,393,3,Business,25,1,43993,25,1,43999,25,1,44004,25,1,44696,25,1,46858,14,25.4,-1.3167113,36.8301563,-1.306378,36.7519845,925,2162,6,697
9995,16286,2069,3,Business,24,5,41114,24,5,41823,24,5,41991,24,5,42317,24,5,43523,12,21.6,-1.2600926,36.8088685,-1.228911,36.881876,240,1206,709,494
9996,25605,2066,3,Business,2,2,58012,2,2,58088,2,2,58700,2,2,59081,2,2,61110,16,29.3,-1.3210189,36.8410551,-1.2397503,36.8797681,299,2029,76,993
9997,6721,2982,3,Business,7,3,34960,7,3,35035,7,3,35044,7,3,39003,7,3,40641,22,25.1,-1.300921,36.828195,-1.1933341,36.9271667,179,1638,75,3968
9998,24797,925,3,Business,7,3,51989,7,3,52973,7,3,53587,7,3,53647,7,3,54849,7,28.1,-1.3253336,36.8305745,-1.3097713,36.849494,436,1202,984,674
9999,21866,3560,3,Business,11,1,45191,11,1,45224,11,1,46295,11,1,46917,11,1,48259,5,24.1,-1.2658424,36.8101804,-1.279395,36.825364,365,1342,33,1693
10000,24779,1073,3,Business,5,4,41920,5,4,41928,5,4,42110,5,4,42681,5,4,43270,5,23.25888921888938,-1.259697,36.800664,-1.2559294,36.788465,726,589,8,753
10001,5464,1920,3,Business,11,4,55699,11,4,55766,11,4,57109,11,4,57254,11,4,58758,8,27.2,-1.3014461,36.7661381,-1.2981352,36.8213822,327,1504,67,1488
10002,3809,1329,3,Business,24,3,35962,24,3,35998,24,3,36397,24,3,36576,24,3,37252,5,17.0,-1.273056,36.811298,-1.277783,36.7816464,446,676,36,578
10003,24811,391,3,Business,15,1,56668,15,1,57040,15,1,57354,15,1,58859,15,1,58864,5,23.25888921888938,-1.2599563,36.7993439,-1.2867454,36.8259017,99,5,372,1819
10004,10808,635,3,Business,5,2,47610,5,2,47773,5,2,48062,5,2,48518,5,2,49536,7,21.4,-1.2599563,36.7993439,-1.3016417,36.8271679,808,1018,163,745
10005,10698,3492,3,Business,29,3,39144,29,3,39170,29,3,39959,29,3,40519,29,3,41818,7,23.25888921888938,-1.299207,36.8414337,-1.2728947,36.8079426,2,1299,26,1349
10006,24703,3355,3,Business,31,1,40183,31,1,40918,31,1,41141,31,1,41208,31,1,43886,17,21.1,-1.2156006,36.8916865,-1.3052491,36.8223899,845,2678,735,290
10007,24203,816,3,Business,11,1,48871,11,1,48912,11,1,49776,11,1,50831,11,1,51991,6,28.8,-1.2584143,36.8048002,-1.290894,36.822971,156,1160,41,1919
10008,2113,3283,3,Business,14,5,36407,14,5,36442,14,5,36786,14,5,38196,14,5,39684,13,21.8,-1.331619,36.847976,-1.2628473,36.781805,690,1488,35,1754
10009,23955,2455,3,Business,19,2,38712,19,2,38738,19,2,38882,19,2,40165,19,2,41069,4,27.5,-1.2943272,36.7667198,-1.275442,36.7660207,269,904,26,1427
10010,6877,2069,3,Business,7,3,57809,7,3,57825,7,3,57849,7,3,59340,7,3,61497,17,28.2,-1.331619,36.847976,-1.228911,36.881876,699,2157,16,1515
10011,19345,1329,3,Business,2,4,50506,2,4,50554,2,4,51062,2,4,51259,2,4,53035,12,23.25888921888938,-1.273056,36.811298,-1.2672045,36.7172069,329,1776,48,705
10012,20392,2834,3,Business,8,3,55285,8,3,55698,8,3,57267,8,3,57506,8,3,61236,12,23.25888921888938,-1.225322,36.80855,-1.290894,36.822971,422,3730,413,1808
10013,14424,2801,3,Business,14,2,47128,14,2,47209,14,2,48681,14,2,48749,14,2,49927,8,23.25888921888938,-1.289081,36.8300409,-1.2674274,36.7870827,276,1178,81,1540
10014,2810,1439,3,Business,17,5,34783,17,5,34825,17,5,35565,17,5,35917,17,5,37504,6,23.25888921888938,-1.2962487,36.7772971,-1.274927,36.8028302,197,1587,42,1092
10015,26187,20,3,Business,12,2,35216,12,2,36531,12,2,37486,12,2,37734,12,2,38651,6,16.3,-1.2628638,36.8070399,-1.300722,36.816865,216,917,1315,1203
10016,4741,2956,3,Business,5,2,37863,5,2,37892,5,2,39364,5,2,39683,5,2,42526,13,21.5,-1.2584143,36.8048002,-1.3281792,36.8532879,207,2843,29,1791
10017,11379,53,3,Business,13,3,54665,13,3,54761,13,3,54904,13,3,55429,13,3,56611,5,27.0,-1.3004062,36.829741,-1.2770708,36.8231093,26,1182,96,668
10018,2722,3647,3,Business,17,1,49562,17,1,49615,17,1,50221,17,1,50501,17,1,53190,26,24.5,-1.272639,36.794723,-1.1586139,36.9561064,279,2689,53,886
10019,25147,3599,3,Business,13,4,48800,13,4,49458,13,4,50075,13,4,52583,13,4,56986,8,26.3,-1.3302996,36.8707935,-1.3079595,36.8335015,312,4403,658,3125
10020,26684,2335,3,Business,5,3,49161,5,3,49168,5,3,49179,5,3,49569,5,3,51622,15,24.9,-1.2551895,36.7822034,-1.3226302,36.8719901,828,2053,7,401
10021,8234,2330,3,Business,25,5,62545,25,5,62575,25,5,63065,25,5,63217,25,5,64779,8,26.6,-1.3192789,36.7112991,-1.3015197,36.7658456,269,1562,30,642
10022,1192,53,3,Business,26,5,55345,26,5,55388,26,5,55393,26,5,55852,26,5,56623,5,23.25888921888938,-1.2770708,36.8231093,-1.3004062,36.829741,320,771,43,464
10023,8330,248,3,Business,6,1,38346,6,1,38367,6,1,39581,6,1,39745,6,1,40399,1,20.4,-1.3025667,36.7803495,-1.304735,36.7846054,956,654,21,1378
10024,13560,2066,3,Business,1,3,44604,1,3,44618,1,3,45525,1,3,45778,1,3,46447,5,20.0,-1.316961,36.820337,-1.305716,36.809882,19,669,14,1160
10025,13275,1281,3,Business,30,4,61309,30,4,61397,30,4,61532,30,4,62162,30,4,63298,7,20.3,-1.268501,36.801065,-1.2707742,36.7578609,574,1136,88,765
10026,14341,1803,1,Personal,30,4,37535,30,4,37738,30,4,39178,30,4,39841,30,4,41699,13,20.5,-1.2057795,36.7747958,-1.2538731,36.7850223,409,1858,203,2103
10027,6086,3496,3,Business,7,4,57725,7,4,57809,7,4,58360,7,4,59888,7,4,61935,7,25.6,-1.3081376,36.8329772,-1.2602337,36.7990548,168,2047,84,2079
10028,11456,1334,2,Personal,16,4,40981,16,4,41128,16,4,41528,16,4,41620,16,4,42200,6,14.6,-1.3086326,36.8080886,-1.304033,36.7848695,88,580,147,492
10029,23067,510,3,Business,5,5,61674,5,5,61691,5,5,62253,5,5,62436,5,5,64533,13,24.7,-1.2860183,36.8975338,-1.3632162,36.9108253,890,2097,17,745
10030,20811,1500,3,Business,26,2,34102,26,2,44125,26,2,44244,26,2,48111,26,2,48575,8,23.25888921888938,-1.3004062,36.829741,-1.2574219,36.7927073,494,464,10023,3986
10031,5519,393,3,Business,25,6,43228,25,6,44179,25,6,44625,25,6,44866,25,6,45587,5,23.25888921888938,-1.3228003,36.8306435,-1.3077869,36.8443207,168,721,951,687
10032,26677,2330,3,Business,11,2,58710,11,2,58945,11,2,59345,11,2,59580,11,2,61516,15,20.8,-1.3015197,36.7658456,-1.2336843,36.8007259,622,1936,235,635
10033,28080,3309,3,Personal,5,4,45410,5,4,45631,5,4,46669,5,4,47745,5,4,48608,4,23.25888921888938,-1.2950408,36.8098172,-1.2995135,36.7933633,844,863,221,2114
10034,3927,2112,3,Business,26,6,61860,26,6,66039,26,6,66614,26,6,67425,26,6,68107,5,22.3,-1.2297202,36.8745508,-1.2156006,36.8916865,79,682,4179,1386
10035,14785,393,3,Business,26,2,28994,26,2,29037,26,2,29042,26,2,29486,26,2,30486,8,23.25888921888938,-1.3167113,36.8301563,-1.2770708,36.8231093,809,1000,43,449
10036,4140,2523,3,Business,28,2,42139,28,2,42161,28,2,42285,28,2,42750,28,2,43538,4,21.3,-1.2551895,36.7822034,-1.2689015,36.7986106,709,788,22,589
10037,5290,3689,3,Business,6,1,57312,6,1,57381,6,1,57934,6,1,60978,6,1,64133,10,22.2,-1.3014461,36.7661381,-1.2527958,36.8003131,636,3155,69,3597
10038,21267,2701,3,Business,24,5,41487,24,5,41873,24,5,42822,24,5,42885,24,5,43861,4,21.3,-1.2765736,36.8513646,-1.290894,36.822971,338,976,386,1012
10039,22234,1271,3,Business,26,1,56625,26,1,58624,26,1,59218,26,1,60182,26,1,60813,8,19.9,-1.3244885,36.897792,-1.3332749,36.8708147,675,631,1999,1558
10040,27912,3241,3,Business,10,1,54565,10,1,54626,10,1,54999,10,1,55355,10,1,56620,8,18.5,-1.2551895,36.7822034,-1.288924,36.831527,291,1265,61,729
10041,8936,1402,3,Business,18,4,34773,18,4,34846,18,4,36098,18,4,36333,18,4,37271,6,23.25888921888938,-1.2813012,36.8323962,-1.2649605,36.7981777,394,938,73,1487
10042,10934,165,1,Personal,26,4,46351,26,4,46556,26,4,47317,26,4,48499,26,4,50005,9,19.1,-1.2261184,36.8094779,-1.2621119,36.803669,208,1506,205,1943
10043,6271,393,3,Business,7,2,41244,7,2,41267,7,2,41397,7,2,42968,7,2,43711,4,23.25888921888938,-1.3167113,36.8301563,-1.3004062,36.829741,211,743,23,1701
10044,19681,3708,1,Personal,1,1,49683,1,1,49703,1,1,50983,1,1,51264,1,1,53651,20,25.7,-1.3120337,36.9147621,-1.2790653,36.7907262,543,2387,20,1561
10045,20348,3711,3,Business,21,5,58576,21,5,60880,21,5,61531,21,5,62224,21,5,62974,5,23.0,-1.2903421,36.7885282,-1.3014461,36.7661381,489,750,2304,1344
10046,26423,3560,3,Business,28,2,62078,28,2,62110,28,2,62429,28,2,62664,28,2,63777,3,18.2,-1.3052491,36.8223899,-1.279395,36.825364,384,1113,32,554
10047,1386,2150,3,Business,17,3,55593,17,3,55822,17,3,56169,17,3,57018,17,3,57766,6,23.25888921888938,-1.3181159,36.7101559,-1.344446,36.756597,340,748,229,1196
10048,7166,1809,3,Business,19,5,45660,19,5,45690,19,5,46121,19,5,46422,19,5,46666,2,24.9,-1.2646084,36.8028645,-1.2591019,36.800577,453,244,30,732
10049,21058,2063,3,Business,21,1,53600,21,1,53665,21,1,53903,21,1,54524,21,1,56053,18,27.8,-1.2551895,36.7822034,-1.2868018,36.8906063,40,1529,65,859
10050,17497,2866,3,Business,14,1,46267,14,1,46282,14,1,46491,14,1,47265,14,1,49246,22,23.4,-1.2551895,36.7822034,-1.3692201,36.9252718,45,1981,15,983
10051,13391,2853,3,Business,10,4,58992,10,4,59175,10,4,59539,10,4,59731,10,4,63149,22,22.2,-1.3700383,36.9190174,-1.2731553,36.7969726,753,3418,183,556
10052,14179,1709,1,Personal,8,3,29711,8,3,30812,8,3,33633,8,3,33830,8,3,35070,19,17.5,-1.284497,36.8286605,-1.1941774,36.9287933,179,1240,1101,3018
10053,27137,3647,3,Business,24,5,44503,24,5,44553,24,5,44736,24,5,45500,24,5,46854,5,21.6,-1.272639,36.794723,-1.2608573,36.8099855,882,1354,50,947
10054,8674,1209,3,Business,4,6,42566,4,6,42584,4,6,43911,4,6,44474,4,6,46816,12,23.25888921888938,-1.2991441,36.7528804,-1.3004062,36.829741,831,2342,18,1890
10055,10070,3506,3,Personal,1,3,42483,1,3,42569,1,3,43125,1,3,43371,1,3,44802,14,23.25888921888938,-1.296268,36.785084,-1.2563531,36.7896742,141,1431,86,802
10056,26051,517,3,Business,6,4,29572,6,4,29591,6,4,29605,6,4,30318,6,4,32643,14,18.6,-1.3177547,36.8303703,-1.306378,36.7519845,523,2325,19,727
10057,12042,2982,3,Business,24,3,32506,24,3,33005,24,3,34530,24,3,36336,24,3,38397,18,23.25888921888938,-1.300921,36.828195,-1.177202,36.8351183,487,2061,499,3331
10058,1203,970,3,Business,29,1,46762,29,1,46774,29,1,46962,29,1,49034,29,1,49036,10,23.25888921888938,-1.2551895,36.7822034,-1.312469,36.815177,193,2,12,2260
10059,3097,1724,3,Business,4,3,30793,4,3,30849,4,3,31780,4,3,32418,4,3,33894,14,15.2,-1.2551895,36.7822034,-1.2482465,36.8889062,101,1476,56,1569
10060,12166,1527,3,Business,8,1,42660,8,1,42678,8,1,43449,8,1,43857,8,1,46156,5,28.0,-1.3004062,36.829741,-1.3228003,36.8306435,155,2299,18,1179
10061,23004,2526,3,Personal,15,5,57538,15,5,57610,15,5,60017,15,5,60394,15,5,61008,4,27.9,-1.3009097,36.7641094,-1.3104734,36.7363698,448,614,72,2784
10062,21508,2100,3,Business,19,5,42392,19,5,42400,19,5,42505,19,5,43170,19,5,43570,8,24.7,-1.2765736,36.8513646,-1.2948092,36.8869203,179,400,8,770
10063,461,631,1,Personal,14,4,37449,14,4,37571,14,4,39462,14,4,39643,14,4,41976,23,19.2,-1.214428,36.883258,-1.3215473,36.8435326,124,2333,122,2072
10064,22902,3689,3,Business,1,4,51170,1,4,51200,1,4,51248,1,4,51997,1,4,52036,3,23.25888921888938,-1.2527958,36.8003131,-1.2551895,36.7822034,731,39,30,797
10065,18381,3309,3,Personal,9,1,53749,9,1,54238,9,1,58308,9,1,58484,9,1,59610,6,21.0,-1.2995135,36.7933633,-1.2823851,36.8186472,844,1126,489,4246
10066,21305,649,3,Business,12,1,55215,12,1,55249,12,1,56170,12,1,56472,12,1,58566,14,26.7,-1.2551895,36.7822034,-1.3332749,36.8708147,112,2094,34,1223
10067,18716,633,3,Business,21,1,56136,21,1,56515,21,1,57011,21,1,58376,21,1,59958,10,27.7,-1.3004062,36.829741,-1.2991441,36.7528804,518,1582,379,1861
10068,15211,1719,3,Business,4,5,43181,4,5,43288,4,5,44813,4,5,44889,4,5,47593,14,17.1,-1.2931728,36.7888371,-1.2330694,36.745451,362,2704,107,1601
10069,130,3597,2,Personal,17,5,35934,17,5,35968,17,5,36500,17,5,37470,17,5,38226,6,14.4,-1.2538731,36.7850223,-1.2855799,36.8176209,754,756,34,1502
10070,11452,2532,3,Business,23,5,31641,23,5,31759,23,5,32709,23,5,32854,23,5,34992,14,20.0,-1.2551895,36.7822034,-1.329568,36.8520825,933,2138,118,1095
10071,55,2066,3,Business,5,1,39139,5,1,39377,5,1,40409,5,1,40630,5,1,42181,10,24.6,-1.316961,36.820337,-1.3662774,36.7607811,532,1551,238,1253
10072,24874,2813,3,Personal,1,3,38425,1,3,38531,1,3,38899,1,3,42532,1,3,43018,5,19.8,-1.2776072,36.8227604,-1.2762384,36.7929522,726,486,106,4001
10073,3168,393,3,Business,14,2,39525,14,2,39821,14,2,40404,14,2,41033,14,2,42391,4,23.25888921888938,-1.3167113,36.8301563,-1.3004062,36.829741,778,1358,296,1212
10074,25767,302,3,Business,16,2,70643,16,2,71236,16,2,71475,16,2,71855,16,2,72294,2,21.5,-1.2649605,36.7981777,-1.2514074,36.8176667,103,439,593,619
10075,21236,1471,3,Business,21,2,39925,21,2,39976,21,2,40857,21,2,40986,21,2,42345,9,22.3,-1.2989465,36.7940379,-1.2551895,36.7822034,148,1359,51,1010
10076,8144,1976,3,Business,25,1,59596,25,1,59625,25,1,60017,25,1,60130,25,1,61314,9,28.4,-1.257028,36.7810435,-1.2581439,36.7236396,291,1184,29,505
10077,19017,1976,1,Business,30,6,52456,30,6,55197,30,6,56172,30,6,56358,30,6,57365,2,23.9,-1.256064,36.77318,-1.257028,36.7810435,844,1007,2741,1161
10078,15416,2112,3,Business,22,5,51050,22,5,51079,22,5,51829,22,5,52871,22,5,55354,15,27.3,-1.2156006,36.8916865,-1.2594539,36.8067841,436,2483,29,1792
10079,21527,816,3,Business,22,2,56480,22,2,56494,22,2,57500,22,2,57986,22,2,58603,2,25.6,-1.279395,36.825364,-1.290894,36.822971,462,617,14,1492
10080,20756,136,3,Business,26,4,54493,26,4,54522,26,4,56871,26,4,57528,26,4,58996,8,22.0,-1.3014461,36.7661381,-1.3326173,36.7146233,229,1468,29,3006
10081,7919,635,3,Business,12,4,29581,12,4,32142,12,4,32726,12,4,33253,12,4,33838,3,16.1,-1.2509176,36.8246646,-1.2599563,36.7993439,427,585,2561,1111
10082,14471,640,3,Business,13,1,40925,13,1,41085,13,1,43608,13,1,44106,13,1,47815,14,23.25888921888938,-1.2969741,36.7856612,-1.3246455,36.8754415,907,3709,160,3021
10083,24102,2789,3,Business,8,2,43402,8,2,43764,8,2,46447,8,2,47310,8,2,50077,14,23.4,-1.2287282,36.8115304,-1.304735,36.7846054,258,2767,362,3546
10084,7406,3295,3,Business,10,4,34664,10,4,34698,10,4,34738,10,4,35218,10,4,35262,2,19.2,-1.2571472,36.7950633,-1.2739424,36.8155357,536,44,34,520
10085,22954,2159,3,Business,13,2,40079,13,2,40196,13,2,41126,13,2,41557,13,2,42635,7,22.3,-1.304735,36.7846054,-1.3082357,36.8161482,518,1078,117,1361
10086,24297,2789,3,Business,29,5,60795,29,5,60835,29,5,61512,29,5,61668,29,5,63212,8,27.8,-1.2690931,36.8065779,-1.304735,36.7846054,177,1544,40,833
10087,14932,2330,3,Business,30,3,44960,30,3,45008,30,3,45674,30,3,45927,30,3,48342,12,24.9,-1.2124582,36.802894,-1.2890715,36.8157588,933,2415,48,919
10088,20021,1578,3,Business,31,3,30959,31,3,31003,31,3,32354,31,3,33271,31,3,34867,8,19.1,-1.3014461,36.7661381,-1.28878,36.8168312,796,1596,44,2268
10089,12605,136,3,Business,19,2,58788,19,2,58834,19,2,59804,19,2,59990,19,2,61068,7,28.3,-1.3009676,36.7657189,-1.2848376,36.8027622,545,1078,46,1156
10090,10173,2532,3,Business,13,3,42170,13,3,42310,13,3,42730,13,3,43008,13,3,47018,8,25.0,-1.2551895,36.7822034,-1.2904049,36.8055154,778,4010,140,698
10091,8614,3222,3,Business,8,1,53584,8,1,53619,8,1,53920,8,1,54180,8,1,54775,4,29.5,-1.2551895,36.7822034,-1.2768326,36.8073804,520,595,35,561
10092,26446,635,3,Business,2,2,34766,2,2,34835,2,2,35451,2,2,36238,2,2,38004,7,20.7,-1.3081376,36.8329772,-1.2643647,36.8127028,843,1766,69,1403
10093,9819,1329,3,Business,26,2,63121,26,2,63144,26,2,63288,26,2,63522,26,2,68540,6,29.6,-1.273056,36.811298,-1.3084722,36.8224665,119,5018,23,378
10094,4851,1205,1,Business,6,6,42926,6,6,42954,6,6,43012,6,6,43434,6,6,44794,6,24.2,-1.2706815,36.7646286,-1.3009173,36.7959207,574,1360,28,480
10095,18803,211,1,Personal,27,4,43562,27,4,43602,27,4,44497,27,4,44560,27,4,46455,4,22.7,-1.299059,36.78756,-1.2918688,36.7603541,328,1895,40,958
10096,24294,2330,3,Business,3,5,61773,3,5,62024,3,5,62442,3,5,62655,3,5,64571,7,23.25888921888938,-1.2536275,36.7987932,-1.2915247,36.8055757,607,1916,251,631
10097,25626,3647,3,Business,15,2,51380,15,2,51388,15,2,52368,15,2,52639,15,2,55294,18,24.5,-1.272639,36.794723,-1.3073803,36.6825842,269,2655,8,1251
10098,27979,2801,3,Business,22,3,43074,22,3,43094,22,3,43370,22,3,43530,22,3,44085,3,23.3,-1.2674274,36.7870827,-1.255392,36.792539,854,555,20,436
10099,17870,2388,2,Personal,31,4,38707,31,4,42260,31,4,43071,31,4,43839,31,4,45034,8,22.0,-1.3598678,36.737584,-1.3192808,36.7121888,159,1195,3553,1579
10100,16345,3291,3,Business,22,5,44152,22,5,44390,22,5,45356,22,5,46024,22,5,47198,12,28.7,-1.228911,36.881876,-1.2600926,36.8088685,459,1174,238,1634
10101,4151,1244,3,Business,12,6,31745,12,6,31781,12,6,32678,12,6,33447,12,6,34312,8,23.25888921888938,-1.307143,36.825009,-1.303596,36.778378,670,865,36,1666
10102,1150,53,3,Business,7,1,42595,7,1,43330,7,1,45070,7,1,45189,7,1,46709,6,25.0,-1.3077869,36.8443207,-1.2770708,36.8231093,436,1520,735,1859
10103,25801,1341,3,Business,14,4,47982,14,4,48116,14,4,48257,14,4,48953,14,4,49710,7,27.6,-1.307143,36.825009,-1.331619,36.847976,519,757,134,837
10104,413,2174,3,Business,31,4,38704,31,4,38710,31,4,38753,31,4,40039,31,4,41328,17,26.4,-1.2482781,36.884092,-1.1707617,36.9675086,510,1289,6,1329
10105,16349,186,3,Business,15,3,43224,15,3,43309,15,3,43669,15,3,44077,15,3,44694,6,23.25888921888938,-1.2902869,36.8085396,-1.2571472,36.7950633,235,617,85,768
10106,19784,635,3,Business,16,4,57070,16,4,57096,16,4,58289,16,4,60255,16,4,61631,8,23.25888921888938,-1.300921,36.828195,-1.2602337,36.7990548,709,1376,26,3159
10107,5346,758,3,Business,30,4,52649,30,4,52667,30,4,53182,30,4,53492,30,4,54358,8,23.25888921888938,-1.2917868,36.7872675,-1.2566689,36.7796952,783,866,18,825
10108,10123,3647,3,Business,9,4,33134,9,4,33166,9,4,34111,9,4,34410,9,4,35317,6,23.25888921888938,-1.272639,36.794723,-1.290789,36.8024859,438,907,32,1244
10109,27089,39,2,Personal,23,4,38922,23,4,39190,23,4,40476,23,4,40643,23,4,41935,7,18.7,-1.2696795,36.8640088,-1.2839568,36.8233106,754,1292,268,1453
10110,15626,3647,3,Business,27,2,39095,27,2,39103,27,2,40630,27,2,40756,27,2,41592,6,23.8,-1.272639,36.794723,-1.2655477,36.8001682,50,836,8,1653
10111,17138,2763,3,Business,1,4,48096,1,4,48103,1,4,49045,1,4,49371,1,4,50257,2,23.25888921888938,-1.3014461,36.7661381,-1.2934638,36.7668028,477,886,7,1268
10112,1403,2017,3,Business,19,2,51376,19,2,51410,19,2,52259,19,2,53780,19,2,55051,15,18.7,-1.2365885,36.8898127,-1.262492,36.800973,455,1271,34,2370
10113,20187,1471,3,Business,30,2,40640,30,2,41276,30,2,41841,30,2,42067,30,2,45615,8,23.25888921888938,-1.2551895,36.7822034,-1.3021707,36.8168444,68,3548,636,791
10114,26372,2828,3,Business,2,6,34639,2,6,37122,2,6,38960,2,6,39053,2,6,40879,19,23.25888921888938,-1.2778747,36.8831829,-1.3846585,36.9375131,59,1826,2483,1931
10115,14518,3669,3,Business,5,2,33615,5,2,33625,5,2,33685,5,2,34743,5,2,35815,17,20.9,-1.2615888,36.7928732,-1.2077728,36.8705319,517,1072,10,1118
10116,13371,20,3,Business,14,3,36295,14,3,36309,14,3,36520,14,3,37047,14,3,39377,17,18.7,-1.2628638,36.8070399,-1.3390024,36.8746657,620,2330,14,738
10117,22581,2986,3,Personal,14,5,36013,14,5,36045,14,5,36816,14,5,37073,14,5,38472,11,17.3,-1.3255287,36.7850772,-1.2903886,36.8063847,610,1399,32,1028
10118,9333,549,2,Personal,19,3,46508,19,3,46562,19,3,46654,19,3,46997,19,3,47753,5,23.25888921888938,-1.2857524,36.8196806,-1.2684239,36.7952462,456,756,54,435
10119,19188,391,3,Business,19,2,56276,19,2,56915,19,2,58052,19,2,58364,19,2,61989,5,29.9,-1.300921,36.828195,-1.2867454,36.8259017,928,3625,639,1449
10120,8774,1482,3,Business,20,1,55815,20,1,55879,20,1,56385,20,1,56686,20,1,57320,3,23.25888921888938,-1.2736466,36.8164042,-1.2649605,36.7981777,123,634,64,807
10121,6161,1271,3,Business,11,2,58957,11,2,60983,11,2,63518,11,2,64543,11,2,65878,7,20.9,-1.3226302,36.8719901,-1.3244885,36.897792,646,1335,2026,3560
10122,9034,265,3,Business,7,2,49472,7,2,49525,7,2,50914,7,2,52633,7,2,53522,10,24.7,-1.341891,36.761269,-1.300921,36.828195,101,889,53,3108
10123,12218,1920,3,Business,23,5,43820,23,5,46050,23,5,46177,23,5,46390,23,5,48197,10,23.9,-1.2551895,36.7822034,-1.321627,36.835193,237,1807,2230,340
10124,18062,2617,1,Personal,15,1,42352,15,1,42461,15,1,43326,15,1,43690,15,1,44662,6,23.25888921888938,-1.2961742,36.8192864,-1.2721466,36.8155359,268,972,109,1229
10125,14174,3426,3,Business,2,6,44214,2,6,47364,2,6,47513,2,6,48025,2,6,49794,9,27.5,-1.279395,36.825364,-1.3012008,36.764868,819,1769,3150,661
10126,23573,111,3,Business,4,5,49041,4,5,49068,4,5,50151,4,5,51066,4,5,54514,13,23.25888921888938,-1.2551895,36.7822034,-1.3215394,36.836621,167,3448,27,1998
10127,26040,2383,3,Business,16,4,39321,16,4,39404,16,4,41143,16,4,41413,16,4,42162,4,23.25888921888938,-1.2608993,36.799246,-1.2732784,36.8029946,435,749,83,2009
10128,17408,2330,3,Business,22,5,66480,22,5,66504,22,5,66563,22,5,67053,22,5,68105,8,28.5,-1.3192789,36.7112991,-1.3015197,36.7658456,881,1052,24,549
10129,16821,3355,3,Business,17,4,53805,17,4,53847,17,4,53976,17,4,54446,17,4,55907,13,27.9,-1.3052491,36.8223899,-1.32943,36.894243,779,1461,42,599
10130,23314,633,3,Business,1,5,48265,1,5,49711,1,5,51901,1,5,52402,1,5,53602,5,28.4,-1.2770708,36.8231093,-1.3004062,36.829741,26,1200,1446,2691
10131,22303,242,3,Business,9,3,40884,9,3,40927,9,3,43663,9,3,44261,9,3,45319,6,21.0,-1.255956,36.789867,-1.2803861,36.8259509,771,1058,43,3334
10132,15185,2550,3,Personal,7,2,43191,7,2,44190,7,2,45989,7,2,47064,7,2,49466,7,23.25888921888938,-1.2941,36.765793,-1.2904753,36.8144721,267,2402,999,2874
10133,4144,978,1,Personal,17,2,47105,17,2,47208,17,2,48452,17,2,49616,17,2,50805,5,24.6,-1.3084067,36.8345014,-1.2767856,36.8285595,752,1189,103,2408
10134,1189,2200,3,Business,12,1,31374,12,1,31654,12,1,32042,12,1,32457,12,1,32778,2,19.4,-1.279395,36.825364,-1.290894,36.822971,88,321,280,803
10135,8171,3283,3,Business,18,5,38545,18,5,38558,18,5,38829,18,5,39076,18,5,39491,5,20.0,-1.2600926,36.8088685,-1.2628473,36.781805,72,415,13,518
10136,27066,1077,3,Personal,3,5,50796,3,5,51009,3,5,52345,3,5,52812,3,5,53903,6,25.2,-1.2882411,36.8274955,-1.263194,36.797624,229,1091,213,1803
10137,23069,2454,3,Business,8,1,55463,8,1,55703,8,1,56225,8,1,56936,8,1,57815,6,29.4,-1.3251496,36.7982151,-1.2944148,36.8033551,375,879,240,1233
10138,23697,3647,3,Business,6,4,58414,6,4,58882,6,4,58929,6,4,61598,6,4,61602,9,21.6,-1.272639,36.794723,-1.235348,36.760016,855,4,468,2716
10139,20713,914,3,Business,28,4,55184,28,4,55297,28,4,56629,28,4,57133,28,4,60426,11,27.4,-1.2670213,36.7994482,-1.3270716,36.8406371,26,3293,113,1836
10140,57,1336,3,Business,3,4,40799,3,4,41285,3,4,43780,3,4,43988,3,4,47509,8,23.5,-1.2885029,36.825605,-1.3038645,36.8684596,436,3521,486,2703
10141,22023,2258,3,Business,8,2,53380,8,2,53463,8,2,53908,8,2,54151,8,2,55333,6,25.5,-1.2571472,36.7950633,-1.3011768,36.818364,671,1182,83,688
10142,16211,2679,3,Business,18,1,52318,18,1,52632,18,1,53997,18,1,54073,18,1,54728,4,17.2,-1.2680643,36.7763499,-1.2857671,36.7875614,441,655,314,1441
10143,12075,1304,3,Business,22,5,56158,22,5,56223,22,5,56972,22,5,57507,22,5,58759,8,27.2,-1.2551895,36.7822034,-1.2876804,36.7802778,831,1252,65,1284
10144,16338,3273,2,Personal,28,5,49012,28,5,49271,28,5,49957,28,5,51752,28,5,54922,26,25.3,-1.3156678,36.713569,-1.2175221,36.8246637,565,3170,259,2481
10145,9751,972,3,Business,22,3,51425,22,3,51506,22,3,51998,22,3,53201,22,3,56601,6,25.6,-1.2862033,36.8152966,-1.2855921,36.7788349,446,3400,81,1695
10146,21881,3426,3,Business,7,5,30792,7,5,30818,7,5,31129,7,5,31442,7,5,32875,8,18.5,-1.3014461,36.7661381,-1.2605938,36.8073235,74,1433,26,624
10147,19801,3239,3,Personal,4,3,36997,4,3,38053,4,3,38693,4,3,39214,4,3,40222,9,17.2,-1.2835525,36.8296382,-1.2323371,36.864817,208,1008,1056,1161
10148,26665,1329,3,Business,25,4,55688,25,4,55949,25,4,56456,25,4,56851,25,4,57831,9,23.25888921888938,-1.273056,36.811298,-1.3210622,36.802019,484,980,261,902
10149,19805,136,3,Business,14,4,42781,14,4,42826,14,4,43489,14,4,44037,14,4,46327,15,23.5,-1.2874648,36.8271985,-1.3254522,36.7216584,378,2290,45,1211
10150,3054,1469,3,Business,2,4,53201,2,4,53235,2,4,56052,2,4,57189,2,4,58776,6,23.25888921888938,-1.2571472,36.7950633,-1.2896399,36.8124498,422,1587,34,3954
10151,8124,3044,3,Business,8,5,59404,8,5,60324,8,5,60970,8,5,61105,8,5,61978,6,28.2,-1.3228003,36.8306435,-1.3127877,36.8481987,127,873,920,781
10152,21345,2457,3,Business,30,4,46085,30,4,46108,30,4,46875,30,4,47147,30,4,48000,6,20.4,-1.2551895,36.7822034,-1.2825774,36.8191403,105,853,23,1039
10153,11161,2523,3,Business,3,1,52794,3,1,53039,3,1,54294,3,1,54575,3,1,56088,13,23.2,-1.2551895,36.7822034,-1.3024388,36.859699,96,1513,245,1536
10154,17230,3521,3,Business,18,1,31847,18,1,31895,18,1,32461,18,1,32843,18,1,33575,3,21.6,-1.2696908,36.81519,-1.2741728,36.7969108,99,732,48,948
10155,10472,1280,3,Business,13,4,47726,13,4,47753,13,4,47858,13,4,48073,13,4,52304,13,21.9,-1.2551895,36.7822034,-1.3208221,36.8295735,168,4231,27,320
10156,3881,2523,3,Business,11,1,37624,11,1,37708,11,1,37722,11,1,38133,11,1,40354,17,26.4,-1.2551895,36.7822034,-1.2702844,36.8803209,576,2221,84,425
10157,13333,3295,3,Business,22,4,41767,22,4,42881,22,4,44386,22,4,45013,22,4,45359,4,22.6,-1.2571472,36.7950633,-1.286583,36.8159584,660,346,1114,2132
10158,14888,1090,3,Personal,15,1,44829,15,1,44949,15,1,46226,15,1,46529,15,1,47918,10,23.25888921888938,-1.3277532,36.8297901,-1.2655332,36.8094648,38,1389,120,1580
10159,16654,1787,3,Business,13,4,52919,13,4,52930,13,4,53016,13,4,53174,13,4,54294,3,22.9,-1.2283403,36.8822756,-1.2343236,36.8861,788,1120,11,244
10160,3407,2154,3,Business,12,2,58457,12,2,58695,12,2,59405,12,2,59698,12,2,60899,6,28.6,-1.2765736,36.8513646,-1.2878913,36.8089253,291,1201,238,1003
10161,25494,81,3,Business,28,3,35673,28,3,35697,28,3,35984,28,3,36625,28,3,37299,4,20.6,-1.2732506,36.8132437,-1.2641496,36.7914139,829,674,24,928
10162,11667,2289,3,Business,6,5,48008,6,5,49144,6,5,49548,6,5,50171,6,5,53172,7,22.4,-1.2551895,36.7822034,-1.2950826,36.8018379,642,3001,1136,1027
10163,22739,1754,3,Business,8,6,46111,8,6,46177,8,6,46306,8,6,46553,8,6,48196,15,18.1,-1.2156006,36.8916865,-1.2860183,36.8975338,819,1643,66,376
10164,23616,2395,1,Personal,13,7,38107,13,7,38112,13,7,38206,13,7,38666,13,7,39066,3,23.8,-1.2763494,36.7671783,-1.2812903,36.7808519,449,400,5,554
10165,3646,3291,3,Business,30,4,37536,30,4,37557,30,4,38495,30,4,39653,30,4,41584,12,23.25888921888938,-1.331619,36.847976,-1.2600926,36.8088685,310,1931,21,2096
10166,17481,867,3,Business,8,4,27440,8,4,31301,8,4,32588,8,4,34463,8,4,36926,10,20.7,-1.2996533,36.8292629,-1.306378,36.7519845,208,2463,3861,3162
10167,12486,2829,3,Business,31,5,48774,31,5,49105,31,5,49475,31,5,49918,31,5,50803,6,24.6,-1.2571472,36.7950633,-1.2857671,36.7875614,709,885,331,813
10168,5024,186,3,Business,14,3,39822,14,3,39837,14,3,40575,14,3,41997,14,3,46605,17,24.5,-1.2902869,36.8085396,-1.3700383,36.9190174,250,4608,15,2160
10169,12829,1244,3,Business,28,5,31828,28,5,31834,28,5,32104,28,5,37282,28,5,40554,17,19.3,-1.228911,36.881876,-1.303596,36.778378,669,3272,6,5448
10170,8710,111,3,Business,12,5,57802,12,5,57849,12,5,58269,12,5,58392,12,5,59712,9,23.25888921888938,-1.2551895,36.7822034,-1.2864747,36.7973884,708,1320,47,543
10171,12863,2691,3,Business,15,5,34351,15,5,34372,15,5,35276,15,5,35406,15,5,37572,21,20.4,-1.264865,36.810488,-1.1962799,36.9521972,958,2166,21,1034
10172,13071,2420,3,Personal,19,2,62026,19,2,62053,19,2,62647,19,2,63915,19,2,63925,4,28.3,-1.3103512,36.814996,-1.3028118,36.8174764,686,10,27,1862
10173,8886,711,3,Business,25,1,48030,25,1,48082,25,1,48168,25,1,52082,25,1,53206,10,27.9,-1.3247683,36.85803,-1.335477,36.9308297,26,1124,52,4000
10174,13615,393,3,Business,12,1,53695,12,1,53710,12,1,55047,12,1,55510,12,1,58032,14,26.7,-1.3177547,36.8303703,-1.306378,36.7519845,555,2522,15,1800
10175,1587,186,3,Business,19,2,53192,19,2,53210,19,2,53972,19,2,54217,19,2,55208,7,29.2,-1.2825816,36.8092346,-1.2571472,36.7950633,763,991,18,1007
10176,15663,2132,3,Business,17,3,38660,17,3,40385,17,3,41629,17,3,42034,17,3,44188,13,25.5,-1.2384056,36.8718698,-1.3172593,36.8558936,775,2154,1725,1649
10177,21665,2523,3,Business,4,1,39695,4,1,39738,4,1,40555,4,1,40890,4,1,41595,7,25.5,-1.2551895,36.7822034,-1.2908303,36.8049512,322,705,43,1152
10178,5304,2200,3,Business,2,2,41319,2,2,41508,2,2,42057,2,2,45851,2,2,46898,6,26.3,-1.2534301,36.8000983,-1.290894,36.822971,436,1047,189,4343
10179,10166,3635,1,Business,17,3,46242,17,3,46726,17,3,48153,17,3,48213,17,3,52975,9,25.5,-1.2615888,36.7928732,-1.2837908,36.7398372,726,4762,484,1487
10180,3743,3264,3,Business,4,4,53480,4,4,53845,4,4,54099,4,4,54677,4,4,55521,6,27.3,-1.2551895,36.7822034,-1.288285,36.815912,61,844,365,832
10181,11959,576,1,Personal,8,3,42833,8,3,42871,8,3,43287,8,3,43860,8,3,45074,5,22.1,-1.30217,36.770468,-1.2760259,36.769888,179,1214,38,989
10182,9718,3624,1,Personal,16,6,41540,16,6,41563,16,6,42170,16,6,43211,16,6,45411,17,19.4,-1.286943,36.800976,-1.2091559,36.7753704,148,2200,23,1648
10183,21264,2509,3,Business,1,1,55927,1,1,56024,1,1,57282,1,1,57675,1,1,60384,20,23.25888921888938,-1.2571472,36.7950633,-1.3700383,36.9190174,138,2709,97,1651
10184,2566,3557,3,Business,15,1,48949,15,1,48965,15,1,49288,15,1,49535,15,1,50239,4,23.25888921888938,-1.2546732,36.8086796,-1.27778,36.803925,467,704,16,570
10185,625,1701,1,Personal,5,2,53730,5,2,54512,5,2,56392,5,2,56740,5,2,59771,11,22.7,-1.3218455,36.7213009,-1.3007998,36.7894954,735,3031,782,2228
10186,14536,1329,3,Business,2,4,46674,2,4,46724,2,4,46742,2,4,47035,2,4,47800,5,23.25888921888938,-1.273056,36.811298,-1.2964348,36.8182757,119,765,50,311
10187,20001,955,2,Personal,4,6,42570,4,6,42598,4,6,42924,4,6,43325,4,6,44133,4,19.6,-1.2790653,36.7907262,-1.2675332,36.808561,452,808,28,727
10188,4397,649,3,Business,30,4,53170,30,4,55223,30,4,56422,30,4,56685,30,4,58197,7,23.25888921888938,-1.2551895,36.7822034,-1.2854089,36.8284874,868,1512,2053,1462
10189,4528,391,3,Business,30,2,41644,30,2,41800,30,2,43821,30,2,45503,30,2,50687,18,23.25888921888938,-1.2867454,36.8259017,-1.3878505,36.7692885,106,5184,156,3703
10190,25306,3064,3,Business,9,1,39684,9,1,39694,9,1,40853,9,1,41500,9,1,42269,5,20.3,-1.2571191,36.8019652,-1.2549476,36.8269576,379,769,10,1806
10191,18032,3560,3,Business,25,1,56570,25,1,56584,25,1,56595,25,1,56682,25,1,58472,18,30.2,-1.3705766,36.9120742,-1.279395,36.825364,448,1790,14,98
10192,19286,2959,2,Personal,6,1,34414,6,1,34500,6,1,35253,6,1,35690,6,1,36443,4,14.9,-1.263453,36.7955612,-1.2866012,36.8195691,857,753,86,1190
10193,25078,598,1,Business,20,1,46130,20,1,47671,20,1,49164,20,1,49749,20,1,53383,24,21.4,-1.2138373,36.7998572,-1.3103985,36.9114173,882,3634,1541,2078
10194,10164,788,3,Business,14,4,31485,14,4,32646,14,4,33901,14,4,35713,14,4,37459,8,17.8,-1.2615888,36.7928732,-1.225322,36.80855,545,1746,1161,3067
10195,20031,393,3,Business,31,3,27748,31,3,29429,31,3,29555,31,3,33228,31,3,33231,4,19.3,-1.3177547,36.8303703,-1.3004062,36.829741,731,3,1681,3799
10196,16812,3647,3,Business,22,5,36102,22,5,36156,22,5,37291,22,5,37557,22,5,38671,6,22.4,-1.272639,36.794723,-1.2946558,36.760775,520,1114,54,1401
10197,5353,1342,3,Business,6,2,42399,6,2,42870,6,2,43628,6,2,44047,6,2,46894,9,24.9,-1.3165542,36.700067,-1.3025826,36.7670807,521,2847,471,1177
10198,25756,645,1,Personal,18,3,56838,18,3,57003,18,3,58052,18,3,59003,18,3,61674,8,20.8,-1.2655306,36.828148,-1.31064,36.8223153,722,2671,165,2000
10199,17963,552,3,Business,20,4,39874,20,4,39922,20,4,40092,20,4,41490,20,4,43858,21,22.1,-1.2551895,36.7822034,-1.3632162,36.9108253,574,2368,48,1568
10200,25612,540,3,Business,15,2,39055,15,2,39236,15,2,39921,15,2,40181,15,2,41694,7,24.1,-1.2551895,36.7822034,-1.287818,36.828623,576,1513,181,945
10201,7582,2555,3,Business,21,7,57829,21,7,57909,21,7,59087,21,7,59351,21,7,61309,12,23.25888921888938,-1.2885398,36.767025,-1.2677415,36.8348418,324,1958,80,1442
10202,13748,3656,3,Personal,10,1,48675,10,1,48697,10,1,49341,10,1,49535,10,1,51889,8,23.25888921888938,-1.2551895,36.7822034,-1.2983124,36.8104456,820,2354,22,838
10203,27043,2174,3,Business,13,4,52195,13,4,52195,13,4,52422,13,4,56034,13,4,56038,12,22.9,-1.2489964,36.8771594,-1.2649605,36.7981777,86,4,0,3839
10204,8147,2627,3,Business,5,3,39241,5,3,39247,5,3,40364,5,3,40565,5,3,42060,17,22.5,-1.2156006,36.8916865,-1.2571472,36.7950633,685,1495,6,1318
10205,20885,1052,3,Personal,16,3,32989,16,3,33314,16,3,34326,16,3,34596,16,3,35571,7,20.1,-1.290894,36.822971,-1.2626906,36.7827022,290,975,325,1282
10206,8946,1724,3,Business,26,4,60386,26,4,60458,26,4,60598,26,4,62480,26,4,63490,6,19.6,-1.2859677,36.8215312,-1.2849763,36.7841767,340,1010,72,2022
10207,1481,675,2,Personal,25,6,38503,25,6,38540,25,6,38734,25,6,38993,25,6,39718,7,23.25888921888938,-1.2595467,36.8113044,-1.2894031,36.7745653,103,725,37,453
10208,16489,2212,3,Business,7,4,39533,7,4,39574,7,4,40225,7,4,40539,7,4,41170,5,24.5,-1.2571472,36.7950633,-1.2357748,36.7900524,717,631,41,965
10209,23222,426,3,Business,25,2,49273,25,2,51624,25,2,52556,25,2,52954,25,2,54400,10,26.9,-1.2824367,36.8353831,-1.3323107,36.8692616,38,1446,2351,1330
10210,13348,633,3,Business,11,5,36374,11,5,36830,11,5,37110,11,5,37475,11,5,38508,9,21.1,-1.2574219,36.7927073,-1.3004062,36.829741,878,1033,456,645
10211,16769,2350,1,Personal,24,1,37236,24,1,37324,24,1,38402,24,1,39661,24,1,40406,4,22.5,-1.293886,36.7596951,-1.2977713,36.7841682,565,745,88,2337
10212,26210,3291,3,Business,15,5,44373,15,5,44431,15,5,45904,15,5,47347,15,5,49841,18,26.0,-1.293515,36.897607,-1.2600926,36.8088685,883,2494,58,2916
10213,25186,2523,3,Business,13,1,41379,13,1,41597,13,1,42299,13,1,42473,13,1,43379,6,17.3,-1.2551895,36.7822034,-1.2687962,36.825707,249,906,218,876
10214,5553,1994,3,Business,13,1,33235,13,1,33305,13,1,34611,13,1,35040,13,1,38365,20,23.25888921888938,-1.2861765,36.8209086,-1.2811816,36.9591729,341,3325,70,1735
10215,17824,3091,1,Business,31,2,58510,31,2,58599,31,2,58976,31,2,60215,31,2,60854,5,20.1,-1.3014461,36.7661381,-1.2858511,36.7946184,207,639,89,1616
10216,23128,1926,3,Business,15,5,49344,15,5,49394,15,5,50564,15,5,54090,15,5,54666,11,27.9,-1.3263105,36.8622904,-1.2884651,36.8249609,686,576,50,4696
10217,26546,3635,1,Business,28,5,56801,28,5,56896,28,5,57489,28,5,59289,28,5,62768,9,25.5,-1.2584143,36.8048002,-1.3185736,36.8258933,178,3479,95,2393
10218,21142,1271,3,Business,22,3,39261,22,3,39990,22,3,40410,22,3,41511,22,3,42444,13,23.2,-1.3244885,36.897792,-1.30927,36.81326,345,933,729,1521
10219,25846,3647,3,Business,8,1,54043,8,1,54067,8,1,54670,8,1,55105,8,1,57712,18,29.7,-1.272639,36.794723,-1.298037,36.6934582,762,2607,24,1038
10220,3294,2387,1,Personal,25,1,37016,25,1,37058,25,1,37740,25,1,38034,25,1,39697,11,23.25888921888938,-1.2535486,36.7933541,-1.2969741,36.7856612,116,1663,42,976
10221,1231,1329,3,Business,19,2,50539,19,2,50573,19,2,52162,19,2,52508,19,2,54726,4,30.2,-1.273056,36.811298,-1.284835,36.8152125,795,2218,34,1935
10222,26398,1363,3,Business,4,2,35155,4,2,37955,4,2,38089,4,2,38170,4,2,39270,6,20.5,-1.3004062,36.829741,-1.2617028,36.7983849,591,1100,2800,215
10223,24688,2154,3,Business,23,3,46045,23,3,46129,23,3,46882,23,3,47460,23,3,48427,5,23.25888921888938,-1.290894,36.822971,-1.2765736,36.8513646,489,967,84,1331
10224,19291,3109,2,Personal,13,5,28592,13,5,28638,13,5,28912,13,5,30809,13,5,31514,5,15.5,-1.2551895,36.7822034,-1.2693522,36.7973993,116,705,46,2171
10225,22301,435,3,Business,29,3,45865,29,3,45896,29,3,48712,29,3,50544,29,3,52737,14,21.3,-1.242265,36.8808728,-1.300921,36.828195,260,2193,31,4648
10226,12261,1880,3,Business,3,3,37304,3,3,37629,3,3,37671,3,3,37919,3,3,38479,7,18.5,-1.2861765,36.8209086,-1.2571472,36.7950633,726,560,325,290
10227,5940,419,3,Business,6,2,63441,6,2,63698,6,2,64489,6,2,64852,6,2,65882,6,23.25888921888938,-1.2571472,36.7950633,-1.3001813,36.811122,427,1030,257,1154
10228,2362,2190,3,Business,13,3,40126,13,3,40140,13,3,41284,13,3,42182,13,3,43230,5,23.25888921888938,-1.3109027,36.7689452,-1.301953,36.788458,678,1048,14,2042
10229,17027,1033,1,Personal,18,4,39384,18,4,39437,18,4,39691,18,4,39767,18,4,41141,9,25.3,-1.2327933,36.8039909,-1.2654983,36.7968622,453,1374,53,330
10230,22583,3203,3,Business,30,2,50010,30,2,50117,30,2,50145,30,2,52534,30,2,54634,17,27.3,-1.331619,36.847976,-1.228911,36.881876,770,2100,107,2417
10231,4948,1500,3,Business,20,2,50079,20,2,50099,20,2,51148,20,2,53174,20,2,54457,8,24.2,-1.3004062,36.829741,-1.2574219,36.7927073,631,1283,20,3075
10232,16897,1271,3,Business,8,1,43490,8,1,43515,8,1,43802,8,1,44103,8,1,46556,24,27.7,-1.3244885,36.897792,-1.3107918,36.761794,418,2453,25,588
10233,21513,3283,3,Business,1,5,47836,1,5,47853,1,5,48342,1,5,49300,1,5,50858,13,31.7,-1.331619,36.847976,-1.2628473,36.781805,663,1558,17,1447
10234,1954,1482,3,Business,13,2,40045,13,2,40087,13,2,41151,13,2,41909,13,2,45183,17,22.1,-1.338579,36.8963038,-1.2979242,36.7902416,565,3274,42,1822
10235,12888,1295,2,Personal,28,4,40901,28,4,40936,28,4,41209,28,4,42627,28,4,43461,11,23.25888921888938,-1.2947459,36.77591,-1.3339461,36.8219129,312,834,35,1691
10236,25522,3517,3,Business,2,2,37399,2,2,37410,2,2,37412,2,2,39796,2,2,41238,15,26.0,-1.300921,36.828195,-1.3882008,36.7699445,595,1442,11,2386
10237,3027,1865,1,Personal,20,1,57759,20,1,57775,20,1,58172,20,1,58448,20,1,61470,23,21.3,-1.214428,36.883258,-1.3197748,36.8280793,898,3022,16,673
10238,10484,2956,3,Business,3,1,54188,3,1,54212,3,1,54295,3,1,54846,3,1,55161,3,23.2,-1.2584143,36.8048002,-1.2551895,36.7822034,205,315,24,634
10239,753,1245,3,Business,14,4,32753,14,4,33005,14,4,33795,14,4,34424,14,4,37654,18,19.1,-1.3198615,36.7110323,-1.300921,36.828195,847,3230,252,1419
10240,19413,3091,3,Business,28,5,50399,28,5,50515,28,5,51099,28,5,51875,28,5,52867,5,25.4,-1.3012008,36.764868,-1.2717174,36.7753883,576,992,116,1360
10241,2237,1500,3,Business,22,5,32410,22,5,32494,22,5,34112,22,5,34512,22,5,36827,10,22.2,-1.2991441,36.7528804,-1.2638185,36.7930057,327,2315,84,2018
10242,24511,1899,3,Business,12,3,42918,12,3,43274,12,3,43288,12,3,44222,12,3,47202,11,19.3,-1.2663631,36.8163329,-1.331619,36.847976,338,2980,356,948
10243,3096,2330,3,Business,30,3,55508,30,3,55556,30,3,56105,30,3,56313,30,3,57594,8,29.0,-1.2873232,36.7658572,-1.2649605,36.7981777,246,1281,48,757
10244,20551,3621,3,Business,2,6,61196,2,6,61242,2,6,61998,2,6,62172,2,6,65386,17,23.25888921888938,-1.2836583,36.7886014,-1.356039,36.750176,246,3214,46,930
10245,3349,391,3,Business,30,4,48624,30,4,48708,30,4,48906,30,4,53071,30,4,53232,5,23.25888921888938,-1.300921,36.828195,-1.2784063,36.8222933,436,161,84,4363
10246,1283,867,3,Business,30,4,54079,30,4,54126,30,4,55321,30,4,55405,30,4,56900,12,23.25888921888938,-1.2991441,36.7528804,-1.3004062,36.829741,2,1495,47,1279
10247,26472,1329,3,Business,24,3,59706,24,3,59760,24,3,59794,24,3,60166,24,3,61110,7,23.25888921888938,-1.273056,36.811298,-1.2596241,36.762407,96,944,54,406
10248,19020,909,3,Business,3,3,50436,3,3,50443,3,3,50639,3,3,50860,3,3,52274,8,28.4,-1.225322,36.80855,-1.225441,36.763899,843,1414,7,417
10249,7299,3283,3,Business,22,2,58034,22,2,58383,22,2,59787,22,2,60477,22,2,61011,6,18.4,-1.2673935,36.8030328,-1.2628473,36.781805,726,534,349,2094
10250,15540,2150,3,Business,8,6,46985,8,6,46995,8,6,47600,8,6,48182,8,6,49269,11,22.4,-1.307143,36.825009,-1.344446,36.756597,736,1087,10,1187
10251,8351,1482,3,Business,4,2,56314,4,2,56326,4,2,56626,4,2,56849,4,2,58595,15,23.6,-1.338579,36.8963038,-1.2822773,36.7953121,267,1746,12,523
10252,9409,1419,1,Personal,19,5,45194,19,5,45262,19,5,45628,19,5,46588,19,5,47671,6,24.9,-1.2728947,36.8079426,-1.285969,36.789205,857,1083,68,1326
10253,15031,2423,3,Business,16,1,53166,16,1,53206,16,1,53441,16,1,53740,16,1,55139,8,22.5,-1.2551895,36.7822034,-1.3012173,36.8093987,147,1399,40,534
10254,28266,738,3,Business,28,5,31153,28,5,31357,28,5,31622,28,5,32001,28,5,34258,6,20.8,-1.288148,36.7850276,-1.289219,36.73749771,612,2257,204,644
10255,21010,2982,3,Business,8,4,50692,8,4,50700,8,4,50737,8,4,51267,8,4,55339,22,27.5,-1.1956524,36.9488069,-1.177202,36.8351183,519,4072,8,567
10256,7478,1796,3,Business,17,3,51122,17,3,51138,17,3,51729,17,3,52679,17,3,55079,17,23.25888921888938,-1.2296618,36.8438272,-1.331619,36.847976,8,2400,16,1541
10257,2935,2691,3,Business,27,3,42906,27,3,42955,27,3,43721,27,3,44368,27,3,45542,8,23.25888921888938,-1.2857671,36.7875614,-1.2551895,36.7822034,101,1174,49,1413
10258,9763,718,3,Business,30,4,52500,30,4,52666,30,4,55009,30,4,55330,30,4,58498,7,23.25888921888938,-1.2551895,36.7822034,-1.2989934,36.8136694,106,3168,166,2664
10259,18433,2159,3,Business,18,4,33849,18,4,33909,18,4,34215,18,4,34457,18,4,35755,8,20.5,-1.304735,36.7846054,-1.2557779,36.7879648,612,1298,60,548
10260,12433,873,1,Personal,26,3,44001,26,3,44016,26,3,44831,26,3,45483,26,3,47064,8,24.0,-1.3308747,36.8567485,-1.2872899,36.820434,698,1581,15,1467
10261,5982,2956,3,Business,11,4,53842,11,4,53855,11,4,53940,11,4,55711,11,4,55713,2,27.0,-1.2527958,36.8003131,-1.2584143,36.8048002,547,2,13,1856
10262,3820,184,1,Personal,4,1,42329,4,1,42523,4,1,43639,4,1,43970,4,1,45334,8,21.2,-1.2821577,36.8220574,-1.3237599,36.8052613,906,1364,194,1447
10263,711,157,3,Business,8,6,53973,8,6,54199,8,6,56594,8,6,56849,8,6,61220,18,23.4,-1.225322,36.80855,-1.2859912,36.8756811,697,4371,226,2650
10264,16380,3201,3,Business,4,1,47669,4,1,48853,4,1,49668,4,1,51435,4,1,52695,6,23.25888921888938,-1.290894,36.822971,-1.2584143,36.8048002,452,1260,1184,2582
10265,800,2030,3,Business,21,4,42293,21,4,42722,21,4,43656,21,4,44583,21,4,45879,1,21.6,-1.2810807,36.8144229,-1.2814452,36.8253735,88,1296,429,1861
10266,3864,1635,1,Personal,20,4,36279,20,4,36290,20,4,36623,20,4,37110,20,4,38614,8,17.9,-1.2652809,36.8080659,-1.3207146,36.8305771,726,1504,11,820
10267,23088,2383,3,Business,21,3,31283,21,3,40001,21,3,40846,21,3,40999,21,3,42678,6,22.2,-1.2608993,36.799246,-1.292044,36.821938,102,1679,8718,998
10268,2685,265,3,Business,1,5,54821,1,5,54855,1,5,55383,1,5,56418,1,5,59238,17,28.3,-1.300921,36.828195,-1.2266484,36.8772086,882,2820,34,1563
10269,8337,1925,2,Personal,8,2,54708,8,2,54730,8,2,54746,8,2,56117,8,2,56565,7,23.3,-1.2859912,36.8756811,-1.2860183,36.8975338,408,448,22,1387
10270,27,577,1,Personal,26,3,45295,26,3,45364,26,3,46063,26,3,46528,26,3,50001,11,24.0,-1.2662728,36.8151265,-1.3270347,36.8667362,50,3473,69,1164
10271,403,2701,3,Business,21,3,34660,21,3,34898,21,3,35534,21,3,35600,21,3,37118,6,16.8,-1.2765736,36.8513646,-1.2885315,36.8230419,878,1518,238,702
10272,18165,3615,1,Personal,5,3,51936,5,3,52009,5,3,53362,5,3,53612,5,3,54469,10,23.6,-1.266362,36.796939,-1.2896693,36.8412299,86,857,73,1603
10273,195,1471,3,Business,17,3,55333,17,3,55361,17,3,55596,17,3,56605,17,3,58180,8,23.25888921888938,-1.2551895,36.7822034,-1.3037387,36.8175661,709,1575,28,1244
10274,16422,3017,3,Business,31,4,74229,31,4,74248,31,4,74644,31,4,74871,31,4,76911,11,18.2,-1.299313,36.7831488,-1.2664227,36.7453671,116,2040,19,623
10275,26646,2216,3,Business,21,3,52116,21,3,52603,21,3,53010,21,3,53406,21,3,56119,8,23.3,-1.2551895,36.7822034,-1.2965924,36.8179314,948,2713,487,803
10276,12962,533,3,Business,30,2,45749,30,2,45812,30,2,45817,30,2,46725,30,2,47485,6,22.5,-1.2551895,36.7822034,-1.2765492,36.7669809,731,760,63,913
10277,7793,2330,3,Business,31,5,46940,31,5,47609,31,5,50395,31,5,50482,31,5,53668,23,24.6,-1.3798085,36.9290528,-1.2642903,36.8002137,233,3186,669,2873
10278,25156,1195,3,Business,21,2,38928,21,2,40015,21,2,40823,21,2,41950,21,2,43381,15,22.4,-1.2991441,36.7528804,-1.3228003,36.8306435,628,1431,1087,1935
10279,20213,2740,3,Personal,15,2,38255,15,2,38330,15,2,38713,15,2,39129,15,2,40141,7,24.3,-1.3127304,36.8189817,-1.2944292,36.7793569,237,1012,75,799
10280,17229,2685,1,Personal,15,1,51650,15,1,51678,15,1,51833,15,1,52067,15,1,53201,11,23.25888921888938,-1.2899,36.7794355,-1.3181152,36.7095457,409,1134,28,389
10281,23330,393,3,Business,22,5,27995,22,5,28049,22,5,28745,22,5,29225,22,5,29862,4,22.0,-1.3167113,36.8301563,-1.3004062,36.829741,910,637,54,1176
10282,28195,2974,3,Business,11,2,33177,11,2,33264,11,2,35254,11,2,35420,11,2,36898,13,16.1,-1.287428,36.7800821,-1.3227037,36.8470872,671,1478,87,2156
10283,15846,60,3,Business,24,1,39079,24,1,39103,24,1,39822,24,1,40475,24,1,41292,8,22.6,-1.272828,36.816608,-1.2296618,36.8438272,427,817,24,1372
10284,24260,1205,3,Business,1,4,38412,1,4,38421,1,4,38644,1,4,38863,1,4,41081,8,23.25888921888938,-1.257309,36.8060084,-1.2839651,36.7891704,726,2218,9,442
10285,22859,393,3,Business,29,1,45926,29,1,45934,29,1,46001,29,1,46941,29,1,50312,14,23.25888921888938,-1.3177547,36.8303703,-1.306378,36.7519845,731,3371,8,1007
10286,19332,431,1,Personal,30,1,40385,30,1,40389,30,1,41710,30,1,41913,30,1,43239,8,22.6,-1.2733186,36.8266338,-1.3108368,36.8226308,229,1326,4,1524
10287,688,2207,3,Business,18,4,51766,18,4,51828,18,4,51877,18,4,52733,18,4,53167,2,27.0,-1.2704656,36.7948766,-1.2768326,36.8073804,881,434,62,905
10288,24090,552,3,Business,20,3,63117,20,3,63125,20,3,63322,20,3,63692,20,3,66803,21,27.4,-1.2571472,36.7950633,-1.335477,36.9308297,778,3111,8,567
10289,21223,1341,3,Business,23,6,38695,23,6,38738,23,6,40474,23,6,40572,23,6,41809,12,23.25888921888938,-1.293515,36.897607,-1.331619,36.847976,691,1237,43,1834
10290,3624,2112,3,Business,17,1,51365,17,1,51644,17,1,51946,17,1,52329,17,1,55036,21,24.7,-1.2156006,36.8916865,-1.2795549,36.7627011,387,2707,279,685
10291,19676,111,3,Business,6,5,44421,6,5,44431,6,5,44666,6,5,45118,6,5,49272,22,20.1,-1.2551895,36.7822034,-1.333148,36.922453,192,4154,10,687
10292,17405,1316,1,Business,7,2,34723,7,2,34811,7,2,35266,7,2,35532,7,2,37184,14,16.6,-1.2551895,36.7822034,-1.3332749,36.8708147,726,1652,88,721
10293,440,1469,3,Business,5,2,55401,5,2,55582,5,2,56905,5,2,57795,5,2,58453,4,27.5,-1.2551895,36.7822034,-1.2738522,36.7992818,607,658,181,2213
10294,11251,2701,3,Business,4,2,39643,4,2,40680,4,2,42301,4,2,42568,4,2,43566,6,20.4,-1.279395,36.825364,-1.2765736,36.8513646,158,998,1037,1888
10295,15573,2587,3,Business,5,3,56553,5,3,56575,5,3,57227,5,3,57768,5,3,59150,13,24.0,-1.28878,36.8168312,-1.225322,36.80855,449,1382,22,1193
10296,13144,346,3,Business,17,5,56613,17,5,56655,17,5,58371,17,5,58660,17,5,60401,12,23.25888921888938,-1.28878,36.8168312,-1.3472066,36.7692638,815,1741,42,2005
10297,19858,1945,2,Personal,2,6,47919,2,6,47954,2,6,48562,2,6,48875,2,6,49972,10,23.9,-1.2568739,36.8179321,-1.289469,36.765738,116,1097,35,921
10298,2730,3309,3,Personal,6,5,51423,6,5,51533,6,5,52299,6,5,53293,6,5,54649,9,22.7,-1.255149,36.805748,-1.2995135,36.7933633,103,1356,110,1760
10299,6176,3517,3,Business,21,2,51103,21,2,51122,21,2,51732,21,2,54450,21,2,55166,16,25.1,-1.300921,36.828195,-1.3882008,36.7699445,137,716,19,3328
10300,7118,265,3,Business,25,2,55560,25,2,55565,25,2,55569,25,2,57815,25,2,58396,13,27.0,-1.3321944,36.8892329,-1.300921,36.828195,874,581,5,2250
10301,16256,53,3,Business,6,3,58191,6,3,58833,6,3,59340,6,3,59455,6,3,60253,5,23.25888921888938,-1.3004062,36.829741,-1.2770708,36.8231093,728,798,642,622
10302,7528,3645,1,Personal,19,5,51638,19,5,51715,19,5,54280,19,5,54373,19,5,55902,10,27.2,-1.2849335,36.8022752,-1.2428734,36.8464149,72,1529,77,2658
10303,23628,661,3,Business,27,4,52092,27,4,52111,27,4,53275,27,4,53664,27,4,55006,11,25.2,-1.3102769,36.850293,-1.2963097,36.7688221,932,1342,19,1553
10304,14891,393,3,Business,7,5,30991,7,5,31191,7,5,32685,7,5,34300,7,5,38902,8,23.25888921888938,-1.3228003,36.8306435,-1.2770708,36.8231093,271,4602,200,3109
10305,22281,1620,1,Personal,9,2,58034,9,2,58228,9,2,63657,9,2,63901,9,2,66615,13,19.2,-1.227132,36.8374277,-1.300921,36.828195,427,2714,194,5673
10306,20657,3647,3,Business,30,2,43779,30,2,43804,30,2,45907,30,2,45991,30,2,50157,26,22.1,-1.272639,36.794723,-1.2790133,36.963059,578,4166,25,2187
10307,22677,3647,3,Business,11,5,32353,11,5,32394,11,5,32789,11,5,33390,11,5,34646,5,21.1,-1.2962618,36.7929334,-1.272639,36.794723,862,1256,41,996
10308,12153,496,3,Business,25,4,56519,25,4,56532,25,4,57004,25,4,57423,25,4,60672,23,23.25888921888938,-1.2551895,36.7822034,-1.374163,36.913444,72,3249,13,891
10309,22775,1271,3,Business,21,4,45419,21,4,45439,21,4,45452,21,4,47693,21,4,48194,7,27.8,-1.3263105,36.8622904,-1.3244885,36.897792,746,501,20,2254
10310,17753,627,3,Business,25,4,55947,25,4,55970,25,4,56004,25,4,60176,25,4,60264,18,23.25888921888938,-1.2571472,36.7950633,-1.3339943,36.7263409,613,88,23,4206
10311,17188,1941,3,Personal,6,3,48352,6,3,49396,6,3,49630,6,3,50481,6,3,51111,5,21.9,-1.2776072,36.8227604,-1.2762384,36.7929522,116,630,1044,1085
10312,34,426,3,Business,30,2,50673,30,2,50723,30,2,51969,30,2,52576,30,2,53701,5,27.5,-1.3323107,36.8692616,-1.3048663,36.8535754,276,1125,50,1853
10313,19523,1687,3,Business,21,3,37903,21,3,37920,21,3,38509,21,3,38944,21,3,41047,13,22.0,-1.3169591,36.7000029,-1.2962832,36.7849683,247,2103,17,1024
10314,16926,570,3,Business,17,4,36976,17,4,37008,17,4,37878,17,4,38016,17,4,38821,6,25.5,-1.2551895,36.7822034,-1.284382,36.7746045,50,805,32,1008
10315,14421,2002,3,Personal,10,4,44301,10,4,44342,10,4,45546,10,4,45947,10,4,47130,12,23.25888921888938,-1.276154,36.8224165,-1.2101737,36.8706616,100,1183,41,1605
10316,5472,954,1,Personal,4,4,38178,4,4,38209,4,4,38599,4,4,39427,4,4,41963,18,23.25888921888938,-1.2763087,36.8170342,-1.3123394,36.907962,101,2536,31,1218
10317,20245,1271,3,Business,9,2,56226,9,2,56277,9,2,57904,9,2,58702,9,2,60204,16,30.4,-1.3244885,36.897792,-1.2896431,36.8086201,770,1502,51,2425
10318,4710,2545,2,Personal,10,4,33981,10,4,34072,10,4,34295,10,4,35834,10,4,36821,6,18.4,-1.2797184,36.7811448,-1.2573403,36.8060742,379,987,91,1762
10319,7950,2169,2,Personal,6,5,32332,6,5,32933,6,5,33667,6,5,34307,6,5,35596,8,15.1,-1.2857764,36.8236622,-1.311208,36.778743,808,1289,601,1374
10320,6250,816,3,Business,31,4,43383,31,4,43455,31,4,44858,31,4,48460,31,4,49698,7,26.3,-1.3104159,36.8657803,-1.290894,36.822971,88,1238,72,5005
10321,21877,291,1,Personal,7,6,41847,7,6,41982,7,6,42507,7,6,43823,7,6,44844,6,19.0,-1.255683,36.813771,-1.2920972,36.8102988,808,1021,135,1841
10322,15495,3091,3,Business,22,4,57261,22,4,57487,22,4,57798,22,4,58374,22,4,59966,9,26.6,-1.2584143,36.8048002,-1.3012008,36.764868,685,1592,226,887
10323,23269,1585,1,Business,14,5,68796,14,5,68808,14,5,68812,14,5,69208,14,5,73023,3,22.0,-1.2963097,36.7688221,-1.2852908,36.7557439,813,3815,12,400
10324,9858,1515,1,Personal,15,2,32445,15,2,32493,15,2,33536,15,2,33784,15,2,35444,12,17.9,-1.2934527,36.7755139,-1.3255286,36.7835132,202,1660,48,1291
10325,17451,432,3,Business,2,4,44162,2,4,44464,2,4,45169,2,4,45349,2,4,46607,9,23.25888921888938,-1.3012008,36.764868,-1.2813012,36.8323962,250,1258,302,885
10326,19024,2066,3,Business,22,5,42129,22,5,42142,22,5,42940,22,5,43194,22,5,44681,9,23.25888921888938,-1.3210189,36.8410551,-1.3044764,36.8843623,25,1487,13,1052
10327,4100,2143,3,Business,6,5,38895,6,5,38970,6,5,39483,6,5,40234,6,5,41505,9,20.3,-1.296797,36.7764525,-1.3147848,36.8332072,844,1271,75,1264
10328,3882,186,3,Business,5,5,59710,5,5,59772,5,5,60678,5,5,61211,5,5,61807,4,26.4,-1.2571472,36.7950633,-1.2825816,36.8092346,205,596,62,1439
10329,2281,1976,3,Business,9,5,45967,9,5,46195,9,5,46697,9,5,46779,9,5,47955,9,25.5,-1.257028,36.7810435,-1.2544761,36.8198826,675,1176,228,584
10330,955,1482,3,Business,7,5,40294,7,5,40339,7,5,40432,7,5,41113,7,5,42524,10,25.0,-1.29666,36.828668,-1.338579,36.8963038,519,1411,45,774
10331,18178,3525,3,Business,7,4,28786,7,4,31795,7,4,34369,7,4,34439,7,4,35417,13,23.25888921888938,-1.3700383,36.9190174,-1.3239488,36.8316835,863,978,3009,2644
10332,2821,650,1,Personal,5,4,47675,5,4,47776,5,4,49097,5,4,50807,5,4,51821,5,22.1,-1.297171,36.783278,-1.271337,36.786712,844,1014,101,3031
10333,2833,972,3,Business,23,3,45330,23,3,45798,23,3,46335,23,3,46764,23,3,49246,16,22.0,-1.2862033,36.8152966,-1.332624,36.913187,888,2482,468,966
10334,5620,2042,3,Business,26,1,55731,26,1,56585,26,1,57873,26,1,58555,26,1,59956,13,22.3,-1.2860183,36.8975338,-1.3189252,36.8617269,539,1401,854,1970
10335,7575,3283,3,Business,18,1,45205,18,1,45354,18,1,48064,18,1,48765,18,1,51323,13,30.9,-1.331619,36.847976,-1.2628473,36.781805,311,2558,149,3411
10336,5892,3326,3,Business,12,2,59690,12,2,60238,12,2,60674,12,2,61616,12,2,64684,8,21.1,-1.2579304,36.8019667,-1.3090727,36.8315262,820,3068,548,1378
10337,8485,627,3,Business,12,3,36107,12,3,36131,12,3,36137,12,3,36861,12,3,37970,10,23.25888921888938,-1.2551895,36.7822034,-1.3131471,36.8176568,619,1109,24,730
10338,7966,361,1,Personal,11,3,41201,11,3,41233,11,3,41536,11,3,41792,11,3,42493,5,18.9,-1.2709086,36.7929516,-1.2817084,36.8143646,812,701,32,559
10339,19690,2956,3,Business,11,2,49131,11,2,49160,11,2,49765,11,2,50100,11,2,50225,2,22.1,-1.2527958,36.8003131,-1.2584143,36.8048002,575,125,29,940
10340,26797,3054,3,Personal,7,4,33123,7,4,33618,7,4,34733,7,4,35260,7,4,36169,6,23.25888921888938,-1.2546732,36.7923244,-1.2934657,36.8212737,378,909,495,1642
10341,19015,2271,3,Business,5,6,50759,5,6,50766,5,6,51011,5,6,51704,5,6,54133,18,22.0,-1.2560184,36.7934342,-1.293515,36.897607,195,2429,7,938
10342,24943,396,3,Personal,5,4,51105,5,4,51121,5,4,52124,5,4,52338,5,4,52993,3,22.0,-1.2883946,36.7728469,-1.2857671,36.7875614,449,655,16,1217
10343,13881,1921,1,Personal,13,6,44516,13,6,44587,13,6,46219,13,6,46389,13,6,47831,6,25.2,-1.2728947,36.8079426,-1.2968658,36.7776584,393,1442,71,1802
10344,17031,419,3,Business,7,2,51953,7,2,51990,7,2,52199,7,2,53037,7,2,55078,20,23.25888921888938,-1.2571472,36.7950633,-1.3700383,36.9190174,233,2041,37,1047
10345,3556,2206,3,Business,4,2,39274,4,2,39326,4,2,41345,4,2,41490,4,2,43466,3,20.6,-1.2615888,36.7928732,-1.2697893,36.8124106,259,1976,52,2164
10346,5227,2330,3,Business,23,4,56852,23,4,56870,23,4,56981,23,4,57077,23,4,57437,4,20.7,-1.3040812,36.7924217,-1.2868601,36.7738025,207,360,18,207
10347,9648,776,1,Personal,1,7,36262,1,7,37812,1,7,37829,1,7,40071,1,7,43875,11,20.3,-1.278967,36.8236745,-1.2711571,36.9017288,805,3804,1550,2259
10348,6506,1162,3,Business,19,2,33462,19,2,33498,19,2,34544,19,2,34626,19,2,35977,8,23.25888921888938,-1.312261,36.794658,-1.2733047,36.8109744,548,1351,36,1128
10349,27976,811,3,Personal,10,5,63169,10,5,63316,10,5,64039,10,5,64567,10,5,64903,2,23.25888921888938,-1.2980229,36.78865,-1.2963097,36.7688221,692,336,147,1251
10350,12266,2789,3,Business,3,1,45059,3,1,46940,3,1,48439,3,1,50227,3,1,52775,6,23.4,-1.2890399,36.8164942,-1.304735,36.7846054,783,2548,1881,3287
10351,4846,393,3,Business,15,5,55119,15,5,55401,15,5,55406,15,5,57239,15,5,57242,5,28.2,-1.3167113,36.8301563,-1.3077869,36.8443207,188,3,282,1838
10352,20479,3688,3,Business,30,3,37578,30,3,37780,30,3,38220,30,3,38543,30,3,39714,8,25.1,-1.2551895,36.7822034,-1.3038156,36.8122733,205,1171,202,763
10353,10456,246,3,Business,8,2,61252,8,2,61269,8,2,62083,8,2,62443,8,2,62880,2,23.6,-1.2527958,36.8003131,-1.2584143,36.8048002,566,437,17,1174
10354,6559,1245,3,Business,3,3,53945,3,3,53965,3,3,54977,3,3,55382,3,3,59519,19,28.2,-1.300921,36.828195,-1.3198615,36.7110323,923,4137,20,1417
10355,8326,3545,1,Personal,9,1,36178,9,1,36204,9,1,38619,9,1,38928,9,1,40277,12,20.1,-1.2912668,36.7656703,-1.3502295,36.7242597,598,1349,26,2724
10356,24628,173,3,Business,12,3,50170,12,3,50280,12,3,51139,12,3,51574,12,3,52879,11,25.8,-1.2993231,36.7753372,-1.2545163,36.8243717,404,1305,110,1294
10357,27306,3283,3,Business,29,2,39259,29,2,39291,29,2,40271,29,2,40781,29,2,42062,13,23.5,-1.2296618,36.8438272,-1.2628473,36.781805,691,1281,32,1490
10358,20000,3647,3,Business,11,1,54471,11,1,54539,11,1,54601,11,1,55606,11,1,56282,3,28.1,-1.272639,36.794723,-1.2674482,36.8076994,26,676,68,1067
10359,24774,190,3,Business,29,1,55802,29,1,56122,29,1,57823,29,1,57919,29,1,58782,6,23.25888921888938,-1.3275885,36.8621552,-1.3270347,36.8667362,211,863,320,1797
10360,1770,136,3,Business,9,1,61556,9,1,61598,9,1,62390,9,1,62494,9,1,64152,7,20.4,-1.2649605,36.7981777,-1.2943272,36.7667198,434,1658,42,896
10361,12796,1226,2,Personal,31,2,35531,31,2,35606,31,2,36641,31,2,37067,31,2,37894,9,17.0,-1.3291184,36.7892374,-1.2981625,36.8130142,857,827,75,1461
10362,5272,3064,3,Business,8,5,52989,8,5,54430,8,5,55146,8,5,55295,8,5,59705,12,30.2,-1.2571472,36.7950633,-1.2404912,36.8847788,305,4410,1441,865
10363,20126,3487,3,Business,18,4,64541,18,4,64559,18,4,65521,18,4,65673,18,4,67944,12,23.25888921888938,-1.279395,36.825364,-1.2232123,36.8932547,119,2271,18,1114
10364,3161,2521,3,Business,29,6,35877,29,6,35886,29,6,35889,29,6,36158,29,6,36304,4,19.3,-1.3167113,36.8301563,-1.3004062,36.829741,10,146,9,272
10365,24989,1148,3,Business,3,3,53835,3,3,53856,3,3,54771,3,3,55166,3,3,57398,12,28.0,-1.3100586,36.8500329,-1.25537,36.7756,519,2232,21,1310
10366,19922,357,3,Business,8,3,47558,8,3,47590,8,3,48471,8,3,48761,8,3,49336,2,23.25888921888938,-1.295319,36.760178,-1.2945179,36.7685349,269,575,32,1171
10367,603,2718,3,Business,18,4,43232,18,4,43360,18,4,43829,18,4,44255,18,4,45739,4,25.4,-1.2668815,36.8017244,-1.2904753,36.8144721,299,1484,128,895
10368,9360,3647,3,Business,16,4,54270,16,4,54432,16,4,55740,16,4,56058,16,4,56810,4,23.25888921888938,-1.272639,36.794723,-1.2615983,36.8083096,930,752,162,1626
10369,4645,3647,3,Business,11,1,50684,11,1,50723,11,1,51054,11,1,53790,11,1,53794,19,27.8,-1.272639,36.794723,-1.3443917,36.6700333,818,4,39,3067
10370,11141,20,3,Business,30,4,37414,30,4,37442,30,4,37716,30,4,37802,30,4,38771,7,19.5,-1.2680478,36.8013518,-1.2909699,36.7826542,96,969,28,360
10371,27524,2587,3,Business,21,1,50024,21,1,50043,21,1,51387,21,1,51997,21,1,53459,15,21.8,-1.2151769,36.8846524,-1.225322,36.80855,397,1462,19,1954
10372,21419,2041,3,Business,28,1,57746,28,1,59210,28,1,60081,28,1,61017,28,1,62729,13,25.2,-1.290894,36.822971,-1.3285517,36.9018,540,1712,1464,1807
10373,7418,147,3,Personal,14,5,46263,14,5,46816,14,5,50881,14,5,51574,14,5,54404,18,23.6,-1.311208,36.778743,-1.2222487,36.8081423,457,2830,553,4758
10374,10966,1500,3,Business,8,2,48908,8,2,49055,8,2,50116,8,2,50372,8,2,51545,11,25.3,-1.3077869,36.8443207,-1.2574219,36.7927073,576,1173,147,1317
10375,7911,393,3,Business,27,1,31122,27,1,31154,27,1,31157,27,1,32569,27,1,33147,4,17.9,-1.3228003,36.8306435,-1.3004062,36.829741,206,578,32,1415
10376,6232,2523,3,Business,17,5,48712,17,5,48846,17,5,49239,17,5,50221,17,5,50901,4,23.25888921888938,-1.2551895,36.7822034,-1.2754343,36.8127158,147,680,134,1375
10377,7989,517,3,Business,29,4,41082,29,4,42468,29,4,42932,29,4,43323,29,4,47290,14,21.4,-1.3177547,36.8303703,-1.306378,36.7519845,523,3967,1386,855
10378,8368,1304,3,Business,11,5,60093,11,5,60377,11,5,60955,11,5,61076,11,5,63498,14,24.2,-1.2859912,36.8756811,-1.2933017,36.8008304,26,2422,284,699
10379,8079,1244,3,Business,7,4,53423,7,4,53447,7,4,53956,7,4,54359,7,4,56163,11,31.3,-1.331619,36.847976,-1.303596,36.778378,332,1804,24,912
10380,6832,2132,3,Business,23,5,38368,23,5,39953,23,5,42055,23,5,42866,23,5,46492,9,24.1,-1.2384056,36.8718698,-1.2879314,36.8418388,660,3626,1585,2913
10381,12362,1831,3,Business,13,1,34675,13,1,34696,13,1,35548,13,1,39106,13,1,39578,21,23.25888921888938,-1.3562374,36.9042954,-1.2551895,36.7822034,863,472,21,4410
10382,27770,1179,3,Business,6,4,51425,6,4,51956,6,4,54517,6,4,56002,6,4,58444,21,23.25888921888938,-1.3700383,36.9190174,-1.2917868,36.7872675,569,2442,531,4046
10383,22297,2801,3,Business,13,4,34618,13,4,34634,13,4,34681,13,4,35511,13,4,36729,17,18.5,-1.307726,36.839117,-1.3483945,36.9074283,205,1218,16,877
10384,17942,2330,3,Business,31,5,39144,31,5,39219,31,5,39741,31,5,39808,31,5,40823,8,21.8,-1.294597,36.7742999,-1.2645318,36.7981775,176,1015,75,589
10385,18364,1609,3,Business,7,1,45350,7,1,45516,7,1,46165,7,1,46964,7,1,48389,5,21.4,-1.32589,36.831679,-1.3205164,36.8098882,543,1425,166,1448
10386,9039,1033,3,Personal,26,2,47896,26,2,47933,26,2,47936,26,2,48494,26,2,49829,15,26.0,-1.2227615,36.8989174,-1.263194,36.797624,345,1335,37,561
10387,7844,1304,3,Business,24,3,47104,24,3,47124,24,3,47567,24,3,47914,24,3,49600,16,19.9,-1.3332749,36.8708147,-1.2564152,36.7792803,620,1686,20,790
10388,22392,1868,3,Business,3,1,39914,3,1,39952,3,1,40141,3,1,40338,3,1,41218,6,21.4,-1.2752846,36.8027022,-1.2817325,36.7681541,564,880,38,386
10389,7051,60,3,Business,4,6,37761,4,6,37770,4,6,38131,4,6,38693,4,6,39334,8,19.8,-1.272828,36.816608,-1.2296618,36.8438272,857,641,9,923
10390,1868,1502,3,Business,22,3,54442,22,3,57021,22,3,58190,22,3,59245,22,3,61396,12,24.3,-1.279395,36.825364,-1.2232123,36.8932547,410,2151,2579,2224
10391,18277,3641,3,Business,13,4,38615,13,4,46647,13,4,47128,13,4,49378,13,4,50335,7,22.5,-1.2551895,36.7822034,-1.2905079,36.8222229,320,957,8032,2731
10392,24672,2987,3,Business,25,4,57184,25,4,57203,25,4,57382,25,4,57639,25,4,61463,12,20.6,-1.270212,36.8210877,-1.2156006,36.8916865,698,3824,19,436
10393,22097,928,3,Business,27,1,32662,27,1,32712,27,1,33385,27,1,33855,27,1,34712,10,18.1,-1.305011,36.8038538,-1.2551895,36.7822034,438,857,50,1143
10394,19324,393,3,Business,30,2,38515,30,2,38586,30,2,39206,30,2,40208,30,2,41829,8,23.25888921888938,-1.3167113,36.8301563,-1.2770708,36.8231093,843,1621,71,1622
10395,7414,970,3,Business,16,4,29296,16,4,29349,16,4,30902,16,4,31274,16,4,32274,6,23.25888921888938,-1.2551895,36.7822034,-1.2897368,36.8226783,155,1000,53,1925
10396,3885,186,3,Business,26,5,55633,26,5,56095,26,5,59533,26,5,60024,26,5,61296,4,23.25888921888938,-1.2571472,36.7950633,-1.2890399,36.8164942,228,1272,462,3929
10397,17945,190,3,Business,19,2,56681,19,2,56693,19,2,56695,19,2,57775,19,2,57777,10,29.8,-1.2740837,36.8212592,-1.3270347,36.8667362,813,2,12,1082
10398,16986,1578,3,Business,25,4,58211,25,4,62111,25,4,62513,25,4,62750,25,4,63808,5,23.25888921888938,-1.28878,36.8168312,-1.2591019,36.800577,878,1058,3900,639
10399,3021,2701,3,Business,21,4,46444,21,4,46468,21,4,46480,21,4,51290,21,4,51295,5,26.4,-1.290894,36.822971,-1.2765736,36.8513646,31,5,24,4822
10400,20878,3201,3,Business,25,3,38127,25,3,38135,25,3,38568,25,3,39883,25,3,40593,7,23.25888921888938,-1.3052491,36.8223899,-1.2649605,36.7981777,951,710,8,1748
10401,873,3686,3,Business,6,2,43312,6,2,44571,6,2,44925,6,2,45203,6,2,47334,10,25.0,-1.2551895,36.7822034,-1.3156452,36.815802,31,2131,1259,632
10402,6479,246,3,Business,5,1,33373,5,1,33461,5,1,34873,5,1,35878,5,1,37573,10,18.4,-1.2584143,36.8048002,-1.2413316,36.8785525,531,1695,88,2417
10403,14193,1500,3,Business,10,1,42362,10,1,42443,10,1,44583,10,1,45483,10,1,46288,8,18.6,-1.3004062,36.829741,-1.2638185,36.7930057,161,805,81,3040
10404,3121,2412,3,Business,11,1,30019,11,1,30134,11,1,30790,11,1,31037,11,1,31826,10,14.3,-1.2873639,36.8256076,-1.2297202,36.8745508,808,789,115,903
10405,24092,3022,1,Personal,14,2,42841,14,2,42857,14,2,43211,14,2,43624,14,2,45106,10,21.4,-1.2595885,36.8088463,-1.3087372,36.8403747,592,1482,16,767
10406,5130,3355,3,Business,4,4,53659,4,4,53685,4,4,53728,4,4,54381,4,4,58655,17,24.8,-1.3052491,36.8223899,-1.3448483,36.9004081,81,4274,26,696
10407,8403,1381,2,Personal,4,5,48368,4,5,48396,4,5,49509,4,5,49737,4,5,51455,10,24.4,-1.22606,36.80039,-1.2668611,36.7956387,103,1718,28,1341
10408,20139,972,3,Business,3,1,38358,3,1,38367,3,1,38771,3,1,38910,3,1,39955,10,20.6,-1.2862033,36.8152966,-1.3241819,36.8823428,74,1045,9,543
10409,18136,2304,1,Personal,5,5,45834,5,5,45890,5,5,46704,5,5,47265,5,5,49102,11,23.7,-1.3091733,36.74081,-1.2715686,36.8023526,328,1837,56,1375
10410,11086,186,3,Business,25,1,32401,25,1,32410,25,1,32457,25,1,33601,25,1,36031,20,23.25888921888938,-1.2571472,36.7950633,-1.3700383,36.9190174,881,2430,9,1191
10411,13566,3426,3,Business,12,2,63971,12,2,64089,12,2,64717,12,2,65037,12,2,66144,2,28.3,-1.3012008,36.764868,-1.2918688,36.7603541,952,1107,118,948
10412,1991,3283,3,Business,25,1,40440,25,1,40671,25,1,43244,25,1,44522,25,1,46005,18,27.1,-1.344446,36.756597,-1.2628473,36.781805,628,1483,231,3851
10413,10349,3647,3,Business,1,5,41994,1,5,42080,1,5,42780,1,5,43214,1,5,44055,4,26.6,-1.272639,36.794723,-1.2753109,36.8130185,167,841,86,1134
10414,9425,113,1,Business,9,2,62225,9,2,65572,9,2,66098,9,2,66343,9,2,67660,7,18.8,-1.2618802,36.8068534,-1.2963097,36.7688221,674,1317,3347,771
10415,4229,1073,3,Business,3,1,56050,3,1,56136,3,1,56759,3,1,57304,3,1,58729,9,23.1,-1.2562361,36.78464038,-1.2906105,36.8053279,770,1425,86,1168
10416,17662,1057,2,Personal,30,1,49366,30,1,49440,30,1,49925,30,1,50278,30,1,51464,7,20.5,-1.2879236,36.7698152,-1.2661264,36.8030359,754,1186,74,838
10417,9131,393,3,Business,2,4,53456,2,4,53541,2,4,55169,2,4,56034,2,4,57198,4,23.25888921888938,-1.3167113,36.8301563,-1.3004062,36.829741,591,1164,85,2493
10418,7288,3017,3,Business,15,6,54436,15,6,58534,15,6,58552,15,6,59056,15,6,60205,11,26.0,-1.2993231,36.7753372,-1.2669026,36.8445273,179,1149,4098,522
10419,18715,111,3,Business,10,3,35672,10,3,35685,10,3,37665,10,3,37912,10,3,40933,23,21.7,-1.3700383,36.9190174,-1.2551895,36.7822034,488,3021,13,2227
10420,24470,478,3,Business,8,5,40729,8,5,40782,8,5,40789,8,5,41526,8,5,43578,12,28.2,-1.2551895,36.7822034,-1.318566,36.837211,523,2052,53,744
10421,8206,3203,3,Business,5,5,54568,5,5,54680,5,5,54821,5,5,56583,5,5,57387,9,26.4,-1.265715,36.823815,-1.228911,36.881876,408,804,112,1903
10422,23358,3283,3,Business,9,4,34757,9,4,34780,9,4,35465,9,4,35999,9,4,36863,5,23.25888921888938,-1.2600926,36.8088685,-1.2628473,36.781805,959,864,23,1219
10423,6558,1500,3,Business,26,2,39032,26,2,39076,26,2,40039,26,2,40353,26,2,41124,6,27.7,-1.2770708,36.8231093,-1.2638185,36.7930057,448,771,44,1277
10424,16278,1818,3,Business,21,3,44548,21,3,44611,21,3,45190,21,3,45575,21,3,47487,11,21.8,-1.304524,36.775371,-1.2551895,36.7822034,596,1912,63,964
10425,9634,950,2,Personal,11,2,34138,11,2,34537,11,2,35097,11,2,36529,11,2,37310,8,18.5,-1.2639238,36.7889646,-1.2481219,36.7530824,482,781,399,1992
10426,18673,1527,3,Business,20,1,56557,20,1,56585,20,1,56598,20,1,58874,20,1,60432,12,23.25888921888938,-1.2991441,36.7528804,-1.3004062,36.829741,871,1558,28,2289
10427,16506,867,3,Business,7,1,57402,7,1,57410,7,1,57428,7,1,57607,7,1,59272,11,26.7,-1.2991441,36.7528804,-1.2996533,36.8292629,523,1665,8,197
10428,21522,1271,3,Business,5,2,34412,5,2,38866,5,2,39740,5,2,40498,5,2,41238,6,21.4,-1.3332749,36.8708147,-1.3244885,36.897792,890,740,4454,1632
10429,7285,2789,3,Business,15,4,41444,15,4,41462,15,4,41929,15,4,42022,15,4,45517,35,24.5,-1.304735,36.7846054,-1.1192788,36.7373695,917,3495,18,560
10430,23801,2447,1,Personal,4,3,60624,4,3,60998,4,3,62309,4,3,63215,4,3,65255,15,23.25888921888938,-1.3413927,36.86289,-1.255956,36.772901,478,2040,374,2217
10431,17548,632,1,Personal,4,2,48565,4,2,48593,4,2,49105,4,2,49722,4,2,50842,6,20.4,-1.2869354,36.7708614,-1.2736095,36.8011282,231,1120,28,1129
10432,17449,2066,3,Business,4,1,48445,4,1,48465,4,1,49248,4,1,50478,4,1,51557,9,28.6,-1.3210189,36.8410551,-1.2658315,36.809049,513,1079,20,2013
10433,11967,478,3,Business,30,2,38734,30,2,38886,30,2,39371,30,2,39797,30,2,41444,3,23.25888921888938,-1.2551895,36.7822034,-1.2560455,36.7800867,690,1647,152,911
10434,9458,2454,3,Business,27,3,55183,27,3,55256,27,3,56093,27,3,56305,27,3,57204,3,29.5,-1.2993231,36.7753372,-1.2942023,36.7958179,678,899,73,1049
10435,24982,248,3,Business,13,3,57742,13,3,57785,13,3,59611,13,3,60345,13,3,62456,8,27.5,-1.304735,36.7846054,-1.254191,36.8099132,855,2111,43,2560
10436,19086,1363,3,Business,30,2,56679,30,2,56686,30,2,56864,30,2,57097,30,2,57743,5,27.5,-1.3004062,36.829741,-1.3177547,36.8303703,208,646,7,411
10437,11063,2587,3,Business,18,1,32062,18,1,32138,18,1,32811,18,1,33398,18,1,34986,8,21.9,-1.3014461,36.7661381,-1.28878,36.8168312,468,1588,76,1260
10438,10090,2767,3,Business,8,3,53303,8,3,53350,8,3,54297,8,3,54753,8,3,55885,9,25.8,-1.257773,36.795486,-1.2248308,36.8012573,116,1132,47,1403
10439,513,2109,2,Personal,4,4,29932,4,4,29954,4,4,30738,4,4,30931,4,4,32846,9,18.6,-1.2915472,36.7746964,-1.3192808,36.7121888,219,1915,22,977
10440,8060,1329,3,Business,20,3,41644,20,3,41736,20,3,42253,20,3,42632,20,3,43707,8,27.2,-1.273056,36.811298,-1.248365,36.7530645,484,1075,92,896
10441,6617,1245,3,Business,1,5,31654,1,5,32133,1,5,32790,1,5,34042,1,5,35884,14,23.25888921888938,-1.300921,36.828195,-1.3616286,36.7452212,416,1842,479,1909
10442,2202,3149,3,Business,20,1,51543,20,1,51572,20,1,52530,20,1,53213,20,1,54105,5,23.25888921888938,-1.3004062,36.829741,-1.3167113,36.8301563,206,892,29,1641
10443,10137,3291,3,Business,5,2,30116,5,2,30128,5,2,32588,5,2,33709,5,2,36556,12,18.2,-1.331619,36.847976,-1.2600926,36.8088685,332,2847,12,3581
10444,7828,3491,3,Business,25,4,43687,25,4,43695,25,4,44497,25,4,45230,25,4,49782,24,19.8,-1.3700383,36.9190174,-1.2297202,36.8819507,222,4552,8,1535
10445,8131,2523,3,Business,11,5,40174,11,5,40231,11,5,40493,11,5,40896,11,5,43756,15,21.1,-1.2551895,36.7822034,-1.2343236,36.8861,105,2860,57,665
10446,15271,2601,3,Personal,14,4,46486,14,4,46893,14,4,47726,14,4,47913,14,4,49117,12,23.6,-1.2852609,36.8313394,-1.2927792,36.9053492,483,1204,407,1020
10447,21932,269,3,Business,25,4,33259,25,4,34580,25,4,34922,25,4,35449,25,4,37960,23,16.6,-1.3169591,36.7000029,-1.3332749,36.8708147,905,2511,1321,869
10448,24253,3136,1,Personal,28,4,33376,28,4,33431,28,4,33813,28,4,34348,28,4,34834,4,23.25888921888938,-1.2696183,36.8021778,-1.264788,36.7883897,116,486,55,917
10449,26219,3326,3,Business,25,5,52028,25,5,52117,25,5,52941,25,5,54768,25,5,54926,8,29.3,-1.2571472,36.7950633,-1.3090727,36.8315262,436,158,89,2651
10450,27326,20,3,Business,29,1,46427,29,1,46443,29,1,47515,29,1,48390,29,1,49507,13,23.25888921888938,-1.2616841,36.801999,-1.3343129,36.8637112,72,1117,16,1947
10451,20887,3621,3,Business,13,6,41353,13,6,41642,13,6,42393,13,6,42653,13,6,43432,5,26.0,-1.2836583,36.7886014,-1.2870081,36.8184742,404,779,289,1011
10452,18844,3557,3,Business,13,3,31495,13,3,31579,13,3,31993,13,3,32811,13,3,34010,6,20.2,-1.2729758,36.8284446,-1.2546732,36.8086796,697,1199,84,1232
10453,17375,2482,2,Personal,5,5,33789,5,5,33916,5,5,34483,5,5,34925,5,5,37241,5,17.7,-1.2661264,36.8030359,-1.2956951,36.8129242,731,2316,127,1009
10454,24063,867,3,Business,11,1,50966,11,1,51586,11,1,52124,11,1,52686,11,1,54095,11,28.7,-1.2991441,36.7528804,-1.2760462,36.8074697,85,1409,620,1100
10455,12101,1304,3,Business,5,5,43950,5,5,44042,5,5,45179,5,5,45330,5,5,48274,7,23.7,-1.2551895,36.7822034,-1.2896399,36.8124498,279,2944,92,1288
10456,26817,3283,3,Business,19,6,55164,19,6,55196,19,6,55534,19,6,56023,19,6,56591,5,24.4,-1.2600926,36.8088685,-1.2628473,36.781805,51,568,32,827
10457,4209,302,3,Business,13,7,50608,13,7,52612,13,7,52987,13,7,53619,13,7,56382,10,24.6,-1.3039695,36.7838267,-1.2649605,36.7981777,541,2763,2004,1007
10458,19402,3264,3,Business,3,5,51823,3,5,51966,3,5,52688,3,5,52869,3,5,54201,3,23.25888921888938,-1.2551895,36.7822034,-1.2594539,36.8067841,322,1332,143,903
10459,9413,3689,3,Business,29,6,43736,29,6,43755,29,6,44145,29,6,44609,29,6,45301,1,24.0,-1.2584143,36.8048002,-1.2527958,36.8003131,477,692,19,854
10460,12567,2956,3,Business,9,4,31676,9,4,31722,9,4,32164,9,4,33282,9,4,34418,2,23.25888921888938,-1.2551895,36.7822034,-1.2584143,36.8048002,720,1136,46,1560
10461,14245,1796,3,Business,15,5,36185,15,5,36201,15,5,36375,15,5,37227,15,5,39046,11,19.4,-1.265715,36.823815,-1.331619,36.847976,63,1819,16,1026
10462,7505,1500,3,Business,5,5,33758,5,5,33771,5,5,33921,5,5,35121,5,5,35966,8,19.7,-1.3004062,36.829741,-1.2638185,36.7930057,206,845,13,1350
10463,6827,3239,3,Personal,22,2,38008,22,2,38042,22,2,40176,22,2,40768,22,2,42392,14,19.3,-1.2839322,36.8292426,-1.3116423,36.9008384,248,1624,34,2726
10464,26283,2763,3,Business,14,2,35644,14,2,35665,14,2,35681,14,2,36087,14,2,37783,12,23.25888921888938,-1.2551895,36.7822034,-1.3200694,36.7931306,99,1696,21,422
10465,19152,3291,3,Business,30,2,34770,30,2,34786,30,2,37250,30,2,39074,30,2,40593,12,23.25888921888938,-1.318062,36.849326,-1.2600926,36.8088685,68,1519,16,4288
10466,16037,2423,3,Business,2,2,56618,2,2,56701,2,2,56988,2,2,57153,2,2,60037,8,26.4,-1.2551895,36.7822034,-1.303664,36.818777,131,2884,83,452
10467,14503,3547,3,Business,6,3,35538,6,3,35558,6,3,35683,6,3,36561,6,3,37746,7,16.9,-1.2760915,36.8081029,-1.2761408,36.7710839,247,1185,20,1003
10468,2719,571,3,Business,2,2,65575,2,2,68135,2,2,69471,2,2,71361,2,2,75529,27,23.4,-1.3236332,36.701152,-1.2911179,36.8893013,831,4168,2560,3226
10469,7445,2344,3,Business,14,1,43867,14,1,43969,14,1,46625,14,1,46714,14,1,48379,8,23.4,-1.2551895,36.7822034,-1.291282,36.798229,817,1665,102,2745
10470,14359,1754,3,Business,26,5,50539,26,5,54835,26,5,55733,26,5,56385,26,5,58111,12,23.25888921888938,-1.3226302,36.8719901,-1.2860183,36.8975338,890,1726,4296,1550
10471,18702,393,3,Business,20,3,36824,20,3,36924,20,3,37842,20,3,38223,20,3,40102,8,26.3,-1.3167113,36.8301563,-1.2770708,36.8231093,448,1879,100,1299
10472,10801,2200,3,Business,6,4,44797,6,4,49708,6,4,50584,6,4,50752,6,4,52310,12,23.25888921888938,-1.225322,36.80855,-1.290894,36.822971,404,1558,4911,1044
10473,13185,3517,3,Business,21,4,52830,21,4,52843,21,4,53305,21,4,53841,21,4,55533,15,31.2,-1.300921,36.828195,-1.3882008,36.7699445,362,1692,13,998
10474,16841,3426,3,Business,26,5,48653,26,5,49115,26,5,50066,26,5,51013,26,5,53579,9,23.25888921888938,-1.2615888,36.7928732,-1.3014461,36.7661381,548,2566,462,1898
10475,4014,776,1,Personal,14,1,41260,14,1,43386,14,1,43527,14,1,44754,14,1,48425,4,22.8,-1.278967,36.8236745,-1.2753757,36.8026592,100,3671,2126,1368
10476,15815,2559,3,Personal,20,4,63248,20,4,63304,20,4,64609,20,4,64997,20,4,69201,18,22.8,-1.3008819,36.7612515,-1.2125712,36.7964151,862,4204,56,1693
10477,21600,3175,3,Business,5,4,52161,5,4,52191,5,4,52232,5,4,53284,5,4,53295,2,22.1,-1.2681004,36.7952081,-1.2575407,36.7868197,51,11,30,1093
10478,11023,53,3,Business,30,3,56920,30,3,56946,30,3,57136,30,3,57507,30,3,58890,5,28.9,-1.3004062,36.829741,-1.2770708,36.8231093,518,1383,26,561
10479,12631,393,3,Business,31,3,36987,31,3,39156,31,3,39214,31,3,40482,31,3,41783,10,24.6,-1.3177547,36.8303703,-1.2574219,36.7927073,39,1301,2169,1326
10480,6631,1568,3,Business,25,5,36897,25,5,36921,25,5,37516,25,5,37880,25,5,39911,17,17.1,-1.2897368,36.8226783,-1.1708105,36.8336102,812,2031,24,959
10481,28053,186,3,Business,9,5,55020,9,5,56109,9,5,56284,9,5,56531,9,5,58136,18,26.4,-1.3700383,36.9190174,-1.2902869,36.8085396,647,1605,1089,422
10482,17327,1652,1,Personal,23,4,51981,23,4,52171,23,4,52790,23,4,53141,23,4,53891,5,21.0,-1.286937,36.8246742,-1.3113795,36.8367695,213,750,190,970
10483,16562,136,3,Business,16,5,54305,16,5,56638,16,5,58679,16,5,60140,16,5,62266,16,26.0,-1.2768704,36.8251777,-1.3326173,36.7146233,287,2126,2333,3502
10484,1497,3326,3,Business,14,4,57820,14,4,58362,14,4,60924,14,4,61048,14,4,62889,7,21.1,-1.2551895,36.7822034,-1.2862269,36.7841601,752,1841,542,2686
10485,13054,393,3,Business,11,5,57086,11,5,57131,11,5,57138,11,5,59208,11,5,59209,4,26.5,-1.3167113,36.8301563,-1.3004062,36.829741,619,1,45,2077
10486,16550,391,3,Business,18,4,42616,18,4,42709,18,4,43129,18,4,44268,18,4,45896,14,23.25888921888938,-1.300921,36.828195,-1.3688433,36.7402114,206,1628,93,1559
10487,13679,1768,3,Personal,19,2,34016,19,2,34069,19,2,34441,19,2,34845,19,2,36098,5,23.25888921888938,-1.2750257,36.8157165,-1.2935617,36.835057,34,1253,53,776
10488,23130,3355,3,Business,21,6,42587,21,6,42796,21,6,43361,21,6,46980,21,6,48622,10,16.3,-1.3404187,36.7614685,-1.3052491,36.8223899,735,1642,209,4184
10489,3769,3547,3,Business,4,4,40418,4,4,40521,4,4,41327,4,4,41734,4,4,45166,6,25.3,-1.2761408,36.7710839,-1.2592428,36.7894541,119,3432,103,1213
10490,12126,374,2,Personal,10,7,72189,10,7,72255,10,7,73511,10,7,73648,10,7,75770,5,17.4,-1.2831463,36.7636022,-1.2900727,36.7890059,334,2122,66,1393
10491,27572,3470,3,Business,21,2,47526,21,2,52939,21,2,54285,21,2,54366,21,2,55582,7,24.9,-1.2551895,36.7822034,-1.2929499,36.8180835,369,1216,5413,1427
10492,8548,1241,2,Personal,6,1,51094,6,1,51133,6,1,51762,6,1,52471,6,1,54346,8,24.6,-1.3012173,36.8093987,-1.261842,36.78486,449,1875,39,1338
10493,19659,2803,1,Business,25,2,31684,25,2,31697,25,2,32275,25,2,32954,25,2,35304,13,17.7,-1.2573382,36.877362,-1.2571472,36.7950633,727,2350,13,1257
10494,18109,346,3,Business,4,1,43849,4,1,44000,4,1,44933,4,1,46013,4,1,47307,2,26.5,-1.290894,36.822971,-1.28878,36.8168312,311,1294,151,2013
10495,11972,1402,3,Business,7,1,46336,7,1,46377,7,1,46687,7,1,47488,7,1,48098,2,24.8,-1.279395,36.825364,-1.281754,36.8324229,330,610,41,1111
10496,7247,3291,3,Business,24,3,52939,24,3,55259,24,3,56488,24,3,57003,24,3,58742,11,23.25888921888938,-1.22978,36.836215,-1.2600926,36.8088685,68,1739,2320,1744
10497,6381,1647,3,Business,29,1,60809,29,1,61927,29,1,62755,29,1,63180,29,1,64932,16,23.25888921888938,-1.2190317,36.8825092,-1.3277669,36.8975169,815,1752,1118,1253
10498,300,2956,3,Business,17,3,58853,17,3,59621,17,3,60909,17,3,61652,17,3,66364,6,23.25888921888938,-1.2584143,36.8048002,-1.2854151,36.8233848,435,4712,768,2031
10499,6118,302,3,Business,29,7,68109,29,7,70009,29,7,71453,29,7,71873,29,7,73222,7,14.6,-1.2649605,36.7981777,-1.2696795,36.8640088,452,1349,1900,1864
10500,5000,2956,3,Business,5,5,43950,5,5,43993,5,5,45210,5,5,45450,5,5,47313,14,24.5,-1.207546,36.7913976,-1.2584143,36.8048002,353,1863,43,1457
10501,24508,1687,3,Business,29,5,41401,29,5,41456,29,5,41711,29,5,42203,29,5,42631,3,26.8,-1.2626574,36.8014034,-1.2732803,36.7940377,564,428,55,747
10502,16576,1724,3,Business,10,3,55270,10,3,55328,10,3,57877,10,3,58825,10,3,60893,14,30.8,-1.32189,36.8589727,-1.2907854,36.7774108,155,2068,58,3497
10503,20884,627,3,Business,4,4,46010,4,4,46038,4,4,46777,4,4,46880,4,4,47324,3,25.7,-1.2551895,36.7822034,-1.2632076,36.7744242,191,444,28,842
10504,19474,2112,3,Business,25,4,42990,25,4,43024,25,4,43474,25,4,43868,25,4,45471,16,19.8,-1.2551895,36.7822034,-1.2156006,36.8916865,490,1603,34,844
10505,19504,302,3,Business,1,2,70688,1,2,70786,1,2,71505,1,2,72184,1,2,72186,3,18.5,-1.2649605,36.7981777,-1.2611642,36.7949932,517,2,98,1398
10506,6695,928,3,Business,17,3,43366,17,3,46358,17,3,46963,17,3,47252,17,3,50776,6,25.2,-1.2551895,36.7822034,-1.2855666,36.8194926,338,3524,2992,894
10507,23372,1133,3,Business,26,5,38482,26,5,38529,26,5,40769,26,5,41389,26,5,43230,11,23.25888921888938,-1.2103609,36.7801748,-1.2571472,36.7950633,353,1841,47,2860
10508,11514,1179,3,Business,31,3,59477,31,3,60204,31,3,60804,31,3,62307,31,3,64331,15,24.3,-1.3700383,36.9190174,-1.298905,36.8538783,588,2024,727,2103
10509,4453,2008,3,Business,18,1,34013,18,1,34056,18,1,34607,18,1,34992,18,1,36724,11,22.0,-1.2508229,36.7895263,-1.3173869,36.8112044,778,1732,43,936
10510,14962,2086,1,Personal,23,3,63517,23,3,63693,23,3,64193,23,3,64501,23,3,65702,4,20.4,-1.2952843,36.7938766,-1.2994194,36.7647917,919,1201,176,808
10511,3352,3526,3,Business,31,5,53510,31,5,53877,31,5,55556,31,5,55893,31,5,58089,13,24.9,-1.300722,36.7882234,-1.3094235,36.87,624,2196,367,2016
10512,10039,1247,3,Business,26,3,33624,26,3,33659,26,3,33835,26,3,34721,26,3,36103,6,18.8,-1.3034396,36.8329998,-1.300284,36.804223,848,1382,35,1062
10513,6998,2066,3,Business,25,3,30458,25,3,30575,25,3,31624,25,3,31983,25,3,32607,6,13.3,-1.316961,36.820337,-1.3048469,36.7876088,726,624,117,1408
10514,23187,3565,3,Business,10,6,33352,10,6,33753,10,6,35041,10,6,37267,10,6,41134,41,21.0,-1.399029,36.757255,-1.1707617,36.9675086,647,3867,401,3514
10515,14731,2778,2,Personal,27,7,34067,27,7,35156,27,7,37634,27,7,38040,27,7,38734,9,20.6,-1.2865726,36.7642184,-1.2647469,36.8157706,103,694,1089,2884
10516,12577,1976,3,Business,22,5,30936,22,5,31930,22,5,33556,22,5,33664,22,5,35552,8,23.25888921888938,-1.2809356,36.8232262,-1.257028,36.7810435,127,1888,994,1734
10517,15817,567,3,Business,29,3,48951,29,3,49012,29,3,50062,29,3,50550,29,3,53202,7,21.2,-1.2963097,36.7688221,-1.295723,36.822692,76,2652,61,1538
10518,24691,908,3,Business,15,1,53425,15,1,57944,15,1,59143,15,1,59223,15,1,60478,6,23.25888921888938,-1.2731962,36.8072499,-1.3014515,36.8120092,352,1255,4519,1279
10519,17988,3404,3,Business,15,4,45200,15,4,46611,15,4,46618,15,4,47876,15,4,49112,8,24.3,-1.279395,36.825364,-1.3270716,36.8406371,925,1236,1411,1265
10520,20853,1245,3,Business,14,1,33084,14,1,33906,14,1,34500,14,1,36366,14,1,38164,17,20.4,-1.3198615,36.7110323,-1.300921,36.828195,412,1798,822,2460
10521,27163,2677,3,Business,22,3,55462,22,3,56330,22,3,56633,22,3,57165,22,3,58746,15,24.4,-1.2991441,36.7528804,-1.3228003,36.8306435,291,1581,868,835
10522,2592,2330,3,Business,30,2,59581,30,2,61488,30,2,61587,30,2,61770,30,2,62838,9,23.25888921888938,-1.2536275,36.7987932,-1.2687407,36.7373043,245,1068,1907,282
10523,27145,2982,3,Business,26,2,47641,26,2,51574,26,2,51830,26,2,54303,26,2,54935,8,23.25888921888938,-1.300921,36.828195,-1.325469,36.862403,101,632,3933,2729
10524,15323,3688,3,Business,14,4,57659,14,4,57775,14,4,59113,14,4,59446,14,4,60802,6,27.6,-1.3147074,36.811722,-1.2897399,36.8270975,156,1356,116,1671
10525,18141,633,3,Business,22,3,57005,22,3,57325,22,3,57568,22,3,57903,22,3,58142,2,25.9,-1.3080092,36.8284543,-1.3004062,36.829741,445,239,320,578
10526,10238,1961,3,Business,30,2,50531,30,2,50896,30,2,51823,30,2,52462,30,2,54628,21,23.25888921888938,-1.331619,36.847976,-1.3181159,36.7101559,420,2166,365,1566
10527,1494,552,3,Business,30,2,35420,30,2,35482,30,2,37973,30,2,38379,30,2,39617,13,22.3,-1.2860183,36.8975338,-1.3632162,36.9108253,397,1238,62,2897
10528,12319,2226,3,Personal,9,1,34584,9,1,36307,9,1,36965,9,1,37495,9,1,39414,19,15.5,-1.2372853,36.7611857,-1.3104734,36.7363698,103,1919,1723,1188
10529,11644,1522,3,Business,11,2,34618,11,2,34656,11,2,34682,11,2,35242,11,2,37108,2,16.4,-1.2584143,36.8048002,-1.268885,36.805758,258,1866,38,586
10530,12178,3080,3,Business,5,3,38187,5,3,38208,5,3,39601,5,3,41475,5,3,42698,22,22.2,-1.3195527,36.8911052,-1.2551895,36.7822034,543,1223,21,3267
10531,5055,3091,3,Business,14,2,61069,14,2,61089,14,2,61261,14,2,61851,14,2,63955,10,23.6,-1.3014461,36.7661381,-1.25896,36.8016691,882,2104,20,762
10532,24042,3149,3,Business,7,5,48304,7,5,48344,7,5,48353,7,5,49665,7,5,50148,5,23.25888921888938,-1.3004062,36.829741,-1.3167113,36.8301563,2,483,40,1321
10533,3493,393,3,Business,27,1,50855,27,1,50855,27,1,50864,27,1,51238,27,1,51781,4,23.2,-1.3228003,36.8306435,-1.3004062,36.829741,863,543,0,383
10534,25050,111,3,Business,27,3,40347,27,3,40386,27,3,41013,27,3,41152,27,3,42961,12,26.3,-1.2551895,36.7822034,-1.320157,36.830887,154,1809,39,766
10535,23745,3521,3,Business,17,1,48404,17,1,48435,17,1,48752,17,1,52111,17,1,52673,5,28.3,-1.264945,36.784678,-1.2696908,36.81519,726,562,31,3676
10536,18029,791,3,Business,24,3,50376,24,3,51362,24,3,53870,24,3,54064,24,3,56229,17,18.5,-1.3671327,36.7564238,-1.2931446,36.7613971,857,2165,986,2702
10537,21975,2767,3,Business,6,6,50291,6,6,50760,6,6,51051,6,6,51611,6,6,52365,3,27.9,-1.257773,36.795486,-1.2590031,36.8078168,905,754,469,851
10538,5396,3686,3,Business,13,4,51735,13,4,53370,13,4,54148,13,4,54250,13,4,55639,7,22.2,-1.2551895,36.7822034,-1.2957631,36.8161042,362,1389,1635,880
10539,20171,3032,3,Business,8,4,53491,8,4,56797,8,4,57544,8,4,57773,8,4,58658,5,27.1,-1.2571472,36.7950633,-1.2850639,36.8179454,79,885,3306,976
10540,27073,393,3,Business,1,1,31942,1,1,31999,1,1,33409,1,1,34198,1,1,36249,8,21.5,-1.3167113,36.8301563,-1.2770708,36.8231093,843,2051,57,2199
10541,7441,449,2,Personal,9,6,39734,9,6,39754,9,6,40762,9,6,40948,9,6,43099,18,17.4,-1.2775066,36.7896532,-1.3052036,36.6872046,543,2151,20,1194
10542,23876,1724,3,Business,27,3,47493,27,3,47527,27,3,47990,27,3,48252,27,3,49117,8,23.25888921888938,-1.2905046,36.7828277,-1.2551895,36.7822034,345,865,34,725
10543,2436,2801,3,Business,22,5,53468,22,5,53518,22,5,54328,22,5,54934,22,5,56604,12,27.1,-1.3108386,36.7555239,-1.2674274,36.7870827,708,1670,50,1416
10544,21807,1280,3,Business,7,4,30855,7,4,30878,7,4,31132,7,4,32329,7,4,34995,13,23.25888921888938,-1.2551895,36.7822034,-1.3207951,36.8286902,708,2666,23,1451
10545,15340,1246,3,Business,31,3,41160,31,3,41215,31,3,41817,31,3,42022,31,3,42620,4,24.5,-1.2615048,36.8116724,-1.2571472,36.7950633,623,598,55,807
10546,21846,186,3,Business,9,4,35454,9,4,35487,9,4,35832,9,4,36373,9,4,37205,6,23.25888921888938,-1.2825816,36.8092346,-1.2571472,36.7950633,819,832,33,886
10547,7862,393,3,Business,21,2,48515,21,2,48530,21,2,48592,21,2,48689,21,2,49389,4,22.5,-1.3167113,36.8301563,-1.3004062,36.829741,239,700,15,159
10548,23119,2242,3,Business,3,1,41425,3,1,41466,3,1,41988,3,1,42496,3,1,45563,10,20.5,-1.3260432,36.8348633,-1.2574088,36.799712,726,3067,41,1030
10549,9380,1953,3,Personal,15,2,34208,15,2,35251,15,2,36552,15,2,37405,15,2,39153,9,18.2,-1.3332749,36.8708147,-1.2802576,36.8246917,100,1748,1043,2154
10550,1813,680,2,Personal,13,1,31508,13,1,31519,13,1,32458,13,1,32569,13,1,33966,14,15.0,-1.3255736,36.7275277,-1.2883346,36.8148489,249,1397,11,1050
10551,20532,2000,3,Business,21,4,54182,21,4,54209,21,4,54226,21,4,54708,21,4,55772,8,31.1,-1.2551895,36.7822034,-1.2985749,36.8088,576,1064,27,499
10552,22512,2504,3,Business,20,2,60600,20,2,60628,20,2,62090,20,2,62364,20,2,63592,8,23.7,-1.2854453,36.8188363,-1.2963097,36.7688221,622,1228,28,1736
10553,2365,2335,3,Business,31,4,48574,31,4,48617,31,4,48887,31,4,49111,31,4,50430,15,28.9,-1.2551895,36.7822034,-1.3323107,36.8692616,871,1319,43,494
10554,3058,788,3,Business,6,4,37796,6,4,37829,6,4,37832,6,4,39520,6,4,41381,16,23.9,-1.3014461,36.7661381,-1.225322,36.80855,450,1861,33,1691
10555,6044,1581,3,Personal,19,5,32142,19,5,32165,19,5,32244,19,5,32743,19,5,33602,2,20.0,-1.2696908,36.81519,-1.2753902,36.808223,531,859,23,578
10556,8882,3326,3,Business,31,4,46894,31,4,47025,31,4,47650,31,4,47764,31,4,49825,8,26.5,-1.2551895,36.7822034,-1.304344,36.812274,857,2061,131,739
10557,17993,246,3,Business,20,2,49856,20,2,50110,20,2,50549,20,2,50849,20,2,52086,12,23.9,-1.2584143,36.8048002,-1.2483726,36.8901617,237,1237,254,739
10558,7557,2973,2,Personal,19,3,42945,19,3,42969,19,3,43914,19,3,44200,19,3,45353,5,23.25888921888938,-1.2824911,36.8218042,-1.2962832,36.7849683,726,1153,24,1231
10559,24383,1178,3,Business,9,3,72757,9,3,72784,9,3,73158,9,3,74615,9,3,75070,5,18.3,-1.2862269,36.7841601,-1.2697859,36.7946203,355,455,27,1831
10560,13653,3426,3,Business,31,3,62799,31,3,62832,31,3,62998,31,3,63441,31,3,65332,10,24.4,-1.2584143,36.8048002,-1.3014461,36.7661381,647,1891,33,609
10561,6564,1882,3,Business,15,5,53695,15,5,56025,15,5,58444,15,5,60785,15,5,60792,4,27.8,-1.2672588,36.8000252,-1.287781,36.817866,314,7,2330,4760
10562,16181,1642,3,Business,31,3,41420,31,3,41429,31,3,43003,31,3,43826,31,3,46144,13,24.5,-1.3316276,36.8727316,-1.2728069,36.7962362,336,2318,9,2397
10563,12340,3291,3,Business,12,2,49269,12,2,49296,12,2,49843,12,2,50989,12,2,52625,12,27.1,-1.331619,36.847976,-1.2600926,36.8088685,513,1636,27,1693
10564,394,3172,3,Personal,24,4,40983,24,4,41022,24,4,41516,24,4,41885,24,4,42829,2,21.2,-1.279285,36.8260574,-1.2842286,36.8150609,360,944,39,863
10565,4524,246,3,Business,17,1,48043,17,1,48131,17,1,48882,17,1,49006,17,1,50013,10,24.6,-1.2584143,36.8048002,-1.2413316,36.8785525,598,1007,88,875
10566,23239,1724,3,Business,2,1,54901,2,1,56284,2,1,56712,2,1,56975,2,1,58264,8,20.0,-1.288966,36.791814,-1.2551895,36.7822034,86,1289,1383,691
10567,8228,1798,3,Business,17,1,48055,17,1,48074,17,1,48398,17,1,48979,17,1,49595,2,28.3,-1.2615888,36.7928732,-1.2642903,36.8002137,620,616,19,905
10568,26195,3058,3,Personal,29,5,45421,29,5,45471,29,5,45889,29,5,46006,29,5,47042,7,19.5,-1.2841726,36.8179589,-1.3043649,36.7816132,476,1036,50,535
10569,24654,733,3,Business,14,5,47726,14,5,47745,14,5,47746,14,5,48184,14,5,50009,14,21.8,-1.2551895,36.7822034,-1.3265961,36.8718676,168,1825,19,439
10570,24945,1271,3,Business,12,3,36166,12,3,36597,12,3,36792,12,3,38591,12,3,41708,19,23.3,-1.3244885,36.897792,-1.2236966,36.9290782,413,3117,431,1994
10571,13183,914,3,Business,19,1,39367,19,1,39455,19,1,40073,19,1,40522,19,1,41670,7,24.8,-1.2670213,36.7994482,-1.2970034,36.8333214,786,1148,88,1067
10572,18146,268,3,Business,14,4,57229,14,4,57868,14,4,58230,14,4,58490,14,4,62995,5,28.2,-1.2551895,36.7822034,-1.2808188,36.8100137,404,4505,639,622
10573,3677,1561,3,Business,15,2,45649,15,2,45670,15,2,46894,15,2,49790,15,2,53320,35,24.4,-1.236909,36.653621,-1.328259,36.860975,854,3530,21,4120
10574,10895,1850,3,Business,4,1,53598,4,1,53620,4,1,53674,4,1,54859,4,1,55718,4,28.5,-1.2551895,36.7822034,-1.2649114,36.8134191,451,859,22,1239
10575,26660,3201,3,Business,18,2,56753,18,2,56777,18,2,57132,18,2,57280,18,2,57283,3,25.4,-1.2584143,36.8048002,-1.2551895,36.7822034,647,3,24,503
10576,27856,1964,3,Personal,4,2,43729,4,2,43813,4,2,43931,4,2,44640,4,2,45757,14,20.7,-1.32671,36.8600138,-1.2670196,36.8077002,359,1117,84,827
10577,12963,691,1,Personal,9,3,36033,9,3,36049,9,3,37183,9,3,37819,9,3,41450,19,17.5,-1.2844303,36.8781656,-1.2046777,36.8568687,248,3631,16,1770
10578,9054,2330,3,Business,20,3,56889,20,3,56911,20,3,57925,20,3,58535,20,3,59687,10,23.1,-1.2524916,36.8656196,-1.2614329,36.8094365,851,1152,22,1624
10579,26526,2439,3,Business,19,2,48515,19,2,48616,19,2,48920,19,2,49676,19,2,50068,5,29.2,-1.2534301,36.8000983,-1.2886923,36.8241519,812,392,101,1060
10580,11705,3234,1,Business,16,4,39698,16,4,39717,16,4,40585,16,4,41748,16,4,42977,6,14.8,-1.2664428,36.809453,-1.2854406,36.789409,222,1229,19,2031
10581,15633,3291,3,Business,25,4,39834,25,4,39876,25,4,40070,25,4,40654,25,4,41608,5,20.1,-1.2628473,36.781805,-1.2600926,36.8088685,737,954,42,778
10582,6568,2532,3,Business,11,2,38586,11,2,40090,11,2,40502,11,2,43277,11,2,46335,6,19.4,-1.2571472,36.7950633,-1.2824911,36.8218042,206,3058,1504,3187
10583,19067,2159,3,Business,29,1,40524,29,1,40540,29,1,41044,29,1,42180,29,1,43565,10,23.25888921888938,-1.2588381,36.7914147,-1.304735,36.7846054,105,1385,16,1640
10584,28122,778,3,Business,3,3,49822,3,3,49849,3,3,50085,3,3,51299,3,3,51303,4,28.4,-1.2535486,36.7933541,-1.2656922,36.8136944,953,4,27,1450
10585,13723,2454,3,Business,18,4,38069,18,4,38093,18,4,39354,18,4,39516,18,4,41360,15,25.6,-1.2219929,36.8349924,-1.2993231,36.7753372,829,1844,24,1423
10586,15985,1363,3,Business,16,5,53413,16,5,53547,16,5,54118,16,5,56848,16,5,57115,5,23.25888921888938,-1.3004062,36.829741,-1.3083777,36.8590077,360,267,134,3301
10587,10672,2330,3,Business,30,2,53766,30,2,55094,30,2,56817,30,2,57221,30,2,58036,2,23.25888921888938,-1.2642903,36.8002137,-1.2612417,36.8138633,843,815,1328,2127
10588,21476,346,3,Business,10,4,39686,10,4,39766,10,4,41180,10,4,41570,10,4,43063,4,24.6,-1.2571472,36.7950633,-1.28878,36.8168312,362,1493,80,1804
10589,13930,3127,3,Business,20,3,43913,20,3,44000,20,3,44519,20,3,44693,20,3,45700,7,27.3,-1.2641888,36.7603984,-1.2918246,36.801585,517,1007,87,693
10590,841,302,3,Business,22,7,50246,22,7,50434,22,7,50779,22,7,51070,22,7,51848,6,19.2,-1.2649605,36.7981777,-1.2855153,36.7834515,194,778,188,636
10591,1624,3635,1,Business,21,5,52846,21,5,52865,21,5,52877,21,5,53577,21,5,53975,3,27.1,-1.2584143,36.8048002,-1.2615888,36.7928732,647,398,19,712
10592,11914,1927,3,Business,10,5,44443,10,5,44486,10,5,45295,10,5,45805,10,5,47198,10,23.25888921888938,-1.3165542,36.700067,-1.3472066,36.7692638,831,1393,43,1319
10593,20295,3557,3,Business,22,3,45480,22,3,45772,22,3,46498,22,3,49311,22,3,49317,6,24.4,-1.286937,36.8246742,-1.2546732,36.8086796,921,6,292,3539
10594,3005,2260,1,Personal,26,3,41327,26,3,41379,26,3,43043,26,3,43209,26,3,47168,2,23.8,-1.3064585,36.8119065,-1.3090663,36.8136865,87,3959,52,1830
10595,21569,733,3,Business,30,3,44288,30,3,44359,30,3,44963,30,3,45113,30,3,45114,5,25.0,-1.2551895,36.7822034,-1.2629461,36.7653137,647,1,71,754
10596,17410,788,3,Business,25,1,40480,25,1,40508,25,1,41315,25,1,41559,25,1,42661,8,25.7,-1.225322,36.80855,-1.259697,36.800802,399,1102,28,1051
10598,950,1329,3,Business,8,5,45907,8,5,47719,8,5,49047,8,5,49111,8,5,49114,4,27.3,-1.273056,36.811298,-1.2878913,36.8089253,779,3,1812,1392
10599,26749,3698,3,Business,17,3,43773,17,3,43812,17,3,44096,17,3,45502,17,3,50228,17,23.25888921888938,-1.2285995,36.9012372,-1.3244885,36.897792,387,4726,39,1690
10600,3086,3361,3,Personal,16,4,46125,16,4,46135,16,4,47383,16,4,48814,16,4,50809,19,19.0,-1.2880351,36.8286389,-1.3297531,36.7063699,648,1995,10,2679
10601,17353,2978,3,Business,3,2,41784,3,2,41943,3,2,43737,3,2,43869,3,2,44441,7,18.6,-1.278612,36.8195876,-1.2551895,36.7822034,726,572,159,1926
10602,13864,478,3,Business,8,5,40809,8,5,40876,8,5,42325,8,5,43496,8,5,44431,7,28.4,-1.2551895,36.7822034,-1.2894795,36.7818534,205,935,67,2620
10603,6240,3727,2,Business,19,2,58273,19,2,58292,19,2,58644,19,2,59036,19,2,60633,8,18.7,-1.2963097,36.7688221,-1.2600616,36.7870182,465,1597,19,744
10604,23389,3602,3,Business,13,3,69516,13,3,69855,13,3,71141,13,3,71475,13,3,72521,6,20.7,-1.2797013,36.7299371,-1.2963097,36.7688221,862,1046,339,1620
10605,10478,22,2,Personal,22,7,50441,22,7,50519,22,7,51104,22,7,51719,22,7,53875,8,18.9,-1.3112325,36.8146321,-1.271337,36.786712,465,2156,78,1200
10606,20537,1607,2,Personal,22,2,33568,22,2,33575,22,2,35586,22,2,36015,22,2,38456,16,17.7,-1.293973,36.80169,-1.2998783,36.9070838,265,2441,7,2440
10607,19800,1502,3,Business,12,6,44543,12,6,46597,12,6,47692,12,6,48421,12,6,50020,14,23.25888921888938,-1.207546,36.7913976,-1.2232123,36.8932547,870,1599,2054,1824
10608,9184,3075,1,Personal,28,6,36045,28,6,36114,28,6,36471,28,6,38378,28,6,39792,6,24.0,-1.274165,36.814577,-1.304078,36.83014,174,1414,69,2264
10609,5880,611,1,Personal,1,7,67057,1,7,67686,1,7,68829,1,7,69213,1,7,71563,12,20.9,-1.29603,36.739172,-1.3267091,36.7785872,105,2350,629,1527
10610,20420,2360,3,Business,13,3,37400,13,3,37472,13,3,40114,13,3,40731,13,3,42078,11,23.25888921888938,-1.2835228,36.7437619,-1.2551895,36.7822034,751,1347,72,3259
10611,24182,3283,3,Business,16,3,37817,16,3,37893,16,3,39449,16,3,40044,16,3,41128,13,22.9,-1.2296618,36.8438272,-1.2628473,36.781805,52,1084,76,2151
10612,14226,1578,3,Business,19,3,37020,19,3,37028,19,3,37466,19,3,38142,19,3,40670,4,22.4,-1.28878,36.8168312,-1.303711,36.8154933,79,2528,8,1114
10613,5282,666,2,Personal,17,4,30808,17,4,32711,17,4,34032,17,4,34194,17,4,35648,5,17.9,-1.2770071,36.832167,-1.2583017,36.8023526,805,1454,1903,1483
10614,17958,2523,3,Business,29,1,50470,29,1,50507,29,1,50527,29,1,50733,29,1,52045,14,23.25888921888938,-1.2551895,36.7822034,-1.3147071,36.8644977,564,1312,37,226
10615,17407,977,1,Personal,31,2,28366,31,2,37610,31,2,38300,31,2,39155,31,2,40447,9,18.5,-1.2952476,36.7539254,-1.289235,36.8135805,844,1292,9244,1545
10616,24968,1363,3,Business,1,5,50666,1,5,50683,1,5,50709,1,5,51000,1,5,52427,11,28.6,-1.2991441,36.7528804,-1.3004062,36.829741,523,1427,17,317
10617,16700,2273,1,Personal,16,4,57886,16,4,57969,16,4,59161,16,4,59326,16,4,62789,8,18.8,-1.286198,36.8193847,-1.3215473,36.8435326,519,3463,83,1357
10618,13327,868,3,Business,28,4,44287,28,4,44320,28,4,47443,28,4,48000,28,4,50059,14,28.1,-1.293515,36.897607,-1.265715,36.823815,513,2059,33,3680
10619,9538,2899,3,Personal,22,5,58833,22,5,59089,22,5,59625,22,5,59702,22,5,60651,3,28.6,-1.2808705,36.7684824,-1.298762,36.7636456,269,949,256,613
10620,25144,1502,3,Business,15,1,60106,15,1,60161,15,1,60588,15,1,61567,15,1,62150,5,23.25888921888938,-1.2283403,36.8822756,-1.2232123,36.8932547,75,583,55,1406
10621,5934,1750,1,Personal,30,6,36762,30,6,36798,30,6,37582,30,6,38087,30,6,38954,12,22.2,-1.2840605,36.8191699,-1.2675351,36.7456136,208,867,36,1289
10622,363,302,3,Business,13,3,57185,13,3,57198,13,3,58165,13,3,59014,13,3,59937,8,29.0,-1.2976314,36.777256,-1.2649605,36.7981777,205,923,13,1816
10623,15390,2757,3,Business,25,1,63763,25,1,63825,25,1,64508,25,1,64710,25,1,65647,8,28.3,-1.314437,36.712353,-1.2963097,36.7688221,484,937,62,885
10624,23772,20,3,Business,26,2,41255,26,2,41455,26,2,42534,26,2,43258,26,2,46327,18,27.4,-1.3160119,36.8967301,-1.2629666,36.8068369,436,3069,200,1803
10625,26347,1156,2,Personal,14,2,43078,14,2,43094,14,2,43924,14,2,44272,14,2,45827,6,21.3,-1.2913178,36.7957948,-1.2793101,36.7660227,229,1555,16,1178
10626,9657,1108,3,Personal,22,3,57533,22,3,57632,22,3,58398,22,3,58660,22,3,60808,11,24.1,-1.3321701,36.8776153,-1.2857521,36.8277457,276,2148,99,1028
10627,22838,3621,3,Business,12,2,43629,12,2,43676,12,2,44482,12,2,44648,12,2,46001,5,28.1,-1.2836583,36.7886014,-1.2821883,36.8269611,118,1353,47,972
10628,24981,633,3,Business,26,2,27382,26,2,27454,26,2,27884,26,2,29491,26,2,30662,9,21.7,-1.2638185,36.7930057,-1.3004062,36.829741,99,1171,72,2037
10629,16055,2197,3,Personal,3,4,30218,3,4,31951,3,4,33165,3,4,33262,3,4,35018,7,20.5,-1.32589,36.831679,-1.2795225,36.8323501,399,1756,1733,1311
10630,11071,3222,3,Business,9,2,56583,9,2,56607,9,2,56619,9,2,56889,9,2,58040,8,30.8,-1.2551895,36.7822034,-1.2944702,36.8009707,576,1151,24,282
10631,28198,972,3,Business,15,1,59077,15,1,59175,15,1,59513,15,1,60098,15,1,62040,12,23.25888921888938,-1.2862033,36.8152966,-1.265568,36.882778,800,1942,98,923
10632,3514,3272,1,Personal,19,5,48540,19,5,48550,19,5,49605,19,5,53241,19,5,55480,12,27.6,-1.306219,36.8699124,-1.2696341,36.8042045,755,2239,10,4691
10633,21346,2523,3,Business,6,3,53253,6,3,53352,6,3,53923,6,3,55219,6,3,55227,8,27.3,-1.2551895,36.7822034,-1.2856234,36.7865464,953,8,99,1867
10634,22880,2240,1,Personal,8,3,49086,8,3,49180,8,3,49271,8,3,49902,8,3,50333,3,25.6,-1.2607786,36.7916657,-1.2628638,36.8070399,574,431,94,722
10635,17978,3599,3,Business,23,5,50291,23,5,51750,23,5,52827,23,5,54101,23,5,58774,20,26.2,-1.3302996,36.8707935,-1.216212,36.841799,519,4673,1459,2351
10636,14331,868,3,Business,30,2,36582,30,2,38089,30,2,38573,30,2,39312,30,2,40002,5,22.5,-1.2600926,36.8088685,-1.265715,36.823815,726,690,1507,1223
10637,20682,3599,3,Business,14,2,39264,14,2,43988,14,2,45226,14,2,46437,14,2,49567,13,23.25888921888938,-1.3302996,36.8707935,-1.2536509,36.8149295,591,3130,4724,2449
10638,8393,3683,3,Business,8,1,50817,8,1,50871,8,1,51293,8,1,51765,8,1,54752,7,24.7,-1.2897368,36.8226783,-1.2765492,36.7669809,857,2987,54,894
10639,2020,2701,3,Business,5,2,39932,5,2,40049,5,2,41782,5,2,41842,5,2,43198,11,23.4,-1.2765736,36.8513646,-1.2571472,36.7950633,530,1356,117,1793
10640,17986,3291,3,Business,19,2,48372,19,2,48424,19,2,48452,19,2,48963,19,2,49458,5,29.8,-1.2628473,36.781805,-1.2600926,36.8088685,75,495,52,539
10641,9296,136,3,Business,6,3,44869,6,3,44909,6,3,45508,6,3,45644,6,3,47614,16,22.6,-1.3254522,36.7216584,-1.3233496,36.8139159,205,1970,40,735
10642,4960,2083,3,Personal,24,4,58446,24,4,58484,24,4,58703,24,4,60191,24,4,61404,8,26.1,-1.3012173,36.8093987,-1.2615888,36.7928732,315,1213,38,1707
10643,12201,3647,3,Business,7,4,44727,7,4,44762,7,4,45025,7,4,45336,7,4,45979,5,24.3,-1.272639,36.794723,-1.2935921,36.7876166,205,643,35,574
10644,18187,1340,3,Business,5,2,57952,5,2,59065,5,2,59566,5,2,59637,5,2,60686,6,24.8,-1.2707179,36.7979713,-1.289882,36.8105888,548,1049,1113,572
10645,21040,3674,3,Business,10,1,53515,10,1,54162,10,1,54540,10,1,54757,10,1,56284,9,18.7,-1.2551895,36.7822034,-1.3018312,36.7817497,786,1527,647,595
10646,8703,3283,3,Business,20,4,52148,20,4,52157,20,4,52175,20,4,53072,20,4,53517,4,28.1,-1.266837,36.799249,-1.2628473,36.781805,874,445,9,915
10647,15021,3194,3,Business,13,3,56310,13,3,56366,13,3,56828,13,3,57115,13,3,58583,4,29.1,-1.2811503,36.8235884,-1.2885504,36.8066908,341,1468,56,749
10648,22345,2214,2,Personal,28,1,38302,28,1,38784,28,1,40593,28,1,40992,28,1,42362,8,22.9,-1.2750975,36.8289032,-1.316521,36.869311,888,1370,482,2208
10649,12300,1346,3,Business,12,2,53246,12,2,53286,12,2,53832,12,2,54072,12,2,55247,6,26.9,-1.2917868,36.7872675,-1.2695287,36.7981777,559,1175,40,786
10650,25077,2468,3,Business,26,1,41938,26,1,42115,26,1,42795,26,1,43348,26,1,44009,7,22.9,-1.2857671,36.7875614,-1.260317,36.7989145,101,661,177,1233
10651,26039,421,3,Business,18,2,50959,18,2,51226,18,2,51757,18,2,52957,18,2,54692,9,25.6,-1.2975066,36.7689423,-1.2551895,36.7822034,548,1735,267,1731
10652,19915,1500,3,Business,8,1,36599,8,1,36637,8,1,36815,8,1,39597,8,1,40514,8,28.0,-1.3004062,36.829741,-1.2638185,36.7930057,206,917,38,2960
10653,4159,2412,3,Business,14,4,34860,14,4,37846,14,4,39491,14,4,39947,14,4,41479,11,18.9,-1.290894,36.822971,-1.2297202,36.8745508,752,1532,2986,2101
10654,19461,2587,3,Business,23,6,42739,23,6,42778,23,6,43108,23,6,43494,23,6,45210,14,26.4,-1.2232123,36.8932547,-1.28878,36.8168312,411,1716,39,716
10655,381,914,3,Business,28,4,55808,28,4,56177,28,4,57062,28,4,57318,28,4,59057,7,27.3,-1.2670213,36.7994482,-1.3023305,36.8260519,99,1739,369,1141
10656,1015,1304,3,Business,5,5,61617,5,5,61640,5,5,61991,5,5,62474,5,5,63125,3,26.2,-1.2551895,36.7822034,-1.2693017,36.8022778,690,651,23,834
10657,16487,2135,1,Personal,29,3,45950,29,3,45988,29,3,46428,29,3,46719,29,3,47332,5,18.4,-1.3119324,36.8382423,-1.2960687,36.8167909,539,613,38,731
10658,15937,2392,3,Personal,6,4,47001,6,4,47147,6,4,47656,6,4,51447,6,4,53421,18,21.3,-1.2365885,36.8898127,-1.3013102,36.7963702,8,1974,146,4300
10659,26512,1341,3,Business,29,3,39614,29,3,39647,29,3,40138,29,3,40543,29,3,41690,13,23.25888921888938,-1.259478,36.8017813,-1.331619,36.847976,96,1147,33,896
10660,9370,1194,1,Personal,16,2,50809,16,2,50822,16,2,51154,16,2,51365,16,2,53140,4,27.6,-1.304192,36.739457,-1.2959724,36.7569331,612,1775,13,543
10661,26193,3651,3,Business,16,5,51672,16,5,54139,16,5,54522,16,5,54655,16,5,59374,7,23.25888921888938,-1.2571472,36.7950633,-1.2482518,36.7550829,470,4719,2467,516
10662,16335,1646,3,Business,13,4,56509,13,4,56555,13,4,57997,13,4,58571,13,4,59487,9,23.1,-1.2517448,36.7924971,-1.2706961,36.7643345,55,916,46,2016
10663,25459,3149,3,Business,3,1,53867,3,1,54304,3,1,54559,3,1,55096,3,1,56125,5,23.0,-1.3004062,36.829741,-1.3228003,36.8306435,158,1029,437,792
10664,16133,554,1,Personal,11,5,39850,11,5,40225,11,5,41080,11,5,41229,11,5,42879,5,20.8,-1.2942764,36.7969749,-1.3127304,36.8189817,196,1650,375,1004
10665,27143,33,3,Personal,7,4,48480,7,4,48553,7,4,48656,7,4,49331,7,4,49929,2,27.8,-1.2814609,36.8265932,-1.2770826,36.8174088,845,598,73,778
10666,3095,2267,2,Personal,3,1,44448,3,1,44577,3,1,46410,3,1,47460,3,1,49700,12,20.4,-1.2956951,36.8129242,-1.2598589,36.7470168,447,2240,129,2883
10667,16987,186,3,Business,7,2,53906,7,2,54469,7,2,55273,7,2,55680,7,2,56574,7,23.25888921888938,-1.2825816,36.8092346,-1.2571472,36.7950633,177,894,563,1211
10668,20495,868,3,Business,2,6,49002,2,6,49021,2,6,49201,2,6,50126,2,6,50974,7,29.1,-1.2628473,36.781805,-1.265715,36.823815,427,848,19,1105
10669,21855,2200,3,Business,29,5,40675,29,5,40983,29,5,41221,29,5,41870,29,5,43266,5,26.6,-1.273488,36.804158,-1.290894,36.822971,907,1396,308,887
10670,17514,2066,3,Business,27,5,49027,27,5,49075,27,5,49427,27,5,49550,27,5,50503,6,23.9,-1.316961,36.820337,-1.2966323,36.7875842,250,953,48,475
10671,7849,53,3,Business,10,3,52802,10,3,52985,10,3,53333,10,3,55229,10,3,56090,5,30.7,-1.3004062,36.829741,-1.2770708,36.8231093,756,861,183,2244
10672,3007,1048,2,Personal,16,6,54156,16,6,54265,16,6,54789,16,6,55700,16,6,56539,7,23.1,-1.2686365,36.7948329,-1.2892281,36.7535185,427,839,109,1435
10673,9844,633,3,Business,14,1,44371,14,1,48329,14,1,49756,14,1,50333,14,1,51258,5,25.9,-1.2770708,36.8231093,-1.3004062,36.829741,935,925,3958,2004
10674,26384,1336,3,Business,19,2,46702,19,2,47203,19,2,47838,19,2,48097,19,2,51985,8,26.8,-1.2885029,36.825605,-1.2615888,36.7928732,548,3888,501,894
10675,16568,1402,3,Business,10,1,34466,10,1,34518,10,1,35571,10,1,37509,10,1,38919,13,16.7,-1.2156006,36.8916865,-1.2813012,36.8323962,76,1410,52,2991
10676,13209,1500,3,Business,19,2,49222,19,2,49275,19,2,50098,19,2,50744,19,2,53322,13,30.0,-1.3083266,36.8494756,-1.2638185,36.7930057,522,2578,53,1469
10677,24655,393,3,Business,14,4,45086,14,4,47134,14,4,47908,14,4,49354,14,4,50594,11,27.9,-1.3167113,36.8301563,-1.2638185,36.7930057,365,1240,2048,2220
10678,14812,1968,1,Personal,16,2,39769,16,2,41219,16,2,42108,16,2,42297,16,2,44139,11,23.6,-1.2670582,36.7680056,-1.3173869,36.8112044,38,1842,1450,1078
10679,3698,1363,3,Business,19,2,32605,19,2,32821,19,2,33099,19,2,33166,19,2,34048,7,21.2,-1.3004062,36.829741,-1.3015998,36.8764939,57,882,216,345
10680,18820,1882,3,Business,6,7,36378,6,7,37964,6,7,39634,6,7,40706,6,7,40710,4,23.0,-1.277018,36.820337,-1.2588775,36.8079744,246,4,1586,2742
10681,17939,1687,3,Business,10,5,49112,10,5,49151,10,5,49996,10,5,50152,10,5,51215,3,23.25888921888938,-1.2626574,36.8014034,-1.2755629,36.8131522,76,1063,39,1001
10682,5151,1500,3,Business,10,1,34888,10,1,34938,10,1,35319,10,1,35449,10,1,36634,9,16.7,-1.2638185,36.7930057,-1.3004062,36.829741,161,1185,50,511
10683,22749,3080,3,Business,13,3,46169,13,3,46177,13,3,46431,13,3,46734,13,3,47111,5,24.8,-1.2551895,36.7822034,-1.266264,36.762418,379,377,8,557
10684,21714,393,3,Business,17,5,39667,17,5,39704,17,5,39872,17,5,40454,17,5,42324,14,23.25888921888938,-1.3167113,36.8301563,-1.2991441,36.7528804,211,1870,37,750
10685,4676,3295,3,Business,13,4,49749,13,4,49762,13,4,50094,13,4,50437,13,4,51198,3,23.3,-1.2571472,36.7950633,-1.2549259,36.7919494,381,761,13,675
10686,10548,2154,3,Business,18,5,40457,18,5,42509,18,5,43087,18,5,43810,18,5,44314,2,21.6,-1.290894,36.822971,-1.2885529,36.8160141,478,504,2052,1301
10687,2111,3552,1,Personal,8,1,45985,8,1,46552,8,1,47088,8,1,48127,8,1,48723,4,24.4,-1.3099295,36.8436807,-1.3046007,36.8211743,932,596,567,1575
10688,16402,3234,1,Business,26,4,37532,26,4,39732,26,4,40444,26,4,41458,26,4,45487,14,18.7,-1.3152797,36.8611458,-1.2874711,36.7646208,519,4029,2200,1726
10689,53,1926,3,Business,6,4,36637,6,4,36658,6,4,39501,6,4,39857,6,4,41819,11,19.6,-1.34364,36.8925345,-1.3065588,36.9076533,856,1962,21,3199
10690,24631,3075,1,Personal,28,5,49858,28,5,49930,28,5,50738,28,5,51248,28,5,52416,6,25.6,-1.3103512,36.814996,-1.2990731,36.8488058,932,1168,72,1318
10691,10689,3091,3,Business,18,5,42538,18,5,42577,18,5,43108,18,5,43235,18,5,45292,17,20.0,-1.2413316,36.8785525,-1.3012008,36.764868,581,2057,39,658
10692,16515,3283,3,Business,29,5,40479,29,5,40533,29,5,41062,29,5,41421,29,5,42708,7,26.6,-1.303596,36.778378,-1.2628473,36.781805,154,1287,54,888
10693,21026,2330,3,Business,4,2,39530,4,2,42444,4,2,42812,4,2,42987,4,2,45840,12,20.7,-1.3339536,36.7181,-1.3040812,36.7924217,204,2853,2914,543
10694,737,1859,3,Business,31,4,44677,31,4,44758,31,4,45804,31,4,47270,31,4,48509,8,21.6,-1.3037387,36.8175661,-1.2626765,36.795599,188,1239,81,2512
10695,27511,2789,3,Business,3,3,43467,3,3,43497,3,3,44357,3,3,44750,3,3,46553,8,27.6,-1.304735,36.7846054,-1.2623495,36.8049247,693,1803,30,1253
10696,28009,2062,1,Personal,15,7,53000,15,7,53044,15,7,54143,15,7,54371,15,7,56171,17,19.7,-1.2873232,36.7658572,-1.3267367,36.8844852,74,1800,44,1327
10697,9288,1316,3,Business,11,1,57155,11,1,57331,11,1,57963,11,1,58084,11,1,61203,23,28.9,-1.2551895,36.7822034,-1.3448483,36.9004081,520,3119,176,753
10698,24988,2154,3,Business,28,3,43133,28,3,43223,28,3,44534,28,3,44874,28,3,46229,8,23.25888921888938,-1.2584143,36.8048002,-1.2765736,36.8513646,674,1355,90,1651
10699,11778,3599,3,Business,2,4,32037,2,4,33521,2,4,34791,2,4,35362,2,4,36653,7,23.25888921888938,-1.3302996,36.8707935,-1.3031652,36.8466816,675,1291,1484,1841
10700,19870,600,1,Personal,7,7,44916,7,7,46153,7,7,47188,7,7,47773,7,7,48780,3,25.4,-1.2915307,36.7905865,-1.2852584,36.8043641,789,1007,1237,1620
10701,2060,136,3,Business,21,1,52145,21,1,52826,21,1,54521,21,1,54744,21,1,58375,20,27.5,-1.3254522,36.7216584,-1.2768704,36.8251777,489,3631,681,1918
10702,21375,2704,1,Personal,29,6,41903,29,6,41938,29,6,42793,29,6,43125,29,6,46827,29,25.0,-1.207546,36.7913976,-1.3091733,36.74081,247,3702,35,1187
10703,9122,71,3,Business,2,4,30272,2,4,30281,2,4,30975,2,4,31460,2,4,33004,11,13.2,-1.225322,36.80855,-1.2891922,36.825189,409,1544,9,1179
10704,13749,3080,3,Business,30,5,57680,30,5,58625,30,5,59528,30,5,60065,30,5,61481,12,21.8,-1.3207146,36.8305771,-1.2551895,36.7822034,647,1416,945,1440
10705,21114,3521,3,Business,6,1,53969,6,1,54019,6,1,55424,6,1,55711,6,1,56269,1,23.25888921888938,-1.2665327,36.8108799,-1.2696908,36.81519,132,558,50,1692
10706,19534,868,3,Business,14,2,56405,14,2,56450,14,2,57096,14,2,57324,14,2,58665,6,23.25888921888938,-1.307143,36.825009,-1.265715,36.823815,351,1341,45,874
10707,3669,246,3,Business,13,4,39095,13,4,44230,13,4,44849,13,4,45075,13,4,46749,10,22.0,-1.2584143,36.8048002,-1.2413316,36.8785525,646,1674,5135,845
10708,25882,2869,3,Business,24,3,61071,24,3,61186,24,3,61663,24,3,62259,24,3,63682,10,23.25888921888938,-1.2584143,36.8048002,-1.3025826,36.7670807,377,1423,115,1073
10709,23663,517,3,Business,29,3,47236,29,3,47259,29,3,47417,29,3,48145,29,3,50113,14,23.25888921888938,-1.3228003,36.8306435,-1.2991441,36.7528804,211,1968,23,886
10710,10393,3291,3,Business,1,1,52607,1,1,52761,1,1,53715,1,1,55095,1,1,56600,12,23.25888921888938,-1.331619,36.847976,-1.2600926,36.8088685,686,1505,154,2334
10711,7509,647,3,Business,3,3,38148,3,3,38200,3,3,39323,3,3,39903,3,3,40967,4,27.2,-1.2770708,36.8231093,-1.3004062,36.829741,96,1064,52,1703
10712,17443,3547,3,Business,17,3,42998,17,3,43071,17,3,43540,17,3,47333,17,3,51894,21,23.25888921888938,-1.3285517,36.9018,-1.2761408,36.7710839,883,4561,73,4262
10713,1441,3496,3,Business,21,1,55207,21,1,55230,21,1,55801,21,1,55925,21,1,57507,17,21.6,-1.3198615,36.7110323,-1.300921,36.828195,620,1582,23,695
10714,11794,3291,3,Business,2,2,40892,2,2,41177,2,2,42253,2,2,42495,2,2,44304,8,26.0,-1.2963367,36.8094235,-1.2600926,36.8088685,740,1809,285,1318
10715,814,393,3,Business,15,2,46752,15,2,46780,15,2,46787,15,2,47455,15,2,49344,14,24.1,-1.3167113,36.8301563,-1.2991441,36.7528804,583,1889,28,675
10716,15892,2289,3,Business,18,2,32616,18,2,32625,18,2,32667,18,2,33075,18,2,33551,1,19.9,-1.2551895,36.7822034,-1.2615888,36.7928732,708,476,9,450
10717,9748,3201,3,Business,19,3,56669,19,3,56939,19,3,57698,19,3,58094,19,3,60555,15,25.5,-1.3463042,36.768164,-1.2649605,36.7981777,328,2461,270,1155
10718,1828,2946,2,Personal,7,2,36987,7,2,37051,7,2,37612,7,2,38134,7,2,39377,8,23.2,-1.2749662,36.7658781,-1.2983462,36.8139996,229,1243,64,1083
10719,24497,3300,3,Business,16,2,56113,16,2,56152,16,2,56995,16,2,57405,16,2,58552,11,23.25888921888938,-1.318062,36.849326,-1.303596,36.778378,768,1147,39,1253
10720,210,3088,3,Business,21,4,67905,21,4,69829,21,4,72265,21,4,72998,21,4,74733,10,21.5,-1.2696795,36.8640088,-1.2551359,36.9062227,436,1735,1924,3169
10721,9062,3291,3,Business,21,5,38563,21,5,39063,21,5,39177,21,5,40444,21,5,41629,11,22.8,-1.2296618,36.8438272,-1.2600926,36.8088685,449,1185,500,1381
10722,4875,3647,3,Business,29,2,53961,29,2,54432,29,2,55131,29,2,55417,29,2,56400,6,27.0,-1.272639,36.794723,-1.2979383,36.7930618,829,983,471,985
10723,16976,2677,3,Business,16,4,35869,16,4,35913,16,4,35919,16,4,37745,16,4,40098,10,23.25888921888938,-1.3004062,36.829741,-1.2991441,36.7528804,99,2353,44,1832
10724,22424,2627,3,Business,3,1,56710,3,1,57057,3,1,57762,3,1,58244,3,1,59215,5,23.2,-1.2571472,36.7950633,-1.2857548,36.819062,407,971,347,1187
10725,9215,3291,3,Business,18,2,45499,18,2,45771,18,2,46160,18,2,47049,18,2,48276,9,23.25888921888938,-1.307143,36.825009,-1.2600926,36.8088685,932,1227,272,1278
10726,1107,1530,3,Personal,8,2,52014,8,2,52078,8,2,52517,8,2,52600,8,2,55066,10,25.3,-1.2924173,36.7797814,-1.3178263,36.7141818,674,2466,64,522
10727,9405,393,3,Business,26,5,34863,26,5,34885,26,5,34890,26,5,37064,26,5,37066,11,23.25888921888938,-1.3167113,36.8301563,-1.2638185,36.7930057,10,2,22,2179
10728,20170,3647,3,Business,15,2,55275,15,2,55301,15,2,56276,15,2,56455,15,2,58052,13,24.4,-1.272639,36.794723,-1.2309704,36.8688593,932,1597,26,1154
10729,2157,393,3,Business,6,3,40776,6,3,40789,6,3,40820,6,3,42119,6,3,42253,4,23.25888921888938,-1.3167113,36.8301563,-1.3004062,36.829741,436,134,13,1330
10730,18377,2523,3,Business,2,4,55996,2,4,56093,2,4,56227,2,4,56511,2,4,58195,11,23.25888921888938,-1.2551895,36.7822034,-1.3169651,36.8340857,764,1684,97,418
10731,5247,265,3,Business,11,5,52794,11,5,52984,11,5,54100,11,5,54451,11,5,55563,6,26.5,-1.267869,36.813379,-1.300921,36.828195,48,1112,190,1467
10732,8056,517,3,Business,31,1,49505,31,1,49525,31,1,49684,31,1,49959,31,1,52416,14,24.0,-1.3167113,36.8301563,-1.306378,36.7519845,523,2457,20,434
10733,10067,2212,3,Business,9,4,30933,9,4,30981,9,4,31482,9,4,31802,9,4,32179,3,23.25888921888938,-1.2571472,36.7950633,-1.2693017,36.8022778,96,377,48,821
10734,6769,1329,3,Business,24,4,45414,24,4,45551,24,4,46168,24,4,46510,24,4,48075,6,21.1,-1.273056,36.811298,-1.2946581,36.7792921,742,1565,137,959
10735,4072,2801,3,Business,8,5,37944,8,5,38311,8,5,39420,8,5,39967,8,5,41784,7,28.6,-1.2809847,36.8274169,-1.2674274,36.7870827,76,1817,367,1656
10736,2116,3222,3,Business,8,5,35572,8,5,35611,8,5,35739,8,5,36056,8,5,38126,12,22.9,-1.2551895,36.7822034,-1.3184779,36.8373109,523,2070,39,445
10737,20262,627,3,Business,12,2,42897,12,2,43052,12,2,43703,12,2,43772,12,2,46693,10,24.7,-1.2551895,36.7822034,-1.2380935,36.8072947,928,2921,155,720
10738,1479,3201,3,Business,28,4,45120,28,4,45237,28,4,45780,28,4,47153,28,4,48500,6,23.7,-1.2886923,36.8241519,-1.2584143,36.8048002,506,1347,117,1916
10739,21225,1724,3,Business,6,1,51000,6,1,51024,6,1,51726,6,1,51887,6,1,52975,8,24.6,-1.2905046,36.7828277,-1.2551895,36.7822034,722,1088,24,863
10740,11627,3222,3,Business,28,1,46898,28,1,47037,28,1,47935,28,1,48174,28,1,48904,4,23.5,-1.2551895,36.7822034,-1.2656922,36.8136944,434,730,139,1137
10741,8406,1578,3,Business,18,2,35319,18,2,35336,18,2,37484,18,2,39582,18,2,41206,16,22.6,-1.2143387,36.7914548,-1.28878,36.8168312,101,1624,17,4246
10742,13478,1340,3,Business,13,3,51069,13,3,51143,13,3,51933,13,3,52040,13,3,52364,2,29.2,-1.259381,36.8024189,-1.2707179,36.7979713,40,324,74,897
10743,27907,2423,3,Business,14,4,48437,14,4,48783,14,4,48815,14,4,49402,14,4,49440,2,28.0,-1.2551895,36.7822034,-1.2566586,36.7929682,446,38,346,619
10744,15774,2956,3,Business,11,2,50173,11,2,50181,11,2,51937,11,2,52243,11,2,53162,2,22.4,-1.2584143,36.8048002,-1.2571472,36.7950633,547,919,8,2062
10745,9416,3497,1,Personal,20,4,39096,20,4,39130,20,4,39605,20,4,39747,20,4,40842,9,24.2,-1.255683,36.813771,-1.22589,36.7822548,857,1095,34,617
10746,783,53,3,Business,7,1,54475,7,1,55512,7,1,55515,7,1,58609,7,1,58619,5,26.6,-1.3004062,36.829741,-1.2770708,36.8231093,188,10,1037,3097
10747,25220,733,3,Business,14,1,36216,14,1,36224,14,1,36263,14,1,36494,14,1,39087,21,20.2,-1.2551895,36.7822034,-1.3407764,36.9100521,353,2593,8,270
10748,26880,1075,3,Business,15,1,42312,15,1,42412,15,1,42427,15,1,43096,15,1,44423,5,23.25888921888938,-1.279395,36.825364,-1.2527958,36.8003131,338,1327,100,684
10749,21921,190,3,Business,23,4,52987,23,4,53142,23,4,54731,23,4,54928,23,4,56978,17,24.8,-1.2459607,36.7661735,-1.3270347,36.8667362,576,2050,155,1786
10750,10430,1958,3,Business,13,4,42287,13,4,42320,13,4,42508,13,4,44058,13,4,46129,21,21.9,-1.2551895,36.7822034,-1.3700383,36.9190174,952,2071,33,1738
10751,22383,1280,3,Business,13,4,46288,13,4,46415,13,4,46787,13,4,47159,13,4,47631,2,22.3,-1.2551895,36.7822034,-1.2567464,36.7915273,50,472,127,744
10752,5329,151,3,Business,22,1,32855,22,1,33016,22,1,33675,22,1,33831,22,1,34858,7,20.1,-1.2751745,36.7657676,-1.2620725,36.8026517,449,1027,161,815
10753,4815,700,3,Business,7,5,31042,7,5,31238,7,5,32988,7,5,33375,7,5,34265,7,18.3,-1.284452,36.8300885,-1.3205164,36.8098882,88,890,196,2137
10754,25168,1544,3,Business,11,2,32850,11,2,32935,11,2,34197,11,2,34542,11,2,35978,7,16.7,-1.2924639,36.7795798,-1.2538731,36.7850223,133,1436,85,1607
10755,16571,867,3,Business,27,2,29885,27,2,33232,27,2,33597,27,2,34925,27,2,36689,10,18.6,-1.2996533,36.8292629,-1.306378,36.7519845,631,1764,3347,1693
10756,23913,393,3,Business,2,6,31069,2,6,31649,2,6,32557,2,6,33745,2,6,33747,4,21.1,-1.3167113,36.8301563,-1.3004062,36.829741,26,2,580,2096
10757,24245,2801,3,Business,6,4,53969,6,4,54009,6,4,54338,6,4,54668,6,4,57111,10,23.3,-1.2595422,36.7871178,-1.2981102,36.8293513,651,2443,40,659
10758,19064,275,2,Personal,22,3,39919,22,3,39956,22,3,40345,22,3,40685,22,3,41136,5,22.8,-1.3066143,36.8161046,-1.2913246,36.8019522,249,451,37,729
10759,12866,346,3,Business,30,2,33114,30,2,33164,30,2,33461,30,2,34082,30,2,34964,2,23.25888921888938,-1.28878,36.8168312,-1.291768,36.8297208,204,882,50,918
10760,4678,1502,3,Business,19,1,41707,19,1,42164,19,1,42167,19,1,42758,19,1,43705,13,24.9,-1.2232123,36.8932547,-1.28878,36.8168312,886,947,457,594
10761,10374,2008,3,Business,26,5,52237,26,5,52325,26,5,53339,26,5,53953,26,5,55374,6,23.25888921888938,-1.2508229,36.7895263,-1.2745551,36.7979797,797,1421,88,1628
10762,24,238,3,Business,15,1,55537,15,1,55594,15,1,55912,15,1,57869,15,1,59793,16,23.25888921888938,-1.2991441,36.7528804,-1.3077869,36.8443207,628,1924,57,2275
10763,13666,1687,3,Business,13,4,39057,13,4,39083,13,4,39360,13,4,41387,13,4,46321,12,21.9,-1.2626574,36.8014034,-1.3288106,36.8697344,734,4934,26,2304
10764,16332,1085,3,Business,5,2,49618,5,2,49962,5,2,50546,5,2,51457,5,2,52911,16,23.25888921888938,-1.232864,36.8084708,-1.301908,36.7592822,746,1454,344,1495
10765,4703,1927,3,Business,11,1,50399,11,1,50483,11,1,52536,11,1,53709,11,1,55489,17,28.9,-1.2859912,36.8756811,-1.3472066,36.7692638,856,1780,84,3226
10766,9960,393,3,Business,10,4,48792,10,4,48809,10,4,48812,10,4,49399,10,4,50848,11,25.3,-1.3167113,36.8301563,-1.2574219,36.7927073,188,1449,17,590
10767,52,391,3,Business,1,5,39967,1,5,40092,1,5,41266,1,5,42107,1,5,43683,14,26.4,-1.3380736,36.8769529,-1.2784063,36.8222933,404,1576,125,2015
10768,19234,3326,3,Business,21,4,54174,21,4,54253,21,4,54257,21,4,54534,21,4,55255,4,26.5,-1.2551895,36.7822034,-1.2738522,36.7992818,523,721,79,281
10769,4188,3752,3,Business,15,3,49016,15,3,49065,15,3,49069,15,3,50046,15,3,50684,7,25.8,-1.3302996,36.8707935,-1.3263105,36.8622904,955,638,49,981
10770,18975,3688,3,Business,19,4,57792,19,4,57810,19,4,58661,19,4,58861,19,4,59287,3,20.7,-1.2551895,36.7822034,-1.2546732,36.8086796,903,426,18,1051
10771,4130,547,1,Personal,6,5,41334,6,5,41436,6,5,42586,6,5,43645,6,5,44942,6,20.5,-1.3082165,36.8320031,-1.2780652,36.8263376,844,1297,102,2209
10772,18322,2828,3,Business,27,3,56926,27,3,57022,27,3,57842,27,3,58394,27,3,59763,10,29.3,-1.2615888,36.7928732,-1.3149257,36.8441635,787,1369,96,1372
10773,6234,1329,3,Business,4,4,35449,4,4,35597,4,4,36080,4,4,36209,4,4,37537,6,21.6,-1.273056,36.811298,-1.2942023,36.7958179,85,1328,148,612
10774,1400,3599,3,Business,19,5,45335,19,5,46282,19,5,46357,19,5,48380,19,5,48824,10,24.7,-1.3302996,36.8707935,-1.3132709,36.9127044,179,444,947,2098
10775,13916,2224,3,Business,18,1,37400,18,1,37426,18,1,38570,18,1,38635,18,1,40900,15,27.9,-1.2132866,36.8678274,-1.2530752,36.7979863,327,2265,26,1209
10776,252,2211,2,Personal,14,5,37775,14,5,37802,14,5,38278,14,5,38607,14,5,39548,5,24.5,-1.2598002,36.7963379,-1.2658011,36.7919358,822,941,27,805
10777,5922,53,3,Business,4,4,42568,4,4,42703,4,4,43301,4,4,43498,4,4,45283,11,25.6,-1.2991441,36.7528804,-1.2770708,36.8231093,420,1785,135,795
10778,1829,1545,1,Personal,16,4,36738,16,4,36770,16,4,37692,16,4,38428,16,4,38976,5,14.5,-1.2535486,36.7933541,-1.2633494,36.7959696,520,548,32,1658
10779,9842,635,3,Business,23,5,38565,23,5,41558,23,5,42888,23,5,44201,23,5,45431,6,24.1,-1.3016417,36.8271679,-1.3229345,36.8566974,208,1230,2993,2643
10780,4793,3108,3,Business,15,5,36360,15,5,36789,15,5,37103,15,5,37450,15,5,38868,10,20.5,-1.2551895,36.7822034,-1.3156452,36.815802,326,1418,429,661
10781,13561,718,3,Business,28,1,56338,28,1,56388,28,1,56611,28,1,56761,28,1,58645,24,26.1,-1.2551895,36.7822034,-1.178056,36.9312342,882,1884,50,373
10782,4931,635,3,Business,11,4,40163,11,4,40351,11,4,40461,11,4,43083,11,4,43085,7,25.7,-1.2602337,36.7990548,-1.3081376,36.8329772,436,2,188,2732
10783,17467,3621,3,Business,6,4,32013,6,4,32034,6,4,33020,6,4,33255,6,4,33739,4,18.7,-1.2836583,36.7886014,-1.30217,36.770468,88,484,21,1221
10784,25143,391,3,Business,2,4,49373,2,4,49494,2,4,52315,2,4,52548,2,4,54057,5,23.25888921888938,-1.3091799,36.8313272,-1.2784063,36.8222933,815,1509,121,3054
10785,25438,393,3,Business,28,4,56102,28,4,56171,28,4,56444,28,4,56982,28,4,57708,4,30.0,-1.3167113,36.8301563,-1.3004062,36.829741,523,726,69,811
10786,5328,1620,3,Personal,29,2,58197,29,2,58281,29,2,59002,29,2,59474,29,2,61761,11,23.7,-1.261849,36.808254,-1.227132,36.8374277,852,2287,84,1193
10787,24751,1471,3,Business,19,3,40756,19,3,41400,19,3,44405,19,3,44674,19,3,45355,6,22.2,-1.2551895,36.7822034,-1.2415412,36.7641607,453,681,644,3274
10788,10787,1976,3,Business,30,5,42417,30,5,42487,30,5,43276,30,5,43688,30,5,45950,14,23.6,-1.257028,36.7810435,-1.3222627,36.8234096,138,2262,70,1201
10789,21701,1920,3,Business,14,3,56194,14,3,58217,14,3,59211,14,3,61022,14,3,63708,18,23.3,-1.2551895,36.7822034,-1.2688353,36.9013859,403,2686,2023,2805
10790,13213,3521,3,Business,31,2,49463,31,2,49503,31,2,50423,31,2,52030,31,2,54020,8,22.3,-1.3031971,36.7863146,-1.2696908,36.81519,851,1990,40,2527
10791,4244,3283,3,Business,21,2,49155,21,2,49254,21,2,49967,21,2,50343,21,2,51249,7,25.0,-1.303596,36.778378,-1.2628473,36.781805,138,906,99,1089
10792,5209,868,3,Business,9,6,38585,9,6,38610,9,6,39185,9,6,40283,9,6,41380,8,24.7,-1.303596,36.778378,-1.265715,36.823815,263,1097,25,1673
10793,27482,3470,3,Business,9,5,44783,9,5,49992,9,5,50558,9,5,50847,9,5,51673,5,26.3,-1.2584143,36.8048002,-1.28878,36.8168312,265,826,5209,855
10794,20608,393,3,Business,6,3,58400,6,3,58417,6,3,58579,6,3,58830,6,3,60145,3,23.25888921888938,-1.3167113,36.8301563,-1.3210541,36.8169608,842,1315,17,413
10795,10446,978,1,Personal,20,3,46118,20,3,46125,20,3,46591,20,3,47106,20,3,49049,25,20.1,-1.3084067,36.8345014,-1.4302983,36.9613684,549,1943,7,981
10796,1334,265,3,Business,9,4,53763,9,4,54670,9,4,55740,9,4,56170,9,4,57321,15,25.6,-1.3486163,36.732494,-1.300921,36.828195,636,1151,907,1500
10797,16763,1389,3,Business,30,2,54864,30,2,55484,30,2,56200,30,2,56766,30,2,58307,15,27.2,-1.207546,36.7913976,-1.2591019,36.800577,754,1541,620,1282
10798,8773,540,3,Business,8,2,42227,8,2,42322,8,2,42742,8,2,43187,8,2,43880,6,23.3,-1.2571472,36.7950633,-1.2967702,36.8040381,247,693,95,865
10799,4127,2330,3,Business,20,4,39025,20,4,39112,20,4,39596,20,4,40015,20,4,41084,10,22.3,-1.2642903,36.8002137,-1.2687407,36.7373043,50,1069,87,903
10800,11437,2956,3,Business,2,2,60073,2,2,60145,2,2,60711,2,2,60784,2,2,61728,3,28.6,-1.2584143,36.8048002,-1.2551895,36.7822034,913,944,72,639
10801,22569,868,3,Business,27,6,45002,27,6,45557,27,6,46973,27,6,47458,27,6,48163,10,23.25888921888938,-1.228911,36.881876,-1.265715,36.823815,484,705,555,1901
10802,3892,1085,3,Business,30,5,40606,30,5,40730,30,5,41217,30,5,42009,30,5,46081,18,23.8,-1.316539,36.7068562,-1.2536275,36.7987932,655,4072,124,1279
10803,7660,2534,3,Personal,18,4,52655,18,4,52708,18,4,54477,18,4,55026,18,4,58747,11,23.25888921888938,-1.3447657,36.9009653,-1.3127877,36.8481987,883,3721,53,2318
10804,20505,2982,3,Business,10,5,33674,10,5,36994,10,5,37563,10,5,38514,10,5,42146,18,19.0,-1.300921,36.828195,-1.177202,36.8351183,471,3632,3320,1520
10805,22005,3222,3,Business,29,3,50225,29,3,50550,29,3,51002,29,3,51248,29,3,52769,11,21.2,-1.2551895,36.7822034,-1.3038543,36.8381051,183,1521,325,698
10806,13550,867,3,Business,16,3,48539,16,3,49026,16,3,49725,16,3,50119,16,3,51610,10,25.7,-1.306378,36.7519845,-1.2996533,36.8292629,543,1491,487,1093
10807,20689,517,3,Business,18,6,41365,18,6,41381,18,6,41487,18,6,42588,18,6,42590,4,21.1,-1.3167113,36.8301563,-1.3004062,36.829741,349,2,16,1207
10808,23952,3139,2,Personal,5,2,52936,5,2,52958,5,2,53545,5,2,53777,5,2,54983,4,22.6,-1.2854453,36.8188363,-1.2965924,36.8179314,531,1206,22,819
10809,19764,2523,3,Business,16,1,38846,16,1,41210,16,1,41740,16,1,41955,16,1,43691,8,19.5,-1.2551895,36.7822034,-1.295156,36.8094306,140,1736,2364,745
10810,666,2931,3,Business,27,3,53405,27,3,54478,27,3,56011,27,3,56896,27,3,59190,23,29.3,-1.3433181,36.9138018,-1.2452664,36.8028541,524,2294,1073,2418
10811,10877,3647,3,Business,9,2,38389,9,2,38431,9,2,39777,9,2,40272,9,2,40795,5,27.2,-1.2963316,36.7863289,-1.272639,36.794723,829,523,42,1841
10812,6382,909,3,Business,24,2,37001,24,2,37010,24,2,38333,24,2,38604,24,2,41034,20,17.6,-1.2859912,36.8756811,-1.225322,36.80855,549,2430,9,1594
10813,23847,1711,3,Business,7,6,49431,7,6,49439,7,6,49578,7,6,50946,7,6,51463,2,21.6,-1.2699491,36.8135968,-1.2689559,36.8097614,379,517,8,1507
10814,1870,3283,3,Business,17,4,38302,17,4,38388,17,4,38789,17,4,39249,17,4,39905,5,25.4,-1.2600926,36.8088685,-1.2628473,36.781805,40,656,86,861
10815,4390,1441,2,Personal,24,2,54390,24,2,54490,24,2,55783,24,2,57649,24,2,58592,6,18.4,-1.298529,36.816482,-1.2849763,36.7841767,937,943,100,3159
10816,26397,1363,3,Business,26,5,43237,26,5,44123,26,5,44517,26,5,44633,26,5,45855,10,23.25888921888938,-1.3004062,36.829741,-1.2991441,36.7528804,867,1222,886,510
10817,9071,3076,1,Personal,21,1,43578,21,1,43716,21,1,44333,21,1,45284,21,1,47241,8,20.0,-1.3034072,36.8218035,-1.2615584,36.8149506,286,1957,138,1568
10818,6229,3510,1,Business,14,1,39093,14,1,39105,14,1,40083,14,1,40689,14,1,42325,11,23.1,-1.2603992,36.7878594,-1.22589,36.7822548,865,1636,12,1584
10819,8213,1787,3,Business,10,4,48077,10,4,48096,10,4,49480,10,4,49915,10,4,51374,9,25.4,-1.2859912,36.8756811,-1.2283403,36.8822756,81,1459,19,1819
10820,20132,2030,3,Business,11,1,41214,11,1,41476,11,1,42102,11,1,42943,11,1,43959,5,24.2,-1.3100586,36.8500329,-1.29658,36.823699,72,1016,262,1467
10821,23729,1500,3,Business,18,4,29492,18,4,30096,18,4,32269,18,4,32443,18,4,33093,6,20.4,-1.2770708,36.8231093,-1.2574219,36.7927073,208,650,604,2347
10822,11930,1363,3,Business,9,2,40649,9,2,40876,9,2,41545,9,2,41933,9,2,43116,8,22.1,-1.3004062,36.829741,-1.2574219,36.7927073,882,1183,227,1057
10823,20721,3689,3,Business,4,2,54078,4,2,55974,4,2,57283,4,2,57677,4,2,58972,9,23.8,-1.2962832,36.7849683,-1.2527958,36.8003131,847,1295,1896,1703
10824,9610,635,3,Business,29,4,53777,29,4,53985,29,4,54628,29,4,55712,29,4,57334,7,25.0,-1.2599563,36.7993439,-1.3016417,36.8271679,646,1622,208,1727
10825,6846,1082,2,Personal,16,4,36680,16,4,36731,16,4,38649,16,4,38739,16,4,40305,7,14.8,-1.291768,36.8297208,-1.2963097,36.7688221,402,1566,51,2008
10826,397,2651,3,Business,8,3,51416,8,3,53045,8,3,53049,8,3,56605,8,3,57023,6,23.25888921888938,-1.2818522,36.8197495,-1.2974015,36.7772406,61,418,1629,3560
10827,6983,3291,3,Business,5,2,36353,5,2,36384,5,2,36717,5,2,37058,5,2,38789,13,18.2,-1.3313643,36.8577422,-1.2600926,36.8088685,926,1731,31,674
10828,12046,1340,3,Business,13,3,55779,13,3,55790,13,3,56283,13,3,56682,13,3,57719,6,29.0,-1.3007714,36.8001722,-1.2707179,36.7979713,25,1037,11,892
10829,22561,246,3,Business,6,1,56856,6,1,56883,6,1,56890,6,1,57520,6,1,58468,5,24.5,-1.279395,36.825364,-1.2584143,36.8048002,531,948,27,637
10830,3939,1573,1,Personal,5,5,40301,5,5,40360,5,5,40861,5,5,40946,5,5,41708,4,23.8,-1.273056,36.811298,-1.2724885,36.7856999,16,762,59,586
10831,4160,990,1,Business,14,4,60550,14,4,60660,14,4,60919,14,4,61317,14,4,63288,16,21.0,-1.263593,36.7882903,-1.3416856,36.7180208,101,1971,110,657
10832,5510,2258,3,Business,6,2,32997,6,2,33174,6,2,33895,6,2,34102,6,2,35537,10,19.7,-1.2571472,36.7950633,-1.2861447,36.7483206,762,1435,177,928
10833,16648,868,3,Business,20,1,50803,20,1,50818,20,1,51158,20,1,51800,20,1,52454,6,21.3,-1.265715,36.823815,-1.2628473,36.781805,932,654,15,982
10834,27105,570,3,Business,16,2,34416,16,2,34454,16,2,34953,16,2,35123,16,2,37362,11,23.25888921888938,-1.2649605,36.7981777,-1.3322618,36.8045412,245,2239,38,669
10835,22509,1392,3,Business,13,3,36051,13,3,36481,13,3,37294,13,3,37420,13,3,38580,7,17.3,-1.2551895,36.7822034,-1.2898179,36.8270849,452,1160,430,939
10836,24284,1392,3,Business,11,4,49644,11,4,53651,11,4,53699,11,4,54225,11,4,55632,8,26.8,-1.2551895,36.7822034,-1.295723,36.822692,245,1407,4007,574
10837,16556,2457,3,Business,26,5,45177,26,5,45233,26,5,46029,26,5,46139,26,5,46141,3,23.25888921888938,-1.2551895,36.7822034,-1.2544973,36.8061844,485,2,56,906
10838,8595,393,3,Business,15,6,42472,15,6,42842,15,6,43008,15,6,43477,15,6,45692,14,21.8,-1.3167113,36.8301563,-1.306378,36.7519845,555,2215,370,635
10839,3962,190,3,Business,29,3,51449,29,3,51623,29,3,52020,29,3,52431,29,3,54795,11,21.3,-1.3270347,36.8667362,-1.2897399,36.8270975,709,2364,174,808
10840,22800,733,3,Business,5,2,42217,5,2,42227,5,2,42278,5,2,43138,5,2,47131,20,23.6,-1.2551895,36.7822034,-1.3185307,36.9001089,831,3993,10,911
10841,8661,265,3,Business,30,2,39588,30,2,39625,30,2,40215,30,2,41143,30,2,43932,40,22.5,-1.300921,36.828195,-1.1481468,36.6515879,619,2789,37,1518
10842,14506,814,3,Business,31,3,26630,31,3,26650,31,3,26841,31,3,26952,31,3,28231,10,15.4,-1.2571472,36.7950633,-1.3014461,36.7661381,731,1279,20,302
10843,819,2330,3,Business,26,5,62138,26,5,62209,26,5,62643,26,5,62864,26,5,63381,5,23.25888921888938,-1.3040812,36.7924217,-1.293082,36.8278578,906,517,71,655
10844,20345,3727,3,Business,13,2,39665,13,2,39730,13,2,40279,13,2,40903,13,2,42644,7,22.5,-1.2963097,36.7688221,-1.268276,36.800139,147,1741,65,1173
10845,20666,1687,3,Business,28,3,47871,28,3,48247,28,3,49295,28,3,49463,28,3,50776,7,23.25888921888938,-1.2626574,36.8014034,-1.3014732,36.7781201,147,1313,376,1216
10846,12471,646,3,Personal,19,3,43776,19,3,44129,19,3,44671,19,3,45066,19,3,45216,2,22.2,-1.2951264,36.798382,-1.2809121,36.7852524,720,150,353,937
10847,20710,3372,3,Business,30,6,56830,30,6,57107,30,6,58219,30,6,58436,30,6,60486,13,23.9,-1.304033,36.7848695,-1.232004,36.7902146,449,2050,277,1329
10848,1416,1502,3,Business,19,1,63852,19,1,63950,19,1,64836,19,1,65179,19,1,66263,13,23.5,-1.2584143,36.8048002,-1.2232123,36.8932547,932,1084,98,1229
10849,16224,2789,3,Business,9,2,36541,9,2,36629,9,2,37519,9,2,37849,9,2,39051,8,20.9,-1.304735,36.7846054,-1.2592428,36.7894541,953,1202,88,1220
10850,6288,84,3,Business,22,2,45308,22,2,45346,22,2,45439,22,2,46957,22,2,48687,11,24.1,-1.2551895,36.7822034,-1.3141837,36.8163275,379,1730,38,1611
10851,3019,1368,3,Business,10,4,36251,10,4,36305,10,4,36630,10,4,37099,10,4,38511,15,19.1,-1.2571472,36.7950633,-1.2190317,36.8825092,477,1412,54,794
10852,27449,3647,3,Business,25,4,55360,25,4,55548,25,4,56131,25,4,60407,25,4,61881,5,23.25888921888938,-1.272639,36.794723,-1.264917,36.8150651,774,1474,188,4859
10853,2115,1304,3,Business,29,1,56001,29,1,58447,29,1,58484,29,1,62294,29,1,63332,9,23.3,-1.2824535,36.8265153,-1.3332749,36.8708147,669,1038,2446,3847
10854,10285,435,3,Business,30,4,41759,30,4,41787,30,4,42272,30,4,42456,30,4,44403,18,23.25888921888938,-1.319613,36.711055,-1.300921,36.828195,571,1947,28,669
10855,22435,633,3,Business,23,3,49843,23,3,49939,23,3,50112,23,3,50429,23,3,51323,5,27.2,-1.2770708,36.8231093,-1.3004062,36.829741,714,894,96,490
10856,975,84,3,Business,21,3,56404,21,3,56595,21,3,57194,21,3,57362,21,3,60612,15,23.3,-1.2551895,36.7822034,-1.3280122,36.7861446,456,3250,191,767
10857,14729,412,3,Business,26,2,32263,26,2,32334,26,2,35708,26,2,36686,26,2,43436,12,22.0,-1.3313643,36.8577422,-1.266837,36.799249,787,6750,71,4352
10858,14884,1195,3,Business,25,1,57545,25,1,57571,25,1,60010,25,1,61768,25,1,63652,20,28.3,-1.2991441,36.7528804,-1.3228003,36.8306435,855,1884,26,4197
10859,14724,3517,3,Business,30,6,37320,30,6,37348,30,6,37695,30,6,38806,30,6,40571,21,26.8,-1.3033328,36.7561697,-1.3882008,36.7699445,855,1765,28,1458
10860,6140,626,3,Personal,21,4,36987,21,4,37043,21,4,37780,21,4,37861,21,4,38353,3,19.1,-1.2683391,36.7983796,-1.269534,36.80697,412,492,56,818
10861,23265,1271,3,Business,30,2,53189,30,2,53753,30,2,56474,30,2,56606,30,2,58667,26,27.5,-1.3244885,36.897792,-1.3949989,36.7654761,699,2061,564,2853
10862,5525,1271,3,Business,10,1,52435,10,1,52472,10,1,53074,10,1,54323,10,1,58820,23,18.8,-1.3107918,36.761794,-1.2927792,36.9053492,279,4497,37,1851
10863,13572,2066,3,Business,13,3,41848,13,3,43681,13,3,44120,13,3,44994,13,3,46684,6,20.0,-1.316961,36.820337,-1.3288576,36.8465936,844,1690,1833,1313
10864,9514,2947,1,Personal,17,1,57454,17,1,57462,17,1,57743,17,1,58140,17,1,58759,3,28.1,-1.26249,36.799715,-1.2731477,36.7950803,727,619,8,678
10865,15566,1500,3,Business,27,1,46144,27,1,46207,27,1,46722,27,1,46988,27,1,48554,10,20.6,-1.2991441,36.7528804,-1.2638185,36.7930057,829,1566,63,781
10866,13084,562,3,Business,14,5,44568,14,5,44666,14,5,45371,14,5,45730,14,5,47290,8,21.9,-1.3227181,36.8528097,-1.2814273,36.8132815,243,1560,98,1064
10867,5418,2523,3,Business,23,5,34054,23,5,38070,23,5,38548,23,5,39200,23,5,40333,8,24.1,-1.2551895,36.7822034,-1.3038156,36.8122733,726,1133,4016,1130
10868,1869,3080,3,Business,13,3,54004,13,3,54031,13,3,54714,13,3,55107,13,3,57017,17,27.3,-1.2551895,36.7822034,-1.3339943,36.7263409,267,1910,27,1076
10869,16783,3201,3,Business,14,1,55056,14,1,55068,14,1,55347,14,1,56172,14,1,56875,9,25.8,-1.3014461,36.7661381,-1.2584143,36.8048002,456,703,12,1104
10870,7574,978,1,Personal,2,6,32858,2,6,32936,2,6,33614,2,6,34273,2,6,35973,5,20.1,-1.3084067,36.8345014,-1.2805312,36.8326687,844,1700,78,1337
10871,5711,2066,3,Business,18,4,34871,18,4,35062,18,4,35560,18,4,36382,18,4,37552,7,23.25888921888938,-1.3210189,36.8410551,-1.2795796,36.819062,96,1170,191,1320
10872,11506,1882,3,Business,28,1,45464,28,1,45478,28,1,45715,28,1,46189,28,1,47201,9,23.6,-1.2958783,36.7928125,-1.253784,36.79907,383,1012,14,711
10873,10635,3541,2,Personal,7,5,55576,7,5,55662,7,5,56523,7,5,57020,7,5,58645,9,25.0,-1.2750415,36.7965813,-1.2804227,36.8250375,89,1625,86,1358
10874,10367,1341,3,Business,7,1,46507,7,1,48214,7,1,49344,7,1,49987,7,1,50496,7,20.3,-1.318062,36.849326,-1.331619,36.847976,751,509,1707,1773
10875,11450,1987,1,Personal,4,3,42584,4,3,42692,4,3,43471,4,3,43575,4,3,44454,3,17.1,-1.3044313,36.818504,-1.2858997,36.8138634,629,879,108,883
10876,22496,2066,3,Business,14,3,64629,14,3,64695,14,3,65651,14,3,66146,14,3,68443,8,23.3,-1.3270716,36.8406371,-1.2917004,36.8802381,554,2297,66,1451
10877,10754,375,3,Business,9,2,28987,9,2,29005,9,2,30699,9,2,30853,9,2,31671,5,20.6,-1.2551895,36.7822034,-1.2658315,36.809049,166,818,18,1848
10878,11917,393,3,Business,15,5,35575,15,5,35585,15,5,35741,15,5,36496,15,5,38451,14,19.3,-1.3167113,36.8301563,-1.2991441,36.7528804,349,1955,10,911
10879,5401,1719,3,Business,7,5,30509,7,5,30657,7,5,31528,7,5,32037,7,5,34037,12,23.25888921888938,-1.353975,36.7263802,-1.2963097,36.7688221,643,2000,148,1380
10880,11306,265,3,Business,17,5,35463,17,5,35511,17,5,35871,17,5,36445,17,5,37455,7,14.5,-1.2642903,36.8002137,-1.300921,36.828195,857,1010,48,934
10881,21863,302,3,Business,15,6,43889,15,6,43913,15,6,44100,15,6,45049,15,6,45057,1,23.25888921888938,-1.2649605,36.7981777,-1.2676026,36.8103629,882,8,24,1136
10882,1402,1482,3,Business,2,2,58143,2,2,58362,2,2,58849,2,2,59769,2,2,60953,7,28.3,-1.2664135,36.8322682,-1.2822773,36.7953121,383,1184,219,1407
10883,6961,346,3,Business,9,2,48983,9,2,49046,9,2,50060,9,2,50647,9,2,51560,8,30.4,-1.3025826,36.7670807,-1.28878,36.8168312,855,913,63,1601
10884,7681,3264,3,Business,31,3,59866,31,3,60037,31,3,60063,31,3,60309,31,3,62587,14,24.4,-1.2551895,36.7822034,-1.3332749,36.8708147,38,2278,171,272
10885,25509,71,3,Business,4,3,45528,4,3,45584,4,3,46402,4,3,46586,4,3,50374,9,17.2,-1.2891922,36.825189,-1.2646084,36.8028645,498,3788,56,1002
10886,22998,598,1,Business,23,6,37596,23,6,37618,23,6,40090,23,6,40842,23,6,42477,19,23.25888921888938,-1.2138373,36.7998572,-1.2590946,36.7607115,101,1635,22,3224
10887,20935,75,2,Personal,12,3,54817,12,3,54840,12,3,56474,12,3,56901,12,3,59448,19,26.5,-1.2367887,36.8628024,-1.3014462,36.7607695,384,2547,23,2061
10888,13874,3222,3,Business,14,2,57083,14,2,57105,14,2,57114,14,2,57439,14,2,58121,5,23.25888921888938,-1.2551895,36.7822034,-1.2731645,36.7900343,576,682,22,334
10889,26748,393,3,Business,16,2,57586,16,2,57598,16,2,57602,16,2,58622,16,2,58626,6,23.25888921888938,-1.3167113,36.8301563,-1.3077869,36.8443207,10,4,12,1024
10890,207,2587,3,Business,5,5,56896,5,5,57374,5,5,58117,5,5,58255,5,5,60001,9,27.5,-1.28878,36.8168312,-1.3097517,36.8645223,48,1746,478,881
10891,15802,635,3,Business,13,4,34479,13,4,34774,13,4,35111,13,4,38070,13,4,39134,11,21.9,-1.2403615,36.872332,-1.2599563,36.7993439,925,1064,295,3296
10892,15902,1245,3,Business,6,6,37541,6,6,37551,6,6,38147,6,6,39158,6,6,41026,17,26.9,-1.300921,36.828195,-1.3198615,36.7110323,728,1868,10,1607
10893,27765,2956,3,Business,23,2,53629,23,2,53837,23,2,54198,23,2,55100,23,2,57303,9,19.0,-1.3014461,36.7661381,-1.2584143,36.8048002,565,2203,208,1263
10894,48,627,3,Business,16,4,42546,16,4,42626,16,4,43644,16,4,44000,16,4,45238,9,23.25888921888938,-1.3012173,36.8093987,-1.2551895,36.7822034,591,1238,80,1374
10895,15852,2828,3,Business,22,5,33632,22,5,33650,22,5,33801,22,5,35353,22,5,36640,16,23.25888921888938,-1.2615888,36.7928732,-1.2155671,36.8898931,555,1287,18,1703
10896,2435,3222,3,Business,21,1,52279,21,1,52304,21,1,52577,21,1,53892,21,1,53903,8,27.6,-1.2551895,36.7822034,-1.295156,36.8094306,576,11,25,1588
10897,18114,1329,3,Business,7,2,59076,7,2,59184,7,2,59737,7,2,60031,7,2,62734,5,23.25888921888938,-1.273056,36.811298,-1.3028118,36.8174764,309,2703,108,847
10898,17677,2066,3,Business,9,2,62066,9,2,62699,9,2,63684,9,2,63881,9,2,65974,6,19.0,-1.316961,36.820337,-1.3111839,36.8426837,662,2093,633,1182
10899,21396,2323,1,Personal,20,4,50158,20,4,50355,20,4,50457,20,4,50763,20,4,51677,6,27.8,-1.2621576,36.8103473,-1.2985749,36.8088,88,914,197,408
10900,23540,391,3,Business,1,4,37707,1,4,40065,1,4,40777,1,4,41214,1,4,43278,18,23.25888921888938,-1.3882008,36.7699445,-1.2867454,36.8259017,88,2064,2358,1149
10901,7224,2956,3,Business,26,2,50654,26,2,50689,26,2,51053,26,2,52315,26,2,53532,9,30.8,-1.3014461,36.7661381,-1.2584143,36.8048002,354,1217,35,1626
10902,6594,1576,3,Business,29,2,58645,29,2,59340,29,2,60191,29,2,61025,29,2,63007,7,22.5,-1.2740925,36.8340107,-1.3100609,36.8205365,949,1982,695,1685
10903,19423,467,3,Business,7,2,34708,7,2,34722,7,2,34965,7,2,35233,7,2,39247,36,23.25888921888938,-1.304735,36.7846054,-1.1247063,36.6795585,952,4014,14,511
10904,6322,3354,3,Business,24,4,46981,24,4,49815,24,4,49887,24,4,50096,24,4,51071,2,28.1,-1.3700383,36.9190174,-1.3708843,36.921096,746,975,2834,281
10905,26417,3686,3,Business,22,5,56174,22,5,56884,22,5,57515,22,5,58793,22,5,59250,6,27.1,-1.2551895,36.7822034,-1.2819608,36.8109939,411,457,710,1909
10906,4268,593,1,Personal,3,2,56802,3,2,63507,3,2,65408,3,2,65491,3,2,67249,9,18.8,-1.271337,36.786712,-1.2665477,36.7410165,465,1758,6705,1984
10907,9713,2701,3,Business,7,5,38821,7,5,41057,7,5,41693,7,5,42161,7,5,46433,12,23.25888921888938,-1.302605,36.766219,-1.2765736,36.8513646,827,4272,2236,1104
10908,118,3688,3,Business,14,4,52978,14,4,53077,14,4,54300,14,4,55739,14,4,58432,12,27.5,-1.2551895,36.7822034,-1.2613229,36.8657183,432,2693,99,2662
10909,28117,3647,3,Business,14,2,40359,14,2,40395,14,2,40994,14,2,41385,14,2,43055,12,23.25888921888938,-1.272639,36.794723,-1.2287314,36.8367354,161,1670,36,990
10910,13590,2423,3,Business,14,5,45714,14,5,45772,14,5,46366,14,5,47185,14,5,48820,7,21.9,-1.2571472,36.7950633,-1.3012173,36.8093987,829,1635,58,1413
10911,11270,1876,1,Personal,6,3,31737,6,3,33731,6,3,35356,6,3,35918,6,3,37089,8,16.2,-1.289498,36.818878,-1.2999633,36.8532683,846,1171,1994,2187
10912,331,1244,3,Business,10,4,34323,10,4,34364,10,4,36196,10,4,36334,10,4,39471,8,19.4,-1.265715,36.823815,-1.303596,36.778378,918,3137,41,1970
10913,11746,391,3,Business,14,2,48653,14,2,48684,14,2,49061,14,2,49796,14,2,50766,7,23.25888921888938,-1.2867454,36.8259017,-1.2901262,36.7951047,291,970,31,1112
10914,20715,1073,3,Business,4,4,62272,4,4,62334,4,4,62797,4,4,63111,4,4,65097,10,23.25888921888938,-1.2563576,36.7881585,-1.2983805,36.8198439,74,1986,62,777
10915,21485,2247,2,Personal,29,2,48367,29,2,48380,29,2,48456,29,2,50194,29,2,52188,12,23.6,-1.324282,36.86625,-1.2846,36.7873609,379,1994,13,1814
10916,25725,412,3,Business,4,1,54742,4,1,54776,4,1,54889,4,1,55086,4,1,57059,7,28.5,-1.303596,36.778378,-1.266837,36.799249,605,1973,34,310
10917,1285,111,3,Business,6,4,48931,6,4,48959,6,4,49173,6,4,49667,6,4,51503,9,21.5,-1.2551895,36.7822034,-1.3023756,36.7949276,676,1836,28,708
10918,16496,1787,3,Business,21,3,45121,21,3,45413,21,3,49013,21,3,50806,21,3,51800,11,23.1,-1.279395,36.825364,-1.2283403,36.8822756,812,994,292,5393
10919,14265,3450,3,Business,8,5,39676,8,5,40068,8,5,41286,8,5,41582,8,5,42636,7,24.3,-1.2551895,36.7822034,-1.292044,36.821938,489,1054,392,1514
10920,27918,215,3,Personal,24,2,61678,24,2,61699,24,2,62897,24,2,63130,24,2,63932,5,18.8,-1.283362,36.8260149,-1.2735166,36.8012556,670,802,21,1431
10921,524,154,2,Business,22,5,46155,22,5,46168,22,5,47060,22,5,48455,22,5,49561,11,21.8,-1.2551895,36.7822034,-1.3107918,36.761794,116,1106,13,2287
10922,17878,2701,3,Business,24,4,52303,24,4,52473,24,4,53007,24,4,53432,24,4,54707,10,22.5,-1.279395,36.825364,-1.2478187,36.8844611,124,1275,170,959
10923,16138,948,3,Business,9,4,50854,9,4,51849,9,4,52099,9,4,53461,9,4,57968,10,23.25888921888938,-1.3200694,36.7931306,-1.2696908,36.81519,557,4507,995,1612
10924,24250,3588,3,Business,20,2,40027,20,2,40054,20,2,40370,20,2,41176,20,2,42721,20,19.8,-1.3632421,36.9183909,-1.2985749,36.8088,598,1545,27,1122
10925,12207,265,3,Business,14,2,47686,14,2,47733,14,2,49752,14,2,49922,14,2,52134,15,23.25888921888938,-1.3459625,36.9073925,-1.300921,36.828195,856,2212,47,2189
10926,18717,3560,3,Business,12,2,55957,12,2,56008,12,2,56236,12,2,56579,12,2,57286,5,23.25888921888938,-1.2584143,36.8048002,-1.279395,36.825364,903,707,51,571
10927,5476,3291,3,Business,13,4,53349,13,4,53629,13,4,54679,13,4,55123,13,4,55992,4,22.2,-1.272828,36.816608,-1.2600926,36.8088685,727,869,280,1494
10928,10693,3565,3,Business,4,7,37239,4,7,37246,4,7,37333,4,7,37787,4,7,40031,35,17.7,-1.2844665,36.7866113,-1.1140488,37.0120302,45,2244,7,541
10929,23962,3186,3,Business,17,5,50231,17,5,50296,17,5,50891,17,5,51171,17,5,52544,3,23.25888921888938,-1.2980229,36.78865,-1.2854406,36.789409,815,1373,65,875
10930,760,1500,3,Business,2,2,57004,2,2,57091,2,2,57413,2,2,58372,2,2,59544,11,29.2,-1.3077869,36.8443207,-1.2638185,36.7930057,809,1172,87,1281
10931,2153,1346,3,Business,5,5,46589,5,5,46604,5,5,46956,5,5,47116,5,5,48271,6,24.5,-1.2917868,36.7872675,-1.2695287,36.7981777,138,1155,15,512
10932,28177,3194,3,Business,15,5,47758,15,5,48367,15,5,49027,15,5,49684,15,5,51193,7,17.8,-1.2551895,36.7822034,-1.2857548,36.819062,119,1509,609,1317
10933,3356,3686,3,Business,15,1,45138,15,1,45166,15,1,45233,15,1,45442,15,1,48029,18,23.25888921888938,-1.2551895,36.7822034,-1.319048,36.8943118,709,2587,28,276
10934,6525,1796,3,Business,27,3,45283,27,3,45378,27,3,45969,27,3,46246,27,3,46657,7,26.2,-1.307143,36.825009,-1.331619,36.847976,524,411,95,868
10935,17933,3064,3,Business,21,1,52536,21,1,52580,21,1,52801,21,1,53100,21,1,53689,4,27.7,-1.2571472,36.7950633,-1.245477,36.785037,205,589,44,520
10936,5239,2457,3,Business,18,2,38154,18,2,39107,18,2,39228,18,2,39601,18,2,41175,7,23.25888921888938,-1.2551895,36.7822034,-1.2891116,36.810438,518,1574,953,494
10937,18957,2330,3,Business,13,4,40912,13,4,43418,13,4,43820,13,4,44253,13,4,48325,5,22.1,-1.2642903,36.8002137,-1.2846026,36.8219425,247,4072,2506,835
10938,16974,1961,3,Business,7,5,49542,7,5,51241,7,5,56678,7,5,59172,7,5,61367,25,23.25888921888938,-1.3393547,36.8910035,-1.3188359,36.7038526,787,2195,1699,7931
10939,15096,3599,3,Business,14,5,38257,14,5,38281,14,5,39372,14,5,42976,14,5,42978,7,22.1,-1.3302996,36.8707935,-1.3270347,36.8667362,459,2,24,4695
10940,26630,2956,3,Business,12,1,36555,12,1,36572,12,1,37277,12,1,37687,12,1,38827,2,19.5,-1.2527958,36.8003131,-1.2584143,36.8048002,112,1140,17,1115
10941,15883,248,3,Business,14,4,45914,14,4,46057,14,4,47549,14,4,48726,14,4,50438,6,27.6,-1.2971877,36.8270159,-1.304735,36.7846054,863,1712,143,2669
10942,10867,439,3,Business,23,4,42054,23,4,42604,23,4,43386,23,4,44261,23,4,45343,9,23.4,-1.3250048,36.8697188,-1.333148,36.922453,591,1082,550,1657
10943,11819,1075,3,Business,3,3,44019,3,3,44162,3,3,44500,3,3,44922,3,3,46468,6,27.4,-1.2813012,36.8323962,-1.2527958,36.8003131,709,1546,143,760
10944,3806,3349,3,Personal,27,4,60766,27,4,61065,27,4,61145,27,4,61626,27,4,62077,2,23.1,-1.2850644,36.8343657,-1.2712408,36.8328319,698,451,299,561
10945,24130,248,3,Business,7,5,51786,7,5,51804,7,5,52192,7,5,52528,7,5,53837,6,24.7,-1.3064665,36.8251977,-1.304735,36.7846054,848,1309,18,724
10946,2110,286,3,Business,30,5,55943,30,5,58806,30,5,60220,30,5,60729,30,5,63139,9,21.9,-1.2551895,36.7822034,-1.3069127,36.8351372,685,2410,2863,1923
10947,22453,393,3,Business,12,2,36809,12,2,36819,12,2,36827,12,2,37552,12,2,40537,14,17.8,-1.3167113,36.8301563,-1.306378,36.7519845,901,2985,10,733
10948,14208,2801,3,Business,16,2,42043,16,2,42070,16,2,42401,16,2,43266,16,2,43994,6,23.6,-1.2595422,36.7871178,-1.2896399,36.8124498,116,728,27,1196
10949,21592,2658,3,Business,29,3,31561,29,3,32103,29,3,33633,29,3,34278,29,3,35877,7,17.9,-1.2924639,36.7795798,-1.2813012,36.8323962,582,1599,542,2175
10950,11421,3283,3,Business,27,4,53805,27,4,53834,27,4,54161,27,4,54539,27,4,55271,4,23.7,-1.266837,36.799249,-1.2628473,36.781805,167,732,29,705
10951,2659,1458,1,Personal,28,4,38117,28,4,38179,28,4,38966,28,4,39213,28,4,42211,10,23.25888921888938,-1.263499,36.8014548,-1.3197323,36.8120386,279,2998,62,1034
10952,18336,1245,3,Business,11,5,42740,11,5,43200,11,5,45582,11,5,46446,11,5,47003,4,20.8,-1.300921,36.828195,-1.2904262,36.8280839,196,557,460,3246
10953,8706,2174,3,Business,8,2,38252,8,2,38256,8,2,38290,8,2,39916,8,2,41650,15,23.5,-1.2482781,36.884092,-1.263736,36.780353,82,1734,4,1660
10954,7367,2577,2,Personal,5,3,54485,5,3,54499,5,3,56391,5,3,57874,5,3,59857,11,23.8,-1.3008999,36.8932803,-1.3122179,36.823696,447,1983,14,3375
10955,20924,1693,3,Business,28,3,56511,28,3,56520,28,3,56546,28,3,57001,28,3,59786,17,23.25888921888938,-1.338579,36.8963038,-1.2574088,36.799712,539,2785,9,481
10956,1850,2154,3,Business,28,3,45605,28,3,45619,28,3,45867,28,3,46026,28,3,47774,16,23.25888921888938,-1.346557,36.769515,-1.2765736,36.8513646,456,1748,14,407
10957,7767,2825,2,Personal,1,1,44987,1,1,45922,1,1,47614,1,1,47877,1,1,51093,26,23.9,-1.2156006,36.8916865,-1.3855778,36.9269619,408,3216,935,1955
10958,26515,3484,1,Personal,15,6,41496,15,6,41508,15,6,42981,15,6,43204,15,6,45905,14,23.25888921888938,-1.29276,36.783799,-1.2367491,36.8700944,612,2701,12,1696
10959,12670,242,3,Business,31,4,57430,31,4,58896,31,4,59583,31,4,59838,31,4,59860,4,22.3,-1.2553615,36.7895376,-1.268027,36.8037005,51,22,1466,942
10960,24463,2782,1,Personal,28,4,31358,28,4,31429,28,4,32530,28,4,32711,28,4,34445,11,23.25888921888938,-1.2967702,36.8040381,-1.3404187,36.7614685,465,1734,71,1282
10961,12152,962,3,Personal,14,4,59067,14,4,59102,14,4,59963,14,4,60503,14,4,62745,16,26.6,-1.3391863,36.7689931,-1.2658941,36.7966665,623,2242,35,1401
10962,15891,793,3,Personal,6,3,39277,6,3,39332,6,3,39871,6,3,40415,6,3,41341,6,23.25888921888938,-1.2651574,36.7474347,-1.256522,36.7864132,518,926,55,1083
10963,7123,500,1,Personal,13,6,57455,13,6,57568,13,6,58054,13,6,58431,13,6,59712,12,27.9,-1.3024388,36.859699,-1.263453,36.7955612,875,1281,113,863
10964,23116,1162,2,Business,18,4,30687,18,4,37091,18,4,38200,18,4,38570,18,4,40469,9,25.7,-1.2575391,36.8055695,-1.312261,36.794658,38,1899,6404,1479
10965,1882,2154,3,Business,28,3,47878,28,3,47909,28,3,48463,28,3,48877,28,3,50967,12,23.25888921888938,-1.303031,36.758577,-1.2765736,36.8513646,675,2090,31,968
10966,2784,788,3,Business,16,3,37595,16,3,37642,16,3,37700,16,3,38555,16,3,39641,10,24.2,-1.28871,36.8251253,-1.225322,36.80855,408,1086,47,913
10967,8667,1500,3,Business,22,3,38945,22,3,39198,22,3,39561,22,3,39981,22,3,41239,7,23.1,-1.2574219,36.7927073,-1.2770708,36.8231093,139,1258,253,783
10968,18486,888,2,Personal,30,1,32063,30,1,32105,30,1,34396,30,1,34478,30,1,36602,13,16.3,-1.250249,36.76639,-1.2995738,36.8199719,452,2124,42,2373
10969,17253,2982,3,Business,8,3,43100,8,3,43115,8,3,43132,8,3,46078,8,3,48888,18,23.25888921888938,-1.300921,36.828195,-1.177202,36.8351183,581,2810,15,2963
10970,14136,2154,3,Business,9,2,54103,9,2,54140,9,2,54479,9,2,54930,9,2,55818,6,30.8,-1.28878,36.8168312,-1.2765736,36.8513646,291,888,37,790
10971,22856,2360,1,Business,20,4,42900,20,4,42940,20,4,43177,20,4,43856,20,4,44262,4,24.3,-1.2708857,36.8135766,-1.2551895,36.7822034,620,406,40,916
10972,14522,2804,3,Business,30,2,53581,30,2,54080,30,2,54632,30,2,54699,30,2,57328,8,23.25888921888938,-1.2551895,36.7822034,-1.2941849,36.7895754,770,2629,499,619
10973,20184,3320,3,Business,6,2,38077,6,2,38101,6,2,39782,6,2,40921,6,2,43950,14,24.9,-1.328259,36.860975,-1.271823,36.789215,338,3029,24,2820
10974,13825,867,3,Business,22,4,44385,22,4,47005,22,4,47699,22,4,48369,22,4,49794,10,22.4,-1.2996533,36.8292629,-1.306378,36.7519845,878,1425,2620,1364
10975,3029,3194,3,Business,5,5,35335,5,5,35352,5,5,36449,5,5,37375,5,5,38645,7,19.6,-1.2811695,36.8200313,-1.2551895,36.7822034,448,1270,17,2023
10976,1009,1271,3,Business,14,1,54412,14,1,54527,14,1,55068,14,1,55669,14,1,58266,18,25.7,-1.3244885,36.897792,-1.2209733,36.9045746,575,2597,115,1142
10977,18274,868,3,Business,8,3,53270,8,3,53295,8,3,53436,8,3,54240,8,3,54906,4,23.25888921888938,-1.2600926,36.8088685,-1.265715,36.823815,178,666,25,945
10978,23475,914,3,Business,6,3,45675,6,3,45699,6,3,46569,6,3,47262,6,3,48852,11,23.25888921888938,-1.2670213,36.7994482,-1.3053578,36.8607913,622,1590,24,1563
10979,24787,3291,3,Business,6,3,46073,6,3,46126,6,3,46680,6,3,47224,6,3,47974,5,23.25888921888938,-1.2628473,36.781805,-1.2600926,36.8088685,56,750,53,1098
10980,125,3490,2,Personal,31,5,34304,31,5,34418,31,5,35648,31,5,35834,31,5,36706,5,14.8,-1.279461,36.7949088,-1.2994217,36.8009779,85,872,114,1416
10981,21941,3283,3,Business,18,5,36879,18,5,36893,18,5,38299,18,5,38895,18,5,41102,19,21.5,-1.293515,36.897607,-1.2628473,36.781805,466,2207,14,2002
10982,11425,2330,3,Business,19,2,54719,19,2,54776,19,2,56179,19,2,56478,19,2,58093,7,29.9,-1.2291477,36.8440295,-1.2326041,36.8009029,339,1615,57,1702
10983,21256,3326,3,Business,8,1,52478,8,1,52529,8,1,52817,8,1,53052,8,1,53740,3,29.4,-1.2571472,36.7950633,-1.2681518,36.8098164,937,688,51,523
10984,8377,3697,3,Personal,2,2,43945,2,2,44042,2,2,44764,2,2,46511,2,2,47763,6,26.2,-1.2845871,36.8234834,-1.2575555,36.7987053,119,1252,97,2469
10985,27800,2330,3,Business,10,5,34072,10,5,34157,10,5,34967,10,5,35099,10,5,36928,14,23.25888921888938,-1.2925641,36.8976449,-1.3798085,36.9290528,690,1829,85,942
10986,2313,1075,3,Business,28,1,54193,28,1,54241,28,1,55193,28,1,55384,28,1,55774,3,26.3,-1.2527958,36.8003131,-1.2551895,36.7822034,190,390,48,1143
10987,3590,811,3,Personal,7,5,44529,7,5,44670,7,5,45920,7,5,46934,7,5,47753,3,25.6,-1.2962832,36.7849683,-1.2963097,36.7688221,343,819,141,2264
10988,18453,2804,3,Business,3,1,31553,3,1,31821,3,1,32406,3,1,32814,3,1,33931,9,18.1,-1.2624935,36.8434339,-1.2551895,36.7822034,416,1117,268,993
10989,13335,1329,3,Business,7,4,59631,7,4,59677,7,4,60056,7,4,60348,7,4,61188,6,29.3,-1.273056,36.811298,-1.2832105,36.7777664,378,840,46,671
10990,13397,3283,3,Business,7,4,49508,7,4,49550,7,4,49886,7,4,50127,7,4,50550,4,27.6,-1.266837,36.799249,-1.2628473,36.781805,46,423,42,577
10991,1708,1209,3,Business,15,1,47887,15,1,47947,15,1,48608,15,1,48868,15,1,50342,12,23.25888921888938,-1.2991441,36.7528804,-1.3004062,36.829741,327,1474,60,921
10992,6073,2132,3,Business,12,5,41992,12,5,42316,12,5,42931,12,5,43999,12,5,44763,8,26.6,-1.2384056,36.8718698,-1.275931,36.8516227,865,764,324,1683
10993,18901,3391,1,Personal,28,5,49045,28,5,49505,28,5,50497,28,5,50614,28,5,51471,4,25.3,-1.2998789,36.8168963,-1.2857248,36.8228262,79,857,460,1109
10994,26704,1226,2,Personal,12,5,31791,12,5,31874,12,5,32764,12,5,33514,12,5,34113,5,18.8,-1.2981625,36.8130142,-1.2753757,36.8026592,85,599,83,1640
10995,18373,1271,3,Business,30,2,44263,30,2,44268,30,2,44299,30,2,45004,30,2,46566,12,22.4,-1.3107918,36.761794,-1.254191,36.8099132,136,1562,5,736
10996,15915,1292,3,Business,10,1,40659,10,1,40753,10,1,41190,10,1,41469,10,1,42761,8,23.5,-1.3025826,36.7670807,-1.3169591,36.7000029,24,1292,94,716
10997,14754,627,3,Business,21,3,57094,21,3,57142,21,3,57679,21,3,60415,21,3,62557,18,23.25888921888938,-1.2571472,36.7950633,-1.3339943,36.7263409,222,2142,48,3273
10998,19907,1687,3,Business,24,4,55494,24,4,55535,24,4,56345,24,4,57056,24,4,57899,3,28.1,-1.2626574,36.8014034,-1.2729802,36.793734,19,843,41,1521
10999,11921,2987,3,Business,29,2,54067,29,2,54272,29,2,55004,29,2,55677,29,2,56368,4,23.8,-1.270212,36.8210877,-1.260232,36.807334,852,691,205,1405
11000,5944,1818,3,Business,13,1,33400,13,1,33436,13,1,33972,13,1,34850,13,1,36059,10,15.2,-1.2551895,36.7822034,-1.304524,36.775371,452,1209,36,1414
11001,6412,3312,3,Business,8,2,40859,8,2,40934,8,2,41422,8,2,41745,8,2,43554,11,23.3,-1.2583017,36.8023526,-1.3108386,36.7555239,878,1809,75,811
11002,1068,81,3,Business,17,1,51991,17,1,52003,17,1,52372,17,1,52551,17,1,53318,4,24.5,-1.2641496,36.7914139,-1.2555811,36.802267,259,767,12,548
11003,1314,198,3,Business,15,3,34693,15,3,35616,15,3,37085,15,3,37190,15,3,38194,11,23.25888921888938,-1.3396256,36.8863135,-1.344994,36.91328,448,1004,923,1574
11004,286,3283,3,Business,4,1,33898,4,1,33971,4,1,34193,4,1,34526,4,1,35124,4,22.0,-1.266837,36.799249,-1.2628473,36.781805,242,598,73,555
11005,751,3283,3,Business,9,6,54930,9,6,55364,9,6,56234,9,6,56331,9,6,58851,6,27.1,-1.272828,36.816608,-1.2628473,36.781805,332,2520,434,967
11006,23812,2412,3,Business,13,1,61523,13,1,61566,13,1,61770,13,1,62856,13,1,63362,11,23.25888921888938,-1.279395,36.825364,-1.2283403,36.8822756,137,506,43,1290
11007,20028,2521,3,Business,1,1,50550,1,1,50585,1,1,51312,1,1,51674,1,1,52061,4,23.25888921888938,-1.3167113,36.8301563,-1.3004062,36.829741,809,387,35,1089
11008,3728,393,3,Business,28,2,37233,28,2,37256,28,2,37360,28,2,38058,28,2,39985,14,21.3,-1.3228003,36.8306435,-1.2991441,36.7528804,211,1927,23,802
11009,1629,2924,2,Personal,4,4,47658,4,4,47696,4,4,48212,4,4,49294,4,4,50267,6,24.6,-1.266486,36.807675,-1.2504511,36.7724943,857,973,38,1598
11010,25933,2271,3,Business,10,3,36035,10,3,36042,10,3,39120,10,3,39817,10,3,42475,21,27.6,-1.344446,36.756597,-1.293515,36.897607,155,2658,7,3775
11011,7059,799,1,Personal,28,1,45217,28,1,45243,28,1,45627,28,1,46113,28,1,47288,10,22.6,-1.304033,36.7848695,-1.2655306,36.828148,919,1175,26,870
11012,22935,265,3,Business,28,5,32699,28,5,32715,28,5,33302,28,5,33789,28,5,36537,21,20.8,-1.300921,36.828195,-1.3233875,36.6878308,761,2748,16,1074
11013,2276,1075,3,Business,5,6,42439,5,6,42451,5,6,42753,5,6,43099,5,6,43462,1,22.5,-1.2649605,36.7981777,-1.2527958,36.8003131,634,363,12,648
11014,17515,1304,3,Business,24,3,39712,24,3,39749,24,3,40441,24,3,40565,24,3,42822,18,20.1,-1.3332749,36.8708147,-1.2363748,36.8177502,737,2257,37,816
11015,23922,2457,3,Business,17,3,57102,17,3,58221,17,3,59254,17,3,59489,17,3,60335,5,28.3,-1.2551895,36.7822034,-1.279309,36.8196569,208,846,1119,1268
11016,22633,1329,3,Business,1,4,45587,1,4,45750,1,4,46283,1,4,46869,1,4,48420,6,23.25888921888938,-1.273056,36.811298,-1.2611728,36.7753701,427,1551,163,1119
11017,13592,1205,3,Business,18,2,55718,18,2,55753,18,2,56412,18,2,58780,18,2,59091,16,25.4,-1.2810807,36.8144229,-1.3395432,36.7230183,329,311,35,3027
11018,24735,552,3,Business,19,2,34459,19,2,34512,19,2,36039,19,2,38792,19,2,42014,21,27.4,-1.2571472,36.7950633,-1.335477,36.9308297,588,3222,53,4280
11019,16391,1655,3,Personal,25,2,41281,25,2,41466,25,2,41510,25,2,42209,25,2,45312,13,24.0,-1.3250048,36.8697188,-1.270766,36.810988,848,3103,185,743
11020,1422,393,3,Business,16,4,50842,16,4,50854,16,4,50858,16,4,51980,16,4,52022,4,23.25888921888938,-1.3167113,36.8301563,-1.3004062,36.829741,515,42,12,1126
11021,23011,346,3,Business,28,4,56619,28,4,56698,28,4,58367,28,4,61147,28,4,63159,14,25.8,-1.2860183,36.8975338,-1.28878,36.8168312,709,2012,79,4449
11022,10061,561,3,Personal,14,5,54330,14,5,54434,14,5,54630,14,5,55041,14,5,59054,11,27.1,-1.2947536,36.8247182,-1.238146,36.7649366,726,4013,104,607
11023,26213,3500,3,Business,9,3,54075,9,3,54096,9,3,54476,9,3,55054,9,3,56440,7,25.1,-1.2906105,36.8053279,-1.2621828,36.7949276,622,1386,21,958
11024,969,2978,3,Business,21,5,50914,21,5,50950,21,5,51013,21,5,51244,21,5,56317,7,27.1,-1.2793642,36.8295717,-1.2551895,36.7822034,447,5073,36,294
11025,12907,3222,3,Business,13,4,56873,13,4,56938,13,4,57660,13,4,57952,13,4,59641,12,22.9,-1.2551895,36.7822034,-1.3203917,36.8334751,161,1689,65,1014
11026,110,3517,3,Business,22,4,34917,22,4,35839,22,4,38508,22,4,39032,22,4,42718,34,22.8,-1.1518113,36.6654506,-1.300921,36.828195,804,3686,922,3193
11027,62,1948,1,Personal,5,2,41244,5,2,41250,5,2,43051,5,2,43901,5,2,45291,16,21.3,-1.3312306,36.8563683,-1.2454036,36.7866654,886,1390,6,2651
11028,17227,1642,3,Business,28,5,35260,28,5,35313,28,5,36449,28,5,36729,28,5,37400,5,20.5,-1.281892,36.7834972,-1.2728069,36.7962362,612,671,53,1416
11029,10313,2102,3,Business,15,1,50087,15,1,50248,15,1,51084,15,1,51416,15,1,53492,14,23.25888921888938,-1.3250048,36.8697188,-1.2613768,36.8019418,19,2076,161,1168
11030,22362,868,3,Business,23,6,53372,23,6,53512,23,6,53895,23,6,54548,23,6,56346,14,23.25888921888938,-1.293515,36.897607,-1.265715,36.823815,855,1798,140,1036
11031,12939,1482,3,Business,3,1,33656,3,1,33716,3,1,36338,3,1,37048,3,1,39172,8,18.2,-1.3122474,36.8728544,-1.338579,36.8963038,114,2124,60,3332
11032,10171,1927,3,Business,28,5,31731,28,5,31859,28,5,31865,28,5,33649,28,5,33989,10,20.7,-1.305399,36.8221849,-1.3472066,36.7692638,179,340,128,1790
11033,4923,553,3,Business,2,2,61304,2,2,61339,2,2,61950,2,2,62049,2,2,62641,3,23.6,-1.2551895,36.7822034,-1.265422,36.8059349,383,592,35,710
11034,23930,1271,3,Business,18,1,58596,18,1,58623,18,1,59137,18,1,59677,18,1,62247,21,29.3,-1.3108386,36.7555239,-1.2184661,36.8260859,785,2570,27,1054
11035,20252,867,3,Business,26,2,30335,26,2,30350,26,2,30407,26,2,31403,26,2,31798,9,23.25888921888938,-1.2638185,36.7930057,-1.2991441,36.7528804,778,395,15,1053
11036,12968,868,3,Business,20,4,55804,20,4,57525,20,4,59079,20,4,59768,20,4,60663,10,22.6,-1.228911,36.881876,-1.265715,36.823815,86,895,1721,2243
11037,8735,3291,3,Business,6,4,49943,6,4,49973,6,4,50891,6,4,51225,6,4,53759,11,21.4,-1.303596,36.778378,-1.2600926,36.8088685,419,2534,30,1252
11038,20134,393,3,Business,4,5,52788,4,5,52977,4,5,53464,4,5,53839,4,5,55187,7,24.4,-1.3177547,36.8303703,-1.3083266,36.8494756,948,1348,189,862
11039,5452,2701,3,Business,12,3,38284,12,3,38696,12,3,39478,12,3,39675,12,3,41472,5,19.3,-1.2765736,36.8513646,-1.3083777,36.8590077,399,1797,412,979
11040,3202,868,3,Business,1,4,32601,1,4,32697,1,4,33853,1,4,34122,1,4,35514,9,23.25888921888938,-1.318062,36.849326,-1.265715,36.823815,31,1392,96,1425
11041,7306,1882,3,Business,14,4,74287,14,4,74323,14,4,75508,14,4,77874,14,4,78446,6,22.1,-1.2956882,36.7861845,-1.2591019,36.800577,678,572,36,3551
11042,1556,868,3,Business,13,6,35700,13,6,35903,13,6,36943,13,6,38054,13,6,40723,14,25.0,-1.293515,36.897607,-1.265715,36.823815,519,2669,203,2151
11043,9643,1414,3,Personal,20,4,48442,20,4,51477,20,4,52723,20,4,55715,20,4,59315,7,25.0,-1.2905666,36.8533097,-1.2786493,36.8252287,436,3600,3035,4238
11044,25010,540,3,Business,3,1,53768,3,1,56776,3,1,57211,3,1,57458,3,1,59663,8,23.6,-1.2551895,36.7822034,-1.2862436,36.791017,523,2205,3008,682
11045,22986,136,3,Business,8,5,42438,8,5,42487,8,5,43393,8,5,44856,8,5,47087,20,24.3,-1.2874648,36.8271985,-1.3254522,36.7216584,440,2231,49,2369
11046,5776,2423,3,Business,27,3,54580,27,3,54768,27,3,54792,27,3,56134,27,3,57192,6,29.3,-1.2551895,36.7822034,-1.2884308,36.821751,576,1058,188,1366
11047,6646,2956,3,Business,11,2,52226,11,2,53145,11,2,53646,11,2,54007,11,2,55029,7,21.5,-1.2911796,36.8215068,-1.2584143,36.8048002,906,1022,919,862
11048,522,1191,1,Personal,24,5,49306,24,5,49334,24,5,49639,24,5,50777,24,5,51441,7,23.3,-1.32589,36.831679,-1.3282758,36.8590281,932,664,28,1443
11049,5201,1329,3,Business,2,2,41161,2,2,41302,2,2,44117,2,2,44207,2,2,45052,3,26.3,-1.273056,36.811298,-1.2605635,36.7985638,167,845,141,2905
11050,1731,3674,3,Business,28,5,34064,28,5,38165,28,5,39039,28,5,39111,28,5,40790,14,24.9,-1.2551895,36.7822034,-1.329568,36.8520825,612,1679,4101,946
11051,14646,1976,3,Business,2,5,62508,2,5,63447,2,5,64137,2,5,64254,2,5,65642,8,24.0,-1.257028,36.7810435,-1.301468,36.77465789,208,1388,939,807
11052,27611,1882,3,Business,11,7,31297,11,7,31327,11,7,33853,11,7,35129,11,7,38088,12,20.7,-1.2958783,36.7928125,-1.3169591,36.7000029,593,2959,30,3802
11053,20778,1856,3,Business,15,2,42721,15,2,42929,15,2,43640,15,2,45467,15,2,45496,5,24.2,-1.2738936,36.8035805,-1.2883698,36.8269434,862,29,208,2538
11054,8496,393,3,Business,6,3,37944,6,3,37961,6,3,37972,6,3,40699,6,3,40714,4,22.4,-1.3167113,36.8301563,-1.3004062,36.829741,515,15,17,2738
11055,26073,3668,1,Personal,2,4,53772,2,4,53847,2,4,54629,2,4,54747,2,4,55803,6,26.4,-1.2798711,36.8207118,-1.312469,36.815177,857,1056,75,900
11056,27242,2642,3,Personal,1,3,30428,1,3,31333,1,3,33320,1,3,33769,1,3,35363,19,23.25888921888938,-1.3700383,36.9190174,-1.2736084,36.9101609,406,1594,905,2436
11057,20269,1787,3,Business,11,2,39665,11,2,39676,11,2,39888,11,2,40468,11,2,42116,15,24.0,-1.2297202,36.8819507,-1.1605816,36.8977958,45,1648,11,792
11058,27682,186,3,Business,17,1,47409,17,1,49395,17,1,50055,17,1,50327,17,1,51861,17,24.7,-1.2902869,36.8085396,-1.3700383,36.9190174,807,1534,1986,932
11059,27659,1304,3,Business,24,1,41792,24,1,41864,24,1,42230,24,1,42504,24,1,43688,7,22.7,-1.2551895,36.7822034,-1.2963492,36.8093377,415,1184,72,640
11060,22467,393,3,Business,16,2,53091,16,2,53101,16,2,53404,16,2,53697,16,2,55288,14,23.25888921888938,-1.3167113,36.8301563,-1.2991441,36.7528804,168,1591,10,596
11061,19838,2066,3,Business,1,3,53161,1,3,53179,1,3,53662,1,3,53803,1,3,55159,11,23.25888921888938,-1.3210189,36.8410551,-1.2664669,36.7921612,233,1356,18,624
11062,18739,2956,3,Business,27,1,39407,27,1,39441,27,1,39569,27,1,39885,27,1,43091,6,23.9,-1.2584143,36.8048002,-1.2882803,36.7815881,222,3206,34,444
11063,10426,3647,3,Business,4,2,39233,4,2,39300,4,2,40066,4,2,40180,4,2,42390,14,18.9,-1.272639,36.794723,-1.2880046,36.8688573,330,2210,67,880
11064,17226,3291,3,Business,2,4,44583,2,4,44599,2,4,45386,2,4,46552,2,4,47002,2,23.25888921888938,-1.266837,36.799249,-1.2600926,36.8088685,448,450,16,1953
11065,13025,2982,3,Business,13,4,54228,13,4,55968,13,4,56616,13,4,57343,13,4,59391,13,22.4,-1.300921,36.828195,-1.2252722,36.8756717,522,2048,1740,1375
11066,709,1836,1,Personal,22,5,42772,22,5,46671,22,5,46789,22,5,47781,22,5,49202,10,21.8,-1.2217967,36.81099,-1.2717851,36.8105363,101,1421,3899,1110
11067,19199,2200,3,Business,23,2,35840,23,2,36946,23,2,38448,23,2,38952,23,2,40033,6,17.9,-1.2584143,36.8048002,-1.290894,36.822971,88,1081,1106,2006
11068,19239,2407,2,Personal,31,4,44085,31,4,44140,31,4,44241,31,4,44643,31,4,44880,2,22.0,-1.2711441,36.8030777,-1.2657199,36.7914391,379,237,55,503
11069,4283,393,3,Business,16,2,54652,16,2,54684,16,2,55493,16,2,57005,16,2,57901,4,23.25888921888938,-1.3167113,36.8301563,-1.3004062,36.829741,910,896,32,2321
11070,5310,3311,3,Personal,10,5,44177,10,5,44194,10,5,44492,10,5,44760,10,5,45835,6,23.25888921888938,-1.2944292,36.7793569,-1.2702348,36.812096,259,1075,17,566
11071,24744,1793,1,Personal,6,3,34216,6,3,34348,6,3,35089,6,3,35379,6,3,37137,9,15.8,-1.3131471,36.8176568,-1.2969275,36.7867879,648,1758,132,1031
11072,12369,2330,3,Business,23,4,56666,23,4,56687,23,4,57015,23,4,57251,23,4,60660,21,24.7,-1.3015197,36.7658456,-1.2925641,36.8976449,161,3409,21,564
11073,4790,3291,3,Business,14,1,46750,14,1,47334,14,1,48076,14,1,48619,14,1,51274,16,23.7,-1.293515,36.897607,-1.2600926,36.8088685,404,2655,584,1285
11074,12899,3109,2,Personal,4,3,55761,4,3,56901,4,3,58353,4,3,59279,4,3,60908,11,18.2,-1.3107918,36.761794,-1.2551895,36.7822034,465,1629,1140,2378
11075,26117,60,3,Business,27,3,48569,27,3,48644,27,3,50162,27,3,51385,27,3,51391,6,29.3,-1.228911,36.881876,-1.2296618,36.8438272,75,6,75,2741
11076,8787,3326,3,Business,18,1,37692,18,1,37719,18,1,38270,18,1,38574,18,1,41876,22,28.0,-1.2551895,36.7822034,-1.341804,36.920576,147,3302,27,855
11077,27565,1471,3,Business,21,5,33120,21,5,33133,21,5,33234,21,5,33771,21,5,37416,18,19.3,-1.2571472,36.7950633,-1.3206433,36.9117533,401,3645,13,638
11078,621,1245,3,Business,24,4,57224,24,4,57234,24,4,57235,24,4,57638,24,4,60563,17,28.4,-1.300921,36.828195,-1.3198615,36.7110323,519,2925,10,404
11079,14018,53,3,Business,18,5,34719,18,5,34816,18,5,35693,18,5,36300,18,5,37361,5,20.3,-1.3004062,36.829741,-1.2770708,36.8231093,725,1061,97,1484
11080,9390,2112,3,Business,19,3,47091,19,3,48107,19,3,49383,19,3,49580,19,3,52492,16,24.6,-1.2156006,36.8916865,-1.3038543,36.8381051,75,2912,1016,1473
11081,11194,246,3,Business,24,4,39425,24,4,39444,24,4,39632,24,4,39869,24,4,40310,3,24.7,-1.2584143,36.8048002,-1.2551895,36.7822034,714,441,19,425
11082,9725,3682,1,Personal,27,4,46428,27,4,46843,27,4,47507,27,4,48290,27,4,49373,8,22.8,-1.2401893,36.7961714,-1.2029332,36.786827,882,1083,415,1447
11084,17923,3621,3,Business,13,6,51997,13,6,52027,13,6,52038,13,6,52542,13,6,56191,18,27.7,-1.2836583,36.7886014,-1.2720282,36.9107491,314,3649,30,515
11085,17879,3291,3,Business,3,1,33378,3,1,33419,3,1,35337,3,1,37051,3,1,39908,5,18.3,-1.2783849,36.8163445,-1.2600926,36.8088685,895,2857,41,3632
11086,17235,2423,3,Business,30,2,39448,30,2,39543,30,2,39776,30,2,40714,30,2,41020,3,23.25888921888938,-1.2551895,36.7822034,-1.256522,36.7864132,291,306,95,1171
11087,21996,302,3,Business,15,5,43211,15,5,43237,15,5,43983,15,5,44208,15,5,48120,1,26.0,-1.2649605,36.7981777,-1.2637057,36.80517,682,3912,26,971
11088,19562,1281,3,Business,25,5,44524,25,5,44617,25,5,45594,25,5,47031,25,5,48314,9,21.0,-1.2817084,36.8143646,-1.275442,36.7660207,186,1283,93,2414
11089,5703,909,3,Business,11,1,63615,11,1,65306,11,1,66410,11,1,67044,11,1,69176,14,23.25888921888938,-1.225322,36.80855,-1.2486689,36.8748969,383,2132,1691,1738
11090,4344,2756,3,Business,13,6,45405,13,6,45476,13,6,45809,13,6,46469,13,6,47445,8,25.8,-1.3266035,36.8412362,-1.2814609,36.8265932,291,976,71,993
11091,25361,3674,3,Business,14,1,55170,14,1,55648,14,1,56232,14,1,56572,14,1,57434,9,25.6,-1.2551895,36.7822034,-1.2747604,36.8259205,62,862,478,924
11092,26434,393,3,Business,13,1,48612,13,1,48629,13,1,48653,13,1,49480,13,1,49891,4,23.25888921888938,-1.3167113,36.8301563,-1.3004062,36.829741,349,411,17,851
11093,17904,1329,3,Business,28,2,53468,28,2,53512,28,2,54525,28,2,54629,28,2,55598,3,23.3,-1.273056,36.811298,-1.2572151,36.7993483,434,969,44,1117
11094,4579,186,3,Business,14,3,56211,14,3,56220,14,3,56950,14,3,57085,14,3,58597,18,25.7,-1.3700383,36.9190174,-1.2902869,36.8085396,647,1512,9,865
11095,11370,1146,3,Business,1,1,60499,1,1,60597,1,1,61105,1,1,61615,1,1,62474,5,27.5,-1.3004062,36.829741,-1.3083266,36.8494756,506,859,98,1018
11096,8156,990,3,Business,8,1,41441,8,1,41458,8,1,42628,8,1,43504,8,1,46229,17,24.3,-1.3164339,36.8578882,-1.3624272,36.7427843,328,2725,17,2046
11097,18258,3147,3,Business,12,2,57002,12,2,58272,12,2,58406,12,2,58628,12,2,60711,18,23.1,-1.3404187,36.7614685,-1.2551895,36.7822034,635,2083,1270,356
11098,3138,970,3,Business,24,2,25904,24,2,25992,24,2,27822,24,2,28189,24,2,30094,9,14.5,-1.2551895,36.7822034,-1.2944842,36.8011625,726,1905,88,2197
11099,17991,1500,3,Business,17,1,33084,17,1,33171,17,1,33684,17,1,34112,17,1,35667,9,18.1,-1.2991441,36.7528804,-1.2574219,36.7927073,345,1555,87,941
11100,7454,1402,3,Business,18,1,36823,18,1,37088,18,1,38119,18,1,39230,18,1,42360,11,27.8,-1.225322,36.80855,-1.2813012,36.8323962,763,3130,265,2142
11101,27201,868,3,Business,13,6,43419,13,6,43497,13,6,44490,13,6,44754,13,6,46115,4,26.0,-1.2600926,36.8088685,-1.265715,36.823815,507,1361,78,1257
11102,3779,1329,3,Business,13,4,36801,13,4,36865,13,4,37388,13,4,37471,13,4,38494,4,18.6,-1.273056,36.811298,-1.2808067,36.7914728,435,1023,64,606
11103,7538,2285,3,Personal,22,3,39999,22,3,40008,22,3,40024,22,3,40382,22,3,42098,19,23.3,-1.3714436,36.9221125,-1.2950041,36.8143583,595,1716,9,374
11104,18698,868,3,Business,15,2,47082,15,2,47112,15,2,47439,15,2,47731,15,2,48271,4,24.2,-1.266837,36.799249,-1.265715,36.823815,279,540,30,619
11105,25305,3689,3,Business,14,5,58851,14,5,59012,14,5,60840,14,5,60952,14,5,62394,8,21.7,-1.2527958,36.8003131,-1.306245,36.8192978,537,1442,161,1940
11106,4550,3486,3,Business,17,1,53528,17,1,58028,17,1,58417,17,1,58696,17,1,60499,8,24.7,-1.2551895,36.7822034,-1.3044313,36.818504,646,1803,4500,668
11107,22497,517,3,Business,29,4,39310,29,4,39312,29,4,39322,29,4,40776,29,4,40778,5,21.7,-1.3177547,36.8303703,-1.3077869,36.8443207,619,2,2,1464
11108,11335,186,3,Business,14,2,42346,14,2,42391,14,2,42602,14,2,43399,14,2,43868,6,23.25888921888938,-1.2825816,36.8092346,-1.2571472,36.7950633,404,469,45,1008
11109,13351,2200,3,Business,6,2,51437,6,2,51651,6,2,53301,6,2,53413,6,2,54993,10,27.5,-1.290894,36.822971,-1.2413316,36.8785525,895,1580,214,1762
11110,16120,1469,3,Business,25,5,43273,25,5,43305,25,5,43314,25,5,43901,25,5,45705,8,26.3,-1.2551895,36.7822034,-1.2954581,36.810997,268,1804,32,596
11111,15042,3607,3,Personal,14,5,44248,14,5,45275,14,5,46498,14,5,47289,14,5,48066,4,21.6,-1.300298,36.7913063,-1.3012008,36.764868,847,777,1027,2014
11112,16056,3147,3,Business,24,3,33768,24,3,34331,24,3,35087,24,3,36346,24,3,38760,15,16.8,-1.3332749,36.8708147,-1.3472066,36.7692638,611,2414,563,2015
11113,19554,1146,3,Business,30,2,47838,30,2,47912,30,2,48319,30,2,49561,30,2,50555,7,23.25888921888938,-1.3167113,36.8301563,-1.3083266,36.8494756,211,994,74,1649
11114,21480,835,3,Business,15,5,43988,15,5,43998,15,5,44352,15,5,45740,15,5,46839,20,26.1,-1.2917868,36.7872675,-1.3700383,36.9190174,678,1099,10,1742
11115,23650,1882,3,Business,6,3,54073,6,3,54099,6,3,54932,6,3,56238,6,3,57179,8,23.25888921888938,-1.2956882,36.7861845,-1.2591019,36.800577,655,941,26,2139
11116,7474,3147,3,Business,12,1,29534,12,1,34493,12,1,35840,12,1,36111,12,1,37766,10,19.5,-1.3472066,36.7692638,-1.3899636,36.7482377,383,1655,4959,1618
11117,9453,3560,3,Business,21,3,37534,21,3,42334,21,3,42471,21,3,42636,21,3,43387,4,21.9,-1.279395,36.825364,-1.2597529,36.806629,237,751,4800,302
11118,23464,3647,3,Business,31,5,59894,31,5,60468,31,5,61645,31,5,61983,31,5,62701,6,23.9,-1.272639,36.794723,-1.3023756,36.7949276,404,718,574,1515
11119,949,1500,3,Business,7,5,35599,7,5,37482,7,5,37724,7,5,38728,7,5,39846,10,25.3,-1.2991441,36.7528804,-1.2574219,36.7927073,926,1118,1883,1246
11120,26287,1368,3,Business,11,2,52640,11,2,53484,11,2,54287,11,2,55215,11,2,60381,10,21.5,-1.2571472,36.7950633,-1.314128,36.777239,109,5166,844,1731
11121,19256,2067,1,Personal,4,2,49840,4,2,49876,4,2,51584,4,2,52183,4,2,52793,6,20.3,-1.2981102,36.8293513,-1.304033,36.7848695,88,610,36,2307
11122,21152,516,3,Business,9,4,53970,9,4,54568,9,4,55726,9,4,55911,9,4,57063,9,23.25888921888938,-1.2950408,36.8098172,-1.2551895,36.7822034,538,1152,598,1343
11123,5909,3201,3,Business,21,2,42517,21,2,42558,21,2,43223,21,2,43458,21,2,44301,6,22.7,-1.2584143,36.8048002,-1.290894,36.822971,341,843,41,900
11124,24732,1271,3,Business,29,5,37286,29,5,37474,29,5,38492,29,5,43137,29,5,44088,17,19.5,-1.2545163,36.8243717,-1.3244885,36.897792,644,951,188,5663
11125,24259,3291,3,Business,26,6,45412,26,6,45475,26,6,45977,26,6,47003,26,6,48880,9,25.9,-1.307143,36.825009,-1.2600926,36.8088685,501,1877,63,1528
11126,144,2079,3,Personal,17,1,58708,17,1,58736,17,1,59099,17,1,59246,17,1,59747,3,24.6,-1.2681004,36.7952081,-1.2733047,36.8109744,50,501,28,510
11127,3016,265,3,Business,15,2,42159,15,2,44038,15,2,45891,15,2,46322,15,2,48831,10,24.1,-1.300921,36.828195,-1.240299,36.795942,870,2509,1879,2284
11128,23348,2037,1,Personal,18,2,44691,18,2,44712,18,2,44872,18,2,45544,18,2,46371,3,22.5,-1.286431,36.818411,-1.2903277,36.80556,785,827,21,832
11129,5251,797,3,Business,23,4,58128,23,4,58150,23,4,59362,23,4,59798,23,4,60482,4,23.25888921888938,-1.2566689,36.7796952,-1.2551895,36.7822034,269,684,22,1648
11130,22774,2523,3,Business,8,1,44909,8,1,45011,8,1,46942,8,1,47240,8,1,48716,5,28.0,-1.2551895,36.7822034,-1.2657199,36.7914391,161,1476,102,2229
11131,11859,2895,3,Business,13,2,39178,13,2,39240,13,2,39572,13,2,39939,13,2,43109,23,22.2,-1.3700383,36.9190174,-1.2571472,36.7950633,200,3170,62,699
11132,1874,3291,3,Business,15,3,36025,15,3,36247,15,3,37160,15,3,37625,15,3,40865,11,23.25888921888938,-1.303596,36.778378,-1.2600926,36.8088685,427,3240,222,1378
11133,2871,540,3,Business,5,3,53314,5,3,55011,5,3,56186,5,3,56611,5,3,57151,5,25.1,-1.2551895,36.7822034,-1.270054,36.815164,857,540,1697,1600
11134,23098,793,2,Personal,30,3,29678,30,3,29746,30,3,30606,30,3,33581,30,3,34606,10,17.2,-1.2464366,36.8170136,-1.2681211,36.7792474,103,1025,68,3835
11135,25958,84,3,Business,4,2,45929,4,2,48624,4,2,49369,4,2,50267,4,2,55086,21,23.7,-1.3562374,36.9042954,-1.2551895,36.7822034,586,4819,2695,1643
11136,11006,1007,3,Personal,23,4,49743,23,4,49765,23,4,50630,23,4,51185,23,4,52934,11,24.5,-1.2943445,36.7515778,-1.2643794,36.816234,217,1749,22,1420
11137,21791,346,3,Business,31,7,38158,31,7,38219,31,7,39261,31,7,39642,31,7,40333,5,27.2,-1.2584143,36.8048002,-1.28878,36.8168312,119,691,61,1423
11138,19255,302,3,Business,19,1,63813,19,1,63834,19,1,63853,19,1,64464,19,1,64924,1,23.8,-1.2649605,36.7981777,-1.25841,36.804026,720,460,21,630
11139,434,1245,3,Business,7,1,59623,7,1,60729,7,1,62322,7,1,62525,7,1,64487,11,24.4,-1.3198615,36.7110323,-1.3841736,36.7418921,862,1962,1106,1796
11140,14538,1980,2,Personal,10,1,47515,10,1,47636,10,1,48450,10,1,49010,10,1,49840,4,23.25888921888938,-1.2918239,36.8235665,-1.305716,36.809882,672,830,121,1374
11141,6110,3222,3,Business,18,5,40632,18,5,40658,18,5,40898,18,5,41216,18,5,42429,9,20.2,-1.2551895,36.7822034,-1.2977565,36.8025534,343,1213,26,558
11142,8563,394,3,Personal,29,1,31838,29,1,31866,29,1,34716,29,1,35062,29,1,39678,19,23.25888921888938,-1.3175925,36.8742349,-1.2383092,36.7573096,792,4616,28,3196
11143,14325,510,3,Business,25,5,55794,25,5,56840,25,5,57578,25,5,57833,25,5,60348,18,23.3,-1.2860183,36.8975338,-1.2553615,36.7895376,589,2515,1046,993
11144,19171,1271,3,Business,4,3,51970,4,3,53687,4,3,53900,4,3,55526,4,3,56134,6,18.5,-1.3244885,36.897792,-1.3332749,36.8708147,543,608,1717,1839
11145,25850,3263,2,Personal,16,1,42495,16,1,42504,16,1,42703,16,1,43174,16,1,45049,17,19.2,-1.255956,36.772901,-1.1884361,36.7407215,103,1875,9,670
11146,17163,1724,3,Business,29,1,53712,29,1,53773,29,1,55305,29,1,55379,29,1,57690,23,23.25888921888938,-1.2551895,36.7822034,-1.3724413,36.9284922,940,2311,61,1606
11147,9892,3517,3,Business,1,1,39173,1,1,39798,1,1,41441,1,1,43720,1,1,45970,17,23.25888921888938,-1.3882008,36.7699445,-1.2896431,36.8086201,519,2250,625,3922
11148,26953,286,3,Business,5,1,35041,5,1,35490,5,1,35907,5,1,36374,5,1,37415,10,18.4,-1.2672002,36.8245542,-1.2551895,36.7822034,237,1041,449,884
11149,3716,1575,3,Personal,24,5,43491,24,5,43546,24,5,43986,24,5,44288,24,5,44796,3,21.4,-1.2452735,36.7911588,-1.2670196,36.8077002,674,508,55,742
11150,1846,527,2,Personal,23,3,50760,23,3,50773,23,3,51331,23,3,52527,23,3,54761,13,22.3,-1.2861765,36.8209086,-1.3295139,36.8985677,360,2234,13,1754
11151,20800,1509,3,Personal,8,2,39284,8,2,40226,8,2,42913,8,2,43286,8,2,45241,18,21.3,-1.355948,36.7440908,-1.2713222,36.7922633,226,1955,942,3060
11152,21650,2330,3,Business,6,4,36485,6,4,36500,6,4,39697,6,4,41455,6,4,44229,18,24.0,-1.2524916,36.8656196,-1.3015197,36.7658456,266,2774,15,4955
11153,5964,704,3,Business,8,5,51980,8,5,55501,8,5,57033,8,5,57464,8,5,59139,13,21.6,-1.2860183,36.8975338,-1.3332749,36.8708147,900,1675,3521,1963
11154,4039,1336,3,Business,22,4,47162,22,4,48322,22,4,49775,22,4,49991,22,4,53315,8,26.5,-1.2891922,36.825189,-1.2615888,36.7928732,554,3324,1160,1669
11155,4765,2150,3,Business,24,5,34185,24,5,34193,24,5,34726,24,5,34802,24,5,36190,15,15.8,-1.344446,36.756597,-1.265715,36.823815,74,1388,8,609
11156,27241,3326,3,Business,7,3,44216,7,3,52816,7,3,53914,7,3,54255,7,3,56472,8,28.2,-1.2551895,36.7822034,-1.304344,36.812274,230,2217,8600,1439
11157,6793,640,3,Business,24,3,32262,24,3,32376,24,3,33557,24,3,33779,24,3,34494,3,16.8,-1.2945106,36.7728398,-1.304033,36.7848695,655,715,114,1403
11158,3201,2701,3,Business,23,2,57222,23,2,57677,23,2,59355,23,2,59602,23,2,62017,9,19.3,-1.2765736,36.8513646,-1.2475028,36.8774697,237,2415,455,1925
11159,5612,2829,3,Business,27,1,38581,27,1,38654,27,1,39892,27,1,41370,27,1,42924,6,20.8,-1.2571472,36.7950633,-1.2933789,36.8087535,115,1554,73,2716
11160,13206,1473,3,Business,7,3,32715,7,3,32922,7,3,33076,7,3,33692,7,3,35576,15,23.25888921888938,-1.207546,36.7913976,-1.2571472,36.7950633,31,1884,207,770
11161,22917,3689,3,Business,10,1,49282,10,1,49356,10,1,50350,10,1,50780,10,1,54029,19,18.1,-1.2571472,36.7950633,-1.1720874,36.8219039,856,3249,74,1424
11162,7717,3525,3,Business,14,3,36011,14,3,36070,14,3,37058,14,3,37243,14,3,38266,15,18.4,-1.309835,36.84727,-1.3700383,36.9190174,231,1023,59,1173
11163,10032,635,3,Business,21,2,43871,21,2,43912,21,2,44004,21,2,46731,21,2,50195,8,22.6,-1.3081376,36.8329772,-1.2575139,36.8338121,686,3464,41,2819
11164,11337,478,3,Business,8,5,45585,8,5,46167,8,5,49280,8,5,49396,8,5,53856,8,27.1,-1.2551895,36.7822034,-1.29752,36.7938083,928,4460,582,3229
11165,25562,867,3,Business,9,4,35447,9,4,35481,9,4,36035,9,4,36356,9,4,38937,12,23.25888921888938,-1.2991441,36.7528804,-1.3004062,36.829741,205,2581,34,875
11166,15735,897,2,Personal,29,2,34401,29,2,34487,29,2,34982,29,2,35484,29,2,36354,9,16.7,-1.2795796,36.819062,-1.2295075,36.8016971,100,870,86,997
11167,8388,1500,3,Business,20,3,53507,20,3,53615,20,3,54102,20,3,55307,20,3,57010,8,28.4,-1.3004062,36.829741,-1.2638185,36.7930057,26,1703,108,1692
11168,18902,265,3,Business,17,1,51641,17,1,53735,17,1,54453,17,1,57220,17,1,60082,18,28.1,-1.300921,36.828195,-1.3593378,36.9433184,482,2862,2094,3485
11169,7821,738,3,Business,15,1,56451,15,1,56829,15,1,58841,15,1,59379,15,1,62536,10,23.25888921888938,-1.288148,36.7850276,-1.2601645,36.7167656,38,3157,378,2550
11170,20140,2085,3,Personal,5,4,32182,5,4,32735,5,4,33408,5,4,33704,5,4,35989,7,23.25888921888938,-1.296797,36.7764525,-1.2876365,36.816096,636,2285,553,969
11171,5960,1363,3,Business,18,4,40348,18,4,40464,18,4,41187,18,4,43210,18,4,46906,8,23.25888921888938,-1.2545163,36.8243717,-1.3004062,36.829741,438,3696,116,2746
11172,26326,633,3,Business,6,2,36205,6,2,37247,6,2,38410,6,2,38990,6,2,41325,10,24.9,-1.3004062,36.829741,-1.2991441,36.7528804,614,2335,1042,1743
11173,18873,2436,3,Business,22,5,52499,22,5,52620,22,5,53039,22,5,53858,22,5,55694,9,27.1,-1.2551895,36.7822034,-1.2315181,36.8140543,434,1836,121,1238
11174,2735,2200,3,Business,29,7,42629,29,7,42925,29,7,43866,29,7,44333,29,7,45868,12,22.0,-1.290894,36.822971,-1.235348,36.760016,105,1535,296,1408
11175,14149,2030,3,Business,4,5,50753,4,5,50816,4,5,51236,4,5,51618,4,5,52209,2,23.25888921888938,-1.2628638,36.8070399,-1.2753109,36.8130185,322,591,63,802
11176,120,2271,3,Business,14,5,61181,14,5,62437,14,5,63170,14,5,64053,14,5,66077,14,22.9,-1.272828,36.816608,-1.293515,36.897607,932,2024,1256,1616
11177,26561,2587,3,Business,23,3,50365,23,3,50382,23,3,50655,23,3,50845,23,3,52987,18,27.3,-1.28878,36.8168312,-1.3562374,36.9042954,70,2142,17,463
11178,1849,1500,3,Business,14,4,55397,14,4,55434,14,4,55704,14,4,55839,14,4,58335,12,27.4,-1.2638185,36.7930057,-1.3167113,36.8301563,709,2496,37,405
11179,10921,459,1,Personal,6,5,43816,6,5,44217,6,5,46126,6,5,46663,6,5,49364,10,20.4,-1.3189407,36.8381862,-1.2655306,36.828148,465,2701,401,2446
11180,15156,3517,3,Business,4,5,53094,4,5,53098,4,5,53215,4,5,53747,4,5,55246,16,24.3,-1.3882008,36.7699445,-1.300921,36.828195,100,1499,4,649
11181,10066,868,3,Business,1,5,33403,1,5,33430,1,5,33942,1,5,34713,1,5,35189,4,23.4,-1.2600926,36.8088685,-1.265715,36.823815,576,476,27,1283
11182,3135,635,3,Business,13,3,56782,13,3,57260,13,3,57624,13,3,59408,13,3,60946,8,23.6,-1.3016417,36.8271679,-1.2599563,36.7993439,406,1538,478,2148
11183,22688,868,3,Business,27,6,42916,27,6,43079,27,6,43424,27,6,44055,27,6,44906,6,23.25888921888938,-1.307143,36.825009,-1.265715,36.823815,161,851,163,976
11184,15819,3647,3,Business,18,1,33186,18,1,33285,18,1,33770,18,1,34220,18,1,35266,9,21.8,-1.272639,36.794723,-1.302088,36.831162,247,1046,99,935
11185,10887,2209,3,Business,16,3,59329,16,3,60048,16,3,61666,16,3,61835,16,3,64322,10,19.9,-1.2626906,36.7827022,-1.3090204,36.8409142,432,2487,719,1787
11186,22923,1375,1,Personal,12,6,37642,12,6,37665,12,6,38374,12,6,38770,12,6,39649,9,23.1,-1.3043292,36.8036743,-1.3209614,36.7808827,103,879,23,1105
11187,3739,1422,3,Business,1,1,57170,1,1,57463,1,1,58389,1,1,60371,1,1,61093,3,23.6,-1.3345872,36.8613148,-1.3261286,36.8469625,532,722,293,2908
11188,19508,1789,3,Business,27,1,54797,27,1,54843,27,1,55863,27,1,56046,27,1,57602,12,23.0,-1.2917868,36.7872675,-1.3002926,36.8668523,68,1556,46,1203
11189,20837,136,3,Business,12,1,41004,12,1,41399,12,1,41794,12,1,42194,12,1,43779,15,23.6,-1.3254522,36.7216584,-1.2881035,36.8142095,71,1585,395,795
11190,24903,2066,3,Business,2,4,47471,2,4,47669,2,4,48546,2,4,49223,2,4,50393,5,23.25888921888938,-1.3210189,36.8410551,-1.3316276,36.8727316,709,1170,198,1554
11191,7852,2216,3,Business,7,4,45358,7,4,45369,7,4,45407,7,4,45888,7,4,47615,15,27.7,-1.2551895,36.7822034,-1.3216456,36.7145156,523,1727,11,519
11192,8383,324,3,Personal,12,5,47753,12,5,47811,12,5,48157,12,5,48306,12,5,51482,15,26.6,-1.2653676,36.7911012,-1.332942,36.714065,880,3176,58,495
11193,19691,186,3,Business,3,3,56125,3,3,56139,3,3,56271,3,3,56750,3,3,58836,23,26.7,-1.3700383,36.9190174,-1.2571472,36.7950633,31,2086,14,611
11194,4474,3698,3,Business,18,4,49224,18,4,50230,18,4,51576,18,4,52920,18,4,57040,27,23.25888921888938,-1.3949989,36.7654761,-1.3244885,36.897792,572,4120,1006,2690
11195,2787,2828,1,Business,30,6,40971,30,6,40999,30,6,41039,30,6,42894,30,6,44917,16,22.1,-1.2615888,36.7928732,-1.3239725,36.8827383,648,2023,28,1895
11196,1504,1051,3,Business,10,3,51736,10,3,51791,10,3,52325,10,3,52664,10,3,56225,14,30.5,-1.2963097,36.7688221,-1.3038645,36.8684596,324,3561,55,873
11197,7212,1544,3,Business,22,3,53087,22,3,56045,22,3,57381,22,3,57478,22,3,59102,5,24.3,-1.2791224,36.8306878,-1.297901,36.8034899,673,1624,2958,1433
11198,22850,393,3,Business,28,4,53363,28,4,53399,28,4,54312,28,4,54458,28,4,55786,4,30.0,-1.3167113,36.8301563,-1.3004062,36.829741,362,1328,36,1059
11199,17246,1209,3,Business,3,5,58399,3,5,58655,3,5,58761,3,5,59581,3,5,59583,4,23.25888921888938,-1.3228003,36.8306435,-1.3004062,36.829741,349,2,256,926
11200,13135,942,2,Personal,11,3,39611,11,3,39646,11,3,42733,11,3,44085,11,3,45373,11,19.2,-1.2620197,36.7800096,-1.3147095,36.8472337,101,1288,35,4439
11201,6647,1500,3,Business,19,2,41595,19,2,41649,19,2,41692,19,2,43563,19,2,44437,8,26.4,-1.3004062,36.829741,-1.2638185,36.7930057,26,874,54,1914
11202,6619,190,3,Business,29,3,50108,29,3,51195,29,3,54337,29,3,55140,29,3,58934,32,21.0,-1.1621358,36.9528801,-1.3270347,36.8667362,139,3794,1087,3945
11203,2092,3487,3,Business,14,5,52081,14,5,52170,14,5,53728,14,5,54985,14,5,56448,1,22.8,-1.290894,36.822971,-1.279395,36.825364,436,1463,89,2815
11204,4794,3168,3,Personal,6,3,45814,6,3,48876,6,3,49873,6,3,49995,6,3,50867,3,22.0,-1.2597431,36.8023063,-1.2765641,36.793782,956,872,3062,1119
11205,15884,3462,1,Personal,8,5,54520,8,5,55184,8,5,56187,8,5,56754,8,5,59978,13,21.7,-1.255683,36.813771,-1.2137605,36.8788137,844,3224,664,1570
11206,18262,3686,3,Business,4,3,45489,4,3,45652,4,3,47202,4,3,47507,4,3,49263,8,17.2,-1.2551895,36.7822034,-1.3024794,36.8228284,908,1756,163,1855
11207,27947,2982,3,Business,15,4,47290,15,4,47357,15,4,47932,15,4,51130,15,4,51401,18,27.6,-1.300921,36.828195,-1.177202,36.8351183,70,271,67,3773
11208,26403,2723,1,Personal,3,3,48069,3,3,48337,3,3,48348,3,3,51414,3,3,52383,4,26.7,-1.2784495,36.7981729,-1.2543899,36.8091271,51,969,268,3077
11209,24975,2808,3,Business,10,1,47992,10,1,51231,10,1,54028,10,1,55015,10,1,56124,7,19.0,-1.263499,36.8014548,-1.2966535,36.8123136,574,1109,3239,3784
11210,16895,1422,3,Business,17,1,58705,17,1,58744,17,1,59432,17,1,60208,17,1,60213,1,25.4,-1.3015162,36.8400955,-1.310518,36.837305,62,5,39,1464
11211,12556,2330,3,Business,11,1,53586,11,1,54198,11,1,55413,11,1,55557,11,1,56690,7,28.2,-1.2687407,36.7373043,-1.3015197,36.7658456,778,1133,612,1359
11212,25277,393,3,Business,23,2,47423,23,2,47439,23,2,48385,23,2,49877,23,2,52057,14,19.2,-1.3177547,36.8303703,-1.306378,36.7519845,518,2180,16,2438
11213,5511,1482,3,Business,15,6,35620,15,6,35642,15,6,35975,15,6,36366,15,6,37784,15,17.0,-1.2573921,36.7992507,-1.338579,36.8963038,341,1418,22,724
11214,5345,393,3,Business,22,5,30243,22,5,30542,22,5,30944,22,5,32181,22,5,33634,11,23.25888921888938,-1.3167113,36.8301563,-1.2638185,36.7930057,778,1453,299,1639
11215,14549,59,3,Business,8,3,52975,8,3,52995,8,3,53330,8,3,53740,8,3,54130,3,26.0,-1.290894,36.822971,-1.26733,36.82368,629,390,20,745
11216,17170,718,3,Business,8,5,58082,8,5,58456,8,5,59622,8,5,59816,8,5,61856,22,28.0,-1.2551895,36.7822034,-1.1851027,36.9392531,885,2040,374,1360
11217,16287,3149,3,Business,22,2,45988,22,2,46070,22,2,46271,22,2,48517,22,2,49077,6,19.3,-1.3004062,36.829741,-1.3177547,36.8303703,297,560,82,2447
11218,17063,635,3,Business,8,3,30552,8,3,30816,8,3,30838,8,3,34670,8,3,35858,10,23.25888921888938,-1.3081376,36.8329772,-1.2602337,36.7990548,206,1188,264,3854
11219,18098,1568,3,Business,4,2,52293,4,2,52408,4,2,52658,4,2,53027,4,2,54650,6,20.4,-1.2897368,36.8226783,-1.303806,36.783041,456,1623,115,619
11220,18775,590,3,Business,10,1,46304,10,1,46325,10,1,46816,10,1,47271,10,1,48421,5,23.6,-1.2734594,36.8170558,-1.2674274,36.7870827,646,1150,21,946
11221,25658,187,3,Business,12,2,52640,12,2,52679,12,2,52731,12,2,54085,12,2,59487,21,27.1,-1.3108783,36.8392726,-1.3169591,36.7000029,876,5402,39,1406
11222,26865,2866,3,Business,9,3,43464,9,3,43535,9,3,44349,9,3,44842,9,3,45490,5,21.1,-1.31861,36.8113967,-1.3047026,36.8172033,100,648,71,1307
11223,18082,2279,3,Business,16,3,48378,16,3,56672,16,3,56871,16,3,58255,16,3,60514,7,26.8,-1.2897368,36.8226783,-1.2571472,36.7950633,268,2259,8294,1583
11224,28254,2828,3,Business,1,5,31431,1,5,31560,1,5,34690,1,5,37405,1,5,40320,14,23.4,-1.2710687,36.8142839,-1.2137605,36.8788137,44,2915,129,5845
11225,23148,1246,3,Business,10,4,41832,10,4,41840,10,4,42481,10,4,42736,10,4,43397,2,24.5,-1.2534301,36.8000983,-1.2682478,36.8072852,547,661,8,896
11226,13089,3202,2,Personal,10,1,56149,10,1,56196,10,1,56739,10,1,57036,10,1,58434,8,23.25888921888938,-1.2817763,36.7792738,-1.26005,36.82108,722,1398,47,840
11227,7675,320,2,Personal,29,2,41359,29,2,41376,29,2,42057,29,2,42591,29,2,45283,20,21.6,-1.2049707,36.7858957,-1.2892762,36.764129,116,2692,17,1215
11228,19205,2987,3,Business,25,4,43384,25,4,44779,25,4,46351,25,4,46475,25,4,47462,3,19.8,-1.270212,36.8210877,-1.2649605,36.7981777,646,987,1395,1696
11229,4031,539,2,Personal,19,5,57924,19,5,58352,19,5,58581,19,5,59416,19,5,60151,5,27.5,-1.2983805,36.8198439,-1.307241,36.8302368,268,735,428,1064
11230,22274,3688,3,Business,13,3,60404,13,3,60499,13,3,61202,13,3,61417,13,3,64420,23,25.8,-1.2551895,36.7822034,-1.374163,36.913444,622,3003,95,918
11231,16285,1882,3,Business,26,6,36994,26,6,37945,26,6,40154,26,6,40544,26,6,43315,15,25.8,-1.2273427,36.7994683,-1.2160907,36.8851949,772,2771,951,2599
11232,20105,1368,3,Business,23,5,36717,23,5,37446,23,5,37598,23,5,37979,23,5,38909,7,24.1,-1.2571472,36.7950633,-1.295737,36.800789,878,930,729,533
11233,16242,2330,3,Business,18,1,57963,18,1,57971,18,1,58891,18,1,59014,18,1,59679,6,30.6,-1.3015197,36.7658456,-1.2921463,36.8029626,510,665,8,1043
11234,15934,238,3,Business,23,4,40066,23,4,40109,23,4,40400,23,4,40648,23,4,41728,4,23.1,-1.3077869,36.8443207,-1.308366,36.823613,216,1080,43,539
11235,24217,1654,1,Personal,11,1,32216,11,1,32980,11,1,34351,11,1,34460,11,1,35376,5,14.6,-1.3157973,36.815148,-1.2891116,36.8106915,322,916,764,1480
11236,14902,1329,3,Business,19,2,39153,19,2,39201,19,2,40637,19,2,41156,19,2,43259,9,27.5,-1.273056,36.811298,-1.3314048,36.8229367,697,2103,48,1955
11237,18613,1964,3,Personal,22,3,45713,22,3,48822,22,3,48944,22,3,49399,22,3,52251,14,24.4,-1.1867519,36.8369389,-1.2791238,36.8200368,709,2852,3109,577
11238,15943,2828,3,Business,29,5,56173,29,5,56323,29,5,56676,29,5,57378,29,5,58461,17,21.3,-1.2615888,36.7928732,-1.2540899,36.7042728,100,1083,150,1055
11239,20571,2150,3,Business,14,2,41850,14,2,42270,14,2,44324,14,2,44644,14,2,45699,6,23.25888921888938,-1.3181159,36.7101559,-1.344446,36.756597,3,1055,420,2374
11240,13911,3674,3,Business,26,2,56753,26,2,56818,26,2,57310,26,2,57474,26,2,57780,3,29.9,-1.2663135,36.7973895,-1.2551895,36.7822034,801,306,65,656
11241,27225,868,3,Business,17,3,50216,17,3,50249,17,3,50629,17,3,50928,17,3,51780,5,23.25888921888938,-1.2600926,36.8088685,-1.265715,36.823815,547,852,33,679
11242,27087,3080,3,Business,12,3,47997,12,3,48017,12,3,48833,12,3,49823,12,3,49831,3,26.3,-1.2643694,36.7854135,-1.2551895,36.7822034,566,8,20,1806
11243,13399,1384,3,Business,6,1,33720,6,1,33772,6,1,34631,6,1,34728,6,1,39821,16,23.25888921888938,-1.2517448,36.7924971,-1.3202111,36.8880995,131,5093,52,956
11244,4169,1786,2,Personal,23,4,31251,23,4,31336,23,4,31880,23,4,32421,23,4,33626,5,15.9,-1.2965924,36.8179314,-1.2775227,36.8174812,857,1205,85,1085
11245,5761,2006,3,Business,1,4,33910,1,4,33928,1,4,35390,1,4,35890,1,4,40285,16,23.25888921888938,-1.2469508,36.8244485,-1.3231725,36.8640177,89,4395,18,1962
11246,5167,1368,3,Business,5,4,52100,5,4,52116,5,4,52410,5,4,52487,5,4,53671,8,22.2,-1.2579304,36.8019667,-1.2903624,36.7875246,379,1184,16,371
11247,17118,1363,3,Business,10,3,55129,10,3,55164,10,3,55217,10,3,55617,10,3,56018,5,30.8,-1.3004062,36.829741,-1.3239488,36.8316835,206,401,35,453
11248,15981,346,3,Business,10,4,38246,10,4,38283,10,4,38774,10,4,39981,10,4,40361,2,23.25888921888938,-1.290894,36.822971,-1.2885529,36.8160141,393,380,37,1698
11249,9265,1500,3,Business,21,2,38484,21,2,38497,21,2,38633,21,2,38757,21,2,39488,5,22.7,-1.2638185,36.7930057,-1.282937,36.7816984,709,731,13,260
11250,22391,517,3,Business,22,4,26928,22,4,33384,22,4,33919,22,4,35653,22,4,35655,4,19.6,-1.3177547,36.8303703,-1.3004062,36.829741,828,2,6456,2269
11251,18345,59,3,Business,6,4,53976,6,4,54064,6,4,54568,6,4,54833,6,4,56276,6,21.3,-1.2649605,36.7981777,-1.290894,36.822971,20,1443,88,769
11252,14436,1194,3,Personal,12,4,57610,12,4,58018,12,4,58970,12,4,59250,12,4,60980,9,21.9,-1.304192,36.739457,-1.2906959,36.7961042,140,1730,408,1232
11253,25243,1329,3,Business,12,3,48633,12,3,48800,12,3,50575,12,3,50789,12,3,51669,5,21.1,-1.273056,36.811298,-1.2772389,36.7855864,690,880,167,1989
11254,6912,3621,3,Business,14,2,37569,14,2,37632,14,2,38104,14,2,38301,14,2,38935,4,23.25888921888938,-1.2836583,36.7886014,-1.2877378,36.8098926,709,634,63,669
11255,13225,811,3,Personal,14,1,54557,14,1,54585,14,1,55096,14,1,55216,14,1,56032,4,25.9,-1.2963097,36.7688221,-1.2944457,36.7923516,862,816,28,631
11256,19173,1304,3,Business,5,1,31904,5,1,31912,5,1,32069,5,1,32413,5,1,34971,15,18.8,-1.2551895,36.7822034,-1.3354076,36.86307,630,2558,8,501
11257,9662,1363,3,Business,11,2,42447,11,2,42536,11,2,43593,11,2,43763,11,2,44284,2,24.3,-1.3004062,36.829741,-1.2940217,36.8213142,882,521,89,1227
11258,21048,2828,1,Business,27,3,50930,27,3,52411,27,3,53464,27,3,54962,27,3,55754,5,23.25888921888938,-1.2479362,36.772759,-1.2615888,36.7928732,498,792,1481,2551
11259,25807,1441,2,Personal,16,2,37919,16,2,37936,16,2,37979,16,2,38929,16,2,40438,10,23.6,-1.3142269,36.839245,-1.2849763,36.7841767,188,1509,17,993
11260,8357,238,3,Business,14,2,51583,14,2,51597,14,2,51609,14,2,51983,14,2,53238,13,23.25888921888938,-1.2638185,36.7930057,-1.3077869,36.8443207,576,1255,14,386
11261,9849,3689,3,Business,31,5,59568,31,5,60191,31,5,61360,31,5,61456,31,5,62804,7,23.7,-1.2584143,36.8048002,-1.225322,36.80855,139,1348,623,1265
11262,15666,1209,3,Business,11,2,49617,11,2,54337,11,2,55310,11,2,56104,11,2,56806,4,22.5,-1.3077869,36.8443207,-1.3004062,36.829741,914,702,4720,1767
11263,20699,3517,3,Business,15,2,34903,15,2,34921,15,2,35790,15,2,39086,15,2,41311,15,24.5,-1.300921,36.828195,-1.3882008,36.7699445,148,2225,18,4165
11264,4166,496,3,Business,20,4,61128,20,4,64282,20,4,65216,20,4,65599,20,4,66841,7,22.8,-1.2551895,36.7822034,-1.2885417,36.8100523,845,1242,3154,1317
11265,16447,20,3,Business,5,5,42799,5,5,42848,5,5,43372,5,5,44707,5,5,46205,14,24.6,-1.2629666,36.8068369,-1.3278522,36.8711134,119,1498,49,1859
11266,12895,1340,3,Business,3,4,44155,3,4,46326,3,4,47522,3,4,48058,3,4,51776,21,22.1,-1.3972661,36.7594584,-1.2707179,36.7979713,74,3718,2171,1732
11267,7711,391,3,Business,21,2,43810,21,2,44092,21,2,44221,21,2,47426,21,2,48287,11,22.3,-1.2784063,36.8222933,-1.2105984,36.8109774,564,861,282,3334
11268,10819,3341,1,Personal,9,1,51931,9,1,52173,9,1,52515,9,1,53104,9,1,54788,5,21.3,-1.2795796,36.819062,-1.2824577,36.7967953,21,1684,242,931
11269,25461,2821,2,Personal,30,1,34591,30,1,37021,30,1,37720,30,1,37829,30,1,40028,19,16.5,-1.3284259,36.726068,-1.3083777,36.8590077,791,2199,2430,808
11270,24161,1527,3,Business,16,4,45710,16,4,45796,16,4,45954,16,4,48580,16,4,49637,8,23.25888921888938,-1.3004062,36.829741,-1.2638185,36.7930057,161,1057,86,2784
11271,19835,1329,3,Business,3,3,40497,3,3,40558,3,3,40942,3,3,41102,3,3,41880,3,27.3,-1.273056,36.811298,-1.2607855,36.8163104,99,778,61,544
11272,22869,1244,3,Business,10,4,45730,10,4,45795,10,4,46719,10,4,47233,10,4,48055,6,24.8,-1.2628473,36.781805,-1.303596,36.778378,52,822,65,1438
11273,20390,2330,3,Business,15,1,60240,15,1,60422,15,1,61090,15,1,61804,15,1,62790,8,23.25888921888938,-1.3263903,36.7179885,-1.3015197,36.7658456,910,986,182,1382
11274,5477,3272,1,Personal,15,1,35963,15,1,35996,15,1,36462,15,1,36767,15,1,38685,13,23.25888921888938,-1.2696341,36.8042045,-1.317151,36.865734,268,1918,33,771
11275,9132,733,3,Business,23,2,56791,23,2,57591,23,2,57594,23,2,57880,23,2,59130,8,23.25888921888938,-1.2551895,36.7822034,-1.2913246,36.8019522,576,1250,800,289
11276,26635,3291,3,Business,18,1,40297,18,1,41403,18,1,41569,18,1,41767,18,1,42425,5,23.25888921888938,-1.2628473,36.781805,-1.2600926,36.8088685,726,658,1106,364
11277,12438,3718,3,Business,11,2,36533,11,2,36810,11,2,37307,11,2,37864,11,2,39386,12,16.3,-1.2650027,36.8126242,-1.2037968,36.7802765,427,1522,277,1054
11278,24368,2423,3,Business,14,5,52810,14,5,52899,14,5,53473,14,5,53912,14,5,56945,8,27.3,-1.2551895,36.7822034,-1.3033012,36.8170864,795,3033,89,1013
11279,10483,970,3,Business,4,2,46686,4,2,48866,4,2,49882,4,2,51334,4,2,54319,6,23.7,-1.2571472,36.7950633,-1.2852,36.82397,404,2985,2180,2468
11280,14166,1595,2,Personal,5,6,58874,5,6,58911,5,6,59433,5,6,60213,5,6,64661,16,23.0,-1.267452,36.806015,-1.2536725,36.6804915,633,4448,37,1302
11281,22385,2423,3,Business,28,4,54756,28,4,54834,28,4,55194,28,4,57026,28,4,58270,12,27.6,-1.2571472,36.7950633,-1.329568,36.8520825,484,1244,78,2192
11282,10207,1404,2,Personal,26,6,54030,26,6,54065,26,6,55049,26,6,55362,26,6,56307,8,24.1,-1.2956928,36.80259,-1.25454,36.83922,100,945,35,1297
11283,14077,1209,3,Business,8,3,37652,8,3,37680,8,3,37684,8,3,40810,8,3,41539,8,23.25888921888938,-1.3004062,36.829741,-1.2638185,36.7930057,258,729,28,3130
11284,14465,2627,3,Business,24,3,53653,24,3,53679,24,3,54265,24,3,54762,24,3,55212,2,23.25888921888938,-1.2584143,36.8048002,-1.2571472,36.7950633,96,450,26,1083
11285,859,1209,3,Business,8,2,57627,8,2,57655,8,2,57818,8,2,58600,8,2,59240,4,25.2,-1.3228003,36.8306435,-1.3004062,36.829741,523,640,28,945
11286,4107,2335,3,Business,18,4,39502,18,4,39520,18,4,39866,18,4,40272,18,4,44038,22,25.6,-1.2551895,36.7822034,-1.3562374,36.9042954,393,3766,18,752
11287,24429,2150,3,Business,2,4,58048,2,4,58087,2,4,58368,2,4,58971,2,4,61123,15,23.25888921888938,-1.272828,36.816608,-1.344446,36.756597,235,2152,39,884
11288,5319,2964,3,Business,30,2,35699,30,2,35715,30,2,35845,30,2,37086,30,2,38104,11,23.25888921888938,-1.2551895,36.7822034,-1.2381,36.732826,245,1018,16,1371
11289,11077,3264,3,Business,24,1,35051,24,1,35300,24,1,35893,24,1,36194,24,1,37534,9,15.7,-1.2551895,36.7822034,-1.2963316,36.7863289,531,1340,249,894
11290,11153,2581,3,Personal,11,1,46101,11,1,48369,11,1,49404,11,1,49795,11,1,51474,5,23.1,-1.2961952,36.7876396,-1.2814452,36.8253735,526,1679,2268,1426
11291,20194,1389,3,Business,16,2,57307,16,2,57914,16,2,59438,16,2,59767,16,2,61163,16,23.25888921888938,-1.207546,36.7913976,-1.2765736,36.8513646,801,1396,607,1853
11292,6226,2360,3,Business,17,1,38765,17,1,38797,17,1,39589,17,1,40038,17,1,41039,5,23.7,-1.2962967,36.8020231,-1.2708857,36.8135766,958,1001,32,1241
11293,2770,2691,3,Business,6,2,46566,6,2,46752,6,2,47111,6,2,47539,6,2,49918,7,25.0,-1.2571472,36.7950633,-1.2857671,36.7875614,427,2379,186,787
11294,11864,186,3,Business,18,1,58534,18,1,58652,18,1,58850,18,1,60056,18,1,60780,4,28.5,-1.2571472,36.7950633,-1.2825816,36.8092346,26,724,118,1404
11295,14084,417,1,Personal,28,1,54533,28,1,55056,28,1,56791,28,1,56897,28,1,58465,6,24.7,-1.267691,36.793649,-1.2628892,36.8244802,752,1568,523,1841
11296,6236,3621,3,Business,28,4,53076,28,4,53089,28,4,54098,28,4,54261,28,4,56293,20,27.6,-1.2836583,36.7886014,-1.3103985,36.9114173,709,2032,13,1172
11297,21790,1920,3,Business,1,4,44296,1,4,44324,1,4,45173,1,4,45464,1,4,46013,1,23.25888921888938,-1.2551895,36.7822034,-1.261842,36.78486,620,549,28,1140
11298,237,1591,2,Personal,11,4,65431,11,4,65697,11,4,67306,11,4,67782,11,4,71152,9,23.9,-1.2655306,36.828148,-1.309645,36.808864,949,3370,266,2085
11299,27186,2801,3,Business,31,3,34697,31,3,34714,31,3,35925,31,3,36048,31,3,37799,10,19.0,-1.2595422,36.7871178,-1.2986123,36.8076281,259,1751,17,1334
11300,22785,867,3,Business,1,6,35897,1,6,36569,1,6,37756,1,6,38326,1,6,39984,10,22.4,-1.3004062,36.829741,-1.2991441,36.7528804,878,1658,672,1757
11301,60,2587,3,Business,9,5,52431,9,5,52621,9,5,52660,9,5,54054,9,5,55326,5,26.2,-1.2584143,36.8048002,-1.28878,36.8168312,403,1272,190,1433
11302,4622,2763,3,Business,4,1,57234,4,1,57759,4,1,57990,4,1,58115,4,1,61194,9,22.8,-1.2553615,36.7895376,-1.300921,36.828195,742,3079,525,356
11303,2452,3147,3,Business,12,3,60973,12,3,61045,12,3,62138,12,3,62728,12,3,65192,17,20.5,-1.2859912,36.8756811,-1.3472066,36.7692638,890,2464,72,1683
11304,18518,393,3,Business,5,2,60219,5,2,60770,5,2,60781,5,2,62944,5,2,62946,11,23.25888921888938,-1.3167113,36.8301563,-1.2638185,36.7930057,515,2,551,2174
11305,6238,1346,3,Business,25,1,40058,25,1,40083,25,1,40401,25,1,40803,25,1,41657,6,25.3,-1.2917868,36.7872675,-1.2695287,36.7981777,322,854,25,720
11306,20936,1880,3,Business,9,2,53699,9,2,53724,9,2,53801,9,2,54412,9,2,55987,12,30.8,-1.2571472,36.7950633,-1.31553,36.863732,131,1575,25,688
11307,10991,3064,3,Business,22,5,37320,22,5,37358,22,5,38939,22,5,39540,22,5,40558,4,23.25888921888938,-1.2571472,36.7950633,-1.2519787,36.7806491,227,1018,38,2182
11308,3794,269,3,Business,17,3,33893,17,3,34048,17,3,35091,17,3,35469,17,3,37573,11,21.0,-1.3332749,36.8708147,-1.294869,36.815327,857,2104,155,1421
11309,622,2330,3,Business,8,5,48078,8,5,48316,8,5,48600,8,5,48665,8,5,49390,5,24.2,-1.3143328,36.8137434,-1.3040812,36.7924217,327,725,238,349
11310,13900,1787,3,Business,12,2,50562,12,2,50584,12,2,50594,12,2,51303,12,2,52219,11,23.25888921888938,-1.279395,36.825364,-1.2283403,36.8822756,812,916,22,719
11311,21823,1991,3,Personal,5,2,54590,5,2,55071,5,2,55868,5,2,56172,5,2,57187,5,23.25888921888938,-1.2963097,36.7688221,-1.290641,36.812941,763,1015,481,1101
11312,5494,2037,1,Personal,18,4,51874,18,4,52274,18,4,52877,18,4,53989,18,4,55230,3,26.6,-1.286431,36.818411,-1.2903277,36.80556,477,1241,400,1715
11313,2142,3426,3,Business,1,4,37695,1,4,37709,1,4,38201,1,4,38352,1,4,41411,20,23.25888921888938,-1.2283403,36.8822756,-1.3014461,36.7661381,685,3059,14,643
11314,21880,3210,1,Personal,2,2,45454,2,2,45558,2,2,45957,2,2,46306,2,2,48066,8,20.8,-1.255956,36.772901,-1.2795261,36.8260185,449,1760,104,748
11315,19090,3635,1,Business,25,2,35415,25,2,35424,25,2,35515,25,2,35908,25,2,36441,3,18.0,-1.2584143,36.8048002,-1.2615888,36.7928732,865,533,9,484
11316,27713,3686,3,Business,14,3,33415,14,3,35175,14,3,35541,14,3,36068,14,3,36952,8,18.3,-1.2551895,36.7822034,-1.2956951,36.8129242,726,884,1760,893
11317,490,529,2,Personal,18,3,48524,18,3,48537,18,3,48905,18,3,49331,18,3,50047,4,20.8,-1.2709604,36.8162138,-1.2676164,36.8075243,844,716,13,794
11318,26530,2978,3,Business,5,2,32838,5,2,32862,5,2,33383,5,2,33713,5,2,34382,2,17.8,-1.263499,36.8014548,-1.2551895,36.7822034,854,669,24,851
11319,2032,265,3,Business,15,1,41249,15,1,41301,15,1,41993,15,1,42338,15,1,43126,7,23.25888921888938,-1.2636814,36.8029965,-1.300921,36.828195,264,788,52,1037
11320,25463,1724,3,Business,5,5,43845,5,5,43877,5,5,43943,5,5,44765,5,5,45804,2,23.9,-1.2551895,36.7822034,-1.2571472,36.7950633,663,1039,32,888
11321,26017,1389,3,Business,25,4,48118,25,4,48243,25,4,48729,25,4,49091,25,4,50428,14,20.9,-1.2584143,36.8048002,-1.207546,36.7913976,32,1337,125,848
11322,27008,2514,3,Business,26,2,39892,26,2,39936,26,2,40371,26,2,40671,26,2,40965,1,23.25888921888938,-1.266294,36.8057971,-1.2684667,36.8002891,100,294,44,735
11323,12535,111,3,Business,24,3,45983,24,3,46018,24,3,46021,24,3,46200,24,3,48289,8,23.25888921888938,-1.2551895,36.7822034,-1.2879682,36.8062613,576,2089,35,182
11324,14544,302,3,Business,27,7,53093,27,7,53124,27,7,53362,27,7,54173,27,7,56164,7,28.1,-1.2649605,36.7981777,-1.291469,36.7802612,112,1991,31,1049
11325,16310,3147,3,Business,12,1,29628,12,1,32527,12,1,33030,12,1,33738,12,1,34592,2,19.2,-1.3472066,36.7692638,-1.3332025,36.7789361,328,854,2899,1211
11326,2558,478,3,Business,7,2,54025,7,2,54123,7,2,54930,7,2,55546,7,2,56931,6,23.25888921888938,-1.2853965,36.8183118,-1.307241,36.8302368,843,1385,98,1423
11327,11557,1597,1,Personal,31,4,66237,31,4,66344,31,4,68222,31,4,68677,31,4,73565,20,22.4,-1.232287,36.801636,-1.3222489,36.7867025,301,4888,107,2333
11328,5453,3064,3,Business,1,5,57706,1,5,57905,1,5,58810,1,5,59164,1,5,60637,10,28.5,-1.2571472,36.7950633,-1.3239488,36.8316835,225,1473,199,1259
11329,22706,1205,3,Business,14,5,54402,14,5,55334,14,5,55653,14,5,56452,14,5,57545,9,23.8,-1.257309,36.8060084,-1.2954438,36.7667096,541,1093,932,1118
11330,2520,496,3,Business,31,3,42082,31,3,42100,31,3,42119,31,3,42741,31,3,45435,23,24.6,-1.2551895,36.7822034,-1.374163,36.913444,450,2694,18,641
11331,22315,2216,3,Business,28,3,56615,28,3,57612,28,3,57710,28,3,57968,28,3,59446,4,23.25888921888938,-1.2551895,36.7822034,-1.2617028,36.7983849,222,1478,997,356
11332,10884,1914,2,Personal,2,1,53505,2,1,55151,2,1,55918,2,1,56313,2,1,58753,6,19.9,-1.2798711,36.8207118,-1.2969741,36.7856612,531,2440,1646,1162
11333,6965,2030,3,Business,15,3,46990,15,3,46996,15,3,47509,15,3,48815,15,3,49944,2,21.5,-1.304735,36.7846054,-1.295908,36.791433,213,1129,6,1819
11334,17854,867,3,Business,27,3,38963,27,3,38987,27,3,38999,27,3,40767,27,3,41821,10,26.1,-1.2996533,36.8292629,-1.2991441,36.7528804,15,1054,24,1780
11335,1944,393,3,Business,8,4,29517,8,4,29858,8,4,29867,8,4,33057,8,4,33110,4,20.5,-1.3177547,36.8303703,-1.3004062,36.829741,128,53,341,3199
11336,25404,2344,3,Business,19,3,44692,19,3,54308,19,3,54675,19,3,55000,19,3,55745,8,25.8,-1.2551895,36.7822034,-1.2857685,36.7866843,857,745,9616,692
11337,25878,2879,3,Business,8,5,57281,8,5,57580,8,5,60240,8,5,61083,8,5,64832,18,19.9,-1.2639198,36.8069299,-1.326207,36.889066,268,3749,299,3503
11338,17598,2727,3,Personal,7,1,51459,7,1,51477,7,1,51550,7,1,52680,7,1,55523,12,26.6,-1.3164171,36.8327168,-1.2862949,36.7599986,31,2843,18,1203
11339,10793,970,3,Business,28,4,52737,28,4,52769,28,4,53653,28,4,53966,28,4,54461,3,29.9,-1.2551895,36.7822034,-1.2629594,36.8077626,52,495,32,1197
11340,20349,297,2,Personal,16,2,36400,16,2,36418,16,2,36873,16,2,37082,16,2,39446,6,23.25888921888938,-1.2852908,36.7557439,-1.2977387,36.8031447,612,2364,18,664
11341,9696,969,1,Personal,31,4,48487,31,4,49634,31,4,50981,31,4,51680,31,4,52810,5,22.7,-1.2850851,36.82176,-1.3004846,36.7901591,844,1130,1147,2046
11342,6395,3669,3,Business,25,4,54929,25,4,54965,25,4,55229,25,4,55660,25,4,56747,9,23.25888921888938,-1.2615888,36.7928732,-1.3025826,36.7670807,576,1087,36,695
11343,23585,1934,2,Personal,19,3,51425,19,3,51502,19,3,52126,19,3,52358,19,3,53558,6,25.4,-1.2877911,36.816449,-1.304033,36.7848695,698,1200,77,856
11344,23368,811,2,Personal,10,5,51991,10,5,52016,10,5,53218,10,5,53520,10,5,54678,7,22.0,-1.278612,36.8195876,-1.296797,36.7764525,213,1158,25,1504
11345,13471,2978,3,Business,25,5,39130,25,5,39182,25,5,39306,25,5,39516,25,5,41199,12,26.6,-1.2551895,36.7822034,-1.325681,36.7959072,518,1683,52,334
11346,22674,1676,2,Personal,15,2,47414,15,2,47807,15,2,48054,15,2,48862,15,2,51810,4,24.6,-1.305716,36.809882,-1.2885364,36.7995016,441,2948,393,1055
11347,7908,136,3,Business,21,4,35730,21,4,35775,21,4,36272,21,4,36829,21,4,38121,11,19.2,-1.2560874,36.7931031,-1.2313147,36.8016863,290,1292,45,1054
11348,7874,1999,1,Personal,2,1,30748,2,1,30775,2,1,31395,2,1,31623,2,1,32289,4,16.5,-1.29276,36.783799,-1.2771989,36.8089752,88,666,27,848
11349,25492,176,1,Personal,19,4,53449,19,4,53637,19,4,54150,19,4,54949,19,4,55754,4,20.7,-1.298529,36.816482,-1.2864298,36.8224345,752,805,188,1312
11350,26107,3091,3,Business,8,3,48123,8,3,48223,8,3,48664,8,3,49692,8,3,50823,7,23.25888921888938,-1.290894,36.822971,-1.2551895,36.7822034,193,1131,100,1469
11351,11603,3494,3,Personal,7,4,53905,7,4,53919,7,4,53945,7,4,54822,7,4,55083,2,20.3,-1.3016513,36.7649321,-1.2963097,36.7688221,100,261,14,903
11352,1184,2239,2,Personal,19,4,57739,19,4,57782,19,4,58586,19,4,59458,19,4,60279,6,20.6,-1.2985749,36.8088,-1.2697141,36.7981777,84,821,43,1676
11353,3893,1244,3,Business,3,6,33340,3,6,33510,3,6,34522,3,6,35419,3,6,36338,8,20.0,-1.272828,36.816608,-1.303596,36.778378,427,919,170,1909
11354,17507,1643,1,Personal,12,5,65581,12,5,65589,12,5,66071,12,5,66278,12,5,68165,15,25.7,-1.2658335,36.8042867,-1.207546,36.7913976,881,1887,8,689
11355,27819,1245,3,Business,9,4,51600,9,4,51744,9,4,51901,9,4,53239,9,4,55243,17,23.25888921888938,-1.300921,36.828195,-1.3198615,36.7110323,728,2004,144,1495
11356,18150,1642,3,Business,25,4,33444,25,4,33533,25,4,34089,25,4,34395,25,4,35287,5,23.25888921888938,-1.2728069,36.7962362,-1.288269,36.8182753,291,892,89,862
11357,23970,972,3,Business,26,6,44439,26,6,44526,26,6,44962,26,6,45270,26,6,46019,4,22.8,-1.2862033,36.8152966,-1.3016043,36.8259264,888,749,87,744
11358,25542,1882,3,Business,19,2,68571,19,2,68598,19,2,68987,19,2,70572,19,2,71407,8,23.6,-1.2958783,36.7928125,-1.2591019,36.800577,336,835,27,1974
11359,25169,3203,3,Business,10,2,41155,10,2,41178,10,2,41184,10,2,42614,10,2,43182,9,20.1,-1.265715,36.823815,-1.228911,36.881876,406,568,23,1436
11360,14048,2306,3,Business,24,5,53876,24,5,54028,24,5,55010,24,5,55144,24,5,57259,17,22.9,-1.2271998,36.8084905,-1.3190962,36.8563967,484,2115,152,1116
11361,2546,1329,3,Business,9,4,49875,9,4,50009,9,4,50341,9,4,50509,9,4,53281,7,23.25888921888938,-1.273056,36.811298,-1.2912496,36.7727743,959,2772,134,500
11362,12569,788,3,Business,14,4,56356,14,4,56509,14,4,56792,14,4,57713,14,4,58959,13,27.9,-1.2283403,36.8822756,-1.225322,36.80855,383,1246,153,1204
11363,22449,53,3,Business,27,3,39843,27,3,39954,27,3,40408,27,3,41219,27,3,42127,5,25.9,-1.3004062,36.829741,-1.2770708,36.8231093,858,908,111,1265
11364,25606,1244,3,Business,24,1,33130,24,1,33138,24,1,33336,24,1,33569,24,1,34464,6,19.5,-1.2628473,36.781805,-1.303596,36.778378,958,895,8,431
11365,18048,868,3,Business,13,4,48333,13,4,51184,13,4,52216,13,4,53270,13,4,54728,8,23.1,-1.303596,36.778378,-1.2663631,36.8163329,838,1458,2851,2086
11366,9280,2436,3,Business,25,3,43883,25,3,43894,25,3,43931,25,3,44513,25,3,46891,10,23.25888921888938,-1.2551895,36.7822034,-1.2304909,36.821691,519,2378,11,619
11367,12265,540,3,Business,26,2,37073,26,2,37088,26,2,37487,26,2,37779,26,2,38691,5,21.9,-1.2551895,36.7822034,-1.270054,36.815164,817,912,15,691
11368,22411,2195,1,Business,29,3,34560,29,3,34848,29,3,35092,29,3,35520,29,3,35907,4,15.2,-1.318062,36.849326,-1.3313643,36.8577422,882,387,288,672
11369,25999,2523,3,Business,5,3,43627,5,3,43671,5,3,44334,5,3,44451,5,3,46473,15,22.4,-1.2551895,36.7822034,-1.3265997,36.8721129,108,2022,44,780
11370,18001,393,3,Business,19,3,31491,19,3,31686,19,3,31689,19,3,33040,19,3,34692,11,19.7,-1.3167113,36.8301563,-1.2574219,36.7927073,515,1652,195,1354
11371,17090,3631,3,Personal,6,1,47705,6,1,47747,6,1,48437,6,1,48690,6,1,49538,5,23.25888921888938,-1.2963097,36.7688221,-1.2799006,36.7916973,678,848,42,943
11372,19116,2801,3,Business,23,2,31770,23,2,31886,23,2,32595,23,2,32830,23,2,34254,8,23.25888921888938,-1.2674274,36.7870827,-1.2809847,36.8274169,953,1424,116,944
11373,19441,2330,3,Business,18,1,49202,18,1,49278,18,1,49760,18,1,49829,18,1,50941,7,30.6,-1.2680363,36.7990466,-1.2873232,36.7658572,778,1112,76,551
11374,16057,1617,1,Personal,22,5,48629,22,5,48633,22,5,48643,22,5,49519,22,5,51151,20,23.25888921888938,-1.2908102,36.7944473,-1.3673224,36.9161975,813,1632,4,886
11375,2723,393,3,Business,27,3,53365,27,3,53378,27,3,53409,27,3,53764,27,3,54942,4,29.5,-1.3167113,36.8301563,-1.3004062,36.829741,349,1178,13,386
11376,23362,517,3,Business,7,1,35812,7,1,35818,7,1,35823,7,1,37999,7,1,38004,11,24.9,-1.3167113,36.8301563,-1.2574219,36.7927073,515,5,6,2181
11377,4668,3149,3,Business,3,4,44681,3,4,44911,3,4,45345,3,4,46100,3,4,47013,5,23.5,-1.3004062,36.829741,-1.3228003,36.8306435,901,913,230,1189
11378,23731,635,3,Business,13,3,51877,13,3,52005,13,3,52611,13,3,52746,13,3,53496,5,29.2,-1.2857764,36.8236622,-1.2602337,36.7990548,291,750,128,741
11379,19820,496,3,Business,30,2,53178,30,2,53879,30,2,54389,30,2,54597,30,2,55008,5,23.25888921888938,-1.2592947,36.7698085,-1.2551895,36.7822034,245,411,701,718
11380,19634,1901,2,Personal,12,5,41734,12,5,41818,12,5,42270,12,5,42395,12,5,44648,6,24.4,-1.2544358,36.7974683,-1.2897215,36.7945959,578,2253,84,577
11381,18660,3560,3,Business,7,1,41368,7,1,41440,7,1,41442,7,1,42558,7,1,43110,1,24.9,-1.290894,36.822971,-1.279395,36.825364,268,552,72,1118
11382,4627,3698,3,Business,7,5,49662,7,5,51340,7,5,51391,7,5,51852,7,5,54977,22,23.25888921888938,-1.3244885,36.897792,-1.3107918,36.761794,75,3125,1678,512
11383,14507,3214,3,Business,17,5,40136,17,5,40177,17,5,40769,17,5,41378,17,5,42405,5,23.25888921888938,-1.2951243,36.8281344,-1.289795,36.7957132,790,1027,41,1201
11384,23101,3689,1,Business,16,1,35879,16,1,38800,16,1,39414,16,1,39903,16,1,41339,20,19.2,-1.1853633,36.9350604,-1.260232,36.807334,644,1436,2921,1103
11385,23999,1484,3,Business,11,1,35382,11,1,35569,11,1,36936,11,1,37016,11,1,37833,4,18.1,-1.2551895,36.7822034,-1.2662138,36.7997481,275,817,187,1447
11386,5462,2112,3,Business,31,5,47394,31,5,48013,31,5,49052,31,5,49665,31,5,53747,12,24.8,-1.28878,36.8168312,-1.2156006,36.8916865,272,4082,619,1652
11387,15889,1500,3,Business,8,5,56755,8,5,57980,8,5,59521,8,5,60439,8,5,62417,11,28.1,-1.3077869,36.8443207,-1.2638185,36.7930057,701,1978,1225,2459
11388,24199,2253,1,Personal,3,5,58676,3,5,59008,3,5,60963,3,5,62437,3,5,64614,10,22.9,-1.2619756,36.800139,-1.321916,36.825801,400,2177,332,3429
11389,15057,85,2,Business,11,3,31876,11,3,31894,11,3,32261,11,3,32650,11,3,34296,9,15.4,-1.3014461,36.7661381,-1.2571191,36.8019652,735,1646,18,756
11390,23620,2404,2,Personal,7,2,50022,7,2,50088,7,2,50787,7,2,51544,7,2,52901,8,25.0,-1.3233955,36.8562944,-1.305716,36.809882,402,1357,66,1456
11391,27291,3203,3,Business,14,2,38266,14,2,38277,14,2,38283,14,2,39996,14,2,41355,13,21.6,-1.307143,36.825009,-1.228911,36.881876,589,1359,11,1719
11392,21693,1781,3,Business,18,2,41908,18,2,43233,18,2,45006,18,2,45381,18,2,49865,17,23.25888921888938,-1.2571472,36.7950633,-1.2860183,36.8975338,532,4484,1325,2148
11393,8565,1102,3,Business,1,1,52969,1,1,53056,1,1,53075,1,1,53777,1,1,54388,4,23.25888921888938,-1.3004062,36.829741,-1.2994772,36.804825,855,611,87,721
11394,19920,889,3,Business,21,4,39446,21,4,39488,21,4,40134,21,4,40440,21,4,41204,7,21.5,-1.2985153,36.7876043,-1.2664956,36.7788652,312,764,42,952
11395,24842,2859,1,Personal,13,1,35412,13,1,35549,13,1,36920,13,1,37144,13,1,39104,5,15.2,-1.2527958,36.8003131,-1.2834945,36.812937,592,1960,137,1595
11396,18026,3331,3,Business,16,5,53438,16,5,54809,16,5,57175,16,5,57391,16,5,61462,8,23.25888921888938,-1.2551895,36.7822034,-1.2987976,36.829477,554,4071,1371,2582
11397,11079,1927,3,Business,8,2,52596,8,2,53095,8,2,53615,8,2,53700,8,2,56331,17,25.1,-1.3467389,36.7690312,-1.2551895,36.7822034,470,2631,499,605
11398,17686,3718,3,Business,13,4,45665,13,4,45735,13,4,46571,13,4,46728,13,4,48139,5,22.2,-1.2906618,36.8131222,-1.2650027,36.8126242,254,1411,70,993
11399,19209,2154,3,Business,27,1,40806,27,1,40873,27,1,41709,27,1,41856,27,1,42883,10,20.9,-1.2765736,36.8513646,-1.2551895,36.7822034,709,1027,67,983
11400,2039,671,1,Personal,6,4,49342,6,4,49349,6,4,49958,6,4,50254,6,4,52624,24,23.2,-1.2343087,36.84749,-1.370436,36.7536015,449,2370,7,905
11401,11346,2982,3,Business,26,2,56717,26,2,56784,26,2,57113,26,2,59691,26,2,62777,18,29.4,-1.300921,36.828195,-1.177202,36.8351183,697,3086,67,2907
11402,10059,3686,3,Business,8,4,56319,8,4,56328,8,4,56986,8,4,57318,8,4,61426,18,27.2,-1.2551895,36.7822034,-1.2902161,36.8936181,911,4108,9,990
11403,22991,3291,3,Business,6,1,32724,6,1,32740,6,1,33283,6,1,33733,6,1,34098,2,23.25888921888938,-1.266837,36.799249,-1.2600926,36.8088685,427,365,16,993
11404,23484,970,3,Business,22,5,33323,22,5,33337,22,5,36900,22,5,37058,22,5,39246,15,23.25888921888938,-1.2551895,36.7822034,-1.3319467,36.7766998,829,2188,14,3721
11405,13691,1954,3,Business,14,4,51880,14,4,52433,14,4,53651,14,4,54395,14,4,55528,4,21.5,-1.289498,36.818878,-1.2857117,36.7968296,531,1133,553,1962
11406,11656,664,1,Personal,12,5,29088,12,5,32623,12,5,33063,12,5,33360,12,5,34246,4,18.6,-1.2517392,36.8249608,-1.2632571,36.7938904,882,886,3535,737
11407,27581,1913,1,Personal,11,4,45421,11,4,45477,11,4,46432,11,4,46645,11,4,47829,8,24.1,-1.2652108,36.8056075,-1.304033,36.7848695,38,1184,56,1168
11408,275,186,3,Business,10,5,33491,10,5,33527,10,5,34169,10,5,34566,10,5,35736,6,13.7,-1.2571472,36.7950633,-1.2857671,36.7875614,770,1170,36,1039
11409,19292,265,3,Business,2,2,45847,2,2,46009,2,2,46679,2,2,47031,2,2,48793,9,26.3,-1.300921,36.828195,-1.2748221,36.7817865,168,1762,162,1022
11410,25442,517,3,Business,30,4,56468,30,4,56483,30,4,56498,30,4,57592,30,4,57595,5,23.25888921888938,-1.3228003,36.8306435,-1.3077869,36.8443207,349,3,15,1109
11411,8575,3606,3,Business,2,4,55136,2,4,55194,2,4,55854,2,4,57900,2,4,58827,7,23.25888921888938,-1.2628638,36.8070399,-1.2623805,36.7805404,119,927,58,2706
11412,7865,2008,3,Business,4,3,31015,4,3,31032,4,3,32160,4,3,32455,4,3,34294,11,15.2,-1.2508229,36.7895263,-1.2884996,36.7422252,116,1839,17,1423
11413,11468,3500,3,Business,23,5,52686,23,5,53819,23,5,53967,23,5,54544,23,5,55686,2,26.3,-1.2621828,36.7949276,-1.2567464,36.7885946,536,1142,1133,725
11414,21004,1999,1,Personal,13,4,54791,13,4,54879,13,4,55626,13,4,56027,13,4,56460,3,26.4,-1.2649605,36.7981777,-1.2771989,36.8089752,100,433,88,1148
11415,11834,1205,3,Business,20,4,38706,20,4,38717,20,4,39481,20,4,41173,20,4,42283,8,24.6,-1.2706815,36.7646286,-1.257309,36.8060084,770,1110,11,2456
11416,26304,2523,3,Business,14,1,54476,14,1,54651,14,1,55734,14,1,56018,14,1,57671,9,25.7,-1.2516167,36.8678844,-1.2544664,36.8224273,447,1653,175,1367
11417,12478,391,3,Business,7,5,31841,7,5,31862,7,5,35665,7,5,39032,7,5,39035,20,23.25888921888938,-1.319613,36.711055,-1.2867454,36.8259017,855,3,21,7170
11418,4353,2112,3,Business,20,1,52819,20,1,52855,20,1,53076,20,1,54320,20,1,54957,5,23.25888921888938,-1.2285835,36.8826468,-1.2156006,36.8916865,519,637,36,1465
11419,28047,2987,3,Business,30,3,45695,30,3,45816,30,3,46312,30,3,46569,30,3,47428,11,22.6,-1.270212,36.8210877,-1.2156006,36.8916865,408,859,121,753
11420,16624,2828,3,Business,20,1,51661,20,1,51768,20,1,52798,20,1,52918,20,1,53609,4,21.2,-1.2696183,36.8021778,-1.2564152,36.7792803,452,691,107,1150
11421,20234,1719,3,Business,11,5,39249,11,5,40433,11,5,41045,11,5,41338,11,5,42519,10,20.9,-1.3339943,36.7263409,-1.2962603,36.7766164,100,1181,1184,905
11422,12873,632,1,Personal,9,4,50181,9,4,50193,9,4,50318,9,4,55235,9,4,56599,7,25.8,-1.2688502,36.8357356,-1.2736095,36.8011282,633,1364,12,5042
11423,12161,1724,3,Business,10,1,44025,10,1,44131,10,1,44188,10,1,44267,10,1,44818,6,23.5,-1.2551895,36.7822034,-1.275612,36.7637978,685,551,106,136
11424,5640,1500,3,Business,4,4,30205,4,4,30215,4,4,30222,4,4,31155,4,4,32103,8,22.0,-1.3004062,36.829741,-1.2638185,36.7930057,843,948,10,940
11425,21958,867,3,Business,25,1,51054,25,1,51188,25,1,51702,25,1,52404,25,1,53319,9,30.1,-1.2638185,36.7930057,-1.2991441,36.7528804,484,915,134,1216
11426,5484,1148,3,Business,7,4,56397,7,4,56411,7,4,56454,7,4,60707,7,4,62899,12,25.6,-1.3100586,36.8500329,-1.255956,36.772901,774,2192,14,4296
11427,15087,3674,3,Business,3,1,37999,3,1,38012,3,1,38089,3,1,38492,3,1,39678,7,21.7,-1.2551895,36.7822034,-1.2388691,36.7579496,161,1186,13,480
11428,10542,1535,1,Business,6,3,59353,6,3,59489,6,3,60164,6,3,60727,6,3,63026,10,19.8,-1.2897368,36.8226783,-1.2994188,36.8903586,360,2299,136,1238
11429,20747,1131,3,Business,9,4,57527,9,4,58416,9,4,58988,9,4,59685,9,4,61547,17,23.25888921888938,-1.207546,36.7913976,-1.2888734,36.8268027,263,1862,889,1269
11430,3094,3491,3,Business,4,2,49492,4,2,51857,4,2,51862,4,2,52559,4,2,53787,9,22.5,-1.2283403,36.8822756,-1.2662524,36.8244795,75,1228,2365,702
11431,20874,2000,3,Business,7,3,43950,7,3,43979,7,3,44447,7,3,45528,7,3,47139,3,25.3,-1.2551895,36.7822034,-1.2595467,36.8113044,620,1611,29,1549
11432,27278,635,3,Business,1,4,52812,1,4,52853,1,4,53361,1,4,56012,1,4,57181,8,23.25888921888938,-1.3016417,36.8271679,-1.2599563,36.7993439,848,1169,41,3159
11433,27872,2112,3,Business,25,1,50744,25,1,50770,25,1,52058,25,1,52148,25,1,53264,6,28.0,-1.2156006,36.8916865,-1.2413316,36.8785525,206,1116,26,1378
11434,17183,1856,3,Business,16,5,51779,16,5,54800,16,5,56083,16,5,56312,16,5,58414,4,23.25888921888938,-1.273009,36.802807,-1.2684319,36.8165853,554,2102,3021,1512
11435,572,1787,3,Business,6,5,30676,6,5,30684,6,5,32466,6,5,32621,6,5,36259,16,14.8,-1.2297202,36.8745508,-1.2592947,36.7698085,644,3638,8,1937
11436,4730,2183,2,Business,1,3,34268,1,3,34736,1,3,35329,1,3,35611,1,3,36685,6,23.25888921888938,-1.2551895,36.7822034,-1.2889396,36.8155486,882,1074,468,875
11437,26585,2330,3,Business,29,1,57187,29,1,57262,29,1,57903,29,1,58055,29,1,59221,8,23.25888921888938,-1.294597,36.7742999,-1.2642903,36.8002137,613,1166,75,793
11438,14401,2418,2,Personal,29,3,31608,29,3,31715,29,3,32071,29,3,32537,29,3,33870,7,15.5,-1.2630118,36.8020743,-1.301259,36.842244,726,1333,107,822
11439,12222,2360,3,Business,7,5,47533,7,5,49762,7,5,50459,7,5,50560,7,5,52042,5,26.7,-1.2551895,36.7822034,-1.2700552,36.817067,857,1482,2229,798
11440,12043,2871,1,Personal,17,5,43607,17,5,43648,17,5,45111,17,5,45426,17,5,46570,8,17.6,-1.288922,36.814826,-1.2623805,36.7805404,213,1144,41,1778
11441,25335,3064,3,Business,3,1,58866,3,1,59499,3,1,60059,3,1,60518,3,1,61734,8,17.6,-1.2908945,36.8246514,-1.2571472,36.7950633,434,1216,633,1019
11442,16329,3647,3,Business,10,1,59070,10,1,59076,10,1,59120,10,1,59640,10,1,63646,27,19.1,-1.272639,36.794723,-1.4108268,36.9441185,680,4006,6,564
11443,13336,1329,3,Business,13,4,38991,13,4,39026,13,4,39039,13,4,39268,13,4,41986,21,21.9,-1.273056,36.811298,-1.2995252,36.6871615,576,2718,35,242
11444,20828,3175,3,Business,6,2,56263,6,2,56291,6,2,58380,6,2,58470,6,2,59266,4,27.3,-1.2681004,36.7952081,-1.263419,36.8060348,434,796,28,2179
11445,18226,1882,3,Business,12,6,51821,12,6,53474,12,6,56894,12,6,57290,12,6,59011,9,24.9,-1.2475028,36.8774697,-1.277512,36.820013,332,1721,1653,3816
11446,7758,3491,3,Business,20,7,51455,20,7,56061,20,7,57681,20,7,57952,20,7,60250,11,20.5,-1.2649605,36.7981777,-1.2297202,36.8745508,95,2298,4606,1891
11447,22131,53,3,Business,6,4,46034,6,4,46119,6,4,48242,6,4,49709,6,4,51274,9,21.5,-1.2770708,36.8231093,-1.3167113,36.8301563,673,1565,85,3590
11448,22104,478,3,Business,10,4,34625,10,4,34657,10,4,34677,10,4,34942,10,4,37068,10,19.3,-1.2551895,36.7822034,-1.2973682,36.7859878,26,2126,32,285
11449,23554,1669,2,Personal,25,2,34549,25,2,34556,25,2,34964,25,2,35879,25,2,36663,3,17.9,-1.2572951,36.79886,-1.2753902,36.808223,208,784,7,1323
11450,22175,1724,3,Business,7,2,41999,7,2,42022,7,2,42029,7,2,42297,7,2,42962,4,23.25888921888938,-1.2551895,36.7822034,-1.2690013,36.8092872,576,665,23,275
11451,6413,3752,3,Business,29,1,36695,29,1,36742,29,1,37042,29,1,37566,29,1,40153,5,23.25888921888938,-1.311356,36.8492094,-1.29658,36.823699,106,2587,47,824
11452,20955,3091,3,Business,6,4,44326,6,4,44441,6,4,44572,6,4,47549,6,4,49924,18,19.8,-1.290894,36.822971,-1.3190102,36.9230693,462,2375,115,3108
11453,14985,2638,1,Personal,25,1,38163,25,1,38918,25,1,40193,25,1,40611,25,1,41434,4,23.25888921888938,-1.2861765,36.8209086,-1.2536855,36.8245276,531,823,755,1693
11454,3977,1491,3,Personal,10,5,44986,10,5,45004,10,5,45471,10,5,45758,10,5,47388,12,19.1,-1.326825,36.864345,-1.2838207,36.8121326,650,1630,18,754
11455,7823,1721,3,Business,17,4,34900,17,4,34920,17,4,35625,17,4,36521,17,4,38067,10,23.25888921888938,-1.2551895,36.7822034,-1.2323335,36.8100356,755,1546,20,1601
11456,16818,1927,3,Business,14,4,61141,14,4,61330,14,4,62544,14,4,62610,14,4,66379,15,25.9,-1.2584143,36.8048002,-1.3472066,36.7692638,682,3769,189,1280
11457,12557,3547,3,Business,10,1,41462,10,1,41526,10,1,43972,10,1,44332,10,1,45477,9,18.5,-1.3285517,36.9018,-1.3194518,36.869396,567,1145,64,2806
11458,11368,3517,3,Business,6,6,44525,6,6,44533,6,6,45068,6,6,45232,6,6,47293,15,24.1,-1.300921,36.828195,-1.3882008,36.7699445,43,2061,8,699
11459,8385,393,3,Business,17,1,29269,17,1,37397,17,1,38884,17,1,40768,17,1,41104,4,23.8,-1.3167113,36.8301563,-1.3004062,36.829741,436,336,8128,3371
11460,19793,2412,3,Business,8,3,44582,8,3,44659,8,3,46973,8,3,49696,8,3,52131,19,23.25888921888938,-1.3352545,36.8659639,-1.2283403,36.8822756,430,2435,77,5037
11461,25944,136,3,Business,14,4,37566,14,4,45049,14,4,45456,14,4,45583,14,4,47504,14,19.0,-1.3326173,36.7146233,-1.3012173,36.8093987,635,1921,7483,534
11462,11244,2330,3,Business,11,2,51789,11,2,51990,11,2,52303,11,2,53467,11,2,53481,9,21.2,-1.2642903,36.8002137,-1.2687407,36.7373043,139,14,201,1477
11463,26766,186,3,Business,10,1,46886,10,1,47119,10,1,48117,10,1,48807,10,1,49955,5,18.3,-1.2571472,36.7950633,-1.2883158,36.8199114,139,1148,233,1688
11464,21666,3621,3,Business,26,6,27618,26,6,27659,26,6,28428,26,6,28793,26,6,30631,13,20.3,-1.2836583,36.7886014,-1.2987419,36.8740842,31,1838,41,1134
11465,283,3303,3,Business,15,6,32937,15,6,32968,15,6,35679,15,6,36151,15,6,36996,5,16.6,-1.318411,36.8059305,-1.3122179,36.823696,610,845,31,3183
11466,6561,3291,3,Business,20,3,35425,20,3,35437,20,3,35906,20,3,40832,20,3,41400,5,27.3,-1.2628473,36.781805,-1.2600926,36.8088685,708,568,12,5395
11467,6920,3283,3,Business,25,5,46489,25,5,47249,25,5,47275,25,5,48094,25,5,49560,5,21.1,-1.2600926,36.8088685,-1.2628473,36.781805,51,1466,760,845
11468,18000,3359,3,Business,18,1,42653,18,1,42682,18,1,42925,18,1,43349,18,1,44198,7,27.1,-1.279395,36.825364,-1.2551895,36.7822034,124,849,29,667
11469,16365,2828,3,Business,26,5,40986,26,5,41055,26,5,41941,26,5,42542,26,5,43845,7,23.25888921888938,-1.2325706,36.8083923,-1.267181,36.8076681,101,1303,69,1487
11470,20256,1363,3,Business,16,4,51734,16,4,51792,16,4,52524,16,4,53116,16,4,53121,4,23.25888921888938,-1.3004062,36.829741,-1.295036,36.8143061,863,5,58,1324
11471,9479,2069,3,Business,27,6,60807,27,6,60826,27,6,61181,27,6,61540,27,6,62424,9,23.25888921888938,-1.272828,36.816608,-1.228911,36.881876,775,884,19,714
11472,21192,1329,3,Business,11,4,38288,11,4,38347,11,4,38668,11,4,39006,11,4,40535,8,25.7,-1.273056,36.811298,-1.3222949,36.8131238,435,1529,59,659
11473,26360,2869,3,Business,23,4,62991,23,4,63265,23,4,65824,23,4,66057,23,4,68227,9,23.25888921888938,-1.291768,36.8297208,-1.3025826,36.7670807,158,2170,274,2792
11474,13717,1245,3,Business,23,2,44527,23,2,44554,23,2,44624,23,2,45047,23,2,47025,19,17.8,-1.300921,36.828195,-1.3198615,36.7110323,210,1978,27,493
11475,10751,2066,3,Business,30,1,39940,30,1,45110,30,1,45657,30,1,45740,30,1,47559,7,22.6,-1.316961,36.820337,-1.3263415,36.7722827,229,1819,5170,630
11476,25079,517,3,Business,4,2,49539,4,2,49547,4,2,49576,4,2,49916,4,2,52096,14,23.7,-1.3177547,36.8303703,-1.306378,36.7519845,523,2180,8,369
11477,9534,1393,1,Business,28,5,32352,28,5,32377,28,5,32811,28,5,33011,28,5,33497,2,20.5,-1.2527958,36.8003131,-1.2685707,36.8064961,881,486,25,634
11478,22334,1719,3,Business,9,3,36272,9,3,36297,9,3,36633,9,3,37252,9,3,40359,16,20.2,-1.2975066,36.7689423,-1.2330694,36.745451,246,3107,25,955
11479,10091,3291,3,Business,2,6,36549,2,6,44543,2,6,45344,2,6,46060,2,6,49106,17,27.3,-1.293515,36.897607,-1.2600926,36.8088685,691,3046,7994,1517
11480,24623,81,3,Business,12,4,47046,12,4,47205,12,4,47833,12,4,47929,12,4,49158,7,19.0,-1.2641496,36.7914139,-1.2596651,36.8086697,415,1229,159,724
11481,13060,391,3,Business,4,2,55397,4,2,61915,4,2,61921,4,2,65433,4,2,65435,5,22.6,-1.2913864,36.7949496,-1.2784063,36.8222933,855,2,6518,3518
11482,18124,186,3,Business,20,4,41032,20,4,41040,20,4,41330,20,4,42540,20,4,44978,20,22.3,-1.2571472,36.7950633,-1.3700383,36.9190174,647,2438,8,1500
11483,23800,3291,3,Business,3,7,37874,3,7,37887,3,7,37911,3,7,42144,3,7,42266,12,28.5,-1.228911,36.881876,-1.2600926,36.8088685,510,122,13,4257
11484,13456,1051,3,Business,26,1,41013,26,1,41324,26,1,42026,26,1,42433,26,1,45053,21,23.1,-1.2963097,36.7688221,-1.3160977,36.9131642,648,2620,311,1109
11485,4980,2008,3,Business,31,1,39912,31,1,39922,31,1,40666,31,1,41067,31,1,43102,19,20.9,-1.2508229,36.7895263,-1.311025,36.9001319,446,2035,10,1145
11486,2744,540,3,Business,13,3,49720,13,3,49753,13,3,50599,13,3,51534,13,3,52512,10,27.3,-1.2551895,36.7822034,-1.2976368,36.7519827,862,978,33,1781
11487,15588,3490,2,Personal,3,5,43932,3,5,43991,3,5,44799,3,5,45022,3,5,45735,4,21.5,-1.269441,36.798544,-1.2738167,36.8157821,882,713,59,1031
11488,14528,517,3,Business,31,1,39084,31,1,39100,31,1,39609,31,1,39910,31,1,41500,14,20.9,-1.3167113,36.8301563,-1.306378,36.7519845,523,1590,16,810
11489,7840,868,3,Business,26,5,34654,26,5,34663,26,5,34813,26,5,35392,26,5,36351,4,23.25888921888938,-1.2600926,36.8088685,-1.265715,36.823815,383,959,9,729
11490,24653,3115,3,Business,7,2,28079,7,2,28698,7,2,28837,7,2,29035,7,2,29548,2,23.25888921888938,-1.2963097,36.7688221,-1.2969741,36.7856612,298,513,619,337
11491,9078,3002,1,Personal,27,4,41239,27,4,41252,27,4,42037,27,4,42103,27,4,43386,8,22.8,-1.2969275,36.7867879,-1.2528485,36.7953722,933,1283,13,851
11492,17089,2183,3,Business,28,2,32311,28,2,32337,28,2,32378,28,2,33122,28,2,34177,8,15.9,-1.2551895,36.7822034,-1.2939912,36.8161329,726,1055,26,785
11493,17212,744,2,Personal,6,3,37768,6,3,37794,6,3,38364,6,3,38425,6,3,42779,7,19.9,-1.2916556,36.8262516,-1.3159197,36.8516724,89,4354,26,631
11494,5286,330,1,Personal,15,6,40540,15,6,40568,15,6,41460,15,6,41751,15,6,42795,7,23.25888921888938,-1.3244691,36.8045873,-1.2914795,36.8248973,281,1044,28,1183
11495,21463,2763,3,Business,6,3,33630,6,3,33736,6,3,34229,6,3,34437,6,3,35888,8,23.25888921888938,-1.2551895,36.7822034,-1.298094,36.803149,885,1451,106,701
11496,2072,3291,3,Business,31,2,47306,31,2,47346,31,2,47997,31,2,48926,31,2,49495,4,22.1,-1.265715,36.823815,-1.2600926,36.8088685,726,569,40,1580
11497,8767,1500,3,Business,17,4,50531,17,4,50547,17,4,50572,17,4,50726,17,4,51637,9,28.1,-1.2574219,36.7927073,-1.3004062,36.829741,518,911,16,179
11498,8378,1719,3,Business,22,5,41006,22,5,41111,22,5,43689,22,5,44609,22,5,46634,18,28.6,-1.23118,36.72678,-1.296797,36.7764525,217,2025,105,3498
11499,20850,1245,3,Business,30,2,56311,30,2,58115,30,2,58684,30,2,59874,30,2,61868,19,23.25888921888938,-1.300921,36.828195,-1.3198615,36.7110323,661,1994,1804,1759
11500,775,1179,3,Business,6,4,59826,6,4,60564,6,4,61039,6,4,61413,6,4,64385,21,22.6,-1.3700383,36.9190174,-1.2917868,36.7872675,130,2972,738,849
11501,11902,240,2,Personal,5,2,38470,5,2,38493,5,2,38867,5,2,39428,5,2,40935,11,21.4,-1.2311903,36.8102105,-1.269534,36.80697,633,1507,23,935
11502,13803,3264,3,Business,17,4,27125,17,4,27167,17,4,29200,17,4,29423,17,4,32632,6,23.25888921888938,-1.2551895,36.7822034,-1.2628009,36.8262921,453,3209,42,2256
11503,23252,3291,3,Business,12,2,53373,12,2,53435,12,2,53842,12,2,56245,12,2,56623,13,23.25888921888938,-1.331619,36.847976,-1.2628473,36.781805,403,378,62,2810
11504,10043,1417,3,Business,12,2,36965,12,2,37043,12,2,37569,12,2,38033,12,2,39737,14,24.4,-1.2741728,36.7969108,-1.3323107,36.8692616,50,1704,78,990
11505,13269,1597,1,Personal,28,1,42709,28,1,42744,28,1,43191,28,1,43760,28,1,44883,5,22.9,-1.3075974,36.8100855,-1.3010059,36.8216816,749,1123,35,1016
11506,21526,2776,3,Personal,3,3,60319,3,3,60523,3,3,60672,3,3,61936,3,3,63538,5,23.5,-1.2567849,36.8140543,-1.2762513,36.7964048,519,1602,204,1413
11507,21244,3491,3,Business,11,1,47760,11,1,48446,11,1,48941,11,1,50078,11,1,53720,10,29.1,-1.2859912,36.8756811,-1.2283403,36.8822756,771,3642,686,1632
11508,8237,2412,3,Business,8,4,60974,8,4,60986,8,4,61437,8,4,62288,8,4,65575,18,25.6,-1.3014461,36.7661381,-1.2297202,36.8819507,755,3287,12,1302
11509,8732,2155,1,Personal,21,5,35344,21,5,35390,21,5,35405,21,5,37492,21,5,38236,8,20.2,-1.2937193,36.8236214,-1.2656394,36.804042,179,744,46,2102
11510,20701,3647,3,Business,2,3,41806,2,3,41828,2,3,42438,2,3,42771,2,3,44107,10,24.2,-1.272639,36.794723,-1.3231001,36.8283559,446,1336,22,943
11511,14071,1245,3,Business,24,3,41540,24,3,43186,24,3,44062,24,3,44989,24,3,46052,6,20.0,-1.300921,36.828195,-1.3009173,36.7959207,596,1063,1646,1803
11512,708,1114,3,Business,18,1,51914,18,1,53866,18,1,54767,18,1,55080,18,1,55908,5,29.7,-1.32671,36.8600138,-1.3077869,36.8443207,691,828,1952,1214
11513,3835,2987,3,Business,2,5,42241,2,5,42345,2,5,43121,2,5,43676,2,5,45786,13,23.7,-1.270212,36.8210877,-1.2927792,36.9053492,100,2110,104,1331
11514,25760,1500,3,Business,10,1,36342,10,1,36517,10,1,36949,10,1,37280,10,1,38480,11,18.3,-1.3077869,36.8443207,-1.2574219,36.7927073,496,1200,175,763
11515,27254,393,3,Business,23,2,28458,23,2,29126,23,2,31066,23,2,32101,23,2,32863,4,15.0,-1.3177547,36.8303703,-1.3004062,36.829741,748,762,668,2975
11516,16130,1688,3,Business,4,2,31680,4,2,31753,4,2,31838,4,2,33706,4,2,34158,5,16.4,-1.300921,36.828195,-1.3210622,36.802019,644,452,73,1953
11517,27397,3599,3,Business,23,6,40518,23,6,43277,23,6,44643,23,6,45363,23,6,47145,13,26.2,-1.3302996,36.8707935,-1.271337,36.786712,675,1782,2759,2086
11518,11131,3050,3,Business,22,5,60675,22,5,60997,22,5,61832,22,5,61970,22,5,61999,4,28.7,-1.2945074,36.8083195,-1.304214,36.8276533,19,29,322,973
11519,17867,3203,3,Business,17,4,36568,17,4,36592,17,4,37222,17,4,37953,17,4,39740,17,22.4,-1.331619,36.847976,-1.228911,36.881876,397,1787,24,1361
11520,15070,3398,3,Business,17,1,36845,17,1,36849,17,1,37262,17,1,39305,17,1,46011,30,25.1,-1.3169591,36.7000029,-1.2413316,36.8785525,478,6706,4,2456
11521,21960,3071,1,Personal,31,4,63607,31,4,65510,31,4,66725,31,4,67906,31,4,70248,13,22.5,-1.2384876,36.8778107,-1.307241,36.8302368,116,2342,1903,2396
11522,13871,2989,3,Business,13,5,31125,13,5,31135,13,5,31258,13,5,33503,13,5,35015,19,15.5,-1.264788,36.7883897,-1.3463042,36.768164,103,1512,10,2368
11523,25694,435,3,Business,27,1,46183,27,1,46329,27,1,46798,27,1,47399,27,1,48305,6,20.9,-1.266294,36.8057971,-1.300921,36.828195,168,906,146,1070
11524,4589,865,3,Business,27,3,60163,27,3,60184,27,3,60191,27,3,60595,27,3,61468,2,27.4,-1.2452664,36.8028541,-1.265422,36.8059349,524,873,21,411
11525,227,1829,3,Personal,24,1,46143,24,1,46224,24,1,46690,24,1,46875,24,1,49736,7,22.5,-1.3056847,36.8101341,-1.2949652,36.7687874,764,2861,81,651
11526,20899,1329,3,Business,18,1,48114,18,1,48168,18,1,48458,18,1,48789,18,1,49429,6,30.7,-1.273056,36.811298,-1.2944292,36.7793569,812,640,54,621
11527,27086,788,3,Business,28,3,44587,28,3,45456,28,3,46357,28,3,47556,28,3,48807,10,23.25888921888938,-1.290894,36.822971,-1.225322,36.80855,320,1251,869,2100
11528,22932,2214,2,Personal,27,3,51329,27,3,51372,27,3,51935,27,3,52066,27,3,54223,8,23.25888921888938,-1.316521,36.869311,-1.2750975,36.8289032,192,2157,43,694
11529,21925,1882,3,Business,2,2,41005,2,2,47565,2,2,48241,2,2,49098,2,2,51328,7,29.4,-1.2958783,36.7928125,-1.2588775,36.8079744,306,2230,6560,1533
11530,11097,3035,3,Business,24,3,46267,24,3,47757,24,3,48879,24,3,49059,24,3,52995,8,18.6,-1.2853965,36.8183118,-1.2963097,36.7688221,328,3936,1490,1302
11531,4768,2601,3,Business,7,4,43172,7,4,43181,7,4,43519,7,4,43954,7,4,44481,3,24.4,-1.2528485,36.7953722,-1.2732506,36.8132437,379,527,9,773
11532,2710,2200,3,Business,28,4,59887,28,4,60738,28,4,61154,28,4,61575,28,4,63900,21,25.6,-1.3165542,36.700067,-1.290894,36.822971,622,2325,851,837
11533,15930,1363,3,Business,17,3,55357,17,3,55381,17,3,55933,17,3,56495,17,3,56949,5,23.25888921888938,-1.3004062,36.829741,-1.3228003,36.8306435,506,454,24,1114
11534,27639,2982,3,Business,24,6,34832,24,6,34936,24,6,34939,24,6,36666,24,6,38416,18,18.7,-1.300921,36.828195,-1.177202,36.8351183,120,1750,104,1730
11535,19369,393,3,Business,3,5,50236,3,5,50428,3,5,50548,3,5,51450,3,5,52097,4,23.25888921888938,-1.3167113,36.8301563,-1.3004062,36.829741,328,647,192,1022
11536,330,1329,3,Business,30,5,48469,30,5,50145,30,5,50594,30,5,50722,30,5,51743,7,24.8,-1.273056,36.811298,-1.2771886,36.8419032,14,1021,1676,577
11537,9107,1113,1,Personal,9,2,50431,9,2,50508,9,2,50949,9,2,51369,9,2,52941,13,22.3,-1.2649605,36.7981777,-1.2156006,36.8916865,259,1572,77,861
11538,14520,644,1,Personal,27,4,56229,27,4,56254,27,4,56486,27,4,56839,27,4,58648,15,25.3,-1.2672588,36.8000252,-1.2016352,36.8200903,383,1809,25,585
11539,4633,635,3,Business,4,2,42352,4,2,42395,4,2,42989,4,2,45987,4,2,47622,14,18.6,-1.3016417,36.8271679,-1.233313,36.764508,882,1635,43,3592
11540,5435,256,3,Personal,13,5,45868,13,5,46091,13,5,47092,13,5,48924,13,5,50016,5,19.4,-1.280572,36.826162,-1.3207146,36.8305771,88,1092,223,2833
11541,21624,3560,3,Business,16,2,50598,16,2,50614,16,2,50730,16,2,53412,16,2,54674,6,27.2,-1.2551895,36.7822034,-1.279395,36.825364,477,1262,16,2798
11542,21764,2041,1,Business,15,3,45622,15,3,45640,15,3,46181,15,3,46618,15,3,48177,10,18.2,-1.290894,36.822971,-1.249526,36.7711579,449,1559,18,978
11543,26556,1976,3,Business,25,5,31392,25,5,31466,25,5,32053,25,5,32172,25,5,32675,6,20.8,-1.257028,36.7810435,-1.2614967,36.7420697,72,503,74,706
11544,24372,1271,3,Business,18,2,57278,18,2,58303,18,2,58764,18,2,58986,18,2,61687,19,25.6,-1.3107918,36.761794,-1.3226302,36.8719901,631,2701,1025,683
11545,3497,2582,3,Business,29,5,42481,29,5,47143,29,5,47912,29,5,48295,29,5,51794,8,19.5,-1.2551895,36.7822034,-1.2901228,36.8234237,268,3499,4662,1152
11546,14240,2358,4,Business,18,4,36154,18,4,36942,18,4,36992,18,4,39942,18,4,40555,5,25.7,-1.288641,36.816646,-1.297956,36.787462,266,613,788,3000
11547,9399,3201,3,Business,7,5,49434,7,5,49517,7,5,49564,7,5,50584,7,5,51517,8,23.25888921888938,-1.2929489,36.8192715,-1.2584143,36.8048002,320,933,83,1067
11548,10100,1205,3,Business,20,3,52240,20,3,52255,20,3,52482,20,3,52850,20,3,53902,6,28.2,-1.2495931,36.8065087,-1.2586964,36.7750085,205,1052,15,595
11549,21291,2330,3,Business,15,5,56057,15,5,56075,15,5,56803,15,5,57051,15,5,60837,13,17.6,-1.2199518,36.8032133,-1.2284323,36.8757058,936,3786,18,976
11550,5116,3661,3,Business,23,1,44458,23,1,44472,23,1,45183,23,1,45247,23,1,46653,16,18.7,-1.2207911,36.8681762,-1.2538731,36.7850223,144,1406,14,775
11551,15803,758,3,Business,5,2,46166,5,2,46193,5,2,46946,5,2,47086,5,2,48207,8,23.5,-1.2917868,36.7872675,-1.2676026,36.8103629,368,1121,27,893
11552,16410,2457,3,Business,31,3,38204,31,3,38248,31,3,38367,31,3,38745,31,3,43173,4,24.7,-1.2551895,36.7822034,-1.269534,36.80697,478,4428,44,497
11553,1782,2200,3,Business,15,6,43496,15,6,43543,15,6,45625,15,6,47357,15,6,47960,2,22.1,-1.279395,36.825364,-1.290894,36.822971,698,603,47,3814
11554,25272,2069,3,Business,27,1,53644,27,1,53677,27,1,53694,27,1,54090,27,1,55783,12,22.9,-1.2600926,36.8088685,-1.228911,36.881876,72,1693,33,413
11555,4099,117,1,Personal,6,6,30515,6,6,30689,6,6,32578,6,6,33202,6,6,36638,16,19.0,-1.3206958,36.8769553,-1.276245,36.8363293,858,3436,174,2513
11556,13366,3727,3,Business,29,5,39531,29,5,39566,29,5,39576,29,5,41662,29,5,41726,6,26.7,-1.2963097,36.7688221,-1.2825816,36.8092346,613,64,35,2096
11557,26327,718,3,Business,9,5,58044,9,5,58623,9,5,59644,9,5,59999,9,5,62729,15,25.0,-1.2551895,36.7822034,-1.3221141,36.8636835,849,2730,579,1376
11558,19921,868,3,Business,6,4,33047,6,4,33132,6,4,34558,6,4,34934,6,4,36452,8,18.8,-1.303596,36.778378,-1.265715,36.823815,937,1518,85,1802
11559,24558,3032,3,Business,9,5,37772,9,5,37787,9,5,38761,9,5,39050,9,5,39834,8,25.6,-1.2924639,36.7795798,-1.2571472,36.7950633,88,784,15,1263
11560,26692,635,3,Business,20,1,48808,20,1,49370,20,1,51714,20,1,53626,20,1,55240,8,21.5,-1.3016417,36.8271679,-1.2599563,36.7993439,427,1614,562,4256
11561,16751,2016,1,Personal,24,1,49602,24,1,49609,24,1,50759,24,1,52090,24,1,54212,18,23.25888921888938,-1.317549,36.8981014,-1.2871136,36.785507,253,2122,7,2481
11562,3308,3123,3,Personal,21,5,34440,21,5,34445,21,5,36002,21,5,36732,21,5,39374,20,19.5,-1.315194,36.9074428,-1.2979147,36.7857814,594,2642,5,2287
11563,17837,2154,3,Business,2,5,55330,2,5,57585,2,5,57605,2,5,58105,2,5,60248,13,25.3,-1.2765736,36.8513646,-1.3472066,36.7692638,699,2143,2255,520
11564,9216,2701,3,Business,20,3,33766,20,3,33972,20,3,35180,20,3,35686,20,3,36669,5,20.8,-1.279395,36.825364,-1.2765736,36.8513646,61,983,206,1714
11565,10192,136,3,Business,11,1,46476,11,1,46591,11,1,46997,11,1,47500,11,1,48205,5,26.6,-1.2654716,36.7983635,-1.2633232,36.8305068,178,705,115,909
11566,13070,2423,3,Business,21,4,52196,21,4,52210,21,4,53257,21,4,53820,21,4,54110,3,26.3,-1.2551895,36.7822034,-1.2642665,36.7788286,269,290,14,1610
11567,27250,2828,3,Business,1,5,35189,1,5,37053,1,5,38132,1,5,39840,1,5,41570,13,28.7,-1.2710687,36.8142839,-1.2778747,36.8831829,716,1730,1864,2787
11568,17005,2828,3,Business,1,5,32483,1,5,34178,1,5,34692,1,5,39603,1,5,41111,13,28.7,-1.2710687,36.8142839,-1.2778747,36.8831829,52,1508,1695,5425
11569,15197,2523,3,Business,18,1,35571,18,1,35595,18,1,35624,18,1,35988,18,1,37742,11,21.5,-1.2551895,36.7822034,-1.2310607,36.8035776,793,1754,24,393
11570,10965,1245,3,Business,28,4,53849,28,4,54198,28,4,54263,28,4,57264,28,4,60699,21,30.0,-1.300921,36.828195,-1.2733676,36.699383,661,3435,349,3066
11571,18492,2112,3,Business,25,1,60072,25,1,60191,25,1,61559,25,1,61704,25,1,65889,12,27.7,-1.2886923,36.8241519,-1.2156006,36.8916865,679,4185,119,1513
11572,15358,2383,3,Business,27,3,55493,27,3,55526,27,3,55677,27,3,55850,27,3,56044,3,29.0,-1.2608993,36.799246,-1.2696819,36.8028694,424,194,33,324
11573,21699,2216,3,Business,29,2,37110,29,2,37250,29,2,38608,29,2,38912,29,2,40005,10,21.5,-1.2553615,36.7895376,-1.2363748,36.8177502,116,1093,140,1662
11574,17154,635,3,Business,9,2,35259,9,2,35301,9,2,36945,9,2,37561,9,2,39388,3,20.6,-1.257069,36.81467,-1.2602337,36.7990548,52,1827,42,2260
11575,22272,3160,3,Business,16,3,50316,16,3,50340,16,3,51016,16,3,51369,16,3,53545,17,25.7,-1.2844665,36.7866113,-1.2698307,36.8801649,789,2176,24,1029
11576,14495,3283,3,Business,18,4,47168,18,4,47185,18,4,47830,18,4,48343,18,4,49275,6,25.4,-1.272828,36.816608,-1.2628473,36.781805,532,932,17,1158
11577,14567,176,1,Personal,12,4,60740,12,4,61298,12,4,61531,12,4,61994,12,4,62340,4,20.5,-1.2907672,36.8252167,-1.2666695,36.8328283,629,346,558,696
11578,21324,1245,3,Business,28,5,55400,28,5,55433,28,5,56557,28,5,57473,28,5,59963,18,25.5,-1.300921,36.828195,-1.3198615,36.7110323,496,2490,33,2040
11579,3111,259,3,Personal,17,4,38555,17,4,44600,17,4,45249,17,4,46083,17,4,47128,6,22.3,-1.312469,36.815177,-1.304033,36.7848695,782,1045,6045,1483
11580,716,20,3,Business,12,5,37041,12,5,37105,12,5,38977,12,5,39128,12,5,39136,5,26.7,-1.278353,36.824045,-1.2628638,36.8070399,843,8,64,2023
11581,9312,265,3,Business,25,4,53336,25,4,54312,25,4,56150,25,4,56907,25,4,60283,15,20.7,-1.300921,36.828195,-1.3374229,36.9091381,131,3376,976,2595
11582,22919,1033,3,Personal,5,2,41847,5,2,41878,5,2,43042,5,2,43176,5,2,47464,12,25.3,-1.2325706,36.8083923,-1.2958383,36.8073162,547,4288,31,1298
11583,2651,1959,1,Business,11,1,36159,11,1,36216,11,1,37134,11,1,37738,11,1,39274,14,14.4,-1.3312306,36.8563683,-1.2551895,36.7822034,791,1536,57,1522
11584,26815,346,3,Business,30,4,36283,30,4,36382,30,4,37080,30,4,37996,30,4,38214,4,23.25888921888938,-1.28878,36.8168312,-1.2979063,36.8373372,19,218,99,1614
11585,259,2376,2,Personal,19,5,42271,19,5,42370,19,5,43373,19,5,43761,19,5,46092,9,24.9,-1.2812015,36.8261246,-1.2916953,36.8855273,477,2331,99,1391
11586,25200,238,3,Business,4,2,49761,4,2,49856,4,2,50391,4,2,50481,4,2,51404,7,22.7,-1.3077869,36.8443207,-1.3167113,36.8301563,211,923,95,625
11587,24565,2327,1,Personal,5,4,50305,5,4,50840,5,4,51768,5,4,52154,5,4,53523,8,22.2,-1.3106677,36.8233137,-1.296797,36.7764525,88,1369,535,1314
11588,10044,2151,1,Personal,23,3,39858,23,3,40187,23,3,40794,23,3,41557,23,3,42917,6,21.8,-1.2733223,36.7951005,-1.2550097,36.8045852,406,1360,329,1370
11589,18172,2195,3,Business,15,6,42747,15,6,42784,15,6,43290,15,6,44015,15,6,44818,9,19.1,-1.2663631,36.8163329,-1.228911,36.881876,775,803,37,1231
11590,15198,1500,3,Business,25,1,57555,25,1,57634,25,1,58870,25,1,59026,25,1,60317,9,27.9,-1.2638185,36.7930057,-1.3004062,36.829741,8,1291,79,1392
11591,18567,1397,3,Business,15,5,55311,15,5,56368,15,5,57812,15,5,57962,15,5,61797,6,27.9,-1.2628638,36.8070399,-1.2913246,36.8019522,697,3835,1057,1594
11592,26342,3295,3,Business,5,4,59445,5,4,59645,5,4,59664,5,4,61246,5,4,61264,2,20.6,-1.2579304,36.8019667,-1.255392,36.792539,51,18,200,1601
11593,23739,3291,3,Business,29,6,32874,29,6,32912,29,6,33368,29,6,34033,29,6,34437,2,19.2,-1.266837,36.799249,-1.2600926,36.8088685,453,404,38,1121
11594,9685,1484,3,Business,19,1,35309,19,1,35336,19,1,35589,19,1,35870,19,1,37130,8,19.1,-1.2551895,36.7822034,-1.304344,36.812274,708,1260,27,534
11595,3899,1329,3,Business,2,5,60483,2,5,61071,2,5,62049,2,5,62393,2,5,63399,6,24.1,-1.273056,36.811298,-1.3005349,36.7873912,147,1006,588,1322
11596,18635,2514,3,Business,31,2,35765,31,2,35791,31,2,36124,31,2,36421,31,2,37878,6,16.8,-1.266294,36.8057971,-1.2983462,36.8139996,882,1457,26,630
11597,11066,2448,2,Personal,2,4,40839,2,4,40941,2,4,41928,2,4,42876,2,4,44074,7,22.3,-1.296797,36.7764525,-1.2876365,36.816096,229,1198,102,1935
11598,24145,3388,1,Personal,27,1,52695,27,1,52745,27,1,52945,27,1,53399,27,1,54005,5,23.25888921888938,-1.2583017,36.8023526,-1.2791714,36.8255997,213,606,50,654
11599,7688,627,3,Business,5,3,51056,5,3,51586,5,3,52757,5,3,52972,5,3,54265,4,24.9,-1.2527958,36.8003131,-1.2764851,36.8007126,509,1293,530,1386
11600,25558,3686,3,Business,5,1,45396,5,1,45448,5,1,45796,5,1,46008,5,1,48712,8,24.7,-1.2551895,36.7822034,-1.3012619,36.8213697,770,2704,52,560
11601,9264,2509,3,Business,21,5,39334,21,5,44542,21,5,44864,21,5,45006,21,5,46385,5,20.1,-1.2571472,36.7950633,-1.2864674,36.820262,726,1379,5208,464
11602,23424,2423,3,Business,18,4,54340,18,4,54451,18,4,54700,18,4,55729,18,4,57133,8,23.25888921888938,-1.2551895,36.7822034,-1.3012173,36.8093987,161,1404,111,1278
11603,27732,633,3,Business,24,3,32605,24,3,33503,24,3,34714,24,3,35219,24,3,35843,6,16.9,-1.3004062,36.829741,-1.3177547,36.8303703,208,624,898,1716
11604,4432,136,3,Business,16,2,52824,16,2,52851,16,2,53829,16,2,54892,16,2,57290,30,23.25888921888938,-1.3094447,36.9107706,-1.3254522,36.7216584,377,2398,27,2041
11605,4464,3291,3,Business,14,4,39722,14,4,40180,14,4,40579,14,4,40727,14,4,41892,11,23.8,-1.303596,36.778378,-1.2600926,36.8088685,958,1165,458,547
11606,23226,1724,3,Business,15,5,39707,15,5,39790,15,5,40864,15,5,40961,15,5,43814,15,26.3,-1.2551895,36.7822034,-1.207546,36.7913976,448,2853,83,1171
11607,18545,1245,3,Business,21,2,50516,21,2,50530,21,2,50546,21,2,51831,21,2,53736,17,25.0,-1.300921,36.828195,-1.3049392,36.7148492,595,1905,14,1301
11608,23700,3283,3,Business,6,3,53023,6,3,53096,6,3,54957,6,3,55889,6,3,56822,5,23.25888921888938,-1.2600926,36.8088685,-1.2628473,36.781805,434,933,73,2793
11609,20143,1075,3,Business,9,4,48282,9,4,49157,9,4,49964,9,4,50316,9,4,51679,6,23.25888921888938,-1.2813012,36.8323962,-1.2527958,36.8003131,92,1363,875,1159
11610,11626,635,3,Business,10,1,36831,10,1,40870,10,1,42861,10,1,43077,10,1,46322,28,18.4,-1.2847613,36.967084,-1.2602337,36.7990548,907,3245,4039,2207
11611,17276,81,3,Business,11,2,46273,11,2,46347,11,2,46378,11,2,46734,11,2,46738,2,19.2,-1.2641496,36.7914139,-1.2652039,36.7734799,848,4,74,387
11612,22572,3686,3,Business,27,3,34461,27,3,34482,27,3,34673,27,3,35774,27,3,39879,22,23.25888921888938,-1.2551895,36.7822034,-1.3190102,36.9230693,800,4105,21,1292
11613,4060,1997,3,Personal,13,4,56705,13,4,56870,13,4,57936,13,4,60251,13,4,62392,19,22.4,-1.288285,36.815912,-1.3398006,36.717935,921,2141,165,3381
11614,8093,393,3,Business,6,4,36525,6,4,36546,6,4,36803,6,4,37219,6,4,37847,4,15.9,-1.3228003,36.8306435,-1.3004062,36.829741,35,628,21,673
11615,8249,1754,3,Business,19,5,44205,19,5,44225,19,5,44232,19,5,45010,19,5,45440,12,25.0,-1.2860183,36.8975338,-1.3189252,36.8617269,179,430,20,785
11616,6595,269,3,Business,5,3,42263,5,3,42271,5,3,42318,5,3,42780,5,3,45318,16,22.1,-1.3332749,36.8708147,-1.2571472,36.7950633,647,2538,8,509
11617,10922,3283,3,Business,19,4,46688,19,4,46712,19,4,47060,19,4,47967,19,4,48525,5,20.4,-1.2600926,36.8088685,-1.2628473,36.781805,101,558,24,1255
11618,13664,733,3,Business,29,1,57541,29,1,57593,29,1,58546,29,1,58720,29,1,60363,15,23.25888921888938,-1.2551895,36.7822034,-1.3265997,36.8721129,263,1643,52,1127
11619,2377,2330,3,Business,20,1,44690,20,1,44724,20,1,45081,20,1,45337,20,1,46221,8,23.25888921888938,-1.3015197,36.7658456,-1.3192789,36.7112991,692,884,34,613
11620,4110,1500,3,Business,29,4,32051,29,4,32085,29,4,32732,29,4,33478,29,4,35500,8,18.9,-1.3004062,36.829741,-1.2574219,36.7927073,911,2022,34,1393
11621,23669,2869,3,Business,18,4,33859,18,4,33927,18,4,37229,18,4,37997,18,4,38477,3,23.25888921888938,-1.3025826,36.7670807,-1.2763494,36.7671783,200,480,68,4070
11622,2838,598,1,Business,7,2,48293,7,2,48329,7,2,49513,7,2,50345,7,2,53862,16,24.9,-1.2329501,36.8083852,-1.3226392,36.8405839,882,3517,36,2016
11623,10255,3091,3,Business,3,3,44828,3,3,44855,3,3,45431,3,3,45683,3,3,47179,8,24.1,-1.3012008,36.764868,-1.2551895,36.7822034,535,1496,27,828
11624,1065,1148,3,Business,12,2,33761,12,2,33828,12,2,34758,12,2,35864,12,2,37812,5,17.9,-1.3100586,36.8500329,-1.2960687,36.8167909,678,1948,67,2036
11625,21887,1141,1,Business,4,1,54029,4,1,55025,4,1,56203,4,1,56706,4,1,59254,5,22.5,-1.2877645,36.8378535,-1.3102508,36.8229978,844,2548,996,1681
11626,17977,3647,3,Business,22,5,60404,22,5,60497,22,5,60855,22,5,61766,22,5,63925,15,25.5,-1.272639,36.794723,-1.2156006,36.8916865,85,2159,93,1269
11627,20712,2679,3,Business,7,2,57414,7,2,57465,7,2,58412,7,2,58860,7,2,59936,4,24.7,-1.2902032,36.7873926,-1.2680643,36.7763499,85,1076,51,1395
11628,24233,3291,3,Business,22,5,41529,22,5,41572,22,5,43139,22,5,44175,22,5,44722,4,23.25888921888938,-1.272828,36.816608,-1.2600926,36.8088685,52,547,43,2603
11629,14730,3594,3,Personal,7,2,39095,7,2,40036,7,2,40774,7,2,41490,7,2,43465,16,23.25888921888938,-1.2397552,36.8791469,-1.3246161,36.8703695,541,1975,941,1454
11630,25732,3510,1,Business,20,3,56235,20,3,56308,20,3,56338,20,3,57406,20,3,58836,14,23.4,-1.2472211,36.7826109,-1.3104734,36.7363698,379,1430,73,1098
11631,20519,633,3,Business,28,4,26753,28,4,27083,28,4,27163,28,4,29269,28,4,29563,9,22.3,-1.2638185,36.7930057,-1.3004062,36.829741,778,294,330,2186
11632,23840,256,2,Personal,26,6,55165,26,6,55192,26,6,55756,26,6,56024,26,6,57847,9,23.9,-1.280572,36.826162,-1.3314048,36.8229367,949,1823,27,832
11633,1202,635,3,Business,7,2,40764,7,2,40809,7,2,41934,7,2,42798,7,2,43944,8,23.25888921888938,-1.3081376,36.8329772,-1.2602337,36.7990548,7,1146,45,1989
11634,2849,2069,3,Business,25,1,40652,25,1,40711,25,1,41139,25,1,41678,25,1,43501,16,27.0,-1.303596,36.778378,-1.228911,36.881876,210,1823,59,967
11635,9061,1724,3,Business,23,2,57765,23,2,58053,23,2,58393,23,2,59304,23,2,60635,7,18.8,-1.2551895,36.7822034,-1.275612,36.7637978,518,1331,288,1251
11636,1075,1882,3,Business,30,6,50692,30,6,50715,30,6,50918,30,6,52094,30,6,53150,7,28.3,-1.2956882,36.7861845,-1.2591019,36.800577,383,1056,23,1379
11637,20264,928,3,Business,7,5,49116,7,5,51081,7,5,52740,7,5,53146,7,5,54601,8,26.6,-1.2551895,36.7822034,-1.2995132,36.8043032,425,1455,1965,2065
11638,12215,3222,3,Business,30,4,47849,30,4,48054,30,4,48507,30,4,48773,30,4,49413,4,23.25888921888938,-1.2551895,36.7822034,-1.2676593,36.8103939,576,640,205,719
11639,16859,3517,3,Business,7,5,49873,7,5,49885,7,5,49896,7,5,50625,7,5,52214,16,23.25888921888938,-1.3882008,36.7699445,-1.300921,36.828195,340,1589,12,740
11640,17782,868,3,Business,6,1,54165,6,1,54250,6,1,55920,6,1,56229,6,1,57751,8,23.25888921888938,-1.303596,36.778378,-1.265715,36.823815,624,1522,85,1979
11641,2802,633,3,Business,9,3,27661,9,3,27967,9,3,29094,9,3,29399,9,3,30679,9,20.4,-1.2574219,36.7927073,-1.3004062,36.829741,436,1280,306,1432
11642,3916,1479,1,Personal,6,1,39538,6,1,39641,6,1,40442,6,1,40888,6,1,41746,8,20.4,-1.2883946,36.7728469,-1.312469,36.815177,636,858,103,1247
11643,10561,53,3,Business,23,6,38836,23,6,38869,23,6,38959,23,6,40978,23,6,42267,5,26.5,-1.3004062,36.829741,-1.2770708,36.8231093,953,1289,33,2109
11644,3153,2279,3,Business,29,4,52794,29,4,53545,29,4,54221,29,4,55106,29,4,57746,16,25.0,-1.2897368,36.8226783,-1.3700383,36.9190174,267,2640,751,1561
11645,616,3048,1,Personal,15,6,68564,15,6,68586,15,6,69581,15,6,70612,15,6,72568,15,19.2,-1.2957807,36.7713953,-1.213137,36.7900285,74,1956,22,2026
11646,22735,533,3,Business,6,1,52788,6,1,52830,6,1,53713,6,1,53915,6,1,55579,20,23.25888921888938,-1.2594539,36.8067841,-1.3700383,36.9190174,484,1664,42,1085
11647,15826,1749,3,Personal,13,4,40341,13,4,40401,13,4,40549,13,4,40804,13,4,41683,5,22.1,-1.2621576,36.8103473,-1.288167,36.8181484,727,879,60,403
11648,23799,412,3,Business,7,2,56427,7,2,56452,7,2,56775,7,2,57620,7,2,58543,3,23.25888921888938,-1.272828,36.816608,-1.266837,36.799249,309,923,25,1168
11649,22367,1250,1,Personal,18,5,36662,18,5,37241,18,5,37962,18,5,40483,18,5,41580,3,21.4,-1.2662716,36.8150237,-1.2620741,36.8158147,909,1097,579,3242
11650,10487,246,3,Business,3,6,48000,3,6,48025,3,6,48039,3,6,48451,3,6,49000,4,23.5,-1.268027,36.8037005,-1.2584143,36.8048002,881,549,25,426
11651,27633,1822,1,Personal,28,5,33016,28,5,36018,28,5,37245,28,5,37342,28,5,37973,8,20.8,-1.2036664,36.8192622,-1.2365703,36.8054368,216,631,3002,1324
11652,17702,3091,3,Business,25,4,44832,25,4,48293,25,4,48437,25,4,50853,25,4,52051,9,23.25888921888938,-1.3012008,36.764868,-1.290894,36.822971,855,1198,3461,2560
11653,12767,1822,3,Personal,29,2,37999,29,2,38050,29,2,39389,29,2,40438,29,2,43967,17,21.6,-1.1994789,36.8167332,-1.178056,36.9312342,100,3529,51,2388
11654,2694,1687,3,Business,11,4,34032,11,4,34080,11,4,34490,11,4,35269,11,4,37940,8,18.4,-1.2626574,36.8014034,-1.225441,36.763899,882,2671,48,1189
11655,5181,136,3,Business,6,2,36363,6,2,36919,6,2,38224,6,2,38469,6,2,40401,16,24.8,-1.3326173,36.7146233,-1.2536042,36.8064895,46,1932,556,1550
11656,7687,1500,3,Business,11,4,56914,11,4,56933,11,4,56943,11,4,58966,11,4,58972,10,27.2,-1.2991441,36.7528804,-1.2638185,36.7930057,515,6,19,2033
11657,22419,3091,3,Business,5,3,40040,5,3,44626,5,3,44783,5,3,45290,5,3,46461,8,22.3,-1.3025826,36.7670807,-1.2899256,36.815551,124,1171,4586,664
11658,27146,1280,3,Business,3,3,59497,3,3,59527,3,3,59554,3,3,60064,3,3,60857,5,27.4,-1.2551895,36.7822034,-1.2684319,36.8165853,576,793,30,537
11659,11045,2180,2,Personal,14,4,31386,14,4,32312,14,4,32865,14,4,32994,14,4,33549,3,15.4,-1.2962832,36.7849683,-1.296797,36.7764525,648,555,926,682
11660,25116,1882,3,Business,31,3,56157,31,3,57064,31,3,58081,31,3,59046,31,3,60759,9,27.2,-1.3169591,36.7000029,-1.3014461,36.7661381,548,1713,907,1982
11661,17671,577,1,Personal,2,4,35418,2,4,35429,2,4,35791,2,4,36117,2,4,37636,11,13.2,-1.2662728,36.8151265,-1.3270347,36.8667362,932,1519,11,688
11662,14288,3560,3,Business,29,5,44603,29,5,45629,29,5,46167,29,5,46449,29,5,47968,6,27.0,-1.2551895,36.7822034,-1.279395,36.825364,306,1519,1026,820
11663,11401,1976,3,Business,15,2,36193,15,2,36208,15,2,36518,15,2,36610,15,2,38227,6,20.4,-1.257028,36.7810435,-1.2800815,36.7753524,576,1617,15,402
11664,3175,2804,3,Business,11,1,52420,11,1,52606,11,1,52961,11,1,53369,11,1,54054,4,28.8,-1.2551895,36.7822034,-1.2656922,36.8136944,655,685,186,763
11665,7673,136,3,Business,28,4,47575,28,4,47595,28,4,47608,28,4,48096,28,4,50000,21,23.25888921888938,-1.3326173,36.7146233,-1.2587285,36.8347764,886,1904,20,501
11666,7745,3201,3,Business,29,3,56678,29,3,56938,29,3,58276,29,3,59545,29,3,60252,7,21.3,-1.2836183,36.8297208,-1.2584143,36.8048002,812,707,260,2607
11667,21043,2195,3,Business,26,2,56813,26,2,56880,26,2,57275,26,2,58509,26,2,60041,14,31.0,-1.3033561,36.8163631,-1.228911,36.881876,177,1532,67,1629
11668,19744,647,3,Business,29,5,36859,29,5,38467,29,5,40382,29,5,42934,29,5,42936,9,26.6,-1.2638185,36.7930057,-1.3004062,36.829741,11,2,1608,4467
11669,3048,2280,2,Personal,4,3,54836,4,3,54934,4,3,55789,4,3,56152,4,3,56452,2,18.5,-1.2744872,36.7926777,-1.2786894,36.8032321,103,300,98,1218
11670,11239,3211,3,Personal,8,1,42125,8,1,42661,8,1,43712,8,1,44255,8,1,45333,4,24.6,-1.2783772,36.8201617,-1.2658315,36.809049,956,1078,536,1594
11671,15413,393,3,Business,8,5,31385,8,5,36972,8,5,36977,8,5,37738,8,5,38413,4,22.8,-1.3167113,36.8301563,-1.3004062,36.829741,901,675,5587,766
11672,17270,3599,3,Business,27,1,47095,27,1,47155,27,1,50016,27,1,51430,27,1,53757,19,23.2,-1.3302996,36.8707935,-1.3668652,36.730459,772,2327,60,4275
11673,7088,1473,3,Business,20,1,43783,20,1,43817,20,1,44970,20,1,45752,20,1,48309,20,23.25888921888938,-1.2571472,36.7950633,-1.3700383,36.9190174,131,2557,34,1935
11674,12587,295,3,Business,31,3,52632,31,3,58132,31,3,58558,31,3,58680,31,3,60017,6,26.8,-1.2967108,36.7871135,-1.286925,36.821916,583,1337,5500,548
11675,5690,1500,3,Business,7,4,42396,7,4,42408,7,4,42490,7,4,43008,7,4,44088,8,27.8,-1.3004062,36.829741,-1.2638185,36.7930057,206,1080,12,600
11676,22642,682,2,Personal,3,5,56758,3,5,59199,3,5,59612,3,5,59915,3,5,61944,10,22.6,-1.3142269,36.839245,-1.2947685,36.7785834,471,2029,2441,716
11677,28118,761,3,Business,16,4,58115,16,4,58121,16,4,58795,16,4,61176,16,4,63126,17,19.3,-1.3361686,36.7520734,-1.2693102,36.7981777,414,1950,6,3055
11678,10640,2066,3,Business,23,6,36504,23,6,36558,23,6,37846,23,6,38169,23,6,39514,4,26.3,-1.3210189,36.8410551,-1.3112893,36.8201664,448,1345,54,1611
11679,6270,2573,1,Personal,26,3,40320,26,3,40790,26,3,41085,26,3,41628,26,3,42990,6,23.8,-1.2941992,36.790017,-1.273854,36.8003368,722,1362,470,838
11680,1618,3621,3,Business,9,2,56185,9,2,56210,9,2,56376,9,2,58781,9,2,58796,16,30.4,-1.2836583,36.7886014,-1.2640196,36.8850599,709,15,25,2571
11681,14742,868,3,Business,11,4,39263,11,4,39280,11,4,39462,11,4,40902,11,4,42185,8,25.6,-1.303596,36.778378,-1.265715,36.823815,831,1283,17,1622
11682,9116,391,3,Business,30,2,40676,30,2,40805,30,2,41149,30,2,42836,30,2,44507,14,22.2,-1.300921,36.828195,-1.2226694,36.86786,450,1671,129,2031
11683,21349,1329,3,Business,30,6,54995,30,6,55040,30,6,55818,30,6,55889,30,6,57548,8,28.6,-1.273056,36.811298,-1.226188,36.7997968,166,1659,45,849
11684,14562,2066,3,Business,18,4,41470,18,4,41511,18,4,42040,18,4,42276,18,4,43779,9,23.25888921888938,-1.3210189,36.8410551,-1.3131274,36.8905653,863,1503,41,765
11685,7511,633,3,Business,2,6,40188,2,6,40194,2,6,40198,2,6,41555,2,6,41558,11,27.5,-1.2991441,36.7528804,-1.3004062,36.829741,239,3,6,1361
11686,24906,1544,3,Business,11,2,45373,11,2,45531,11,2,49588,11,2,51088,11,2,54901,14,21.5,-1.2851603,36.8249667,-1.3390024,36.8746657,673,3813,158,5557
11687,13426,2207,3,Business,22,5,43093,22,5,43124,22,5,43669,22,5,44044,22,5,46809,9,23.25888921888938,-1.3107818,36.8477324,-1.2696908,36.81519,778,2765,31,920
11688,10307,868,3,Business,21,4,34569,21,4,34797,21,4,35524,21,4,36378,21,4,37710,8,21.6,-1.303596,36.778378,-1.265715,36.823815,306,1332,228,1581
11689,27994,246,3,Business,8,2,61213,8,2,61222,8,2,61261,8,2,61780,8,2,62719,3,23.7,-1.2584143,36.8048002,-1.2551895,36.7822034,45,939,9,558
11690,10084,393,3,Business,12,2,32015,12,2,32023,12,2,32047,12,2,33608,12,2,35480,14,18.2,-1.3167113,36.8301563,-1.306378,36.7519845,523,1872,8,1585
11691,16834,1205,3,Business,25,4,42586,25,4,42612,25,4,43103,25,4,43348,25,4,44247,4,23.25888921888938,-1.2495931,36.8065087,-1.2738936,36.8035805,547,899,26,736
11692,6565,1500,3,Business,22,3,49631,22,3,49978,22,3,50385,22,3,50837,22,3,52701,8,24.5,-1.3004062,36.829741,-1.2638185,36.7930057,603,1864,347,859
11693,15550,1044,2,Personal,4,6,61767,4,6,61819,4,6,62483,4,6,63021,4,6,63679,4,22.6,-1.288621,36.778846,-1.284835,36.8152125,427,658,52,1202
11694,21358,3599,3,Business,27,1,46286,27,1,46409,27,1,47041,27,1,50152,27,1,51632,13,23.3,-1.3302996,36.8707935,-1.3189908,36.777074,211,1480,123,3743
11695,13970,3647,3,Business,29,1,55975,29,1,56011,29,1,56536,29,1,57178,29,1,58657,13,23.25888921888938,-1.272639,36.794723,-1.29928,36.85631,291,1479,36,1167
11696,27159,3647,3,Business,7,3,48284,7,3,48464,7,3,49061,7,3,49279,7,3,50246,3,28.3,-1.272639,36.794723,-1.265971,36.766806,646,967,180,815
11697,22959,1527,3,Business,15,3,53662,15,3,53842,15,3,54640,15,3,54927,15,3,56069,5,26.0,-1.2770708,36.8231093,-1.3004062,36.829741,148,1142,180,1085
11698,25994,2982,3,Business,28,4,46192,28,4,46216,28,4,46819,28,4,48766,28,4,50771,18,27.6,-1.300921,36.828195,-1.177202,36.8351183,691,2005,24,2550
11699,7792,1075,3,Business,15,6,44478,15,6,45608,15,6,48266,15,6,48773,15,6,50287,10,23.2,-1.3014461,36.7661381,-1.2527958,36.8003131,205,1514,1130,3165
11700,11195,2586,1,Personal,27,5,57032,27,5,57086,27,5,59396,27,5,59799,27,5,60466,5,17.8,-1.2809423,36.7540036,-1.2979147,36.7857814,465,667,54,2713
11701,22152,970,3,Business,21,4,33732,21,4,33901,21,4,35547,21,4,36159,21,4,37392,8,19.2,-1.2935508,36.7948949,-1.2551895,36.7822034,774,1233,169,2258
11702,17384,393,3,Business,8,4,50725,8,4,51304,8,4,52003,8,4,52385,8,4,54542,14,27.4,-1.3177547,36.8303703,-1.306378,36.7519845,952,2157,579,1081
11703,191,2869,3,Business,26,5,35318,26,5,35362,26,5,36866,26,5,37125,26,5,39160,3,23.25888921888938,-1.3014461,36.7661381,-1.2763494,36.7671783,263,2035,44,1763
11704,21641,3647,3,Business,12,1,57555,12,1,57851,12,1,58276,12,1,58432,12,1,59081,4,26.7,-1.272639,36.794723,-1.2569503,36.7834728,56,649,296,581
11705,2171,1205,3,Business,24,5,47287,24,5,47494,24,5,48232,24,5,48625,24,5,49706,4,20.9,-1.2810807,36.8144229,-1.2680829,36.798204,88,1081,207,1131
11706,476,830,3,Business,5,1,64125,5,1,64321,5,1,64423,5,1,64713,5,1,65950,8,24.3,-1.2551895,36.7822034,-1.2904016,36.8226303,31,1237,196,392
11707,25218,1075,3,Business,21,1,47331,21,1,48037,21,1,49566,21,1,50133,21,1,51339,8,27.5,-1.2326041,36.8009029,-1.2527958,36.8003131,263,1206,706,2096
11708,7343,3557,3,Business,3,3,59312,3,3,59343,3,3,60527,3,3,60967,3,3,60975,2,27.5,-1.2546732,36.8086796,-1.2695287,36.7981777,850,8,31,1624
11709,10184,570,3,Business,2,2,52149,2,2,52276,2,2,52292,2,2,52389,2,2,55064,7,29.4,-1.2861765,36.8209086,-1.2551895,36.7822034,779,2675,127,113
11710,1617,1304,3,Business,25,2,56412,25,2,56479,25,2,56943,25,2,57058,25,2,58491,8,27.3,-1.3052491,36.8223899,-1.2551895,36.7822034,338,1433,67,579
11711,4641,2579,3,Business,9,3,36164,9,3,36725,9,3,37171,9,3,37694,9,3,38708,10,17.8,-1.2536855,36.8245276,-1.287428,36.7800821,207,1014,561,969
11712,277,1875,3,Personal,14,5,54424,14,5,56086,14,5,56648,14,5,56978,14,5,57559,2,23.7,-1.3236332,36.701152,-1.326647,36.7100442,205,581,1662,892
11713,21087,2658,3,Business,20,2,42074,20,2,44100,20,2,45208,20,2,45313,20,2,47097,9,19.8,-1.2891922,36.825189,-1.3014461,36.7661381,253,1784,2026,1213
11714,14098,1927,3,Business,10,4,52491,10,4,53079,10,4,53747,10,4,54802,10,4,55730,10,21.9,-1.3051608,36.8288914,-1.3404187,36.7614685,742,928,588,1723
11715,13260,1246,3,Business,25,4,31127,25,4,31314,25,4,33653,25,4,33788,25,4,36982,18,16.2,-1.3700383,36.9190174,-1.2824744,36.804724,487,3194,187,2474
11716,16966,3295,3,Business,8,1,41611,8,1,41648,8,1,42411,8,1,43229,8,1,44888,5,28.0,-1.2571472,36.7950633,-1.2815072,36.82096,769,1659,37,1581
11717,11635,1246,3,Business,31,5,31482,31,5,31498,31,5,31587,31,5,32386,31,5,33049,2,14.8,-1.2571472,36.7950633,-1.2550227,36.8023076,536,663,16,888
11718,545,2229,3,Business,10,1,33046,10,1,33081,10,1,35924,10,1,36619,10,1,39154,20,16.4,-1.3247683,36.85803,-1.2367023,36.8758725,48,2535,35,3538
11719,15825,1924,3,Personal,21,4,53465,21,4,53505,21,4,53731,21,4,54800,21,4,56976,18,22.4,-1.2916738,36.7901057,-1.2540899,36.7042728,449,2176,40,1295
11720,27505,2159,3,Business,15,4,48017,15,4,48229,15,4,49507,15,4,49584,15,4,50837,8,27.6,-1.304735,36.7846054,-1.2557779,36.7879648,425,1253,212,1355
11721,8425,391,3,Business,6,3,42800,6,3,43881,6,3,45260,6,3,45789,6,3,48610,19,23.25888921888938,-1.3524201,36.9045107,-1.2784063,36.8222933,436,2821,1081,1908
11722,4199,2987,3,Business,16,2,62990,16,2,63022,16,2,63622,16,2,64026,16,2,65403,12,25.3,-1.270212,36.8210877,-1.2156006,36.8916865,427,1377,32,1004
11723,1879,246,3,Business,26,5,58365,26,5,58888,26,5,59736,26,5,60266,26,5,63781,6,23.25888921888938,-1.290894,36.822971,-1.2584143,36.8048002,580,3515,523,1378
11724,577,393,3,Business,6,2,28153,6,2,29072,6,2,30587,6,2,31821,6,2,33919,14,19.7,-1.3177547,36.8303703,-1.306378,36.7519845,932,2098,919,2749
11725,7590,3339,3,Business,16,3,52725,16,3,52817,16,3,54279,16,3,54907,16,3,57422,22,25.3,-1.3173869,36.8112044,-1.3932312,36.9379199,581,2515,92,2090
11726,4702,3433,1,Personal,15,1,61405,15,1,61412,15,1,61476,15,1,61837,15,1,62231,2,23.25888921888938,-1.2571472,36.7950633,-1.254191,36.8099132,720,394,7,425
11727,8244,928,3,Business,24,3,57956,24,3,57972,24,3,58137,24,3,58486,24,3,61140,12,18.6,-1.2551895,36.7822034,-1.2484602,36.855067,184,2654,16,514
11728,17261,2223,2,Personal,18,1,50655,18,1,50746,18,1,52090,18,1,52397,18,1,54152,7,17.0,-1.3314048,36.8229367,-1.2896399,36.8124498,46,1755,91,1651
11729,17869,2066,3,Business,26,4,50592,26,4,50597,26,4,50967,26,4,51804,26,4,53176,16,22.2,-1.316961,36.820337,-1.2343236,36.8861,74,1372,5,1207
11730,18128,1469,3,Business,24,3,56984,24,3,57090,24,3,57712,24,3,57794,24,3,61415,10,23.25888921888938,-1.2571472,36.7950633,-1.3127877,36.8481987,931,3621,106,704
11731,16788,3355,3,Business,5,3,56019,5,3,57241,5,3,57674,5,3,57777,5,3,58048,2,25.2,-1.3052491,36.8223899,-1.2983805,36.8198439,551,271,1222,536
11732,22185,635,3,Business,4,1,50269,4,1,54625,4,1,55335,4,1,57377,4,1,60564,7,23.25888921888938,-1.300921,36.828195,-1.2599563,36.7993439,61,3187,4356,2752
11733,8607,186,3,Business,18,1,33427,18,1,33443,18,1,34009,18,1,34277,18,1,36432,20,21.5,-1.2571472,36.7950633,-1.3700383,36.9190174,520,2155,16,834
11734,10132,2178,1,Personal,22,5,49115,22,5,49321,22,5,50477,22,5,51917,22,5,52923,7,23.25888921888938,-1.2248308,36.8012573,-1.2615584,36.8149506,101,1006,206,2596
11735,13321,1205,3,Business,8,1,42307,8,1,42357,8,1,43614,8,1,44012,8,1,46364,7,28.0,-1.2495931,36.8065087,-1.297451,36.803117,435,2352,50,1655
11736,13289,3647,3,Business,14,5,37823,14,5,38010,14,5,40141,14,5,40641,14,5,42111,5,21.8,-1.272639,36.794723,-1.2797536,36.8223726,739,1470,187,2631
11737,11722,246,3,Business,18,2,54001,18,2,54009,18,2,54060,18,2,55240,18,2,55244,3,27.1,-1.2584143,36.8048002,-1.2551895,36.7822034,520,4,8,1231
11738,23565,265,3,Business,15,1,35923,15,1,36108,15,1,36974,15,1,37622,15,1,38714,7,23.25888921888938,-1.2609397,36.8010827,-1.300921,36.828195,85,1092,185,1514
11739,18751,136,3,Business,23,3,55271,23,3,56190,23,3,57092,23,3,58436,23,3,63206,24,22.4,-1.3326173,36.7146233,-1.240248,36.8230472,226,4770,919,2246
11740,23843,1075,3,Business,25,1,44222,25,1,44252,25,1,44751,25,1,44989,25,1,45445,1,27.1,-1.2649605,36.7981777,-1.2527958,36.8003131,547,456,30,737
11741,15932,478,3,Business,21,2,49519,21,2,49573,21,2,50270,21,2,50411,21,2,52030,11,24.8,-1.2551895,36.7822034,-1.3142701,36.8537693,548,1619,54,838
11742,27233,2587,3,Business,12,3,53734,12,3,55505,12,3,55534,12,3,55901,12,3,56587,7,26.4,-1.28878,36.8168312,-1.2551895,36.7822034,648,686,1771,396
11743,15186,2216,3,Business,8,2,44624,8,2,44645,8,2,44814,8,2,45954,8,2,47980,8,23.3,-1.2551895,36.7822034,-1.295156,36.8094306,512,2026,21,1309
11744,25379,3635,1,Business,5,5,61739,5,5,61747,5,5,62054,5,5,62751,5,5,63287,3,24.7,-1.2584143,36.8048002,-1.2615888,36.7928732,449,536,8,1004
11745,27117,2789,3,Business,1,1,42334,1,1,42413,1,1,43026,1,1,43995,1,1,44660,8,23.25888921888938,-1.304735,36.7846054,-1.2651643,36.8072214,958,665,79,1582
11746,23153,635,3,Business,6,4,48400,6,4,49388,6,4,50298,6,4,50404,6,4,51581,7,23.25888921888938,-1.2599563,36.7993439,-1.234958,36.8104235,267,1177,988,1016
11747,8363,2330,3,Business,2,2,47236,2,2,47321,2,2,48363,2,2,48442,2,2,49253,6,26.0,-1.2533885,36.8165128,-1.2124582,36.802894,783,811,85,1121
11748,8542,3104,1,Personal,20,3,55709,20,3,55734,20,3,57099,20,3,57349,20,3,60709,27,23.2,-1.3421985,36.9040545,-1.2524958,36.7261025,543,3360,25,1615
11749,23007,2016,3,Personal,19,2,54578,19,2,54695,19,2,55605,19,2,57010,19,2,57738,5,29.9,-1.2821929,36.8281227,-1.2871136,36.785507,845,728,117,2315
11750,8564,1761,3,Business,8,4,35100,8,4,36015,8,4,36857,8,4,37351,8,4,40512,26,20.4,-1.3688433,36.7402114,-1.332624,36.913187,387,3161,915,1336
11751,20385,1796,3,Business,12,2,51168,12,2,51254,12,2,51288,12,2,54491,12,2,54643,11,27.2,-1.272828,36.816608,-1.331619,36.847976,41,152,86,3237
11752,26662,733,3,Business,5,2,38757,5,2,38773,5,2,38799,5,2,39261,5,2,40700,10,23.7,-1.2551895,36.7822034,-1.3031971,36.7863146,518,1439,16,488
11753,24230,1996,3,Business,18,6,41110,18,6,41128,18,6,41522,18,6,41685,18,6,42685,6,21.2,-1.2946359,36.8352718,-1.3272104,36.8528418,211,1000,18,557
11754,4347,2789,3,Business,9,4,45614,9,4,45805,9,4,46246,9,4,46653,9,4,47945,10,23.25888921888938,-1.304735,36.7846054,-1.3239248,36.7091136,599,1292,191,848
11755,11256,1363,3,Business,26,5,38618,26,5,38645,26,5,38986,26,5,39613,26,5,40255,5,23.25888921888938,-1.3004062,36.829741,-1.3083266,36.8494756,211,642,27,968
11756,239,2509,3,Business,5,2,56601,5,2,56621,5,2,56736,5,2,57250,5,2,58975,20,23.25888921888938,-1.2571472,36.7950633,-1.3700383,36.9190174,24,1725,20,629
11757,21849,2987,3,Business,28,3,58355,28,3,59498,28,3,59983,28,3,60349,28,3,63067,4,23.1,-1.270212,36.8210877,-1.2534301,36.8000983,279,2718,1143,851
11758,2786,2021,3,Business,9,2,36100,9,2,36108,9,2,38189,9,2,38445,9,2,40164,13,27.2,-1.29475,36.83421,-1.2967635,36.7527447,448,1719,8,2337
11759,22553,2008,3,Business,17,3,60159,17,3,60786,17,3,60919,17,3,61671,17,3,62828,5,24.8,-1.2866012,36.8195691,-1.2508229,36.7895263,208,1157,627,885
11760,14160,1994,3,Business,18,1,43415,18,1,43509,18,1,44748,18,1,45257,18,1,46299,3,28.2,-1.273733,36.818022,-1.286925,36.821916,763,1042,94,1748
11761,21875,1469,3,Business,15,1,35514,15,1,35624,15,1,36310,15,1,36615,15,1,40656,7,23.25888921888938,-1.2551895,36.7822034,-1.2822277,36.8268543,646,4041,110,991
11762,17983,1195,3,Business,7,4,31333,7,4,31378,7,4,32526,7,4,33513,7,4,35816,15,23.25888921888938,-1.2991441,36.7528804,-1.3228003,36.8306435,678,2303,45,2135
11763,4306,2306,3,Business,1,5,51491,1,5,51546,1,5,51571,1,5,53674,1,5,57590,16,32.1,-1.3271109,36.8093583,-1.2271998,36.8084905,89,3916,55,2128
11764,21613,2112,3,Business,14,4,54721,14,4,54788,14,4,55243,14,4,55525,14,4,56312,5,27.4,-1.2285835,36.8826468,-1.2156006,36.8916865,691,787,67,737
11765,13481,2952,1,Personal,7,5,50779,7,5,53754,7,5,54106,7,5,54659,7,5,56777,9,24.8,-1.2629818,36.8135865,-1.302546,36.7773717,789,2118,2975,905
11766,6182,412,3,Business,19,3,45235,19,3,45339,19,3,45525,19,3,45865,19,3,45867,2,22.2,-1.2600926,36.8088685,-1.266837,36.799249,517,2,104,526
11767,13627,269,3,Business,6,4,42854,6,4,43331,6,4,44946,6,4,45472,6,4,47080,15,24.3,-1.3472066,36.7692638,-1.3226302,36.8719901,114,1608,477,2141
11768,18838,2567,1,Personal,8,3,37935,8,3,37960,8,3,38160,8,3,38445,8,3,39911,11,22.1,-1.318165,36.828513,-1.2634125,36.778789,449,1466,25,485
11769,21492,2669,1,Personal,6,6,67184,6,6,68203,6,6,68978,6,6,69289,6,6,71201,10,25.1,-1.2801206,36.817709,-1.3049726,36.8912382,148,1912,1019,1086
11770,9820,1789,3,Business,19,3,41626,19,3,41641,19,3,42218,19,3,43053,19,3,45214,20,22.2,-1.2917868,36.7872675,-1.3700383,36.9190174,803,2161,15,1412
11771,162,3599,3,Business,12,5,45601,12,5,45635,12,5,46424,12,5,46613,12,5,49967,24,26.3,-1.3302996,36.8707935,-1.2835228,36.7437619,233,3354,34,978
11772,22195,635,3,Business,20,1,34287,20,1,34337,20,1,34696,20,1,37285,20,1,38096,8,19.0,-1.300921,36.828195,-1.2602337,36.7990548,538,811,50,2948
11773,6705,2282,3,Personal,20,3,53176,20,3,53199,20,3,53497,20,3,53756,20,3,56269,8,28.2,-1.2735394,36.8337752,-1.3043649,36.7816132,698,2513,23,557
11774,24882,357,3,Business,26,2,31717,26,2,32021,26,2,32359,26,2,33967,26,2,35152,7,23.25888921888938,-1.2996681,36.8068413,-1.2945179,36.7685349,837,1185,304,1946
11775,12406,186,3,Business,7,1,38891,7,1,39391,7,1,42761,7,1,44067,7,1,48623,24,21.6,-1.3700383,36.9190174,-1.2579304,36.8019667,753,4556,500,4676
11776,16919,3326,3,Business,8,3,56835,8,3,56855,8,3,57003,8,3,58005,8,3,59240,7,25.7,-1.2571472,36.7950633,-1.304344,36.812274,882,1235,20,1150
11777,15853,2154,3,Business,27,4,51077,27,4,51461,27,4,52220,27,4,52326,27,4,53128,4,23.6,-1.2765736,36.8513646,-1.2979063,36.8373372,263,802,384,865
11778,10406,2316,1,Personal,5,3,54282,5,3,54338,5,3,55843,5,3,56559,5,3,57687,9,23.7,-1.2861765,36.8209086,-1.306939,36.7727566,882,1128,56,2221
11779,12430,3686,3,Business,11,4,52554,11,4,52577,11,4,53435,11,4,53584,11,4,54627,4,27.2,-1.2551895,36.7822034,-1.2747247,36.8150014,903,1043,23,1007
11780,8150,2066,3,Business,24,3,45499,24,3,45579,24,3,46544,24,3,46688,24,3,48502,13,23.25888921888938,-1.3270716,36.8406371,-1.3050802,36.7540383,663,1814,80,1109
11781,6585,2200,3,Business,30,2,45915,30,2,46319,30,2,47127,30,2,48999,30,2,49711,6,27.6,-1.2571472,36.7950633,-1.290894,36.822971,687,712,404,2680
11782,17213,2587,3,Business,6,1,53396,6,1,53606,6,1,54859,6,1,55628,6,1,57835,16,23.25888921888938,-1.323615,36.700475,-1.28878,36.8168312,564,2207,210,2022
11783,7517,2150,3,Business,17,3,44093,17,3,44431,17,3,44553,17,3,45448,17,3,46196,6,23.25888921888938,-1.3181159,36.7101559,-1.344446,36.756597,533,748,338,1017
11784,3051,1396,2,Personal,3,1,64008,3,1,64046,3,1,64708,3,1,65725,3,1,66834,5,22.4,-1.2449604,36.7965155,-1.2768829,36.7965104,208,1109,38,1679
11785,24607,1578,3,Business,11,2,47288,11,2,48350,11,2,48388,11,2,48847,11,2,49794,5,22.3,-1.2765736,36.8513646,-1.28878,36.8168312,150,947,1062,497
11786,20846,2956,3,Business,7,5,51665,7,5,52311,7,5,53383,7,5,53727,7,5,55835,14,26.9,-1.207546,36.7913976,-1.2584143,36.8048002,103,2108,646,1416
11787,7689,3291,3,Business,18,4,40750,18,4,40782,18,4,41184,18,4,41517,18,4,42736,4,23.25888921888938,-1.272828,36.816608,-1.2600926,36.8088685,7,1219,32,735
11788,24964,1927,3,Business,2,6,40890,2,6,40980,2,6,41895,2,6,42221,2,6,44883,9,27.5,-1.3014461,36.7661381,-1.3472066,36.7692638,605,2662,90,1241
11789,7437,265,3,Business,26,5,47804,26,5,50197,26,5,50436,26,5,53075,26,5,55470,9,23.25888921888938,-1.300921,36.828195,-1.3034899,36.7733256,519,2395,2393,2878
11790,9744,248,3,Business,27,5,33902,27,5,33914,27,5,33927,27,5,35367,27,5,36397,7,16.4,-1.3173869,36.8112044,-1.304735,36.7846054,105,1030,12,1453
11791,16389,3338,3,Business,31,5,44438,31,5,44842,31,5,44957,31,5,46534,31,5,49786,18,21.7,-1.2551895,36.7822034,-1.3301121,36.89331,926,3252,404,1692
11792,12379,2622,2,Personal,2,3,38308,2,3,38748,2,3,39847,2,3,40189,2,3,41732,6,21.8,-1.292206,36.800284,-1.300921,36.828195,479,1543,440,1441
11793,16305,3283,3,Business,20,2,55145,20,2,56327,20,2,56329,20,2,57056,20,2,58134,13,24.1,-1.331619,36.847976,-1.2628473,36.781805,345,1078,1182,729
11794,16417,761,3,Business,18,3,34631,18,3,34671,18,3,35147,18,3,35405,18,3,37630,25,14.8,-1.2693102,36.7981777,-1.2740084,36.9621681,103,2225,40,734
11795,23203,393,3,Business,17,5,35024,17,5,35058,17,5,35065,17,5,38366,17,5,39091,11,23.25888921888938,-1.3167113,36.8301563,-1.2638185,36.7930057,843,725,34,3308
11796,7621,1410,3,Business,7,5,38518,7,5,39012,7,5,39776,7,5,40957,7,5,43259,5,25.1,-1.300921,36.828195,-1.2797664,36.826967,725,2302,494,1945
11797,11555,393,3,Business,11,1,57049,11,1,57214,11,1,57582,11,1,58554,11,1,60171,11,28.9,-1.3167113,36.8301563,-1.2638185,36.7930057,191,1617,165,1340
11798,20956,3647,3,Business,5,5,40255,5,5,40299,5,5,41072,5,5,41292,5,5,42637,5,24.0,-1.272639,36.794723,-1.2885417,36.8100523,607,1345,44,993
11799,19787,375,3,Business,30,2,51624,30,2,57738,30,2,58257,30,2,58506,30,2,61831,8,23.25888921888938,-1.2551895,36.7822034,-1.3025453,36.8320497,709,3325,6114,768
11800,8976,420,3,Business,6,4,57001,6,4,57792,6,4,58078,6,4,58591,6,4,61027,8,23.25888921888938,-1.281614,36.8275424,-1.2609537,36.7910164,280,2436,791,799
11801,24518,1261,1,Personal,3,2,52776,3,2,53168,3,2,53732,3,2,54072,3,2,55267,9,20.3,-1.266362,36.796939,-1.2966785,36.7896469,770,1195,392,904
11802,6006,2412,3,Business,21,2,56464,21,2,56591,21,2,57014,21,2,58590,21,2,58601,12,25.2,-1.2584143,36.8048002,-1.2283403,36.8822756,517,11,127,1999
11803,28245,33,3,Personal,15,5,54534,15,5,54668,15,5,55292,15,5,56069,15,5,56654,6,17.8,-1.2814609,36.8265932,-1.2544051,36.7982934,61,585,134,1401
11804,10551,3647,3,Business,4,5,62674,4,5,62719,4,5,62853,4,5,63738,4,5,63997,4,21.6,-1.272639,36.794723,-1.2676759,36.801804,427,259,45,1019
11805,12167,1527,3,Business,28,4,40433,28,4,40447,28,4,41132,28,4,42800,28,4,42803,9,23.8,-1.2638185,36.7930057,-1.3004062,36.829741,762,3,14,2353
11806,7654,3291,3,Business,25,6,32600,25,6,32631,25,6,33493,25,6,34894,25,6,35706,12,23.25888921888938,-1.228911,36.881876,-1.2600926,36.8088685,75,812,31,2263
11807,25034,1976,3,Business,20,3,55858,20,3,55870,20,3,56290,20,3,56806,20,3,58004,9,29.3,-1.257028,36.7810435,-1.2321733,36.7974377,828,1198,12,936
11808,28205,3222,3,Business,20,3,34599,20,3,34612,20,3,35661,20,3,35844,20,3,39132,30,20.7,-1.2551895,36.7822034,-1.1429062,36.9300994,953,3288,13,1232
11809,7405,18,3,Personal,23,1,42611,23,1,42654,23,1,42809,23,1,43146,23,1,44434,7,18.7,-1.2960302,36.7711317,-1.3038156,36.8122733,64,1288,43,492
11810,24350,3280,2,Personal,22,2,44260,22,2,44295,22,2,44557,22,2,45336,22,2,45954,3,19.2,-1.275001,36.766323,-1.290239,36.7620412,334,618,35,1041
11811,27583,1179,3,Business,28,3,42340,28,3,42377,28,3,43959,28,3,44205,28,3,47915,21,23.25888921888938,-1.3700383,36.9190174,-1.2917868,36.7872675,179,3710,37,1828
11812,19968,1402,3,Business,24,4,56191,24,4,56213,24,4,56587,24,4,58546,24,4,59079,1,28.4,-1.290894,36.822971,-1.2813012,36.8323962,365,533,22,2333
11813,9358,1575,1,Personal,4,4,38667,4,4,38678,4,4,39072,4,4,40407,4,4,41365,12,23.25888921888938,-1.2682179,36.8009289,-1.2646374,36.7235671,785,958,11,1729
11814,7682,3355,3,Business,29,4,49805,29,4,49943,29,4,50917,29,4,51746,29,4,53137,13,24.8,-1.3562374,36.9042954,-1.3052491,36.8223899,587,1391,138,1803
11815,4141,2190,3,Business,25,5,50439,25,5,50461,25,5,51246,25,5,51823,25,5,53299,6,29.0,-1.301953,36.788458,-1.2904406,36.7598219,332,1476,22,1362
11816,12835,1638,1,Personal,10,3,64776,10,3,64830,10,3,65995,10,3,66162,10,3,68058,11,22.7,-1.3247535,36.8880572,-1.2773974,36.9678677,532,1896,54,1332
11817,11392,1148,3,Business,5,1,44518,5,1,44539,5,1,44893,5,1,45607,5,1,48115,10,24.4,-1.3100586,36.8500329,-1.2568001,36.8215083,848,2508,21,1068
11818,13280,311,3,Business,29,2,51367,29,2,51423,29,2,51581,29,2,52166,29,2,54740,20,27.1,-1.2917868,36.7872675,-1.3705766,36.9120742,656,2574,56,743
11819,901,1500,3,Business,10,1,53554,10,1,53690,10,1,54367,10,1,54805,10,1,56213,9,18.5,-1.2638185,36.7930057,-1.3004062,36.829741,42,1408,136,1115
11820,10379,1442,3,Personal,20,4,34339,20,4,34377,20,4,34381,20,4,35717,20,4,36698,8,18.5,-1.2840605,36.8191699,-1.2963097,36.7688221,886,981,38,1340
11821,24505,3295,3,Business,11,2,41092,11,2,41144,11,2,41338,11,2,42055,11,2,44256,12,24.4,-1.2571472,36.7950633,-1.2409346,36.8743053,279,2201,52,911
11822,20593,3686,3,Business,26,3,54671,26,3,54683,26,3,54716,26,3,54968,26,3,58229,8,27.3,-1.2551895,36.7822034,-1.2924639,36.7795798,38,3261,12,285
11823,21458,867,3,Business,14,5,34314,14,5,35146,14,5,35498,14,5,36687,14,5,37067,9,17.3,-1.2574219,36.7927073,-1.2991441,36.7528804,868,380,832,1541
11824,8380,540,3,Business,20,4,36298,20,4,38898,20,4,39795,20,4,40278,20,4,41618,7,22.2,-1.2551895,36.7822034,-1.289498,36.818878,300,1340,2600,1380
11825,26348,3309,3,Personal,28,4,46869,28,4,46971,28,4,47566,28,4,48162,28,4,49812,5,23.25888921888938,-1.2995135,36.7933633,-1.3108386,36.7555239,898,1650,102,1191
11826,15549,3647,3,Business,8,3,39895,8,3,39910,8,3,40640,8,3,41058,8,3,42326,8,23.25888921888938,-1.272639,36.794723,-1.3041129,36.8104939,341,1268,15,1148
11827,27283,517,3,Business,10,1,34257,10,1,35237,10,1,36852,10,1,37461,10,1,39285,14,18.7,-1.3228003,36.8306435,-1.306378,36.7519845,523,1824,980,2224
11828,2867,2066,3,Business,23,4,56558,23,4,56632,23,4,56929,23,4,57015,23,4,59151,12,24.7,-1.2502493,36.7923169,-1.3270716,36.8406371,205,2136,74,383
11829,19931,3686,3,Business,9,4,35609,9,4,35819,9,4,37614,9,4,37727,9,4,41080,8,23.25888921888938,-1.2551895,36.7822034,-1.305146,36.830025,435,3353,210,1908
11830,5012,393,3,Business,13,1,40821,13,1,40838,13,1,41044,13,1,41199,13,1,42977,4,23.25888921888938,-1.3167113,36.8301563,-1.3004062,36.829741,211,1778,17,361
11831,19058,1500,3,Business,9,3,41726,9,3,43116,9,3,43212,9,3,44198,9,3,49012,8,21.2,-1.3004062,36.829741,-1.2569006,36.7925141,543,4814,1390,1082
11832,18788,142,3,Business,29,5,49271,29,5,49310,29,5,49315,29,5,49674,29,5,50628,4,28.8,-1.2963097,36.7688221,-1.2977387,36.8031447,425,954,39,364
11833,20526,3222,3,Business,10,1,54883,10,1,55628,10,1,59270,10,1,59394,10,1,61006,8,19.0,-1.2551895,36.7822034,-1.295156,36.8094306,268,1612,745,3766
11834,8756,855,1,Personal,26,7,41584,26,7,41597,26,7,44165,26,7,44543,26,7,46478,15,23.25888921888938,-1.309513,36.811345,-1.2727259,36.9100807,644,1935,13,2946
11835,13774,1075,3,Business,18,1,60469,18,1,60499,18,1,62424,18,1,63692,18,1,65765,6,29.3,-1.2904016,36.8226303,-1.2527958,36.8003131,127,2073,30,3193
11836,22086,1882,3,Business,31,4,30864,31,4,31919,31,4,33322,31,4,34433,31,4,35139,7,20.5,-1.2958783,36.7928125,-1.2588775,36.8079744,412,706,1055,2514
11837,12566,1363,3,Business,1,1,41318,1,1,42118,1,1,42982,1,1,43136,1,1,44284,9,23.25888921888938,-1.3004062,36.829741,-1.2551895,36.7822034,763,1148,800,1018
11838,2480,3647,3,Business,17,4,40803,17,4,40884,17,4,41562,17,4,41981,17,4,43029,5,25.3,-1.272639,36.794723,-1.2854174,36.7951152,518,1048,81,1097
11839,15196,2222,3,Business,2,4,54800,2,4,58517,2,4,59325,2,4,59628,2,4,61110,10,23.8,-1.2930128,36.8356869,-1.3191788,36.8895401,88,1482,3717,1111
11840,8616,1787,3,Business,19,5,56385,19,5,56398,19,5,56659,19,5,57032,19,5,58395,12,23.25888921888938,-1.2527958,36.8003131,-1.2283403,36.8822756,697,1363,13,634
11841,26840,3017,1,Business,13,5,62092,13,5,62135,13,5,62809,13,5,63125,13,5,63421,2,19.2,-1.299313,36.7831488,-1.3063901,36.7873672,431,296,43,990
11842,17191,162,3,Business,6,3,47829,6,3,48051,6,3,49080,6,3,49868,6,3,54065,28,27.6,-1.3510811,36.894806,-1.2023973,36.913955,411,4197,222,1817
11843,2249,3647,3,Business,21,1,54513,21,1,54525,21,1,54643,21,1,55601,21,1,55746,3,27.7,-1.272639,36.794723,-1.272798,36.8124195,818,145,12,1076
11844,22577,2691,3,Business,27,2,58803,27,2,58909,27,2,59373,27,2,59758,27,2,60530,8,22.3,-1.2857671,36.7875614,-1.2571472,36.7950633,247,772,106,849
11845,21333,1205,3,Business,28,4,38368,28,4,38422,28,4,39120,28,4,39681,28,4,42186,3,23.25888921888938,-1.2810807,36.8144229,-1.2920693,36.8026415,88,2505,54,1259
11846,8891,1525,3,Business,29,5,45604,29,5,45622,29,5,46674,29,5,46884,29,5,49807,22,26.9,-1.3197021,36.9092821,-1.2597839,36.808196,411,2923,18,1262
11847,19289,868,3,Business,12,2,44883,12,2,44955,12,2,45392,12,2,45920,12,2,45921,5,24.5,-1.2600926,36.8088685,-1.265715,36.823815,250,1,72,965
11848,4932,496,3,Business,4,1,38885,4,1,38930,4,1,38936,4,1,40424,4,1,41297,5,21.0,-1.2553615,36.7895376,-1.2677588,36.8169359,379,873,45,1494
11849,13941,2200,3,Business,28,5,48188,28,5,48931,28,5,49436,28,5,52449,28,5,54588,17,25.3,-1.3700383,36.9190174,-1.290894,36.822971,498,2139,743,3518
11850,24506,3665,3,Personal,4,5,29263,4,5,29365,4,5,31649,4,5,31905,4,5,33217,7,19.4,-1.253087,36.793333,-1.2758338,36.7858201,159,1312,102,2540
11851,5628,2330,3,Business,28,4,52870,28,4,52929,28,4,53667,28,4,53733,28,4,54504,3,29.8,-1.3015197,36.7658456,-1.2873232,36.7658572,348,771,59,804
11852,358,3546,3,Personal,3,1,49645,3,1,50258,3,1,52698,3,1,52981,3,1,55231,13,22.8,-1.3316438,36.76916731,-1.293973,36.80169,328,2250,613,2723
11853,2051,3450,3,Business,6,3,57850,6,3,57860,6,3,58073,6,3,59162,6,3,59739,9,23.25888921888938,-1.2551895,36.7822034,-1.2942,36.7777614,953,577,10,1302
11854,11314,1950,1,Personal,15,1,37306,15,1,37354,15,1,37940,15,1,38217,15,1,39164,7,23.25888921888938,-1.2413316,36.8785525,-1.2257343,36.8933543,704,947,48,863
11855,2189,3771,3,Personal,16,2,30743,16,2,30760,16,2,31670,16,2,31975,16,2,33648,7,23.25888921888938,-1.2696908,36.81519,-1.298437,36.781971,99,1673,17,1215
11856,3332,2178,1,Personal,14,5,33881,14,5,34025,14,5,35157,14,5,35303,14,5,36174,5,18.1,-1.2793503,36.8039715,-1.2998552,36.8187077,726,871,144,1278
11857,7353,3091,3,Business,9,6,53557,9,6,55420,9,6,55768,9,6,56557,9,6,57308,6,27.3,-1.290894,36.822971,-1.2962832,36.7849683,276,751,1863,1137
11858,2746,3669,3,Business,16,3,46678,16,3,46686,16,3,46955,16,3,47536,16,3,49212,19,23.0,-1.2615888,36.7928732,-1.2708104,36.910537,598,1676,8,850
11859,952,1905,3,Personal,22,3,436,22,3,515,22,3,731,22,3,2992,22,3,2997,2,18.6,-1.3039706,36.7688174,-1.301809,36.75643,398,5,79,2477
11860,10196,1500,3,Business,10,1,33616,10,1,34094,10,1,35068,10,1,35647,10,1,38466,6,16.6,-1.2770708,36.8231093,-1.2638185,36.7930057,779,2819,478,1553
11861,4399,1209,3,Business,17,3,37270,17,3,37302,17,3,37589,17,3,37971,17,3,39504,9,23.25888921888938,-1.2638185,36.7930057,-1.3004062,36.829741,709,1533,32,669
11862,21554,2359,1,Personal,5,5,49220,5,5,49722,5,5,50947,5,5,51908,5,5,52890,6,26.6,-1.2853965,36.8183118,-1.2812776,36.7810331,328,982,502,2186
11863,13510,246,3,Business,21,1,50549,21,1,55205,21,1,56226,21,1,58171,21,1,60192,10,21.6,-1.214328,36.7911903,-1.2584143,36.8048002,654,2021,4656,2966
11864,20947,3698,3,Business,15,1,52803,15,1,52832,15,1,53537,15,1,54575,15,1,57948,22,23.25888921888938,-1.3244885,36.897792,-1.261403,36.7692242,856,3373,29,1743
11865,22915,85,2,Business,29,2,44868,29,2,44917,29,2,45357,29,2,45448,29,2,46934,9,21.3,-1.267229,36.806399,-1.3018758,36.7590863,101,1486,49,531
11866,27237,816,3,Business,20,3,45981,20,3,46072,20,3,47396,20,3,49688,20,3,49696,3,28.5,-1.3052491,36.8223899,-1.290894,36.822971,127,8,91,3616
11867,9448,2200,3,Business,4,1,58128,4,1,58803,4,1,59564,4,1,60064,4,1,61269,7,27.4,-1.290894,36.822971,-1.2551895,36.7822034,953,1205,675,1261
11868,22999,71,3,Business,28,1,45840,28,1,45853,28,1,46544,28,1,46700,28,1,48401,8,23.9,-1.2813012,36.8323962,-1.2571472,36.7950633,365,1701,13,847
11869,10460,3426,3,Business,6,3,57590,6,3,58718,6,3,59531,6,3,59648,6,3,63137,21,25.8,-1.2232123,36.8932547,-1.3012008,36.764868,199,3489,1128,930
11870,7027,3064,3,Business,26,5,51553,26,5,51739,26,5,53449,26,5,53852,26,5,54768,7,23.25888921888938,-1.2571472,36.7950633,-1.3025299,36.7901963,775,916,186,2113
11871,3511,136,3,Business,23,6,39545,23,6,40133,23,6,40608,23,6,40681,23,6,41249,4,23.25888921888938,-1.3165104,36.7077726,-1.3254522,36.7216584,575,568,588,548
11872,7,60,3,Business,27,4,34531,27,4,34562,27,4,35263,27,4,35597,27,4,36368,8,18.6,-1.272828,36.816608,-1.2296618,36.8438272,882,771,31,1035
11873,6781,3718,3,Business,21,3,36891,21,3,38187,21,3,39000,21,3,39236,21,3,39907,5,21.8,-1.2906618,36.8131222,-1.2650027,36.8126242,744,671,1296,1049
11874,24682,3028,1,Personal,17,2,44673,17,2,44694,17,2,45683,17,2,45881,17,2,46358,3,19.2,-1.290239,36.7620412,-1.3014461,36.7661381,844,477,21,1187
11875,25468,2229,3,Business,21,2,52429,21,2,52450,21,2,52789,21,2,53301,21,2,54822,10,25.2,-1.3190408,36.7114416,-1.2974015,36.7772406,524,1521,21,851
11876,24617,1280,3,Business,27,3,61426,27,3,61436,27,3,61471,27,3,62359,27,3,62362,3,27.6,-1.2551895,36.7822034,-1.265338,36.8088155,576,3,10,923
11877,20402,286,3,Business,4,1,32613,4,1,32627,4,1,32678,4,1,34048,4,1,35868,10,21.8,-1.2597436,36.8282526,-1.2551895,36.7822034,627,1820,14,1421
11878,11501,3557,3,Business,30,5,34734,30,5,34793,30,5,35202,30,5,35480,30,5,36787,9,19.2,-1.2546732,36.8086796,-1.3066143,36.8161046,449,1307,59,687
11879,25217,2106,1,Personal,31,4,51287,31,4,51405,31,4,53717,31,4,54096,31,4,55914,13,23.1,-1.2874648,36.8271985,-1.1985673,36.8363688,116,1818,118,2691
11880,238,735,1,Personal,3,5,35498,3,5,35505,3,5,37379,3,5,37926,3,5,39990,20,21.4,-1.3029371,36.8609337,-1.3091733,36.74081,402,2064,7,2421
11881,5538,265,3,Business,4,4,57436,4,4,57526,4,4,57630,4,4,58219,4,4,58597,2,24.7,-1.300921,36.828195,-1.310011,36.820824,848,378,90,693
11882,19465,1304,3,Business,25,1,40139,25,1,40152,25,1,40528,25,1,41761,25,1,42071,3,23.25888921888938,-1.2551895,36.7822034,-1.255956,36.772901,498,310,13,1609
11883,27908,2330,3,Business,14,5,49049,14,5,49550,14,5,50560,14,5,50685,14,5,52295,12,23.6,-1.3376825,36.7575489,-1.2915247,36.8055757,232,1610,501,1135
11884,12536,302,3,Business,13,6,67051,13,6,68206,13,6,68984,13,6,69370,13,6,71089,7,26.5,-1.2649605,36.7981777,-1.2696795,36.8640088,775,1719,1155,1164
11885,8050,1363,3,Business,23,2,43799,23,2,44261,23,2,45036,23,2,45147,23,2,47776,7,18.2,-1.3004062,36.829741,-1.2593834,36.8045189,477,2629,462,886
11886,25858,517,3,Business,13,2,28111,13,2,34275,13,2,35003,13,2,36073,13,2,37167,4,19.7,-1.3177547,36.8303703,-1.3004062,36.829741,80,1094,6164,1798
11887,17113,393,3,Business,8,3,50326,8,3,50348,8,3,51232,8,3,52356,8,3,53035,4,23.25888921888938,-1.3167113,36.8301563,-1.3004062,36.829741,843,679,22,2008
11888,22956,1271,3,Business,28,3,40933,28,3,41901,28,3,42503,28,3,43462,28,3,46936,23,23.25888921888938,-1.3244885,36.897792,-1.2022216,36.9198343,712,3474,968,1561
11889,18442,393,3,Business,26,5,57038,26,5,57331,26,5,58325,26,5,58527,26,5,60237,5,23.25888921888938,-1.3167113,36.8301563,-1.3077869,36.8443207,161,1710,293,1196
11890,11268,2523,3,Business,11,1,45597,11,1,45658,11,1,46918,11,1,47404,11,1,50039,7,26.8,-1.2551895,36.7822034,-1.2545163,36.8243717,131,2635,61,1746
11891,3070,1899,3,Business,4,6,37214,4,6,37240,4,6,37721,4,6,37836,4,6,38889,11,15.6,-1.272828,36.816608,-1.331619,36.847976,414,1053,26,596
11892,17357,478,3,Business,15,1,44098,15,1,44107,15,1,44137,15,1,44765,15,1,46468,17,23.25888921888938,-1.2551895,36.7822034,-1.3339943,36.7263409,291,1703,9,658
11893,4207,2330,3,Business,24,3,48625,24,3,48941,24,3,50143,24,3,50315,24,3,50338,9,23.25888921888938,-1.2326041,36.8009029,-1.2645318,36.7981775,634,23,316,1374
11894,2246,53,3,Business,3,1,33429,3,1,33607,3,1,35272,3,1,35651,3,1,37100,13,18.0,-1.2770708,36.8231093,-1.2257343,36.8933543,92,1449,178,2044
11895,8469,647,3,Business,5,5,36606,5,5,36641,5,5,36647,5,5,37176,5,5,37907,4,19.8,-1.2770708,36.8231093,-1.3004062,36.829741,349,731,35,535
11896,1579,3560,3,Business,6,3,52326,6,3,52382,6,3,52674,6,3,53254,6,3,53341,1,23.25888921888938,-1.28878,36.8168312,-1.279395,36.825364,410,87,56,872
11897,2756,1985,1,Personal,1,1,60209,1,1,61124,1,1,62083,1,1,62153,1,1,63966,14,23.6,-1.2746171,36.8815366,-1.2759432,36.7892706,933,1813,915,1029
11898,20597,633,3,Business,11,5,38085,11,5,38272,11,5,38985,11,5,39266,11,5,39889,4,20.9,-1.3077869,36.8443207,-1.3004062,36.829741,523,623,187,994
11899,9799,3201,3,Business,30,4,60904,30,4,61032,30,4,61557,30,4,62161,30,4,64388,14,23.25888921888938,-1.207546,36.7913976,-1.2584143,36.8048002,7,2227,128,1129
11900,21148,868,3,Business,28,4,47041,28,4,47151,28,4,47729,28,4,48220,28,4,49347,8,28.2,-1.303596,36.778378,-1.265715,36.823815,341,1127,110,1069
11901,27965,393,3,Business,11,1,48279,11,1,48287,11,1,48291,11,1,50367,11,1,50369,11,27.9,-1.3167113,36.8301563,-1.2638185,36.7930057,619,2,8,2080
11902,23238,893,3,Business,16,2,46956,16,2,47047,16,2,47489,16,2,47583,16,2,48819,8,23.25888921888938,-1.2663194,36.809901,-1.2985153,36.7876043,394,1236,91,536
11903,8037,3755,1,Personal,16,3,41089,16,3,41687,16,3,42006,16,3,42315,16,3,43968,7,24.0,-1.2965005,36.7791835,-1.28249,36.8190983,756,1653,598,628
11904,12720,3391,1,Personal,5,5,66451,5,5,67478,5,5,68350,5,5,68462,5,5,69227,5,24.9,-1.2998789,36.8168963,-1.283016,36.8019595,365,765,1027,984
11905,10638,2457,3,Business,26,5,45518,26,5,46449,26,5,46805,26,5,47209,26,5,49194,9,23.25888921888938,-1.2551895,36.7822034,-1.2942,36.7777614,726,1985,931,760
11906,13867,2072,3,Personal,4,4,53989,4,4,54114,4,4,54880,4,4,55773,4,4,57557,4,24.6,-1.2586742,36.8016438,-1.2640571,36.7883547,802,1784,125,1659
11907,23451,868,3,Business,26,5,49895,26,5,49934,26,5,50418,26,5,51901,26,5,51910,3,23.25888921888938,-1.2783849,36.8163445,-1.265715,36.823815,907,9,39,1967
11908,15705,2956,3,Business,17,2,35742,17,2,35864,17,2,37218,17,2,39391,17,2,40439,7,19.0,-1.2885529,36.8160141,-1.2584143,36.8048002,714,1048,122,3527
11909,493,2150,3,Business,27,4,49144,27,4,49306,27,4,50106,27,4,51272,27,4,52245,12,23.9,-1.331619,36.847976,-1.344446,36.756597,533,973,162,1966
11910,27612,1469,3,Business,14,4,34596,14,4,37272,14,4,37300,14,4,37839,14,4,39394,7,17.8,-1.2551895,36.7822034,-1.2963492,36.8093377,268,1555,2676,567
11911,14237,302,3,Business,21,3,54683,21,3,54735,21,3,54851,21,3,55434,21,3,56318,7,23.2,-1.2649605,36.7981777,-1.2852954,36.7896362,446,884,52,699
11912,2604,1592,1,Personal,28,5,66869,28,5,66940,28,5,68001,28,5,69074,28,5,70194,7,23.25888921888938,-1.3207146,36.8305771,-1.3291155,36.8861,85,1120,71,2134
11913,26367,835,3,Business,4,4,40330,4,4,40526,4,4,42635,4,4,43061,4,4,44473,5,25.7,-1.2917868,36.7872675,-1.2867843,36.8134769,119,1412,196,2535
11914,1506,733,3,Business,29,1,50270,29,1,50294,29,1,50738,29,1,51895,29,1,53103,29,23.25888921888938,-1.2551895,36.7822034,-1.1728272,36.9575076,411,1208,24,1601
11915,2004,3470,3,Business,26,1,58902,26,1,59659,26,1,60423,26,1,60529,26,1,61741,2,20.0,-1.28878,36.8168312,-1.2905033,36.8096462,362,1212,757,870
11916,18793,704,1,Business,2,2,34240,2,2,34358,2,2,34932,2,2,35177,2,2,38405,11,15.2,-1.2831203,36.8316065,-1.2860183,36.8975338,81,3228,118,819
11917,23741,668,3,Business,11,1,42684,11,1,42724,11,1,44341,11,1,45373,11,1,46752,9,24.0,-1.2628638,36.8070399,-1.2326041,36.8009029,755,1379,40,2649
11918,24784,3560,3,Business,5,2,52482,5,2,52568,5,2,53673,5,2,54220,5,2,54578,1,27.3,-1.28878,36.8168312,-1.279395,36.825364,899,358,86,1652
11919,16661,1340,3,Business,20,3,36644,20,3,36872,20,3,37517,20,3,38274,20,3,39104,5,27.4,-1.2707179,36.7979713,-1.288036,36.827211,119,830,228,1402
11920,1979,510,3,Business,7,5,41000,7,5,41372,7,5,42780,7,5,43190,7,5,44722,13,25.3,-1.2860183,36.8975338,-1.3189252,36.8617269,408,1532,372,1818
11921,402,2829,3,Business,27,5,51063,27,5,51070,27,5,51188,27,5,51716,27,5,53855,20,24.2,-1.2571472,36.7950633,-1.3700383,36.9190174,415,2139,7,646
11922,2628,663,3,Business,15,6,50447,15,6,50473,15,6,50541,15,6,52579,15,6,53783,6,21.6,-1.2689785,36.8082713,-1.2705887,36.8292101,25,1204,26,2106
11923,11042,2789,3,Business,5,3,39262,5,3,39331,5,3,39945,5,3,40197,5,3,40927,6,22.5,-1.304735,36.7846054,-1.2902869,36.8085396,315,730,69,866
11924,20839,1141,3,Business,28,6,40471,28,6,40487,28,6,40761,28,6,40986,28,6,41893,6,24.2,-1.2877645,36.8378535,-1.2643994,36.812919,629,907,16,499
11925,25185,635,3,Business,13,6,39390,13,6,39467,13,6,39486,13,6,45460,13,6,47005,19,25.3,-1.300921,36.828195,-1.319613,36.711055,179,1545,77,5993
11926,5293,3404,3,Business,4,5,53660,4,5,59884,4,5,60874,4,5,61650,4,5,63726,11,21.5,-1.225322,36.80855,-1.279395,36.825364,489,2076,6224,1766
11927,4603,1107,2,Personal,13,5,54164,13,5,54181,13,5,54620,13,5,54812,13,5,56601,12,19.1,-1.2728058,36.8049903,-1.3232436,36.77993,629,1789,17,631
11928,3780,3222,3,Business,8,1,44655,8,1,44660,8,1,44672,8,1,45262,8,1,47562,22,24.7,-1.2551895,36.7822034,-1.3190102,36.9230693,120,2300,5,602
11929,17416,2112,3,Business,29,5,53716,29,5,57284,29,5,58341,29,5,59103,29,5,60460,5,21.1,-1.2156006,36.8916865,-1.206228,36.9174672,752,1357,3568,1819
11930,1971,2000,3,Business,4,1,37804,4,1,38136,4,1,38324,4,1,39472,4,1,40550,9,26.7,-1.2551895,36.7822034,-1.2697054,36.8519724,103,1078,332,1336
11931,20536,733,3,Business,22,3,40661,22,3,40827,22,3,41111,22,3,41347,22,3,42260,8,23.2,-1.2551895,36.7822034,-1.2937193,36.8236214,709,913,166,520
11932,10283,3586,3,Business,22,2,49140,22,2,49160,22,2,49590,22,2,50161,22,2,55746,9,25.6,-1.2869041,36.8240057,-1.275442,36.7660207,237,5585,20,1001
11933,4800,2330,3,Business,27,3,58836,27,3,59196,27,3,59972,27,3,60199,27,3,61608,9,27.7,-1.2124582,36.802894,-1.2637057,36.80517,547,1409,360,1003
11934,18339,1142,3,Personal,8,2,56379,8,2,56552,8,2,58294,8,2,58598,8,2,61129,8,25.2,-1.2775276,36.8140021,-1.3238573,36.8492744,48,2531,173,2046
11935,6157,3599,3,Business,30,4,45237,30,4,50580,30,4,52324,30,4,52857,30,4,54537,9,23.25888921888938,-1.3302996,36.8707935,-1.2872899,36.820434,944,1680,5343,2277
11936,3001,3647,3,Business,2,4,43930,2,4,44010,2,4,44641,2,4,45266,2,4,46833,9,23.25888921888938,-1.272639,36.794723,-1.3103512,36.814996,709,1567,80,1256
11937,11174,1245,3,Business,21,2,44463,21,2,44494,21,2,45295,21,2,46339,21,2,47811,17,22.6,-1.300921,36.828195,-1.3198615,36.7110323,676,1472,31,1845
11938,17629,811,3,Personal,3,4,39251,3,4,39356,3,4,39927,3,4,40818,3,4,41837,6,22.2,-1.3024794,36.8228284,-1.2963097,36.7688221,101,1019,105,1462
11939,27916,2777,3,Business,6,4,52794,6,4,55461,6,4,55512,6,4,55796,6,4,59081,7,23.25888921888938,-1.2820628,36.8253236,-1.2551895,36.7822034,351,3285,2667,335
11940,19393,1809,3,Business,4,3,37310,4,3,38054,4,3,38673,4,3,39364,4,3,41708,17,17.2,-1.3463042,36.768164,-1.2646084,36.8028645,914,2344,744,1310
11941,25927,18,1,Personal,22,6,52096,22,6,52112,22,6,52746,22,6,52919,22,6,53514,1,23.25888921888938,-1.2869313,36.7668487,-1.296684,36.770172,465,595,16,807
11942,10301,3283,3,Business,17,5,37660,17,5,37806,17,5,40096,17,5,41025,17,5,42068,7,17.8,-1.303596,36.778378,-1.2628473,36.781805,179,1043,146,3219
11943,18809,635,3,Business,15,5,35971,15,5,36178,15,5,36740,15,5,36887,15,5,38046,7,19.1,-1.2602337,36.7990548,-1.3081376,36.8329772,291,1159,207,709
11944,4887,2412,3,Business,17,3,50454,17,3,50588,17,3,51449,17,3,51656,17,3,53324,10,23.25888921888938,-1.2765736,36.8513646,-1.2283403,36.8822756,204,1668,134,1068
11945,21977,1502,3,Business,5,2,40345,5,2,40392,5,2,43980,5,2,44303,5,2,45261,11,25.5,-1.2765736,36.8513646,-1.2232123,36.8932547,550,958,47,3911
11946,23477,2956,3,Business,6,6,32760,6,6,32768,6,6,35990,6,6,37025,6,6,41465,20,19.7,-1.2860183,36.8975338,-1.2584143,36.8048002,223,4440,8,4257
11947,25627,302,3,Business,13,3,45291,13,3,45577,13,3,46277,13,3,46704,13,3,47816,8,23.25888921888938,-1.2649605,36.7981777,-1.3121752,36.8083282,119,1112,286,1127
11948,12382,921,3,Personal,1,5,52501,1,5,52710,1,5,53182,1,5,53349,1,5,55438,7,31.8,-1.3144104,36.8462411,-1.2903067,36.8151026,283,2089,209,639
11949,19359,3391,1,Personal,27,4,43543,27,4,43600,27,4,44708,27,4,46215,27,4,47983,5,23.0,-1.2998789,36.8168963,-1.283016,36.8019595,87,1768,57,2615
11950,19417,3686,3,Business,9,4,56961,9,4,58050,9,4,58187,9,4,59566,9,4,60707,11,23.25888921888938,-1.2551895,36.7822034,-1.2529484,36.8651347,291,1141,1089,1516
11951,26277,136,3,Business,4,2,37956,4,2,38311,4,2,39883,4,2,40952,4,2,41615,6,20.7,-1.3376931,36.7512668,-1.3254522,36.7216584,204,663,355,2641
11952,7431,892,2,Personal,29,5,57548,29,5,58510,29,5,59941,29,5,60132,29,5,61748,9,20.5,-1.306735,36.8256226,-1.2606445,36.8185586,549,1616,962,1622
11953,19334,2816,1,Personal,11,4,45184,11,4,45212,11,4,46255,11,4,46539,11,4,47082,7,23.8,-1.2916556,36.8262516,-1.3288576,36.8465936,662,543,28,1327
11954,2780,2195,3,Business,17,5,36358,17,5,36545,17,5,37107,17,5,37644,17,5,38845,9,23.25888921888938,-1.265715,36.823815,-1.228911,36.881876,660,1201,187,1099
11955,6000,1787,3,Business,9,4,36821,9,4,37311,9,4,39057,9,4,39210,9,4,40103,6,23.25888921888938,-1.2283403,36.8822756,-1.2255337,36.8371306,930,893,490,1899
11956,24727,302,3,Business,10,7,50266,10,7,50290,10,7,50822,10,7,51158,10,7,52428,8,23.25888921888938,-1.2649605,36.7981777,-1.307376,36.813404,761,1270,24,868
11957,8750,627,3,Business,29,5,47746,29,5,48021,29,5,49542,29,5,50163,29,5,52413,6,21.1,-1.2579304,36.8019667,-1.3001813,36.811122,326,2250,275,2142
11958,5828,3283,3,Business,22,5,55554,22,5,55662,22,5,56344,22,5,56838,22,5,59121,10,27.5,-1.307143,36.825009,-1.2628473,36.781805,605,2283,108,1176
11959,2071,2330,3,Business,12,4,54089,12,4,54202,12,4,57332,12,4,58505,12,4,59088,4,21.8,-1.2243841,36.8024757,-1.2465253,36.8162559,951,583,113,4303
11960,656,3222,3,Business,22,3,56162,22,3,56543,22,3,56576,22,3,58278,22,3,58284,7,24.3,-1.2551895,36.7822034,-1.289498,36.818878,843,6,381,1735
11961,19699,1500,3,Business,3,4,57471,3,4,57485,3,4,57492,3,4,57632,3,4,59362,22,26.2,-1.2574219,36.7927073,-1.1930572,36.9348901,523,1730,14,147
11962,5096,217,3,Personal,6,3,34210,6,3,34357,6,3,36086,6,3,36510,6,3,37902,6,16.0,-1.2950041,36.8143583,-1.2825581,36.7775416,105,1392,147,2153
11963,21651,3727,3,Business,11,2,51047,11,2,51116,11,2,51172,11,2,51817,11,2,52765,8,22.2,-1.2963097,36.7688221,-1.2600616,36.7870182,375,948,69,701
11964,7978,265,3,Business,10,3,58918,10,3,59206,10,3,60704,10,3,61191,10,3,63447,7,27.3,-1.300921,36.828195,-1.2721466,36.8155359,76,2256,288,1985
11965,13400,1500,3,Business,9,2,36968,9,2,37016,9,2,37223,9,2,39224,9,2,39231,8,27.1,-1.3004062,36.829741,-1.2638185,36.7930057,507,7,48,2208
11966,14462,635,3,Business,28,3,57210,28,3,58573,28,3,59014,28,3,60247,28,3,61400,6,23.3,-1.3016417,36.8271679,-1.3229345,36.8566974,675,1153,1363,1674
11967,20166,2521,3,Business,9,6,38981,9,6,39005,9,6,39375,9,6,40083,9,6,41787,8,27.1,-1.3167113,36.8301563,-1.2770708,36.8231093,349,1704,24,1078
11968,16046,2627,3,Business,2,3,40854,2,3,40875,2,3,41249,2,3,41376,2,3,42389,5,22.2,-1.2646084,36.8028645,-1.2857548,36.819062,264,1013,21,501
11969,8942,1237,3,Personal,23,3,38519,23,3,38538,23,3,38919,23,3,39159,23,3,40434,5,21.9,-1.2741728,36.7969108,-1.279767,36.7695313,543,1275,19,621
11970,15721,3426,3,Business,4,1,48909,4,1,49300,4,1,50270,4,1,51898,4,1,52970,9,28.4,-1.290894,36.822971,-1.3012008,36.764868,124,1072,391,2598
11971,13695,1207,3,Business,16,3,44737,16,3,44795,16,3,45021,16,3,45375,16,3,47104,19,22.8,-1.2648363,36.8023754,-1.317461,36.707031,634,1729,58,580
11972,26934,3080,3,Business,30,1,39543,30,1,39609,30,1,40224,30,1,41049,30,1,42165,8,22.4,-1.3052491,36.8223899,-1.2551895,36.7822034,19,1116,66,1440
11973,5512,944,1,Personal,26,4,41166,26,4,41297,26,4,43287,26,4,43510,26,4,44713,5,18.9,-1.255597,36.830024,-1.2731241,36.7992818,849,1203,131,2213
11974,9574,3201,3,Business,7,4,54839,7,4,54851,7,4,55196,7,4,55999,7,4,57234,14,27.7,-1.207546,36.7913976,-1.2584143,36.8048002,52,1235,12,1148
11975,14314,3355,3,Business,23,4,55035,23,4,55268,23,4,56133,23,4,59375,23,4,61261,10,20.6,-1.3472066,36.7692638,-1.3052491,36.8223899,882,1886,233,4107
11976,10,491,1,Personal,24,5,41966,24,5,42055,24,5,42502,24,5,43023,24,5,43796,4,20.8,-1.29387,36.7907813,-1.2808482,36.8003686,865,773,89,968
11977,9666,111,3,Business,17,3,44352,17,3,44825,17,3,44914,17,3,45262,17,3,46325,8,25.2,-1.2551895,36.7822034,-1.2521881,36.7537237,208,1063,473,437
11978,1679,2010,2,Personal,10,1,37012,10,1,37147,10,1,38374,10,1,39076,10,1,39991,6,23.25888921888938,-1.2820581,36.8284909,-1.3173869,36.8112044,88,915,135,1929
11979,10076,2987,3,Business,28,2,45776,28,2,45786,28,2,45792,28,2,46433,28,2,47207,10,17.6,-1.270212,36.8210877,-1.2297202,36.8819507,397,774,10,647
11980,22635,3647,3,Business,17,4,50523,17,4,50558,17,4,50700,17,4,52724,17,4,55526,28,27.9,-1.272639,36.794723,-1.138784,36.970811,741,2802,35,2166
11981,15574,2200,3,Business,7,2,51027,7,2,51372,7,2,52350,7,2,53880,7,2,54691,7,23.25888921888938,-1.290894,36.822971,-1.2551895,36.7822034,448,811,345,2508
11982,4961,3496,3,Business,10,5,39892,10,5,39900,10,5,39913,10,5,41992,10,5,43265,16,19.4,-1.3190102,36.9230693,-1.300921,36.828195,813,1273,8,2092
11983,26890,635,3,Business,9,3,34206,9,3,39150,9,3,39246,9,3,39803,9,3,40243,4,21.1,-1.2788381,36.8140116,-1.2602337,36.7990548,100,440,4944,653
11984,2670,425,1,Personal,9,6,56206,9,6,56700,9,6,57961,9,6,58605,9,6,60041,18,19.4,-1.3581253,36.7444904,-1.3238699,36.8488766,852,1436,494,1905
11985,14286,867,3,Business,8,2,37756,8,2,37802,8,2,37923,8,2,39379,8,2,40466,9,21.6,-1.2569006,36.7925141,-1.306378,36.7519845,345,1087,46,1577
11986,27956,1280,3,Business,7,4,27493,7,4,27541,7,4,28295,7,4,28547,7,4,31218,18,23.25888921888938,-1.2551895,36.7822034,-1.3343129,36.8854175,523,2671,48,1006
11987,17177,393,3,Business,30,5,50134,30,5,50964,30,5,51559,30,5,51742,30,5,53552,14,24.8,-1.3177547,36.8303703,-1.306378,36.7519845,663,1810,830,778
11988,2742,286,3,Business,30,5,54474,30,5,55033,30,5,56591,30,5,56930,30,5,60378,8,24.4,-1.2551895,36.7822034,-1.2899197,36.8191269,436,3448,559,1897
11989,3038,2330,3,Business,26,2,34295,26,2,34320,26,2,34665,26,2,34914,26,2,35229,3,23.25888921888938,-1.3015197,36.7658456,-1.2873232,36.7658572,327,315,25,594
11990,17423,3487,3,Business,27,6,37976,27,6,38139,27,6,39073,27,6,40224,27,6,43189,5,23.25888921888938,-1.2527958,36.8003131,-1.279395,36.825364,3,2965,163,2085
11991,3216,868,3,Business,18,4,43501,18,4,43699,18,4,43734,18,4,44437,18,4,46968,17,23.25888921888938,-1.3181159,36.7101559,-1.265715,36.823815,548,2531,198,738
11992,3726,1500,3,Business,29,4,47182,29,4,50199,29,4,50796,29,4,52261,29,4,53736,8,24.6,-1.3004062,36.829741,-1.2574219,36.7927073,345,1475,3017,2062
11993,4020,1271,3,Business,15,5,36854,15,5,36870,15,5,38028,15,5,39619,15,5,41035,24,26.1,-1.3244885,36.897792,-1.3107918,36.761794,675,1416,16,2749
11994,25523,246,3,Business,11,1,45113,11,1,45133,11,1,47080,11,1,47457,11,1,47787,2,18.2,-1.2601709,36.8002238,-1.2584143,36.8048002,100,330,20,2324
11995,9172,1746,3,Business,6,1,63190,6,1,63206,6,1,64229,6,1,64643,6,1,65189,4,22.3,-1.3092046,36.7458722,-1.296797,36.7764525,541,546,16,1437
11996,5342,3107,3,Business,4,1,40676,4,1,40690,4,1,40967,4,1,41660,4,1,42770,11,21.0,-1.3059346,36.8349339,-1.3277669,36.8975169,852,1110,14,970
11997,7613,2174,3,Business,24,5,38128,24,5,38128,24,5,38152,24,5,41819,24,5,43843,6,21.4,-1.2482781,36.884092,-1.2643042,36.8424251,86,2024,0,3691
11998,10247,3150,3,Business,25,5,53706,25,5,53944,25,5,54808,25,5,55186,25,5,56604,6,23.6,-1.2508229,36.7895263,-1.2848489,36.825009,116,1418,238,1242
11999,15754,2921,1,Personal,18,2,46486,18,2,46536,18,2,47119,18,2,47296,18,2,48282,4,22.8,-1.2766664,36.818441,-1.3012173,36.8093987,21,986,50,760
12000,17597,3689,3,Business,6,1,41158,6,1,41206,6,1,41720,6,1,42040,6,1,43125,8,20.3,-1.2765736,36.8513646,-1.2527958,36.8003131,174,1085,48,834
12001,26421,928,3,Business,19,2,54948,19,2,55018,19,2,55928,19,2,56142,19,2,56843,5,29.4,-1.2551895,36.7822034,-1.2657199,36.7914391,456,701,70,1124
12002,12954,3251,3,Business,8,3,48040,8,3,48199,8,3,49519,8,3,50061,8,3,52167,6,26.0,-1.2478668,36.8069224,-1.2833534,36.8165865,88,2106,159,1862
12003,6609,733,3,Business,12,5,64192,12,5,64720,12,5,64746,12,5,65159,12,5,66345,8,26.4,-1.2551895,36.7822034,-1.2977387,36.8031447,674,1186,528,439
12004,19077,1578,3,Business,30,2,48253,30,2,48376,30,2,50430,30,2,50712,30,2,52324,17,27.6,-1.28878,36.8168312,-1.3632162,36.9108253,532,1612,123,2336
12005,6207,570,3,Business,14,1,36084,14,1,36124,14,1,36296,14,1,36515,14,1,37491,2,18.6,-1.255956,36.789867,-1.263483,36.8005343,798,976,40,391
12006,404,758,3,Business,22,5,40298,22,5,40400,22,5,40999,22,5,41173,22,5,45048,14,28.6,-1.2917868,36.7872675,-1.3194518,36.869396,32,3875,102,773
12007,26566,1207,3,Business,4,2,35998,4,2,36018,4,2,37345,4,2,37867,4,2,41213,18,16.3,-1.317461,36.707031,-1.2629666,36.8068369,789,3346,20,1849
12008,18078,1694,2,Personal,31,4,34918,31,4,34935,31,4,35114,31,4,35930,31,4,37846,12,17.6,-1.2595467,36.8113044,-1.3186522,36.7699884,103,1916,17,995
12009,18648,3487,3,Business,12,3,60876,12,3,60961,12,3,61484,12,3,61731,12,3,62121,1,20.5,-1.28878,36.8168312,-1.279395,36.825364,36,390,85,770
12010,9060,3698,3,Business,23,4,43253,23,4,43313,23,4,43690,23,4,44847,23,4,47186,22,23.2,-1.3107918,36.761794,-1.3244885,36.897792,709,2339,60,1534
12011,14070,909,3,Business,21,4,48840,21,4,49036,21,4,50447,21,4,50669,21,4,52808,10,26.5,-1.225322,36.80855,-1.2885315,36.8230419,452,2139,196,1633
12012,19960,3647,3,Business,7,3,57556,7,3,57659,7,3,58474,7,3,58730,7,3,59474,7,28.3,-1.272639,36.794723,-1.3014461,36.7661381,279,744,103,1071
12013,13965,3101,1,Personal,12,3,24801,12,3,25020,12,3,26611,12,3,26871,12,3,29107,4,14.3,-1.3061448,36.7978023,-1.2973949,36.816038,328,2236,219,1851
12014,6153,2112,3,Business,3,4,56897,3,4,57296,3,4,57316,3,4,58277,3,4,59951,15,26.0,-1.3277669,36.8975169,-1.2156006,36.8916865,31,1674,399,981
12015,20600,2930,1,Personal,20,4,52003,20,4,52081,20,4,54184,20,4,55168,20,4,57608,9,28.2,-1.2242979,36.7647642,-1.2261184,36.8094779,810,2440,78,3087
12016,19795,393,3,Business,2,4,48951,2,4,48964,2,4,50886,2,4,53342,2,4,53354,14,23.25888921888938,-1.3167113,36.8301563,-1.2991441,36.7528804,349,12,13,4378
12017,4380,3149,3,Business,30,5,53970,30,5,56747,30,5,56748,30,5,58222,30,5,60483,15,24.8,-1.2991441,36.7528804,-1.3177547,36.8303703,848,2261,2777,1475
12018,17185,1620,1,Personal,9,2,45116,9,2,45130,9,2,46469,9,2,46698,9,2,48117,10,22.1,-1.2871215,36.822053,-1.227132,36.8374277,622,1419,14,1568
12019,8177,3723,1,Personal,12,5,53424,12,5,53450,12,5,54360,12,5,54466,12,5,55577,8,27.2,-1.300722,36.816865,-1.2560455,36.7800867,751,1111,26,1016
12020,19267,246,3,Business,5,3,37201,5,3,37214,5,3,37697,5,3,38064,5,3,38455,2,22.5,-1.2527958,36.8003131,-1.2584143,36.8048002,289,391,13,850
12021,28241,2400,2,Personal,21,1,47008,21,1,47092,21,1,47683,21,1,47830,21,1,48343,5,19.9,-1.280951,36.7990799,-1.2887345,36.8225613,441,513,84,738
12022,14787,3008,1,Personal,9,1,34111,9,1,34135,9,1,34562,9,1,35097,9,1,38238,16,15.3,-1.2882968,36.7768414,-1.3124922,36.8804974,228,3141,24,962
12023,19467,2457,3,Business,12,2,48558,12,2,48603,12,2,48723,12,2,48826,12,2,49719,8,27.1,-1.2551895,36.7822034,-1.2862436,36.791017,434,893,45,223
12024,16186,3647,3,Business,1,1,44608,1,1,44674,1,1,45953,1,1,46070,1,1,47569,5,23.25888921888938,-1.272639,36.794723,-1.2567464,36.7915273,168,1499,66,1396
12025,14952,706,3,Business,7,3,40864,7,3,41009,7,3,42087,7,3,43132,7,3,44000,5,24.9,-1.32671,36.8600138,-1.3077869,36.8443207,559,868,145,2123
12026,20103,3336,2,Personal,16,2,53533,16,2,53648,16,2,54370,16,2,54916,16,2,55563,5,27.5,-1.2800617,36.7883831,-1.2959769,36.7853374,299,647,115,1268
12027,16620,928,3,Business,10,5,45227,10,5,45713,10,5,48328,10,5,49515,10,5,50370,6,23.25888921888938,-1.2551895,36.7822034,-1.2897368,36.8226783,436,855,486,3802
12028,1904,1209,3,Business,24,3,58733,24,3,58755,24,3,59260,24,3,59681,24,3,61085,12,23.25888921888938,-1.2991441,36.7528804,-1.3004062,36.829741,438,1404,22,926
12029,14756,552,3,Business,7,1,42546,7,1,42620,7,1,43589,7,1,43768,7,1,47952,14,25.0,-1.2852569,36.8976121,-1.3562374,36.9042954,831,4184,74,1148
12030,7754,325,3,Business,29,2,35711,29,2,35726,29,2,36074,29,2,36503,29,2,36982,3,16.4,-1.2632355,36.7796905,-1.2553615,36.7895376,103,479,15,777
12031,22530,3405,2,Personal,12,5,66520,12,5,66537,12,5,67163,12,5,67472,12,5,69698,15,25.8,-1.2709086,36.7929516,-1.1992502,36.8294932,105,2226,17,935
12032,8310,1013,1,Personal,8,1,36744,8,1,37557,8,1,38349,8,1,38548,8,1,39759,8,24.5,-1.2915472,36.7746964,-1.3173869,36.8112044,288,1211,813,991
12033,2218,540,3,Business,21,5,62104,21,5,62449,21,5,63227,21,5,63322,21,5,64101,4,23.1,-1.2551895,36.7822034,-1.2753109,36.8130185,108,779,345,873
12034,21826,98,3,Personal,14,4,33804,14,4,33974,14,4,35116,14,4,35282,14,4,36135,8,15.5,-1.2560222,36.7886679,-1.22606,36.80039,726,853,170,1308
12035,7466,3661,3,Business,16,2,34836,16,2,34848,16,2,37596,16,2,37705,16,2,39799,15,23.25888921888938,-1.2132866,36.8678274,-1.3090727,36.8315262,266,2094,12,2857
12036,23887,2987,1,Business,12,4,55087,12,4,55292,12,4,57673,12,4,58183,12,4,58855,4,21.6,-1.270212,36.8210877,-1.2649605,36.7981777,427,672,205,2891
12037,14768,1450,3,Personal,7,5,55037,7,5,55194,7,5,55924,7,5,56288,7,5,58798,13,23.25888921888938,-1.2583017,36.8023526,-1.3108386,36.7555239,161,2510,157,1094
12038,12057,807,2,Personal,20,3,52670,20,3,52705,20,3,53594,20,3,54316,20,3,55407,7,23.4,-1.312643,36.8032671,-1.2891064,36.7743692,101,1091,35,1611
12039,8110,53,3,Business,14,5,55965,14,5,56452,14,5,56839,14,5,56960,14,5,58001,8,22.8,-1.2831137,36.8197134,-1.3167113,36.8301563,89,1041,487,508
12040,3316,3080,3,Business,7,4,39518,7,4,39531,7,4,40630,7,4,41055,7,4,45172,15,27.6,-1.2551895,36.7822034,-1.3231725,36.8640177,118,4117,13,1524
12041,13899,3517,3,Business,30,6,40676,30,6,40686,30,6,40764,30,6,40825,30,6,42123,8,26.6,-1.3882008,36.7699445,-1.4139362,36.7059881,716,1298,10,139
12042,27971,3689,3,Business,20,4,58207,20,4,59325,20,4,59876,20,4,60455,20,4,61871,10,22.7,-1.3014461,36.7661381,-1.2527958,36.8003131,845,1416,1118,1130
12043,22631,391,3,Business,26,5,48530,26,5,48766,26,5,49174,26,5,51481,26,5,54562,8,23.25888921888938,-1.2867454,36.8259017,-1.2935549,36.7703935,800,3081,236,2715
12044,12501,3517,3,Business,4,6,36666,4,6,36676,4,6,37224,4,6,37301,4,6,40239,16,23.25888921888938,-1.300921,36.828195,-1.3882008,36.7699445,614,2938,10,625
12045,14252,2112,3,Business,28,4,45700,28,4,45744,28,4,46523,28,4,47178,28,4,48902,5,23.5,-1.2285835,36.8826468,-1.2156006,36.8916865,75,1724,44,1434
12046,18781,1146,3,Business,15,5,34254,15,5,34550,15,5,34558,15,5,35898,15,5,36389,5,20.3,-1.3004062,36.829741,-1.3083266,36.8494756,10,491,296,1348
12047,11651,391,3,Business,1,4,56787,1,4,57037,1,4,57816,1,4,58986,1,4,61935,18,23.25888921888938,-1.2857574,36.8295667,-1.3878505,36.7692885,942,2949,250,1949
12048,28021,393,3,Business,26,5,53842,26,5,53888,26,5,53902,26,5,54820,26,5,57585,14,23.25888921888938,-1.3167113,36.8301563,-1.2991441,36.7528804,349,2765,46,932
12049,25996,1059,1,Personal,12,2,34906,12,2,35366,12,2,36918,12,2,37285,12,2,38701,11,16.0,-1.296567,36.7813901,-1.3303649,36.7260187,808,1416,460,1919
12050,26849,3727,3,Business,6,4,55781,6,4,55809,6,4,56607,6,4,56757,6,4,57631,6,21.1,-1.2963097,36.7688221,-1.2825816,36.8092346,404,874,28,948
12051,718,1891,3,Business,29,2,38630,29,2,38685,29,2,39009,29,2,39171,29,2,40333,6,23.4,-1.2606981,36.8088627,-1.2506462,36.846258,72,1162,55,486
12052,24197,1075,3,Business,3,5,43109,3,5,43139,3,5,43358,3,5,43732,3,5,44083,3,23.25888921888938,-1.2527958,36.8003131,-1.2551895,36.7822034,484,351,30,593
12053,21594,2066,3,Business,29,3,48396,29,3,48421,29,3,48807,29,3,50312,29,3,51701,10,18.9,-1.316961,36.820337,-1.2551895,36.7822034,229,1389,25,1891
12054,9476,393,3,Business,11,4,39020,11,4,39033,11,4,39443,11,4,40572,11,4,41168,4,25.6,-1.3167113,36.8301563,-1.3004062,36.829741,177,596,13,1539
12055,16802,635,3,Business,28,4,50463,28,4,50480,28,4,50763,28,4,51732,28,4,53908,14,27.5,-1.3081376,36.8329772,-1.2171852,36.8145508,519,2176,17,1252
12056,1073,3621,3,Business,4,4,43507,4,4,43539,4,4,44245,4,4,44495,4,4,46343,22,25.6,-1.2836583,36.7886014,-1.1926735,36.9311812,299,1848,32,956
12057,12568,2412,3,Business,26,5,55563,26,5,55607,26,5,55708,26,5,56844,26,5,59152,18,23.25888921888938,-1.3014461,36.7661381,-1.2283403,36.8822756,855,2308,44,1237
12058,68,2987,3,Business,6,2,49595,6,2,50552,6,2,51708,6,2,51852,6,2,56161,13,27.3,-1.270212,36.8210877,-1.2927792,36.9053492,920,4309,957,1300
12059,25193,3689,3,Business,23,4,38096,23,4,38138,23,4,41358,23,4,41751,23,4,43613,14,23.3,-1.225322,36.80855,-1.1720874,36.8219039,362,1862,42,3613
12060,6268,1271,3,Business,2,4,54240,2,4,54260,2,4,56692,2,4,57199,2,4,59026,20,26.2,-1.3244885,36.897792,-1.284752,36.7748784,886,1827,20,2939
12061,9389,3420,3,Business,19,2,32422,19,2,34076,19,2,34466,19,2,34634,19,2,35554,6,15.5,-1.3046007,36.8211743,-1.32573,36.801356,208,920,1654,558
12062,11303,2767,3,Business,6,2,46840,6,2,46891,6,2,46989,6,2,47216,6,2,47972,9,24.8,-1.257773,36.795486,-1.2295075,36.8016971,107,756,51,325
12063,23954,706,3,Business,19,3,57575,19,3,57630,19,3,58233,19,3,58772,19,3,59256,4,25.6,-1.3004062,36.829741,-1.3077869,36.8443207,632,484,55,1142
12064,5774,3426,3,Business,11,7,42048,11,7,43142,11,7,43830,11,7,45834,11,7,48306,9,25.0,-1.290894,36.822971,-1.3014461,36.7661381,303,2472,1094,2692
12065,4866,3426,3,Business,31,3,35159,31,3,35446,31,3,36173,31,3,36277,31,3,40090,10,19.3,-1.3025826,36.7670807,-1.2517841,36.8013388,596,3813,287,831
12066,25514,3517,3,Business,30,2,35850,30,2,36138,30,2,38285,30,2,39919,30,2,42264,16,23.25888921888938,-1.300921,36.828195,-1.3882008,36.7699445,787,2345,288,3781
12067,20829,114,1,Personal,3,3,49045,3,3,49151,3,3,51269,3,3,54343,3,3,56778,10,26.9,-1.3025826,36.7670807,-1.307241,36.8302368,565,2435,106,5192
12068,9127,3370,3,Business,7,2,40940,7,2,40973,7,2,40986,7,2,41605,7,2,41958,3,23.0,-1.2527958,36.8003131,-1.2615888,36.7928732,51,353,33,632
12069,25094,265,3,Business,21,3,60569,21,3,61554,21,3,61956,21,3,62370,21,3,63233,5,23.25888921888938,-1.300921,36.828195,-1.3042113,36.8683022,669,863,985,816
12070,22815,53,3,Business,15,6,34906,15,6,35009,15,6,35416,15,6,37569,15,6,38960,11,16.7,-1.2991441,36.7528804,-1.2770708,36.8231093,161,1391,103,2560
12071,15180,733,3,Business,6,2,44470,6,2,44482,6,2,45372,6,2,45668,6,2,46872,15,25.2,-1.2551895,36.7822034,-1.2232396,36.8933215,79,1204,12,1186
12072,26722,2523,3,Business,12,2,45294,12,2,45597,12,2,46862,12,2,47030,12,2,48672,12,20.8,-1.2551895,36.7822034,-1.3083777,36.8590077,752,1642,303,1433
12073,15555,1363,3,Business,26,2,51417,26,2,51553,26,2,51763,26,2,53557,26,2,55691,6,30.9,-1.3004062,36.829741,-1.2714767,36.8138291,349,2134,136,2004
12074,22871,3647,3,Business,9,3,36912,9,3,36927,9,3,37267,9,3,37622,9,3,37731,4,20.4,-1.272639,36.794723,-1.2651643,36.8072214,829,109,15,695
12075,22788,2801,3,Business,4,4,45285,4,4,45445,4,4,45842,4,4,46483,4,4,48565,11,25.7,-1.2674274,36.7870827,-1.307726,36.839117,126,2082,160,1038
12076,11215,2237,3,Business,13,2,53120,13,2,53133,13,2,53728,13,2,54022,13,2,55859,15,26.0,-1.266571,36.801406,-1.2036664,36.8192622,902,1837,13,889
12077,15779,1075,3,Business,24,1,45622,24,1,45641,24,1,45834,24,1,46083,24,1,46572,1,22.9,-1.2649605,36.7981777,-1.2527958,36.8003131,79,489,19,442
12078,12749,872,3,Business,4,1,39006,4,1,39030,4,1,40418,4,1,40488,4,1,43101,22,25.6,-1.2798369,36.7752995,-1.1671865,36.8260738,269,2613,24,1458
12079,11576,1217,3,Personal,14,1,30064,14,1,30095,14,1,30389,14,1,30933,14,1,32021,12,18.8,-1.2886685,36.8297138,-1.2251345,36.8835216,940,1088,31,838
12080,19675,2982,3,Business,1,1,39989,1,1,40035,1,1,40205,1,1,41926,1,1,44015,18,23.25888921888938,-1.300921,36.828195,-1.177202,36.8351183,297,2089,46,1891
12081,6642,478,3,Business,30,2,53149,30,2,55008,30,2,55166,30,2,55784,30,2,57107,3,23.25888921888938,-1.2551895,36.7822034,-1.2640571,36.7883547,535,1323,1859,776
12082,28159,2330,3,Business,21,4,51649,21,4,51667,21,4,52460,21,4,53493,21,4,54759,6,26.4,-1.2642903,36.8002137,-1.2641888,36.7603984,795,1266,18,1826
12083,20129,2132,3,Business,3,4,43537,3,4,43547,3,4,43866,3,4,44514,3,4,46357,13,23.5,-1.2384056,36.8718698,-1.3108783,36.8392726,237,1843,10,967
12084,6895,1424,3,Business,18,4,51584,18,4,51613,18,4,51725,18,4,52012,18,4,52390,2,23.25888921888938,-1.30157,36.7871,-1.2990349,36.8030545,132,378,29,399
12085,4129,1927,3,Business,7,4,31195,7,4,31233,7,4,31534,7,4,32274,7,4,35082,15,23.25888921888938,-1.2584143,36.8048002,-1.3472066,36.7692638,131,2808,38,1041
12086,21420,706,3,Business,14,1,38693,14,1,38726,14,1,39133,14,1,39258,14,1,39644,3,23.5,-1.3077869,36.8443207,-1.3080092,36.8284543,589,386,33,532
12087,6147,2658,3,Business,10,5,57620,10,5,58195,10,5,62765,10,5,63329,10,5,64907,7,23.25888921888938,-1.2924639,36.7795798,-1.2813012,36.8323962,843,1578,575,5134
12088,11543,3517,3,Business,11,5,33157,11,5,33214,11,5,33765,11,5,35267,11,5,36888,15,20.9,-1.300921,36.828195,-1.3882008,36.7699445,136,1621,57,2053
12089,11431,186,3,Business,17,5,56206,17,5,56219,17,5,56247,17,5,56714,17,5,57996,5,23.25888921888938,-1.2825816,36.8092346,-1.2571472,36.7950633,564,1282,13,495
12090,27478,909,3,Business,25,4,61275,25,4,61326,25,4,61914,25,4,62175,25,4,64440,7,23.25888921888938,-1.2584143,36.8048002,-1.225322,36.80855,205,2265,51,849
12091,12693,3295,3,Business,13,4,32292,13,4,32326,13,4,33516,13,4,34401,13,4,35356,7,18.5,-1.2571472,36.7950633,-1.2965924,36.8179314,576,955,34,2075
12092,15546,3404,3,Business,12,2,32967,12,2,33160,12,2,34284,12,2,34965,12,2,37393,5,20.7,-1.279395,36.825364,-1.2571472,36.7950633,309,2428,193,1805
12093,20765,1425,3,Business,25,4,41260,25,4,41274,25,4,41597,25,4,41850,25,4,44523,12,23.25888921888938,-1.3004062,36.829741,-1.338283,36.8871775,223,2673,14,576
12094,26079,3599,3,Business,27,1,46036,27,1,46138,27,1,47456,27,1,50391,27,1,51604,13,23.0,-1.3302996,36.8707935,-1.3189908,36.777074,218,1213,102,4253
12095,713,635,3,Business,10,1,42140,10,1,46052,10,1,46350,10,1,48888,10,1,49965,6,18.6,-1.300921,36.828195,-1.3229345,36.8566974,661,1077,3912,2836
12096,1371,2587,3,Business,28,5,50853,28,5,51409,28,5,51903,28,5,52042,28,5,53226,5,25.3,-1.2584143,36.8048002,-1.28878,36.8168312,844,1184,556,633
12097,6116,59,3,Business,13,2,44029,13,2,44043,13,2,44264,13,2,44644,13,2,46489,14,22.4,-1.2232123,36.8932547,-1.290894,36.822971,447,1845,14,601
12098,18876,248,3,Business,5,4,51318,5,4,51329,5,4,51387,5,4,52294,5,4,53348,8,22.3,-1.304735,36.7846054,-1.2562249,36.7868661,101,1054,11,965
12099,7836,1346,3,Business,1,4,41151,1,4,41186,1,4,41220,1,4,41558,1,4,42138,2,23.25888921888938,-1.2917868,36.7872675,-1.2985749,36.8088,390,580,35,372
12100,17022,647,3,Business,13,4,43666,13,4,43685,13,4,44148,13,4,45196,13,4,45254,8,22.0,-1.3004062,36.829741,-1.2574219,36.7927073,70,58,19,1511
12101,12295,506,3,Business,26,2,41473,26,2,42474,26,2,44436,26,2,44631,26,2,48666,28,26.2,-1.3939049,36.7565199,-1.2321358,36.8727847,917,4035,1001,2157
12102,11267,1370,3,Personal,3,4,57799,3,4,57852,3,4,58719,3,4,58980,3,4,59463,1,24.8,-1.261692,36.80161,-1.2655144,36.8127377,290,483,53,1128
12103,12138,3689,3,Business,31,3,35918,31,3,35928,31,3,36265,31,3,37207,31,3,37680,3,19.2,-1.2527958,36.8003131,-1.2551895,36.7822034,216,473,10,1279
12104,21827,2258,3,Business,14,2,52047,14,2,52066,14,2,52195,14,2,55683,14,2,55692,2,24.1,-1.2571472,36.7950633,-1.263161,36.8059854,875,9,19,3617
12105,28214,3283,3,Business,27,1,47173,27,1,47230,27,1,47867,27,1,48671,27,1,49966,13,20.7,-1.331619,36.847976,-1.2628473,36.781805,16,1295,57,1441
12106,7951,2207,3,Business,2,5,40512,2,5,40658,2,5,40933,2,5,41744,2,5,44851,3,23.6,-1.2768326,36.8073804,-1.28164,36.816867,88,3107,146,1086
12107,14743,3331,3,Business,19,4,37795,19,4,39239,19,4,39429,19,4,39636,19,4,42523,18,20.4,-1.2551895,36.7822034,-1.353683,36.7611562,147,2887,1444,397
12108,4963,3078,1,Personal,10,3,36748,10,3,36781,10,3,36934,10,3,38080,10,3,39255,11,22.1,-1.2871164,36.7652395,-1.255597,36.830024,731,1175,33,1299
12109,10228,1288,1,Personal,28,1,41873,28,1,41894,28,1,41905,28,1,42204,28,1,44768,8,22.8,-1.2861765,36.8209086,-1.2586145,36.7782729,546,2564,21,310
12110,23506,186,3,Business,5,5,39782,5,5,40083,5,5,40997,5,5,41354,5,5,42298,6,24.6,-1.2825816,36.8092346,-1.2571472,36.7950633,576,944,301,1271
12111,10809,246,3,Business,11,1,65462,11,1,65485,11,1,65783,11,1,66010,11,1,67029,7,23.25888921888938,-1.2584143,36.8048002,-1.2765492,36.7669809,147,1019,23,525
12112,304,3419,3,Personal,14,5,46780,14,5,46792,14,5,47620,14,5,48986,14,5,50520,17,23.7,-1.215892,36.913345,-1.1768394,36.8401382,124,1534,12,2194
12113,23423,1222,3,Personal,15,1,38545,15,1,38558,15,1,38726,15,1,38981,15,1,39705,6,23.25888921888938,-1.2707179,36.7979713,-1.2969293,36.8027733,467,724,13,423
12114,24700,2587,3,Business,16,2,54800,16,2,54880,16,2,54900,16,2,56593,16,2,58589,8,23.25888921888938,-1.28878,36.8168312,-1.3322618,36.8045412,718,1996,80,1713
12115,2473,2008,3,Business,17,3,36814,17,3,36905,17,3,37896,17,3,38300,17,3,39585,6,23.25888921888938,-1.2508229,36.7895263,-1.2674404,36.8231651,422,1285,91,1395
12116,2040,1587,1,Personal,4,1,33386,4,1,33492,4,1,34085,4,1,34445,4,1,35705,6,17.8,-1.2684961,36.8141099,-1.3019025,36.7917843,752,1260,106,953
12117,17574,2552,3,Personal,13,3,34666,13,3,34733,13,3,35320,13,3,35611,13,3,36607,5,20.0,-1.3100609,36.8205365,-1.2962967,36.8020231,154,996,67,878
12118,3734,1456,3,Business,29,3,35837,29,3,35851,29,3,36207,29,3,36487,29,3,38855,16,17.9,-1.2584143,36.8048002,-1.2860183,36.8975338,660,2368,14,636
12119,4142,91,3,Personal,19,2,44978,19,2,45027,19,2,47166,19,2,47407,19,2,49118,4,27.4,-1.2775276,36.8140021,-1.2611523,36.8069229,484,1711,49,2380
12120,10706,2200,3,Business,26,5,47616,26,5,48167,26,5,50780,26,5,50902,26,5,54489,11,23.25888921888938,-1.2927792,36.9053492,-1.290894,36.822971,6,3587,551,2735
12121,11655,868,3,Business,26,4,45566,26,4,45882,26,4,46865,26,4,49262,26,4,50729,8,22.1,-1.303596,36.778378,-1.265715,36.823815,229,1467,316,3380
12122,12451,237,3,Business,7,3,41794,7,3,41915,7,3,42691,7,3,42994,7,3,44691,12,25.0,-1.2551895,36.7822034,-1.3181687,36.8373675,19,1697,121,1079
12123,4962,3641,3,Business,15,5,47434,15,5,47488,15,5,47656,15,5,48435,15,5,49388,6,26.1,-1.2551895,36.7822034,-1.2897368,36.8226783,85,953,54,947
12124,9056,302,3,Business,21,5,55904,21,5,55969,21,5,57014,21,5,57451,21,5,58620,4,24.8,-1.2649605,36.7981777,-1.2838297,36.8109232,685,1169,65,1482
12125,18464,733,3,Business,6,2,43371,6,2,43407,6,2,43478,6,2,44240,6,2,47500,20,25.1,-1.2551895,36.7822034,-1.3251247,36.8995926,648,3260,36,833
12126,19232,2828,1,Business,20,1,44318,20,1,44330,20,1,44412,20,1,45382,20,1,45850,3,20.3,-1.264272,36.7978791,-1.2615888,36.7928732,648,468,12,1052
12127,7138,2330,3,Business,14,4,60260,14,4,60377,14,4,61506,14,4,61812,14,4,64661,15,26.0,-1.2854537,36.9051024,-1.2291477,36.8440295,588,2849,117,1435
12128,2486,3201,3,Business,29,3,42676,29,3,42702,29,3,43238,29,3,44413,29,3,44415,1,23.25888921888938,-1.2571472,36.7950633,-1.2584143,36.8048002,424,2,26,1711
12129,24695,1500,3,Business,22,5,56232,22,5,56415,22,5,57082,22,5,59227,22,5,60289,8,31.2,-1.3004062,36.829741,-1.2638185,36.7930057,448,1062,183,2812
12130,5903,3295,3,Business,7,5,50502,7,5,50617,7,5,51108,7,5,51670,7,5,52608,6,23.25888921888938,-1.2571472,36.7950633,-1.2927403,36.8031436,407,938,115,1053
12131,11934,1205,3,Business,1,1,50464,1,1,50468,1,1,50833,1,1,51059,1,1,53265,22,25.6,-1.257309,36.8060084,-1.341891,36.761269,105,2206,4,591
12132,23390,3291,3,Business,13,4,37432,13,4,37462,13,4,37618,13,4,38089,13,4,38578,5,22.0,-1.2628473,36.781805,-1.2600926,36.8088685,564,489,30,627
12133,9656,265,3,Business,7,5,38711,7,5,38787,7,5,39499,7,5,39892,7,5,40413,3,25.1,-1.3207146,36.8305771,-1.300921,36.828195,685,521,76,1105
12134,20267,186,3,Business,25,4,37663,25,4,37763,25,4,38442,25,4,38537,25,4,40582,4,20.2,-1.2571472,36.7950633,-1.2890399,36.8164942,147,2045,100,774
12135,15925,1754,3,Business,2,4,49937,2,4,50175,2,4,50633,2,4,51383,2,4,53094,12,23.25888921888938,-1.279395,36.825364,-1.2860183,36.8975338,291,1711,238,1208
12136,14015,2112,3,Business,29,5,33913,29,5,35091,29,5,35204,29,5,37270,29,5,37716,13,23.25888921888938,-1.2156006,36.8916865,-1.2889576,36.8183358,886,446,1178,2179
12137,10336,517,3,Business,30,3,36720,30,3,37006,30,3,37914,30,3,38272,30,3,39879,12,24.9,-1.3167113,36.8301563,-1.2551895,36.7822034,523,1607,286,1266
12138,24293,117,1,Personal,30,1,33586,30,1,33645,30,1,34279,30,1,34808,30,1,35393,7,16.3,-1.2732869,36.832159,-1.2601,36.796528,174,585,59,1163
12139,13297,540,3,Business,15,5,54357,15,5,54407,15,5,55460,15,5,55521,15,5,56549,4,17.8,-1.2551895,36.7822034,-1.2753109,36.8130185,147,1028,50,1114
12140,2886,3621,3,Business,26,6,40567,26,6,40625,26,6,40949,26,6,41260,26,6,42208,5,26.2,-1.2836583,36.7886014,-1.2884243,36.8207248,317,948,58,635
12141,26577,1927,3,Business,8,6,43302,8,6,43305,8,6,43387,8,6,44225,8,6,45955,10,18.3,-1.3472066,36.7692638,-1.3052491,36.8223899,477,1730,3,920
12142,5817,393,3,Business,25,4,48880,25,4,50252,25,4,50989,25,4,51642,25,4,53692,10,20.9,-1.3177547,36.8303703,-1.2574219,36.7927073,761,2050,1372,1390
12143,28042,2195,3,Business,7,2,38335,7,2,42260,7,2,43628,7,2,44440,7,2,46129,17,23.25888921888938,-1.331619,36.847976,-1.228911,36.881876,675,1689,3925,2180
12144,12610,53,3,Business,13,4,34999,13,4,35052,13,4,35915,13,4,37381,13,4,38592,5,18.5,-1.3004062,36.829741,-1.2770708,36.8231093,76,1211,53,2329
12145,9005,1363,3,Business,20,3,58723,20,3,58758,20,3,58834,20,3,61004,20,3,61029,8,27.4,-1.3004062,36.829741,-1.2638185,36.7930057,619,25,35,2246
12146,11856,200,3,Personal,9,6,52467,9,6,52521,9,6,53351,9,6,53868,9,6,54380,3,30.1,-1.2971024,36.7836598,-1.2875012,36.7927159,801,512,54,1347
12147,26715,510,3,Business,24,7,42092,24,7,42655,24,7,43363,24,7,43902,24,7,45177,11,23.25888921888938,-1.2297202,36.8745508,-1.2860183,36.8975338,845,1275,563,1247
12148,6151,2100,3,Business,1,4,49222,1,4,50681,1,4,51541,1,4,51785,1,4,55000,9,23.25888921888938,-1.2860183,36.8975338,-1.2765736,36.8513646,230,3215,1459,1104
12149,497,2330,3,Business,20,3,33786,20,3,33806,20,3,34298,20,3,34550,20,3,35202,8,20.8,-1.3015197,36.7658456,-1.3192789,36.7112991,786,652,20,744
12150,17240,2358,4,Business,18,1,35444,18,1,35678,18,1,37287,18,1,37476,18,1,40112,7,15.0,-1.3256904,36.8747943,-1.290678,36.8829787,192,2636,234,1798
12151,5158,635,3,Business,19,6,42943,19,6,43016,19,6,43128,19,6,45756,19,6,49416,13,25.4,-1.2602337,36.7990548,-1.3288106,36.8697344,26,3660,73,2740
12152,8617,186,3,Business,15,4,40999,15,4,43636,15,4,44099,15,4,44250,15,4,47895,18,24.3,-1.3700383,36.9190174,-1.2902869,36.8085396,222,3645,2637,614
12153,2387,3521,3,Business,8,1,40234,8,1,40257,8,1,42148,8,1,43457,8,1,44269,7,28.0,-1.2524627,36.7772593,-1.2696908,36.81519,709,812,23,3200
12154,3463,393,3,Business,13,2,42665,13,2,43305,13,2,45712,13,2,46116,13,2,49387,10,22.3,-1.3177547,36.8303703,-1.2574219,36.7927073,518,3271,640,2811
12155,14085,3025,3,Business,14,3,53023,14,3,54930,14,3,57944,14,3,58118,14,3,59106,8,25.5,-1.292462,36.7972911,-1.255081,36.802335,612,988,1907,3188
12156,23074,733,3,Business,29,1,58061,29,1,58081,29,1,58285,29,1,58999,29,1,60685,10,24.5,-1.2551895,36.7822034,-1.312469,36.815177,208,1686,20,918
12157,5751,1746,3,Business,12,5,59264,12,5,60300,12,5,62635,12,5,64090,12,5,67499,19,26.4,-1.2701894,36.90246,-1.2975066,36.7689423,507,3409,1036,3790
12158,5337,2523,3,Business,13,4,56337,13,4,56523,13,4,57074,13,4,57140,13,4,58075,9,23.1,-1.2551895,36.7822034,-1.29387,36.7907813,409,935,186,617
12159,3799,2030,3,Business,18,2,50547,18,2,52465,18,2,52490,18,2,53939,18,2,54268,7,25.5,-1.2482465,36.8889062,-1.2156006,36.8916865,539,329,1918,1474
12160,17075,393,3,Business,26,2,49397,26,2,49407,26,2,49411,26,2,52222,26,2,52224,14,31.2,-1.3167113,36.8301563,-1.306378,36.7519845,515,2,10,2815
12161,28048,3625,1,Personal,29,5,37615,29,5,37882,29,5,39459,29,5,40031,29,5,41482,10,19.7,-1.2725144,36.8272178,-1.2994194,36.7647917,874,1451,267,2149
12162,26226,74,3,Business,12,3,47178,12,3,47302,12,3,48762,12,3,49322,12,3,51256,13,21.2,-1.2283403,36.8822756,-1.225322,36.80855,8,1934,124,2020
12163,7976,2200,3,Business,20,2,57505,20,2,60740,20,2,61646,20,2,62875,20,2,63525,2,24.0,-1.2885315,36.8230419,-1.290894,36.822971,583,650,3235,2135
12164,26793,533,3,Business,8,5,54658,8,5,54910,8,5,56025,8,5,57819,8,5,59173,7,30.2,-1.2571472,36.7950633,-1.2765492,36.7669809,327,1354,252,2909
12165,586,898,1,Personal,1,6,38782,1,6,38792,1,6,39429,1,6,42387,1,6,43350,11,18.6,-1.289498,36.818878,-1.3206958,36.8769553,449,963,10,3595
12166,2323,1453,1,Business,30,1,41987,30,1,41999,30,1,42525,30,1,43219,30,1,44396,7,22.4,-1.2628638,36.8070399,-1.2956882,36.7861845,320,1177,12,1220
12167,19207,1688,3,Business,7,3,48114,7,3,48132,7,3,48541,7,3,50773,7,3,53088,19,28.3,-1.300921,36.828195,-1.3916459,36.9305892,208,2315,18,2641
12168,5652,547,1,Personal,16,1,51644,16,1,54220,16,1,55161,16,1,55468,16,1,56687,5,22.4,-1.2795985,36.8233004,-1.2903421,36.7885282,616,1219,2576,1248
12169,12788,1773,1,Personal,5,6,43082,5,6,43128,5,6,43909,5,6,44207,5,6,46002,9,22.3,-1.3102508,36.8229978,-1.2444408,36.7934817,779,1795,46,1079
12170,24162,1761,3,Business,18,5,43610,18,5,43801,18,5,45403,18,5,45768,18,5,49670,14,21.4,-1.3688433,36.7402114,-1.3028223,36.7879534,543,3902,191,1967
12171,13520,3651,3,Business,31,5,28895,31,5,28915,31,5,29039,31,5,30018,31,5,31069,11,14.7,-1.2571472,36.7950633,-1.298784,36.8643814,179,1051,20,1103
12172,9024,1280,3,Business,9,3,61721,9,3,61777,9,3,63981,9,3,64129,9,3,66360,15,21.9,-1.2927792,36.9053492,-1.298988,36.81075,581,2231,56,2352
12173,21882,478,3,Business,3,3,42063,3,3,42120,3,3,42954,3,3,43052,3,3,45091,15,24.1,-1.2551895,36.7822034,-1.3216456,36.7145156,279,2039,57,932
12174,16145,3300,3,Business,13,1,38826,13,1,38877,13,1,40805,13,1,41959,13,1,43457,16,17.0,-1.228911,36.881876,-1.303596,36.778378,124,1498,51,3082
12175,7893,1146,3,Business,28,5,39121,28,5,39212,28,5,39216,28,5,39744,28,5,40382,6,23.8,-1.3167113,36.8301563,-1.3012842,36.8561033,619,638,91,532
12176,3017,2066,3,Business,30,4,44449,30,4,44514,30,4,45146,30,4,45391,30,4,46807,6,23.25888921888938,-1.3210189,36.8410551,-1.288285,36.815912,183,1416,65,877
12177,25239,1620,1,Personal,19,5,36439,19,5,36472,19,5,36713,19,5,38583,19,5,40111,13,25.1,-1.2686837,36.8891847,-1.227132,36.8374277,408,1528,33,2111
12178,25314,3147,3,Business,27,2,30611,27,2,34502,27,2,35615,27,2,35861,27,2,37656,17,18.9,-1.3472066,36.7692638,-1.2551895,36.7822034,71,1795,3891,1359
12179,2219,1927,3,Business,16,4,49504,16,4,49551,16,4,50415,16,4,50956,16,4,53383,17,23.25888921888938,-1.34364,36.8925345,-1.3472066,36.7692638,502,2427,47,1405
12180,17088,3701,3,Business,10,3,37316,10,3,37326,10,3,37836,10,3,37907,10,3,38644,6,22.0,-1.2612574,36.7879622,-1.2804664,36.7701111,541,737,10,581
12181,13829,2805,3,Business,14,1,49318,14,1,49371,14,1,50109,14,1,50641,14,1,52666,13,25.6,-1.2854406,36.789409,-1.3169591,36.7000029,801,2025,53,1270
12182,14345,2523,3,Business,6,4,50710,6,4,50780,6,4,51413,6,4,51810,6,4,53908,22,21.1,-1.2551895,36.7822034,-1.3190102,36.9230693,320,2098,70,1030
12183,18337,1410,3,Business,8,6,33539,8,6,33680,8,6,37140,8,6,38263,8,6,40405,20,18.2,-1.300921,36.828195,-1.2847613,36.967084,167,2142,141,4583
12184,3082,2956,3,Business,13,3,57579,13,3,58746,13,3,58758,13,3,62674,13,3,66972,6,26.1,-1.290894,36.822971,-1.2584143,36.8048002,86,4298,1167,3928
12185,8772,1038,1,Business,14,6,60048,14,6,60063,14,6,60389,14,6,60640,14,6,61475,6,19.0,-1.2962893,36.7708484,-1.3099145,36.8022774,465,835,15,577
12186,22202,3622,3,Personal,14,4,42963,14,4,43003,14,4,43243,14,4,44892,14,4,48308,7,24.8,-1.2882767,36.8201996,-1.271672,36.783604,845,3416,40,1889
12187,4635,733,3,Business,24,5,42450,24,5,43963,24,5,45216,24,5,45844,24,5,47241,7,21.5,-1.2551895,36.7822034,-1.2857241,36.8203481,490,1397,1513,1881
12188,13588,3278,2,Personal,17,3,58304,17,3,58359,17,3,58961,17,3,59814,17,3,60984,11,24.8,-1.3117439,36.8108257,-1.3141805,36.7397786,207,1170,55,1455
12189,7471,2423,3,Business,6,3,52966,6,3,53070,6,3,53452,6,3,57305,6,3,58150,6,27.5,-1.2571472,36.7950633,-1.2967702,36.8040381,178,845,104,4235
12190,22121,1580,2,Personal,20,6,60859,20,6,60903,20,6,60962,20,6,61723,20,6,62388,4,23.8,-1.295983,36.782284,-1.2825581,36.7775416,568,665,44,820
12191,23851,3211,3,Personal,20,1,55959,20,1,55987,20,1,56664,20,1,56960,20,1,58573,5,21.4,-1.2846475,36.8275903,-1.2994217,36.8009779,548,1613,28,973
12192,11730,3689,3,Business,17,1,51538,17,1,58372,17,1,58468,17,1,60699,17,1,61708,6,25.4,-1.2904016,36.8226303,-1.2527958,36.8003131,272,1009,6834,2327
12193,6663,2801,3,Business,13,4,33331,13,4,33349,13,4,33612,13,4,33879,13,4,34903,7,18.7,-1.2674274,36.7870827,-1.2827545,36.7936129,161,1024,18,530
12194,12064,661,3,Business,3,1,47130,3,1,47663,3,1,48264,3,1,48492,3,1,51250,17,22.4,-1.2963097,36.7688221,-1.2224188,36.8868824,267,2758,533,829
12195,18664,1502,3,Business,14,1,59888,14,1,59907,14,1,60413,14,1,60989,14,1,62856,17,24.5,-1.2232123,36.8932547,-1.2571472,36.7950633,685,1867,19,1082
12196,17319,2383,3,Business,14,2,45137,14,2,45155,14,2,45489,14,2,45703,14,2,46007,3,23.25888921888938,-1.2608993,36.799246,-1.2654447,36.7978671,634,304,18,548
12197,22010,1471,3,Business,29,2,44729,29,2,44744,29,2,45578,29,2,47159,29,2,48145,11,21.5,-1.2815349,36.8293307,-1.2927792,36.9053492,812,986,15,2415
12198,18548,457,3,Personal,14,5,51413,14,5,51544,14,5,51808,14,5,52148,14,5,52954,6,23.8,-1.2985749,36.8088,-1.2630521,36.8068019,607,806,131,604
12199,20052,187,3,Business,9,2,52243,9,2,52251,9,2,53194,9,2,54678,9,2,57469,31,22.5,-1.2413316,36.8785525,-1.3169591,36.7000029,882,2791,8,2427
12200,19131,999,1,Personal,24,4,37447,24,4,37464,24,4,38110,24,4,38511,24,4,39679,19,21.1,-1.2853965,36.8183118,-1.1983842,36.9289067,103,1168,17,1047
12201,3574,412,3,Business,1,5,37163,1,5,37171,1,5,37189,1,5,40755,1,5,41696,12,28.7,-1.228911,36.881876,-1.266837,36.799249,539,941,8,3584
12202,5634,1500,3,Business,6,3,40299,6,3,40374,6,3,40855,6,3,41221,6,3,42631,13,22.6,-1.2638185,36.7930057,-1.3228003,36.8306435,247,1410,75,847
12203,2848,3655,1,Personal,4,4,43420,4,4,44195,4,4,45014,4,4,45245,4,4,45965,4,23.25888921888938,-1.288709,36.802659,-1.2943371,36.8267,844,720,775,1050
12204,16869,2662,1,Personal,2,4,31627,2,4,31661,2,4,32487,2,4,32681,2,4,33466,7,13.2,-1.2809077,36.825558,-1.3039411,36.7695316,754,785,34,1020
12205,27280,3354,3,Business,30,2,44681,30,2,45599,30,2,47011,30,2,48734,30,2,50317,7,23.25888921888938,-1.2571472,36.7950633,-1.301824,36.783976,205,1583,918,3135
12206,3918,2677,3,Business,30,2,34907,30,2,34925,30,2,35540,30,2,35663,30,2,37932,14,17.2,-1.306378,36.7519845,-1.3177547,36.8303703,905,2269,18,738
12207,18012,635,3,Business,8,6,37832,8,6,37862,8,6,38291,8,6,41280,8,6,42220,10,20.2,-1.300921,36.828195,-1.2602337,36.7990548,570,940,30,3418
12208,9455,2174,3,Business,15,6,39391,15,6,39405,15,6,39521,15,6,41412,15,6,42960,6,23.25888921888938,-1.2482781,36.884092,-1.2241625,36.8851115,216,1548,14,2007
12209,24766,346,3,Business,17,4,35458,17,4,35514,17,4,36183,17,4,36336,17,4,37275,5,23.25888921888938,-1.28878,36.8168312,-1.2584143,36.8048002,41,939,56,822
12210,19575,1855,1,Personal,26,3,32986,26,3,33026,26,3,34484,26,3,35934,26,3,38870,11,19.2,-1.3099804,36.8983789,-1.2855799,36.8176209,612,2936,40,2908
12211,13451,3109,2,Personal,6,5,40128,6,5,40642,6,5,41394,6,5,41669,6,5,41813,7,20.3,-1.2551895,36.7822034,-1.2921114,36.819219,621,144,514,1027
12212,8574,703,1,Personal,2,4,39421,2,4,39428,2,4,40195,2,4,40576,2,4,42993,22,22.6,-1.2628638,36.8070399,-1.3466861,36.6695761,379,2417,7,1148
12213,17803,3283,3,Business,20,1,52797,20,1,52853,20,1,53151,20,1,53388,20,1,55073,13,23.25888921888938,-1.331619,36.847976,-1.2628473,36.781805,48,1685,56,535
12214,12303,269,3,Business,22,5,41177,22,5,41730,22,5,42090,22,5,42572,22,5,44109,15,21.8,-1.3332749,36.8708147,-1.2551895,36.7822034,663,1537,553,842
12215,206,732,1,Personal,25,5,44478,25,5,44935,25,5,45707,25,5,46855,25,5,48431,7,21.0,-1.2961952,36.7876396,-1.2636912,36.788437,888,1576,457,1920
12216,1783,2803,3,Business,27,3,45681,27,3,45832,27,3,46406,27,3,46490,27,3,47409,8,26.1,-1.2765736,36.8513646,-1.2915971,36.8809029,933,919,151,658
12217,9980,3557,3,Business,25,4,56091,25,4,56174,25,4,56892,25,4,59283,25,4,59429,3,20.8,-1.269534,36.80697,-1.2546732,36.8086796,215,146,83,3109
12218,21816,2154,3,Business,2,5,59280,2,5,59719,2,5,60637,2,5,61080,2,5,62095,11,24.0,-1.2283403,36.8822756,-1.2765736,36.8513646,414,1015,439,1361
12219,13169,2150,3,Business,16,4,42224,16,4,42240,16,4,42401,16,4,43068,16,4,44320,11,14.8,-1.307143,36.825009,-1.344446,36.756597,648,1252,16,828
12220,26053,2987,3,Business,27,4,40864,27,4,40898,27,4,41476,27,4,41830,27,4,43091,9,22.7,-1.270212,36.8210877,-1.3280091,36.8524146,622,1261,34,932
12221,20334,2869,3,Business,18,4,38174,18,4,38311,18,4,38899,18,4,39885,18,4,41941,10,23.25888921888938,-1.3472066,36.7692638,-1.3025826,36.7670807,533,2056,137,1574
12222,24206,1386,2,Personal,9,4,47854,9,4,47875,9,4,48453,9,4,48781,9,4,49336,4,25.9,-1.3040899,36.7842136,-1.2998137,36.7606908,779,555,21,906
12223,18474,2641,3,Business,20,3,37933,20,3,37966,20,3,39093,20,3,42511,20,3,43836,12,26.4,-1.3103985,36.9114173,-1.3263105,36.8622904,883,1325,33,4545
12224,23958,1484,3,Business,23,3,45164,23,3,45218,23,3,45384,23,3,46099,23,3,47320,13,23.25888921888938,-1.2571472,36.7950633,-1.2343236,36.8861,31,1221,54,881
12225,16740,2866,3,Business,7,5,56446,7,5,57391,7,5,58498,7,5,58673,7,5,60948,8,23.25888921888938,-1.2551895,36.7822034,-1.2913246,36.8019522,937,2275,945,1282
12226,22161,3295,3,Business,10,1,55307,10,1,55338,10,1,55505,10,1,56226,10,1,58179,14,18.3,-1.2571472,36.7950633,-1.3312396,36.8575323,177,1953,31,888
12227,6554,3147,3,Business,5,2,41948,5,2,41959,5,2,42235,5,2,42437,5,2,43831,16,23.5,-1.2765492,36.7669809,-1.3472066,36.7692638,368,1394,11,478
12228,17257,393,3,Business,7,2,34499,7,2,34510,7,2,35473,7,2,37701,7,2,39672,6,23.25888921888938,-1.3167113,36.8301563,-1.3077869,36.8443207,910,1971,11,3191
12229,1373,1964,3,Personal,7,4,44648,7,4,44666,7,4,45561,7,4,45686,7,4,48104,13,24.1,-1.34364,36.8925345,-1.2802618,36.8191684,411,2418,18,1020
12230,14696,3647,3,Business,7,3,35441,7,3,35489,7,3,36084,7,3,36396,7,3,37870,16,23.25888921888938,-1.272639,36.794723,-1.3239725,36.8827383,648,1474,48,907
12231,15214,3404,3,Business,15,6,57776,15,6,57902,15,6,59342,15,6,59800,15,6,60687,2,21.1,-1.2882184,36.826346,-1.279395,36.825364,725,887,126,1898
12232,3030,3613,3,Business,9,4,45553,9,4,45728,9,4,46253,9,4,46416,9,4,47029,4,24.0,-1.2633494,36.7959696,-1.286925,36.821916,857,613,175,688
12233,24265,627,3,Business,22,4,55843,22,4,55866,22,4,55963,22,4,56298,22,4,56303,3,26.5,-1.2551895,36.7822034,-1.2567075,36.7739831,876,5,23,432
12234,389,1179,3,Business,20,4,52250,20,4,52256,20,4,52276,20,4,52959,20,4,54941,21,27.8,-1.3700383,36.9190174,-1.2917868,36.7872675,64,1982,6,703
12235,1182,111,3,Business,1,5,52057,1,5,52107,1,5,52707,1,5,53439,1,5,54775,10,28.5,-1.2551895,36.7822034,-1.2948835,36.7830474,205,1336,50,1332
12236,1763,1046,1,Personal,15,6,56888,15,6,56940,15,6,58816,15,6,58986,15,6,60746,6,26.1,-1.3054537,36.8284768,-1.2790501,36.8261866,328,1760,52,2046
12237,15747,2383,3,Business,3,3,34138,3,3,34240,3,3,35450,3,3,35545,3,3,36035,2,21.5,-1.2608993,36.799246,-1.2516391,36.8114886,487,490,102,1305
12238,6231,60,3,Business,15,3,41854,15,3,41876,15,3,42733,15,3,43228,15,3,44461,11,23.25888921888938,-1.266837,36.799249,-1.2296618,36.8438272,369,1233,22,1352
12239,11753,1284,1,Personal,16,4,37495,16,4,37503,16,4,37924,16,4,38355,16,4,39527,9,14.7,-1.2672018,36.8071919,-1.3185736,36.8258933,857,1172,8,852
12240,7351,2801,3,Business,15,5,43046,15,5,43091,15,5,44428,15,5,44841,15,5,48585,9,26.1,-1.307726,36.839117,-1.2595422,36.7871178,341,3744,45,1750
12241,19482,613,3,Business,11,6,59704,11,6,59720,11,6,59873,11,6,60685,11,6,61453,1,23.25888921888938,-1.2584143,36.8048002,-1.2527958,36.8003131,435,768,16,965
12242,9141,3669,3,Business,20,4,43323,20,4,43356,20,4,44262,20,4,46110,20,4,46121,3,24.5,-1.2685707,36.8064961,-1.2615888,36.7928732,51,11,33,2754
12243,6430,3426,3,Business,14,1,57141,14,1,57203,14,1,57736,14,1,58095,14,1,59645,9,25.9,-1.2676026,36.8103629,-1.3012008,36.764868,205,1550,62,892
12244,19151,633,3,Business,26,2,57515,26,2,58482,26,2,59021,26,2,59184,26,2,60108,5,29.5,-1.2770708,36.8231093,-1.3004062,36.829741,953,924,967,702
12245,25140,3146,1,Personal,26,4,52509,26,4,52528,26,4,52963,26,4,54391,26,4,55512,6,21.8,-1.299313,36.7831488,-1.3175119,36.8058513,101,1121,19,1863
12246,18917,3773,3,Personal,28,5,53634,28,5,53658,28,5,53933,28,5,54063,28,5,55007,6,25.4,-1.2591019,36.800577,-1.270701,36.8378757,280,944,24,405
12247,23286,633,3,Business,18,5,34505,18,5,35059,18,5,36137,18,5,36417,18,5,37831,5,20.2,-1.2770708,36.8231093,-1.3004062,36.829741,436,1414,554,1358
12248,918,1363,3,Business,28,1,57811,28,1,58065,28,1,59202,28,1,59755,28,1,60282,3,22.4,-1.3077869,36.8443207,-1.3090727,36.8315262,432,527,254,1690
12249,9106,1527,3,Business,30,2,36789,30,2,36842,30,2,37564,30,2,38330,30,2,38831,4,23.25888921888938,-1.3077869,36.8443207,-1.3004062,36.829741,663,501,53,1488
12250,10762,76,1,Personal,19,5,67618,19,5,67630,19,5,67730,19,5,69356,19,5,70792,6,24.3,-1.2962832,36.7849683,-1.260232,36.807334,519,1436,12,1726
12251,8414,441,1,Personal,28,2,62803,28,2,62821,28,2,63931,28,2,64215,28,2,65886,4,18.3,-1.2561914,36.7946542,-1.2615584,36.8149506,447,1671,18,1394
12252,18087,867,3,Business,4,2,58184,4,2,58188,4,2,58196,4,2,58771,4,2,61397,14,23.7,-1.306378,36.7519845,-1.3177547,36.8303703,619,2626,4,583
12253,27773,2718,3,Business,15,2,43254,15,2,43269,15,2,43685,15,2,44138,15,2,46106,20,24.4,-1.2668815,36.8017244,-1.3415467,36.6696294,31,1968,15,869
12254,10242,2244,1,Personal,25,5,67029,25,5,68314,25,5,68972,25,5,69615,25,5,70194,5,21.1,-1.2562249,36.7868661,-1.2681946,36.8012069,103,579,1285,1301
12255,27860,633,3,Business,31,5,31932,31,5,32003,31,5,33180,31,5,33934,31,5,34758,4,14.8,-1.3077869,36.8443207,-1.3004062,36.829741,56,824,71,1931
12256,24073,186,3,Business,7,4,39719,7,4,39743,7,4,40025,7,4,40553,7,4,41322,5,24.2,-1.2825816,36.8092346,-1.2571472,36.7950633,19,769,24,810
12257,26553,346,3,Business,7,2,56517,7,2,56569,7,2,57091,7,2,57921,7,2,58637,6,23.25888921888938,-1.2615888,36.7928732,-1.28878,36.8168312,205,716,52,1352
12258,18003,1329,3,Business,14,2,40423,14,2,40450,14,2,41411,14,2,42242,14,2,44673,12,21.6,-1.3233955,36.8562944,-1.252973,36.8165107,308,2431,27,1792
12259,2586,3149,3,Business,21,2,41791,21,2,41911,21,2,41947,21,2,42671,21,2,44501,9,22.3,-1.2770708,36.8231093,-1.3167113,36.8301563,436,1830,120,760
12260,2114,136,3,Business,2,4,39724,2,4,40784,2,4,41230,2,4,41621,2,4,43592,16,23.25888921888938,-1.3254522,36.7216584,-1.3233496,36.8139159,675,1971,1060,837
12261,23581,3291,3,Business,10,3,47321,10,3,47340,10,3,47404,10,3,48476,10,3,48846,5,28.0,-1.2628473,36.781805,-1.2600926,36.8088685,291,370,19,1136
12262,18414,136,3,Business,31,4,59229,31,4,59303,31,4,60335,31,4,60430,31,4,61113,2,27.7,-1.2531983,36.8069669,-1.2733047,36.8109744,428,683,74,1127
12263,27917,2924,3,Personal,14,5,54523,14,5,54803,14,5,55796,14,5,57924,14,5,60117,16,23.6,-1.2827651,36.8433831,-1.2664227,36.7453671,359,2193,280,3121
12264,534,203,3,Business,8,5,42808,8,5,42821,8,5,42860,8,5,43088,8,5,44512,10,24.0,-1.3167113,36.8301563,-1.2963097,36.7688221,523,1424,13,267
12265,11261,2627,3,Business,10,1,54363,10,1,54415,10,1,55026,10,1,55419,10,1,55740,2,18.1,-1.2584143,36.8048002,-1.2571472,36.7950633,547,321,52,1004
12266,24404,1687,3,Business,4,1,39001,4,1,39091,4,1,39812,4,1,40151,4,1,40729,3,25.8,-1.2732803,36.7940377,-1.2626574,36.8014034,397,578,90,1060
12267,8046,3283,3,Business,27,1,44563,27,1,44590,27,1,44862,27,1,45456,27,1,46609,13,20.8,-1.318062,36.849326,-1.2628473,36.781805,675,1153,27,866
12268,22074,3487,3,Business,7,2,36547,7,2,36747,7,2,37122,7,2,37642,7,2,38196,5,23.25888921888938,-1.2658424,36.8101804,-1.279395,36.825364,205,554,200,895
12269,23842,2344,3,Business,25,5,32620,25,5,32633,25,5,34554,25,5,35377,25,5,36401,8,20.9,-1.290815,36.7969312,-1.2551895,36.7822034,761,1024,13,2744
12270,28010,1500,3,Business,1,1,54746,1,1,55017,1,1,55569,1,1,55772,1,1,56541,6,23.25888921888938,-1.2770708,36.8231093,-1.2638185,36.7930057,349,769,271,755
12271,696,3222,3,Business,20,3,38208,20,3,38228,20,3,38291,20,3,38551,20,3,40506,5,27.1,-1.2551895,36.7822034,-1.2731645,36.7900343,579,1955,20,323
12272,26958,246,3,Business,24,4,36239,24,4,36247,24,4,38001,24,4,38839,24,4,42265,17,24.4,-1.3472066,36.7692638,-1.2584143,36.8048002,267,3426,8,2592
12273,15761,269,3,Business,12,1,36684,12,1,36801,12,1,37426,12,1,38838,12,1,41194,16,23.7,-1.3332749,36.8708147,-1.2551895,36.7822034,761,2356,117,2037
12274,19373,3540,2,Personal,25,3,29789,25,3,29799,25,3,30448,25,3,30762,25,3,33368,17,13.7,-1.265324,36.782244,-1.3006051,36.6803439,379,2606,10,963
12275,14640,1642,3,Business,29,1,38454,29,1,38472,29,1,38513,29,1,39390,29,1,40617,5,23.25888921888938,-1.2726506,36.7960153,-1.2887076,36.8254658,785,1227,18,918
12276,22187,302,3,Business,24,7,47549,24,7,47581,24,7,48451,24,7,49368,24,7,50686,8,23.25888921888938,-1.2976314,36.777256,-1.2649605,36.7981777,101,1318,32,1787
12277,24679,1051,3,Business,27,1,59761,27,1,59761,27,1,59770,27,1,59852,27,1,60694,8,23.25888921888938,-1.2963097,36.7688221,-1.2753109,36.8130185,71,842,0,91
12278,10089,635,3,Business,15,4,51832,15,4,52353,15,4,52902,15,4,54238,15,4,57308,7,27.7,-1.300921,36.828195,-1.2599563,36.7993439,726,3070,521,1885
12279,8508,590,3,Business,22,4,44356,22,4,44479,22,4,44862,22,4,45125,22,4,45238,2,22.7,-1.257773,36.795486,-1.2644742,36.8083457,574,113,123,646
12280,26122,1882,3,Business,13,3,31034,13,3,31083,13,3,31677,13,3,33878,13,3,35324,6,20.0,-1.2956882,36.7861845,-1.2591019,36.800577,855,1446,49,2795
12281,18816,2801,3,Business,19,1,43865,19,1,43880,19,1,44383,19,1,44937,19,1,47278,15,24.9,-1.2595422,36.7871178,-1.3104506,36.8687235,620,2341,15,1057
12282,27457,1927,3,Business,20,2,41112,20,2,41121,20,2,42004,20,2,42127,20,2,45367,20,19.7,-1.2927792,36.9053492,-1.3463042,36.768164,699,3240,9,1006
12283,27855,1405,3,Business,7,3,42673,7,3,42970,7,3,43500,7,3,44069,7,3,45709,9,24.9,-1.3194518,36.869396,-1.3478563,36.8935824,276,1640,297,1099
12284,9629,517,3,Business,31,3,56659,31,3,57233,31,3,57431,31,3,57817,31,3,58438,6,26.9,-1.3077869,36.8443207,-1.3177547,36.8303703,62,621,574,584
12285,15264,2216,3,Business,11,5,35653,11,5,35674,11,5,35769,11,5,36404,11,5,36697,2,20.9,-1.2551895,36.7822034,-1.2561334,36.7990458,449,293,21,730
12286,22865,2801,3,Business,6,3,45587,6,3,45640,6,3,45791,6,3,46183,6,3,46834,4,22.5,-1.2689186,36.8001681,-1.2674274,36.7870827,807,651,53,543
12287,25105,3247,3,Business,22,4,52160,22,4,52458,22,4,52851,22,4,53145,22,4,54052,5,26.4,-1.2571472,36.7950633,-1.2655306,36.828148,407,907,298,687
12288,5426,1222,3,Personal,16,2,59372,16,2,59942,16,2,60667,16,2,61039,16,2,62494,7,25.1,-1.2707179,36.7979713,-1.3027767,36.7730036,823,1455,570,1097
12289,17732,1329,3,Business,30,6,55025,30,6,55107,30,6,55633,30,6,55963,30,6,56817,9,28.6,-1.273056,36.811298,-1.252726,36.7563739,383,854,82,856
12290,3694,3214,3,Business,27,3,36533,27,3,36559,27,3,36839,27,3,37158,27,3,37929,3,21.5,-1.304735,36.7846054,-1.289795,36.7957132,708,771,26,599
12291,2145,391,3,Business,10,1,40784,10,1,44271,10,1,44946,10,1,45950,10,1,47953,5,23.4,-1.300921,36.828195,-1.2867454,36.8259017,48,2003,3487,1679
12292,1844,976,2,Personal,19,4,31252,19,4,31495,19,4,32619,19,4,35846,19,4,37603,8,14.5,-1.312745,36.875715,-1.3284461,36.8204084,415,1757,243,4351
12293,5849,2733,3,Business,8,1,41313,8,1,41386,8,1,43563,8,1,43842,8,1,45181,5,27.7,-1.2963097,36.7688221,-1.2857723,36.8088058,763,1339,73,2456
12294,17542,1402,3,Business,20,3,51363,20,3,51439,20,3,52140,20,3,52396,20,3,54885,8,29.6,-1.2813012,36.8323962,-1.2551895,36.7822034,506,2489,76,957
12295,23530,2487,2,Personal,8,6,40319,8,6,40375,8,6,41900,8,6,42142,8,6,43174,9,22.4,-1.2556618,36.8178427,-1.2197009,36.8269618,882,1032,56,1767
12296,21634,1250,1,Personal,14,1,53892,14,1,54002,14,1,54559,14,1,55761,14,1,57662,8,25.8,-1.3034396,36.8329998,-1.2620741,36.8158147,101,1901,110,1759
12297,4223,3203,3,Business,17,6,58954,17,6,59245,17,6,60281,17,6,60943,17,6,62259,12,19.8,-1.2600926,36.8088685,-1.228911,36.881876,510,1316,291,1698
12298,6427,3300,3,Business,6,4,35834,6,4,35865,6,4,36506,6,4,37049,6,4,38036,5,16.2,-1.3040553,36.8092658,-1.303596,36.778378,277,987,31,1184
12299,20763,2330,3,Business,10,1,52578,10,1,52677,10,1,53569,10,1,53979,10,1,55572,5,18.2,-1.3040812,36.7924217,-1.2890715,36.8157588,109,1593,99,1302
12300,16452,3326,3,Business,11,4,55751,11,4,56011,11,4,57856,11,4,58042,11,4,58867,4,27.2,-1.2551895,36.7822034,-1.2585521,36.7945765,547,825,260,2031
12301,24676,206,2,Personal,13,1,49947,13,1,49978,13,1,50332,13,1,50894,13,1,54838,28,19.7,-1.3233955,36.8562944,-1.1806989,36.9332858,519,3944,31,916
12302,22918,1363,3,Business,6,4,39772,6,4,39818,6,4,40377,6,4,40458,6,4,40964,4,19.7,-1.3004062,36.829741,-1.3185736,36.8258933,211,506,46,640
12303,13720,3426,3,Business,7,1,34784,7,1,34817,7,1,35072,7,1,35533,7,1,36363,9,21.5,-1.3014461,36.7661381,-1.2551895,36.7822034,655,830,33,716
12304,26945,1245,3,Business,14,1,45819,14,1,45841,14,1,46016,14,1,48181,14,1,49760,17,23.6,-1.300921,36.828195,-1.3198615,36.7110323,340,1579,22,2340
12305,19398,393,3,Business,30,2,29901,30,2,32019,30,2,32039,30,2,35061,30,2,37787,14,17.1,-1.3177547,36.8303703,-1.306378,36.7519845,98,2726,2118,3042
12306,5110,1363,3,Business,23,3,30750,23,3,30758,23,3,31182,23,3,31302,23,3,31536,2,23.25888921888938,-1.3004062,36.829741,-1.2945552,36.8397497,842,234,8,544
12307,18429,1936,1,Personal,28,1,46496,28,1,46631,28,1,48522,28,1,49571,28,1,51705,10,24.7,-1.3118872,36.8039137,-1.2750282,36.8532236,844,2134,135,2940
12308,12444,3686,3,Business,13,3,40769,13,3,40786,13,3,41160,13,3,41281,13,3,47097,5,25.0,-1.2551895,36.7822034,-1.245477,36.785037,452,5816,17,495
12309,16481,1075,3,Business,15,5,57537,15,5,58501,15,5,59614,15,5,60244,15,5,61783,8,27.5,-1.2326041,36.8009029,-1.2527958,36.8003131,956,1539,964,1743
12310,2602,3222,3,Business,23,4,53707,23,4,54105,23,4,54549,23,4,55232,23,4,56284,8,24.5,-1.2551895,36.7822034,-1.295156,36.8094306,448,1052,398,1127
12311,17896,3404,3,Business,3,1,34310,3,1,36069,3,1,38152,3,1,40903,3,1,41557,1,22.3,-1.290894,36.822971,-1.279395,36.825364,299,654,1759,4834
12312,9494,1500,3,Business,24,3,35261,24,3,35272,24,3,35696,24,3,35957,24,3,37176,11,23.25888921888938,-1.3077869,36.8443207,-1.2638185,36.7930057,411,1219,11,685
12313,27978,311,3,Business,13,1,33517,13,1,33601,13,1,34430,13,1,34542,13,1,35588,4,15.3,-1.299813,36.7871392,-1.2890399,36.8164942,592,1046,84,941
12314,4330,868,3,Business,18,4,35242,18,4,35271,18,4,36174,18,4,36457,18,4,38218,9,23.25888921888938,-1.2296618,36.8438272,-1.265715,36.823815,7,1761,29,1186
12315,5657,1304,3,Business,6,2,32691,6,2,32706,6,2,33237,6,2,33395,6,2,35653,13,20.0,-1.3332749,36.8708147,-1.2695287,36.7981777,611,2258,15,689
12316,4185,478,3,Business,26,5,49985,26,5,49996,26,5,50109,26,5,50340,26,5,53463,23,23.25888921888938,-1.2551895,36.7822034,-1.34364,36.8925345,168,3123,11,344
12317,11765,3332,3,Personal,9,2,44101,9,2,44195,9,2,45546,9,2,45719,9,2,48684,12,27.0,-1.2463396,36.7547983,-1.282843,36.821474,177,2965,94,1524
12318,8428,2789,3,Business,20,3,54986,20,3,55033,20,3,56219,20,3,56288,20,3,58484,10,28.3,-1.304735,36.7846054,-1.3169591,36.7000029,448,2196,47,1255
12319,16925,2523,3,Business,2,3,55145,2,3,55163,2,3,55642,2,3,55790,2,3,56743,16,25.8,-1.2551895,36.7822034,-1.2156006,36.8916865,647,953,18,627
12320,27763,478,3,Business,8,5,46082,8,5,49342,8,5,50624,8,5,50769,8,5,53970,9,27.4,-1.2551895,36.7822034,-1.29387,36.7907813,521,3201,3260,1427
12321,816,2330,3,Business,4,1,47693,4,1,47889,4,1,48403,4,1,48806,4,1,49723,9,28.7,-1.3015197,36.7658456,-1.2649605,36.7981777,862,917,196,917
12322,19447,20,3,Business,24,3,39960,24,3,40522,24,3,42227,24,3,42968,24,3,45139,5,19.8,-1.2878081,36.8200516,-1.2654348,36.8022464,660,2171,562,2446
12323,3581,3283,3,Business,20,1,52908,20,1,53161,20,1,56016,20,1,56305,20,1,59368,19,23.25888921888938,-1.293515,36.897607,-1.2628473,36.781805,697,3063,253,3144
12324,11183,3246,3,Business,26,1,42142,26,1,42153,26,1,43046,26,1,44465,26,1,48279,16,23.2,-1.2551895,36.7822034,-1.3165542,36.700067,395,3814,11,2312
12325,5109,269,3,Business,15,4,52574,15,4,52991,15,4,54163,15,4,57853,15,4,61512,16,27.5,-1.3332749,36.8708147,-1.2551895,36.7822034,593,3659,417,4862
12326,17760,2801,3,Business,14,5,54082,14,5,54205,14,5,54773,14,5,55604,14,5,56563,6,23.1,-1.3109801,36.8810758,-1.307726,36.839117,907,959,123,1399
12327,17100,1927,3,Business,22,5,45654,22,5,45662,22,5,45681,22,5,46598,22,5,49101,23,23.25888921888938,-1.2285835,36.8826468,-1.3472066,36.7692638,539,2503,8,936
12328,5840,462,1,Personal,28,4,38902,28,4,39488,28,4,40696,28,4,40878,28,4,41919,7,23.25888921888938,-1.2626954,36.8273738,-1.2560455,36.7800867,846,1041,586,1390
12329,13286,3149,3,Business,10,5,54499,10,5,54585,10,5,54852,10,5,56015,10,5,56665,6,23.25888921888938,-1.3004062,36.829741,-1.3167113,36.8301563,211,650,86,1430
12330,27911,393,3,Business,13,3,57047,13,3,57060,13,3,57064,13,3,58547,13,3,59924,11,27.3,-1.3167113,36.8301563,-1.2638185,36.7930057,842,1377,13,1487
12331,4419,517,3,Business,9,6,32142,9,6,32159,9,6,32173,9,6,34483,9,6,34487,11,20.0,-1.3167113,36.8301563,-1.2638185,36.7930057,619,4,17,2324
12332,1082,2538,1,Personal,15,1,35685,15,1,35757,15,1,36270,15,1,36706,15,1,37591,5,23.25888921888938,-1.2575407,36.7868197,-1.2848928,36.777887,467,885,72,949
12333,2915,2729,2,Personal,13,5,49316,13,5,49771,13,5,50907,13,5,51604,13,5,52608,3,19.4,-1.2857095,36.8188266,-1.298529,36.816482,752,1004,455,1833
12334,26160,2117,1,Personal,19,4,37796,19,4,38008,19,4,38419,19,4,39292,19,4,40108,5,20.3,-1.2897215,36.7945959,-1.2787795,36.8258525,692,816,212,1284
12335,2150,3127,3,Business,5,2,60180,5,2,60297,5,2,61172,5,2,61542,5,2,62372,5,25.2,-1.2795796,36.819062,-1.2918246,36.801585,513,830,117,1245
12336,17730,1304,3,Business,5,1,36559,5,1,36642,5,1,36709,5,1,37728,5,1,39898,14,18.8,-1.3332749,36.8708147,-1.2636814,36.8029965,108,2170,83,1086
12337,17469,2728,1,Personal,7,1,46847,7,1,46899,7,1,48327,7,1,48395,7,1,48980,6,21.3,-1.3101624,36.818915,-1.3211103,36.7929487,742,585,52,1496
12338,4789,2522,3,Personal,18,2,26828,18,2,32491,18,2,33665,18,2,34183,18,2,36539,9,16.3,-1.258348,36.8449018,-1.307774,36.8407541,427,2356,5663,1692
12339,17830,1500,3,Business,1,1,47876,1,1,47907,1,1,48076,1,1,48501,1,1,49700,9,23.25888921888938,-1.2638185,36.7930057,-1.3004062,36.829741,177,1199,31,594
12340,12593,733,3,Business,6,4,54792,6,4,54883,6,4,54989,6,4,55266,6,4,56900,7,21.2,-1.2551895,36.7822034,-1.2821929,36.8281227,709,1634,91,383
12341,25434,3108,3,Business,4,3,44765,4,3,44777,4,3,45547,4,3,47622,4,3,50126,20,17.0,-1.2551895,36.7822034,-1.1672795,36.8245972,116,2504,12,2845
12342,5717,1584,3,Business,7,4,52660,7,4,52866,7,4,53595,7,4,54249,7,4,56154,6,31.2,-1.2857524,36.8196806,-1.2969741,36.7856612,698,1905,206,1383
12343,20706,2069,3,Business,22,3,39962,22,3,40014,22,3,41056,22,3,42151,22,3,43278,9,22.9,-1.265715,36.823815,-1.228911,36.881876,221,1127,52,2137
12344,10643,635,3,Business,24,4,57371,24,4,57438,24,4,58458,24,4,59409,24,4,60931,8,28.5,-1.3081376,36.8329772,-1.2602337,36.7990548,399,1522,67,1971
12345,25768,1502,3,Business,23,2,43236,23,2,43256,23,2,43980,23,2,45709,23,2,47972,24,23.25888921888938,-1.3562374,36.9042954,-1.2232123,36.8932547,19,2263,20,2453
12346,24313,3218,3,Business,11,1,33539,11,1,33582,11,1,34015,11,1,35311,11,1,36554,6,14.4,-1.2885529,36.8160141,-1.2765736,36.8513646,444,1243,43,1729
12347,21086,3189,3,Personal,31,5,39374,31,5,39452,31,5,40021,31,5,41480,31,5,42823,11,21.9,-1.2784798,36.8315208,-1.2513529,36.752172,206,1343,78,2028
12348,8664,2869,3,Business,12,2,38912,12,2,39490,12,2,42490,12,2,43063,12,2,45415,9,24.3,-1.2845766,36.8245168,-1.3025826,36.7670807,404,2352,578,3573
12349,16634,1838,3,Business,17,5,48169,17,5,48198,17,5,48654,17,5,49019,17,5,49520,2,23.25888921888938,-1.2649605,36.7981777,-1.2617028,36.7983849,660,501,29,821
12350,26701,830,3,Business,15,3,59480,15,3,59505,15,3,59775,15,3,59980,15,3,60155,3,24.9,-1.2551895,36.7822034,-1.2603403,36.7998848,177,175,25,475
12351,21092,384,1,Personal,24,4,53422,24,4,53626,24,4,53887,24,4,54305,24,4,55044,4,22.8,-1.299029,36.782493,-1.2765492,36.7669809,761,739,204,679
12352,26756,659,2,Personal,1,3,44527,1,3,44530,1,3,45117,1,3,45382,1,3,45880,3,19.8,-1.2852584,36.8043641,-1.2898176,36.7782389,229,498,3,852
12353,27864,2774,1,Personal,22,6,51757,22,6,51770,22,6,53703,22,6,54119,22,6,56343,24,23.25888921888938,-1.2921513,36.752547,-1.3061785,36.9094142,100,2224,13,2349
12354,20970,635,3,Business,12,3,50779,12,3,50915,12,3,51947,12,3,52241,12,3,54891,10,20.9,-1.2599563,36.7993439,-1.2105068,36.7859421,739,2650,136,1326
12355,25290,2008,3,Business,2,2,51051,2,2,51175,2,2,51575,2,2,51804,2,2,53482,7,29.6,-1.2508229,36.7895263,-1.2902539,36.8211322,858,1678,124,629
12356,7832,346,3,Business,3,1,45695,3,1,45826,3,1,48082,3,1,51233,3,1,51238,4,23.2,-1.2571472,36.7950633,-1.28878,36.8168312,76,5,131,5407
12357,17658,1075,3,Business,3,1,51297,3,1,51959,3,1,52661,3,1,54278,3,1,54279,8,23.2,-1.2765736,36.8513646,-1.2527958,36.8003131,709,1,662,2319
12358,989,1120,3,Personal,25,4,44340,25,4,48260,25,4,48898,25,4,48997,25,4,49543,5,23.25888921888938,-1.2807,36.808066,-1.2564222,36.7937091,576,546,3920,737
12359,18718,821,1,Personal,18,5,28544,18,5,28565,18,5,29504,18,5,29838,18,5,31587,11,17.9,-1.2792155,36.830315,-1.328751,36.8818019,680,1749,21,1273
12360,5120,3647,3,Business,19,5,37350,19,5,37379,19,5,37687,19,5,37917,19,5,39358,13,20.1,-1.272639,36.794723,-1.3216456,36.7145156,22,1441,29,538
12361,6311,1578,3,Business,5,1,38653,5,1,38664,5,1,39521,5,1,40435,5,1,42624,13,24.7,-1.2232123,36.8932547,-1.28878,36.8168312,89,2189,11,1771
12362,14328,3239,3,Personal,16,3,56751,16,3,56888,16,3,56951,16,3,57534,16,3,58272,6,25.3,-1.276154,36.8224165,-1.2982033,36.8092632,100,738,137,646
12363,21447,883,1,Personal,11,5,50838,11,5,51820,11,5,52735,11,5,53009,11,5,54840,15,22.8,-1.2384876,36.8778107,-1.3025286,36.7964474,393,1831,982,1189
12364,22861,3599,3,Business,29,5,35533,29,5,36589,29,5,37753,29,5,39632,29,5,43638,23,26.7,-1.3302996,36.8707935,-1.201731,36.8418008,519,4006,1056,3043
12365,16514,823,3,Personal,26,2,51900,26,2,51916,26,2,52365,26,2,52632,26,2,56086,19,31.2,-1.2485958,36.7888228,-1.3195469,36.6976868,147,3454,16,716
12366,4759,3109,2,Personal,18,3,44182,18,3,44254,18,3,44775,18,3,46107,18,3,47720,9,19.7,-1.3014461,36.7661381,-1.2551895,36.7822034,140,1613,72,1853
12367,22094,1205,3,Business,12,2,45758,12,2,45808,12,2,46233,12,2,46545,12,2,47692,7,28.3,-1.2495931,36.8065087,-1.2958383,36.8073162,953,1147,50,737
12368,1916,20,3,Business,30,4,42739,30,4,42747,30,4,42786,30,4,44737,30,4,44954,7,20.3,-1.2628638,36.8070399,-1.3034167,36.8197498,620,217,8,1990
12369,14681,2423,3,Business,11,1,39061,11,1,46948,11,1,47318,11,1,47720,11,1,48819,7,24.0,-1.2551895,36.7822034,-1.2934657,36.8212737,267,1099,7887,772
12370,12511,393,3,Business,12,2,57799,12,2,57819,12,2,57822,12,2,58328,12,2,59061,4,26.9,-1.3167113,36.8301563,-1.3004062,36.829741,751,733,20,509
12371,19602,758,3,Business,29,3,58833,29,3,59080,29,3,60103,29,3,60416,29,3,61381,7,21.3,-1.2917868,36.7872675,-1.2684319,36.8165853,146,965,247,1336
12372,19404,2956,3,Business,6,6,33333,6,6,33341,6,6,33384,6,6,35541,6,6,36410,17,19.5,-1.2156006,36.8916865,-1.2584143,36.8048002,291,869,8,2200
12373,28100,1205,3,Business,2,2,35492,2,2,35562,2,2,35745,2,2,36159,2,2,37059,7,20.5,-1.2495931,36.8065087,-1.294598,36.781639,484,900,70,597
12374,14644,1207,3,Business,2,6,49755,2,6,51216,2,6,51243,2,6,52685,2,6,54636,14,31.0,-1.2629666,36.8068369,-1.207546,36.7913976,657,1951,1461,1469
12375,444,893,3,Business,26,2,34794,26,2,34831,26,2,35150,26,2,35511,26,2,35914,2,21.8,-1.2664491,36.8102685,-1.2561022,36.8220661,383,403,37,680
12376,5330,3517,3,Business,7,4,52488,7,4,52494,7,4,52509,7,4,53018,7,4,55635,16,27.7,-1.3882008,36.7699445,-1.300921,36.828195,164,2617,6,524
12377,8462,136,3,Business,11,2,44308,11,2,44390,11,2,46572,11,2,47411,11,2,52833,15,19.3,-1.2949455,36.8195238,-1.3254522,36.7216584,168,5422,82,3021
12378,18755,3504,2,Personal,14,4,35780,14,4,36540,14,4,36888,14,4,37029,14,4,37798,5,15.3,-1.2911636,36.7857333,-1.3136452,36.7974014,379,769,760,489
12379,13074,2066,3,Business,2,4,50568,2,4,50589,2,4,50962,2,4,51170,2,4,52641,12,23.25888921888938,-1.3210189,36.8410551,-1.2551895,36.7822034,68,1471,21,581
12380,22506,1562,2,Personal,8,7,49446,8,7,50082,8,7,52719,8,7,53051,8,7,53649,2,21.7,-1.288966,36.791814,-1.2834505,36.7856036,465,598,636,2969
12381,4830,2827,3,Business,3,1,48180,3,1,49240,3,1,50004,3,1,50254,3,1,56706,8,23.4,-1.2850644,36.8343657,-1.238874,36.807889,79,6452,1060,1014
12382,12936,346,3,Business,5,2,46344,5,2,47092,5,2,47449,5,2,47908,5,2,48749,4,25.4,-1.28878,36.8168312,-1.2979063,36.8373372,448,841,748,816
12383,19962,1927,3,Business,19,3,58577,19,3,59591,19,3,60029,19,3,60711,19,3,62035,10,22.3,-1.3165542,36.700067,-1.3472066,36.7692638,279,1324,1014,1120
12384,9976,3683,3,Business,28,1,43254,28,1,43279,28,1,43741,28,1,43946,28,1,45168,7,23.8,-1.2897368,36.8226783,-1.2765492,36.7669809,601,1222,25,667
12385,12240,11,1,Personal,4,4,53458,4,4,53588,4,4,54816,4,4,55191,4,4,56691,8,24.6,-1.2604472,36.8365287,-1.2962731,36.8111863,795,1500,130,1603
12386,23364,111,3,Business,8,2,42729,8,2,42756,8,2,43084,8,2,43197,8,2,43706,1,23.6,-1.2551895,36.7822034,-1.2538731,36.7850223,512,509,27,441
12387,6718,393,3,Business,30,2,48422,30,2,48778,30,2,48809,30,2,49255,30,2,51595,14,27.2,-1.3177547,36.8303703,-1.306378,36.7519845,239,2340,356,477
12388,3383,3127,3,Business,16,2,36206,16,2,36233,16,2,37057,16,2,37206,16,2,38171,7,23.25888921888938,-1.2918246,36.801585,-1.2760462,36.8074697,559,965,27,973
12389,14897,517,3,Business,3,4,48864,3,4,48872,3,4,49462,3,4,49987,3,4,51414,11,26.1,-1.3167113,36.8301563,-1.2574219,36.7927073,523,1427,8,1115
12390,22823,1932,3,Business,5,2,56543,5,2,56575,5,2,56977,5,2,57269,5,2,58088,7,22.6,-1.3100609,36.8205365,-1.2922857,36.7813274,116,819,32,694
12391,7970,496,3,Business,3,4,42804,3,4,42930,3,4,43446,3,4,43631,3,4,45966,9,21.8,-1.255956,36.789867,-1.251162,36.8277973,147,2335,126,701
12392,15103,3420,3,Business,17,5,56690,17,5,56724,17,5,57617,17,5,58064,17,5,60720,8,20.0,-1.3046007,36.8211743,-1.2575407,36.7868197,213,2656,34,1340
12393,10159,635,3,Business,10,1,59936,10,1,60200,10,1,60332,10,1,60440,10,1,61062,5,19.2,-1.2599563,36.7993439,-1.24309,36.77747,770,622,264,240
12394,2530,1874,3,Business,3,4,39993,3,4,40009,3,4,40576,3,4,40741,3,4,43020,16,22.0,-1.2579304,36.8019667,-1.3261883,36.7202391,486,2279,16,732
12395,17414,2047,1,Personal,11,4,45586,11,4,48433,11,4,49528,11,4,49779,11,4,50653,7,26.5,-1.310796,36.86283,-1.3044313,36.818504,532,874,2847,1346
12396,1592,3560,3,Business,27,3,59308,27,3,59521,27,3,59940,27,3,60464,27,3,62957,5,27.7,-1.2571472,36.7950633,-1.279395,36.825364,351,2493,213,943
12397,11847,2677,3,Business,15,1,48477,15,1,48694,15,1,49173,15,1,49559,15,1,51134,11,23.25888921888938,-1.2770708,36.8231093,-1.2991441,36.7528804,320,1575,217,865
12398,5032,3698,3,Business,26,5,40240,26,5,40240,26,5,40539,26,5,40917,26,5,44257,15,23.25888921888938,-1.3244885,36.897792,-1.2285835,36.8826468,863,3340,0,677
12399,21616,535,3,Business,15,3,57335,15,3,57410,15,3,58973,15,3,59748,15,3,62209,20,24.8,-1.3206958,36.8769553,-1.2549259,36.7919494,870,2461,75,2338
12400,17880,2071,1,Personal,31,4,68779,31,4,68834,31,4,69684,31,4,70038,31,4,72442,19,22.1,-1.2812976,36.7625848,-1.2108864,36.7807022,874,2404,55,1204
12401,9909,2008,3,Business,19,3,52165,19,3,53172,19,3,53564,19,3,53925,19,3,60298,11,24.4,-1.3008589,36.8447612,-1.2508229,36.7895263,75,6373,1007,753
12402,26931,3320,3,Business,29,5,48020,29,5,48074,29,5,49446,29,5,49939,29,5,52569,26,28.8,-1.2708331,36.7904193,-1.3799485,36.9349923,377,2630,54,1865
12403,21927,157,3,Business,23,3,53482,23,3,53762,23,3,55041,23,3,56940,23,3,57857,10,22.1,-1.3043061,36.7803735,-1.264272,36.7978791,103,917,280,3178
12404,15998,1932,3,Business,16,3,42901,16,3,43103,16,3,44292,16,3,44633,16,3,45575,5,23.8,-1.2922857,36.7813274,-1.3075701,36.7504306,782,942,202,1530
12405,3289,2587,3,Business,6,3,55980,6,3,56022,6,3,56517,6,3,56869,6,3,61111,17,23.25888921888938,-1.28878,36.8168312,-1.3169591,36.7000029,452,4242,42,847
12406,28188,59,3,Business,4,1,33648,4,1,33730,4,1,34909,4,1,36411,4,1,36533,6,18.1,-1.290894,36.822971,-1.2628638,36.8070399,927,122,82,2681
12407,25967,3688,3,Business,4,4,57110,4,4,57151,4,4,57386,4,4,61295,4,4,61342,15,26.0,-1.2285835,36.8826468,-1.2519787,36.7806491,307,47,41,4144
12408,145,3291,3,Business,23,2,57678,23,2,59555,23,2,61205,23,2,63003,23,2,63007,2,23.25888921888938,-1.266837,36.799249,-1.2600926,36.8088685,76,4,1877,3448
12409,26642,3669,3,Business,25,5,36278,25,5,36292,25,5,36325,25,5,36921,25,5,38582,13,20.7,-1.2615888,36.7928732,-1.3339166,36.8692482,379,1661,14,629
12410,15621,1398,3,Business,8,5,50794,8,5,51476,8,5,52962,8,5,53677,8,5,58156,5,27.1,-1.2615584,36.8149506,-1.2788306,36.8081707,404,4479,682,2201
12411,13996,3621,3,Business,3,6,37215,3,6,37493,3,6,38177,3,6,38239,3,6,38786,4,23.6,-1.2836583,36.7886014,-1.2899256,36.815551,250,547,278,746
12412,18829,2132,3,Business,18,1,48106,18,1,48137,18,1,49209,18,1,50272,18,1,52146,14,29.6,-1.2384056,36.8718698,-1.3376052,36.901917,691,1874,31,2135
12413,528,20,3,Business,28,2,63968,28,2,63996,28,2,64309,28,2,64802,28,2,68842,17,21.4,-1.2562797,36.8075858,-1.3390024,36.8746657,139,4040,28,806
12414,10332,517,3,Business,3,1,53535,3,1,53909,3,1,53913,3,1,54347,3,1,56038,14,23.3,-1.3177547,36.8303703,-1.306378,36.7519845,515,1691,374,438
12415,1155,393,3,Business,13,3,31977,13,3,32005,13,3,32019,13,3,36013,13,3,36015,11,20.1,-1.3167113,36.8301563,-1.2638185,36.7930057,515,2,28,4008
12416,15015,391,3,Business,31,5,45755,31,5,46738,31,5,46823,31,5,48969,31,5,49801,5,24.7,-1.300921,36.828195,-1.2867454,36.8259017,158,832,983,2231
12417,24971,3295,3,Business,13,2,30921,13,2,30980,13,2,31468,13,2,32188,13,2,33850,11,19.9,-1.2571472,36.7950633,-1.3229345,36.8566974,708,1662,59,1208
12418,13638,2154,3,Business,16,4,55021,16,4,55162,16,4,56728,16,4,56949,16,4,58147,5,23.25888921888938,-1.2765736,36.8513646,-1.2857548,36.819062,204,1198,141,1787
12419,20589,3599,3,Business,10,3,33594,10,3,33610,10,3,35744,10,3,36188,10,3,37638,8,21.7,-1.3302996,36.8707935,-1.3064585,36.8119065,760,1450,16,2578
12420,3057,393,3,Business,28,4,45384,28,4,45397,28,4,45425,28,4,48171,28,4,48173,4,23.6,-1.3167113,36.8301563,-1.3004062,36.829741,10,2,13,2774
12421,12716,412,3,Business,25,1,56999,25,1,57014,25,1,58042,25,1,58216,25,1,58875,4,30.3,-1.266837,36.799249,-1.272828,36.816608,52,659,15,1202
12422,27584,1341,3,Business,24,3,50541,24,3,50574,24,3,50988,24,3,51187,24,3,52659,13,23.25888921888938,-1.303596,36.778378,-1.331619,36.847976,324,1472,33,613
12423,25911,502,3,Personal,25,1,39211,25,1,40141,25,1,40679,25,1,41810,25,1,43144,6,23.25888921888938,-1.3019137,36.7925105,-1.279085,36.819303,752,1334,930,1669
12424,2210,203,3,Business,25,1,60153,25,1,60190,25,1,60714,25,1,60888,25,1,63320,6,28.5,-1.2963097,36.7688221,-1.2826463,36.728912,306,2432,37,698
12425,22842,1865,1,Personal,10,1,57654,10,1,57752,10,1,60447,10,1,60730,10,1,62576,15,19.1,-1.2166078,36.882501,-1.2951243,36.8281344,406,1846,98,2978
12426,19569,1882,3,Business,23,5,68930,23,5,68953,23,5,74822,23,5,75157,23,5,77521,13,20.1,-1.2958783,36.7928125,-1.3175825,36.7004796,829,2364,23,6204
12427,9117,2869,3,Business,4,2,53691,4,2,54244,4,2,55150,4,2,55936,4,2,57264,9,22.4,-1.3025826,36.7670807,-1.2551895,36.7822034,269,1328,553,1692
12428,4659,3283,3,Business,20,2,37064,20,2,37732,20,2,38201,20,2,39011,20,2,40595,14,19.6,-1.228911,36.881876,-1.2628473,36.781805,100,1584,668,1279
12429,9294,3109,2,Personal,31,4,39582,31,4,39618,31,4,40531,31,4,43732,31,4,44944,11,22.0,-1.3107918,36.761794,-1.2553615,36.7895376,45,1212,36,4114
12430,20491,2987,3,Business,10,1,47416,10,1,52023,10,1,52458,10,1,52599,10,1,53485,3,18.8,-1.270212,36.8210877,-1.253654,36.8204391,646,886,4607,576
12431,8820,2030,3,Business,11,2,56028,11,2,56399,11,2,57487,11,2,60280,11,2,60718,1,21.3,-1.2733047,36.8109744,-1.2753109,36.8130185,940,438,371,3881
12432,8327,2289,3,Business,21,3,46309,21,3,46784,21,3,48254,21,3,48610,21,3,51772,7,22.0,-1.2551895,36.7822034,-1.2864674,36.820262,436,3162,475,1826
12433,12629,1271,3,Business,7,5,49049,7,5,50676,7,5,51534,7,5,51668,7,5,52537,8,24.8,-1.3244885,36.897792,-1.3221141,36.8636835,874,869,1627,992
12434,13535,3149,3,Business,20,3,53291,20,3,53300,20,3,53825,20,3,54704,20,3,55687,5,29.2,-1.3004062,36.829741,-1.3167113,36.8301563,349,983,9,1404
12435,15419,53,3,Business,8,4,35903,8,4,36779,8,4,39006,8,4,39099,8,4,40501,6,26.4,-1.2574219,36.7927073,-1.2770708,36.8231093,432,1402,876,2320
12436,3014,1509,3,Personal,2,4,60942,2,4,60984,2,4,61935,2,4,62149,2,4,63200,4,23.7,-1.2701765,36.8109424,-1.2709086,36.7929516,338,1051,42,1165
12437,25539,1075,3,Business,6,3,49996,6,3,50013,6,3,52072,6,3,52179,6,3,53219,3,27.3,-1.2527958,36.8003131,-1.2712193,36.8256876,547,1040,17,2166
12438,25465,2330,3,Business,14,4,57295,14,4,57525,14,4,58113,14,4,59065,14,4,59875,9,27.8,-1.2642903,36.8002137,-1.2326041,36.8009029,611,810,230,1540
12439,17052,1724,3,Business,26,5,38951,26,5,38962,26,5,39273,26,5,39563,26,5,41370,11,23.25888921888938,-1.2551895,36.7822034,-1.2991616,36.8424509,177,1807,11,601
12440,23328,3283,3,Business,22,3,31970,22,3,31984,22,3,32790,22,3,33370,22,3,34050,6,15.3,-1.265715,36.823815,-1.2628473,36.781805,379,680,14,1386
12441,1577,935,1,Personal,1,3,53806,1,3,53900,1,3,55142,1,3,57617,1,3,59578,17,23.9,-1.2960265,36.8780276,-1.3005488,36.7722248,886,1961,94,3717
12442,2245,2956,3,Business,25,5,37366,25,5,37476,25,5,37842,25,5,37970,25,5,38866,2,21.0,-1.279395,36.825364,-1.290894,36.822971,676,896,110,494
12443,9235,1959,1,Business,7,4,59925,7,4,62767,7,4,63585,7,4,64018,7,4,65465,8,17.7,-1.289788,36.824911,-1.2551895,36.7822034,742,1447,2842,1251
12444,27865,2112,3,Business,27,6,37019,27,6,37902,27,6,40153,27,6,40697,27,6,45070,23,23.25888921888938,-1.3472066,36.7692638,-1.2156006,36.8916865,206,4373,883,2795
12445,13338,672,2,Personal,7,2,51344,7,2,51463,7,2,52741,7,2,53083,7,2,54514,7,24.7,-1.2901669,36.7685878,-1.2628938,36.7921146,722,1431,119,1620
12446,9500,1500,3,Business,2,6,38560,2,6,39682,2,6,40741,2,6,40954,2,6,42245,8,27.4,-1.3004062,36.829741,-1.2636051,36.7850995,362,1291,1122,1272
12447,3284,3426,3,Business,5,3,64126,5,3,64143,5,3,64454,5,3,64931,5,3,65528,3,22.4,-1.2765492,36.7669809,-1.3014461,36.7661381,847,597,17,788
12448,16475,2528,3,Business,16,2,49326,16,2,49340,16,2,50167,16,2,50352,16,2,50771,3,23.25888921888938,-1.2584143,36.8048002,-1.2551895,36.7822034,575,419,14,1012
12449,21930,2102,3,Business,3,3,29441,3,3,29496,3,3,29803,3,3,30504,3,3,31678,13,18.5,-1.2613768,36.8019418,-1.3323107,36.8692616,726,1174,55,1008
12450,22153,1205,3,Business,12,2,34865,12,2,35971,12,2,36473,12,2,36786,12,2,39028,9,16.1,-1.2810807,36.8144229,-1.2475136,36.7703179,635,2242,1106,815
12451,17810,2582,3,Business,20,3,59004,20,3,59113,20,3,59773,20,3,59970,20,3,61594,10,27.3,-1.2551895,36.7822034,-1.2985642,36.7707474,953,1624,109,857
12452,7686,661,3,Business,6,4,49797,6,4,49826,6,4,50161,6,4,51176,6,4,52353,6,23.2,-1.2744161,36.8032725,-1.2963097,36.7688221,655,1177,29,1350
12453,19221,3091,3,Business,13,4,52342,13,4,52368,13,4,52459,13,4,52840,13,4,56630,17,23.0,-1.3165542,36.700067,-1.290894,36.822971,582,3790,26,472
12454,267,641,3,Personal,2,2,44885,2,2,44967,2,2,46277,2,2,46413,2,2,48226,14,20.8,-1.2848681,36.7904515,-1.2297202,36.8819507,432,1813,82,1446
12455,4544,2523,3,Business,29,2,52716,29,2,52736,29,2,52788,29,2,53300,29,2,54340,8,27.0,-1.2551895,36.7822034,-1.29387,36.7907813,698,1040,20,564
12456,3721,323,1,Business,8,1,54679,8,1,55271,8,1,56137,8,1,56657,8,1,58520,16,24.9,-1.3861826,36.9349923,-1.3123349,36.9152001,427,1863,592,1386
12457,12460,3496,3,Business,30,2,54628,30,2,55098,30,2,55433,30,2,59741,30,2,60358,7,23.25888921888938,-1.300921,36.828195,-1.2600034,36.807763,613,617,470,4643
12458,11757,3599,3,Business,10,3,42130,10,3,42152,10,3,42463,10,3,43691,10,3,46481,18,28.0,-1.3302996,36.8707935,-1.2323371,36.864817,855,2790,22,1539
12459,359,1578,3,Business,12,3,42890,12,3,42961,12,3,44715,12,3,45246,12,3,48296,10,24.3,-1.225322,36.80855,-1.28878,36.8168312,630,3050,71,2285
12460,16945,3295,3,Business,13,4,51469,13,4,51495,13,4,51911,13,4,52113,13,4,53243,7,23.2,-1.2571472,36.7950633,-1.300663,36.790907,259,1130,26,618
12461,25764,2828,2,Business,16,1,57202,16,1,57213,16,1,57412,16,1,59086,16,1,61848,23,22.6,-1.2615888,36.7928732,-1.3663376,36.6582124,105,2762,11,1873
12462,20178,2987,3,Business,27,4,45385,27,4,45423,27,4,46091,27,4,46187,27,4,47174,3,23.0,-1.270212,36.8210877,-1.2649605,36.7981777,517,987,38,764
12463,20767,391,3,Business,15,5,32139,15,5,32150,15,5,32416,15,5,34297,15,5,35784,5,19.2,-1.300921,36.828195,-1.2867454,36.8259017,119,1487,11,2147
12464,24821,2659,3,Business,3,1,42728,3,1,43130,3,1,43857,3,1,44223,3,1,45617,7,22.4,-1.2917868,36.7872675,-1.269534,36.80697,822,1394,402,1093
12465,13414,685,3,Business,7,5,42121,7,5,42244,7,5,43402,7,5,43583,7,5,45914,8,23.25888921888938,-1.265432,36.795034,-1.2960687,36.8167909,177,2331,123,1339
12466,22971,186,3,Business,28,2,55262,28,2,55398,28,2,56298,28,2,58062,28,2,58661,5,23.5,-1.2825816,36.8092346,-1.2571472,36.7950633,448,599,136,2664
12467,18787,955,2,Personal,4,3,52576,4,3,52747,4,3,53515,4,3,54036,4,3,54751,8,18.4,-1.2579172,36.7938337,-1.2846195,36.7958316,103,715,171,1289
12468,4954,3688,3,Business,20,3,42740,20,3,42766,20,3,43095,20,3,43429,20,3,43916,3,20.3,-1.2551895,36.7822034,-1.2560594,36.7798023,101,487,26,663
12469,3709,2330,3,Business,3,3,62027,3,3,62050,3,3,62794,3,3,62868,3,3,64178,4,23.7,-1.2465253,36.8162559,-1.2267055,36.8013889,391,1310,23,818
12470,16185,2987,3,Business,2,5,38764,2,5,38878,2,5,40201,2,5,40405,2,5,41609,12,23.4,-1.270212,36.8210877,-1.2156006,36.8916865,937,1204,114,1527
12471,1041,640,3,Business,9,2,42164,9,2,42301,9,2,43331,9,2,44772,9,2,44828,7,26.8,-1.2874797,36.8307277,-1.304033,36.7848695,76,56,137,2471
12472,1576,2297,2,Personal,16,6,54040,16,6,54603,16,6,55149,16,6,55501,16,6,56516,8,22.9,-1.290724,36.81947,-1.2473038,36.7884707,844,1015,563,898
12473,19771,1389,3,Business,26,5,60030,26,5,60073,26,5,60886,26,5,62906,26,5,64855,15,23.25888921888938,-1.28878,36.8168312,-1.207546,36.7913976,341,1949,43,2833
12474,12762,3411,1,Personal,20,3,47658,20,3,48184,20,3,48279,20,3,49684,20,3,50887,8,23.2,-1.2855799,36.8176209,-1.2919323,36.7659602,661,1203,526,1500
12475,20099,1042,1,Personal,7,2,56159,7,2,56189,7,2,56530,7,2,56724,7,2,59668,16,24.6,-1.2882462,36.8164538,-1.20079,36.77198,857,2944,30,535
12476,11026,1329,3,Business,20,4,62535,20,4,62572,20,4,62640,20,4,62800,20,4,63784,5,22.8,-1.273056,36.811298,-1.2984974,36.8142189,205,984,37,228
12477,26299,1171,2,Personal,22,2,39064,22,2,39068,22,2,39134,22,2,39710,22,2,42080,34,19.2,-1.2571264,36.8118347,-1.4168588,36.9530035,633,2370,4,642
12478,14535,738,3,Business,5,5,46849,5,5,46928,5,5,48041,5,5,48486,5,5,49601,6,23.6,-1.288148,36.7850276,-1.283813,36.7385728,38,1115,79,1558
12479,7157,2956,3,Business,19,1,44149,19,1,44168,19,1,44230,19,1,44432,19,1,44992,3,24.6,-1.2584143,36.8048002,-1.2551895,36.7822034,551,560,19,264
12480,14775,577,1,Personal,18,4,45192,18,4,45226,18,4,45640,18,4,46591,18,4,49759,12,25.5,-1.3270347,36.8667362,-1.2662728,36.8151265,789,3168,34,1365
12481,17575,2195,3,Business,17,3,55343,17,3,55683,17,3,57442,17,3,57834,17,3,58997,6,23.25888921888938,-1.2296618,36.8438272,-1.228911,36.881876,394,1163,340,2151
12482,7116,3517,3,Business,14,4,40065,14,4,40341,14,4,41022,14,4,42362,14,4,43687,3,23.7,-1.300921,36.828195,-1.315089,36.833064,856,1325,276,2021
12483,6319,2637,3,Personal,5,2,49843,5,2,50057,5,2,51243,5,2,51426,5,2,52705,4,27.3,-1.2575907,36.8060203,-1.2762593,36.8272556,953,1279,214,1369
12484,25280,3621,3,Business,30,4,49265,30,4,49330,30,4,49672,30,4,49961,30,4,51688,14,23.25888921888938,-1.2836583,36.7886014,-1.2206179,36.8488524,676,1727,65,631
12485,9521,3698,3,Business,11,2,55427,11,2,57497,11,2,58478,11,2,59152,11,2,61252,19,21.2,-1.3244885,36.897792,-1.2567393,36.8143232,75,2100,2070,1655
12486,25520,286,3,Business,1,4,36876,1,4,37224,1,4,38357,1,4,38915,1,4,40408,9,23.25888921888938,-1.2551895,36.7822034,-1.2945552,36.8397497,469,1493,348,1691
12487,26484,2169,2,Personal,28,4,50056,28,4,50098,28,4,50479,28,4,50693,28,4,53246,14,23.25888921888938,-1.3205164,36.8098882,-1.2287282,36.8115304,421,2553,42,595
12488,9475,1206,3,Personal,26,4,59307,26,4,59380,26,4,59767,26,4,59934,26,4,60243,2,19.7,-1.2915247,36.8055757,-1.2933834,36.7944832,216,309,73,554
12489,2894,1450,3,Personal,31,5,59625,31,5,59739,31,5,62294,31,5,62644,31,5,64647,6,19.7,-1.2995135,36.7933633,-1.3108386,36.7555239,447,2003,114,2905
12490,24761,432,3,Business,24,5,41865,24,5,48557,24,5,49793,24,5,49866,24,5,53152,11,23.2,-1.2846863,36.7383051,-1.269942,36.801095,372,3286,6692,1309
12491,1635,788,3,Business,25,1,50138,25,1,50157,25,1,51236,25,1,51492,25,1,53725,14,28.2,-1.225322,36.80855,-1.2413316,36.8785525,870,2233,19,1335
12492,27336,1882,3,Business,24,7,55576,24,7,55622,24,7,56342,24,7,57201,24,7,57203,7,23.25888921888938,-1.2956882,36.7861845,-1.2591019,36.800577,119,2,46,1579
12493,5180,186,3,Business,15,1,36048,15,1,36118,15,1,36386,15,1,36905,15,1,37156,1,23.25888921888938,-1.2571472,36.7950633,-1.2606419,36.8055244,648,251,70,787
12494,10208,391,3,Business,25,1,55934,25,1,56217,25,1,59595,25,1,61567,25,1,63031,5,28.3,-1.300921,36.828195,-1.2867454,36.8259017,99,1464,283,5350
12495,14361,970,3,Business,10,1,50779,10,1,50819,10,1,51547,10,1,52136,10,1,52592,2,18.5,-1.2551895,36.7822034,-1.2567251,36.798841,76,456,40,1317
12496,2930,3283,3,Business,19,1,48344,19,1,49488,19,1,49611,19,1,50263,19,1,51554,10,25.1,-1.307143,36.825009,-1.2628473,36.781805,19,1291,1144,775
12497,11214,2658,3,Business,12,5,52458,12,5,52686,12,5,53258,12,5,53428,12,5,56788,8,23.25888921888938,-1.2813012,36.8323962,-1.2963097,36.7688221,787,3360,228,742
12498,18711,3599,3,Business,7,5,33330,7,5,38892,7,5,38907,7,5,39845,7,5,41696,9,25.2,-1.3302996,36.8707935,-1.2939517,36.8446767,609,1851,5562,953
12499,17919,478,3,Business,8,5,47174,8,5,47482,8,5,48075,8,5,48150,8,5,48800,1,24.3,-1.2551895,36.7822034,-1.2538731,36.7850223,467,650,308,668
12500,16727,1927,3,Business,19,2,62036,19,2,62100,19,2,62933,19,2,63388,19,2,64939,12,28.2,-1.279395,36.825364,-1.3472066,36.7692638,26,1551,64,1288
12501,4457,1416,1,Personal,25,2,42619,25,2,42652,25,2,42892,25,2,42986,25,2,43943,10,23.7,-1.284939,36.829984,-1.3241819,36.8823428,409,957,33,334
12502,5894,3013,3,Personal,18,6,36330,18,6,36339,18,6,38477,18,6,39910,18,6,43391,26,19.2,-1.2850644,36.8343657,-1.3510653,36.6665115,208,3481,9,3571
12503,1088,1675,1,Personal,25,6,47832,25,6,47842,25,6,48189,25,6,48263,25,6,49914,18,23.25888921888938,-1.282716,36.821009,-1.2121451,36.9044352,449,1651,10,421
12504,18742,1245,3,Business,28,3,49418,28,3,49437,28,3,49899,28,3,51232,28,3,52905,19,23.25888921888938,-1.300921,36.828195,-1.3198615,36.7110323,74,1673,19,1795
12505,26807,1568,3,Business,28,1,51804,28,1,52201,28,1,52622,28,1,53584,28,1,54849,8,26.2,-1.2897368,36.8226783,-1.263989,36.765174,88,1265,397,1383
12506,2504,3017,3,Business,27,5,55277,27,5,55330,27,5,55598,27,5,55732,27,5,56078,2,24.0,-1.299313,36.7831488,-1.2946558,36.7908316,312,346,53,402
12507,6787,3201,3,Business,28,4,33275,28,4,33290,28,4,33720,28,4,34360,28,4,35262,9,19.5,-1.2967702,36.8040381,-1.2584143,36.8048002,933,902,15,1070
12508,16978,2066,3,Business,6,4,37996,6,4,38126,6,4,39519,6,4,39704,6,4,41525,8,22.1,-1.316961,36.820337,-1.3084775,36.8611883,820,1821,130,1578
12509,25928,704,3,Business,29,1,53982,29,1,53987,29,1,53993,29,1,54171,29,1,55958,18,24.4,-1.2620912,36.8013562,-1.2860183,36.8975338,408,1787,5,184
12510,8819,2200,3,Business,5,2,50173,5,2,51178,5,2,52327,5,2,52463,5,2,53449,4,23.25888921888938,-1.2765736,36.8513646,-1.290894,36.822971,448,986,1005,1285
12511,3413,496,3,Business,30,2,55319,30,2,55813,30,2,57035,30,2,57358,30,2,58593,4,23.25888921888938,-1.2551895,36.7822034,-1.266294,36.8057971,856,1235,494,1545
12512,12242,3222,3,Business,22,2,54221,22,2,54255,22,2,54566,22,2,54766,22,2,55336,3,25.8,-1.2551895,36.7822034,-1.2610837,36.8021315,446,570,34,511
12513,23609,2828,1,Business,5,6,44383,5,6,44396,5,6,46869,5,6,47552,5,6,49263,13,22.4,-1.2141875,36.791039,-1.2615888,36.7928732,658,1711,13,3156
12514,24877,776,1,Personal,15,7,36407,15,7,38430,15,7,39101,15,7,39374,15,7,41213,12,18.1,-1.278967,36.8236745,-1.2664227,36.7453671,467,1839,2023,944
12515,27851,1642,3,Business,22,1,43317,22,1,44915,22,1,46092,22,1,46155,22,1,49266,5,25.0,-1.2728069,36.7962362,-1.2887076,36.8254658,857,3111,1598,1240
12516,9761,1500,3,Business,17,5,49620,17,5,50306,17,5,51453,17,5,53378,17,5,54786,8,23.25888921888938,-1.3004062,36.829741,-1.2638185,36.7930057,868,1408,686,3072
12517,5026,1796,3,Business,8,5,46208,8,5,46222,8,5,46643,8,5,47291,8,5,48233,7,24.1,-1.307143,36.825009,-1.331619,36.847976,718,942,14,1069
12518,15624,2200,3,Business,29,1,54252,29,1,54430,29,1,59025,29,1,59293,29,1,60339,7,24.6,-1.290894,36.822971,-1.2615888,36.7928732,736,1046,178,4863
12519,14537,2330,3,Business,10,5,51110,10,5,51210,10,5,51571,10,5,52990,10,5,55363,9,23.25888921888938,-1.2671943,36.8062533,-1.2124582,36.802894,547,2373,100,1780
12520,23306,909,3,Business,14,2,51510,14,2,51547,14,2,52641,14,2,52953,14,2,52968,1,23.25888921888938,-1.2584143,36.8048002,-1.2527958,36.8003131,445,15,37,1406
12521,12435,3283,3,Business,14,1,35529,14,1,35549,14,1,36080,14,1,36941,14,1,37482,4,20.2,-1.266837,36.799249,-1.2628473,36.781805,427,541,20,1392
12522,10674,3599,3,Business,19,5,44870,19,5,45236,19,5,45250,19,5,48315,19,5,49812,15,25.0,-1.3302996,36.8707935,-1.2912772,36.7734495,874,1497,366,3079
12523,28072,2853,3,Business,3,2,61565,3,2,61754,3,2,62036,3,2,62295,3,2,65290,24,18.5,-1.3700383,36.9190174,-1.2617342,36.7927233,379,2995,189,541
12524,24907,597,3,Business,29,3,42197,29,3,42204,29,3,43091,29,3,43504,29,3,45073,16,18.4,-1.26056,36.703846,-1.2893884,36.828207,229,1569,7,1300
12525,4426,2469,3,Business,28,3,58920,28,3,60069,28,3,63056,28,3,63484,28,3,65037,20,23.2,-1.3802928,36.9364493,-1.308231,36.857306,72,1553,1149,3415
12526,22750,421,3,Business,19,3,53319,19,3,57771,19,3,58296,19,3,59118,19,3,60613,8,24.3,-1.2975066,36.7689423,-1.2737591,36.8142522,607,1495,4452,1347
12527,25410,186,3,Business,2,4,30314,2,4,30327,2,4,31576,2,4,31873,2,4,34314,25,23.25888921888938,-1.3700383,36.9190174,-1.2285835,36.8826468,349,2441,13,1546
12528,10925,516,3,Business,28,1,55403,28,1,55520,28,1,56272,28,1,56357,28,1,56958,3,26.3,-1.2551895,36.7822034,-1.2611987,36.8060913,535,601,117,837
12529,12150,2150,3,Business,13,6,43051,13,6,43097,13,6,43814,13,6,44235,13,6,45781,13,26.1,-1.3033561,36.8163631,-1.344446,36.756597,166,1546,46,1138
12530,7619,2216,3,Business,18,1,43395,18,1,43406,18,1,43568,18,1,43847,18,1,47604,25,27.9,-1.2551895,36.7822034,-1.3888629,36.935984,931,3757,11,441
12531,16312,3355,3,Business,4,2,56755,4,2,56783,4,2,57659,4,2,57734,4,2,59218,12,24.0,-1.2860183,36.8975338,-1.3052491,36.8223899,31,1484,28,951
12532,9359,3599,3,Business,30,2,39632,30,2,41257,30,2,41805,30,2,42997,30,2,45783,8,22.3,-1.3302996,36.8707935,-1.2953659,36.8249462,268,2786,1625,1740
12533,7633,1410,3,Business,11,2,49971,11,2,50079,11,2,50612,11,2,52034,11,2,53715,20,21.4,-1.300921,36.828195,-1.2847613,36.967084,156,1681,108,1955
12534,14219,3647,3,Business,17,4,35721,17,4,35769,17,4,36910,17,4,37820,17,4,37830,6,23.25888921888938,-1.272639,36.794723,-1.2963555,36.8084065,818,10,48,2051
12535,27340,2532,3,Business,21,4,43459,21,4,43480,21,4,43779,21,4,44462,21,4,46185,7,27.9,-1.2824911,36.8218042,-1.2551895,36.7822034,377,1723,21,982
12536,27064,393,3,Business,6,2,28427,6,2,33697,6,2,33977,6,2,35697,6,2,36796,10,19.8,-1.3177547,36.8303703,-1.2574219,36.7927073,62,1099,5270,2000
12537,28029,1482,3,Business,26,1,53204,26,1,53438,26,1,55303,26,1,59090,26,1,59860,8,22.4,-1.3214137,36.8569475,-1.338579,36.8963038,661,770,234,5652
12538,25997,1942,1,Personal,14,4,34921,14,4,37739,14,4,37777,14,4,37930,14,4,41902,8,18.8,-1.2963097,36.7688221,-1.3138647,36.811896,698,3972,2818,191
12539,3238,3621,3,Business,25,1,49809,25,1,49858,25,1,50383,25,1,50546,25,1,51365,6,29.9,-1.2836583,36.7886014,-1.2836832,36.8306719,336,819,49,688
12540,11806,830,3,Business,2,5,56743,2,5,57070,2,5,57666,2,5,58144,2,5,60214,14,25.2,-1.2972659,36.8267178,-1.3681253,36.9155298,779,2070,327,1074
12541,27399,2330,3,Business,10,3,47412,10,3,47456,10,3,48082,10,3,48400,10,3,50335,1,27.8,-1.2642903,36.8002137,-1.2658486,36.8021534,547,1935,44,944
12542,17000,3017,3,Business,9,7,66780,9,7,67000,9,7,68263,9,7,68323,9,7,71718,15,24.3,-1.2993231,36.7753372,-1.3206958,36.8769553,328,3395,220,1323
12543,18706,3186,3,Business,8,3,53898,8,3,53945,8,3,54674,8,3,54762,8,3,56582,8,23.25888921888938,-1.2980229,36.78865,-1.2635089,36.7887337,277,1820,47,817
12544,11076,3097,3,Personal,17,4,51581,17,4,51598,17,4,53286,17,4,53458,17,4,55443,23,27.9,-1.175308,36.950746,-1.271033,36.799323,48,1985,17,1860
12545,23084,2801,3,Business,20,3,30091,20,3,30145,20,3,32959,20,3,33429,20,3,37604,16,20.8,-1.3104506,36.8687235,-1.2595422,36.7871178,373,4175,54,3284
12546,12059,60,3,Business,8,3,34768,8,3,34804,8,3,35190,8,3,36215,8,3,36923,8,17.3,-1.272828,36.816608,-1.2296618,36.8438272,174,708,36,1411
12547,8120,3621,3,Business,19,2,61342,19,2,61358,19,2,61752,19,2,62315,19,2,62965,5,28.2,-1.2836583,36.7886014,-1.2949722,36.7524325,855,650,16,957
12548,20506,1541,3,Business,31,5,55926,31,5,56006,31,5,56986,31,5,57152,31,5,60758,6,24.8,-1.2675557,36.803061,-1.2840461,36.7934021,269,3606,80,1146
12549,22937,3517,3,Business,19,2,45010,19,2,45053,19,2,45736,19,2,46741,19,2,48099,14,27.6,-1.300921,36.828195,-1.3647738,36.7442965,858,1358,43,1688
12550,5705,3517,3,Business,14,2,29662,14,2,29685,14,2,29922,14,2,32283,14,2,34216,16,23.25888921888938,-1.300921,36.828195,-1.3882008,36.7699445,211,1933,23,2598
12551,6366,176,1,Personal,5,2,47245,5,2,47408,5,2,48626,5,2,49434,5,2,50910,15,22.9,-1.330427,36.8931705,-1.2666695,36.8328283,906,1476,163,2026
12552,6930,1927,3,Business,25,6,56095,25,6,56828,25,6,58685,25,6,59638,25,6,61536,19,23.25888921888938,-1.3562374,36.9042954,-1.3472066,36.7692638,384,1898,733,2810
12553,20585,2982,3,Business,24,6,35076,24,6,35210,24,6,36908,24,6,37450,24,6,40564,30,18.4,-1.300921,36.828195,-1.1302992,36.7008781,715,3114,134,2240
12554,8589,1721,3,Business,10,1,35169,10,1,35281,10,1,37075,10,1,38676,10,1,39576,7,18.7,-1.2551895,36.7822034,-1.2995738,36.8199719,2,900,112,3395
12555,19250,1461,2,Personal,8,3,68317,8,3,68335,8,3,69722,8,3,70242,8,3,72283,5,24.1,-1.2720769,36.8180604,-1.2765334,36.8015051,519,2041,18,1907
12556,15730,2956,3,Business,12,5,40290,12,5,40317,12,5,40335,12,5,41046,12,5,44776,3,24.6,-1.2584143,36.8048002,-1.2551895,36.7822034,215,3730,27,729
12557,25372,1597,1,Personal,22,5,51885,22,5,51908,22,5,53075,22,5,53320,22,5,54620,14,23.25888921888938,-1.3159617,36.8117934,-1.3339943,36.7263409,216,1300,23,1412
12558,19892,635,3,Business,22,6,37208,22,6,37226,22,6,37238,22,6,38029,22,6,38523,7,21.2,-1.2599563,36.7993439,-1.3016417,36.8271679,179,494,18,803
12559,11807,2306,3,Business,18,1,35184,18,1,35342,18,1,37387,18,1,37904,18,1,41078,17,22.1,-1.3241108,36.8692908,-1.2271998,36.8084905,611,3174,158,2562
12560,18046,510,3,Business,1,1,51585,1,1,51617,1,1,52049,1,1,52762,1,1,55540,21,25.6,-1.225322,36.80855,-1.2860183,36.8975338,882,2778,32,1145
12561,24878,1500,3,Business,12,5,50466,12,5,50490,12,5,50498,12,5,52136,12,5,53497,8,23.25888921888938,-1.3004062,36.829741,-1.2638185,36.7930057,349,1361,24,1646
12562,11707,2218,1,Personal,8,1,50294,8,1,50355,8,1,50718,8,1,51123,8,1,52552,13,24.9,-1.2600219,36.8019631,-1.2239755,36.7087131,932,1429,61,768
12563,18122,2804,3,Business,18,5,53280,18,5,53430,18,5,54106,18,5,54335,18,5,55444,11,27.0,-1.3229204,36.8190265,-1.2551895,36.7822034,111,1109,150,905
12564,17288,3404,3,Business,17,1,33783,17,1,33887,17,1,34328,17,1,34960,17,1,35468,4,19.2,-1.279395,36.825364,-1.2790653,36.7907262,194,508,104,1073
12565,20115,248,3,Business,18,3,52122,18,3,52159,18,3,52757,18,3,53141,18,3,54876,8,20.9,-1.304735,36.7846054,-1.265715,36.808525,844,1735,37,982
12566,13851,510,3,Business,6,3,41156,6,3,41180,6,3,41987,6,3,45811,6,3,45814,20,23.25888921888938,-1.3472066,36.7692638,-1.2860183,36.8975338,533,3,24,4631
12567,5744,2521,3,Business,3,6,30260,3,6,34068,3,6,34762,3,6,35965,3,6,36553,4,19.7,-1.3177547,36.8303703,-1.3004062,36.829741,331,588,3808,1897
12568,18332,2436,3,Business,2,2,39397,2,2,39524,2,2,40238,2,2,40571,2,2,42176,12,26.0,-1.2571472,36.7950633,-1.2647206,36.7259313,470,1605,127,1047
12569,27662,1500,3,Business,3,3,42824,3,3,43002,3,3,44419,3,3,44637,3,3,49480,11,27.3,-1.3077869,36.8443207,-1.2638185,36.7930057,155,4843,178,1635
12570,14752,2069,3,Business,10,5,59647,10,5,60814,10,5,61216,10,5,61650,10,5,63564,12,23.25888921888938,-1.266837,36.799249,-1.228911,36.881876,787,1914,1167,836
12571,20445,1471,3,Business,19,3,57826,19,3,57854,19,3,57928,19,3,58093,19,3,58409,3,24.4,-1.2551895,36.7822034,-1.2560455,36.7800867,708,316,28,239
12572,3910,633,3,Business,3,6,40334,3,6,40536,3,6,41965,3,6,42730,3,6,43562,4,23.5,-1.3177547,36.8303703,-1.3004062,36.829741,56,832,202,2194
12573,11332,951,1,Personal,5,3,57426,5,3,57441,5,3,57726,5,3,58062,5,3,59376,15,23.8,-1.256731,36.7525716,-1.229805,36.803534,116,1314,15,621
12574,12076,1363,3,Business,29,5,37194,29,5,38064,29,5,40763,29,5,41012,29,5,42790,9,26.7,-1.3004062,36.829741,-1.2544109,36.8460525,291,1778,870,2948
12575,15688,1761,3,Business,27,4,53660,27,4,53705,27,4,54421,27,4,54727,27,4,58040,28,24.9,-1.3339943,36.7263409,-1.2134646,36.8755266,123,3313,45,1022
12576,19905,567,3,Business,28,4,54229,28,4,54867,28,4,55552,28,4,56511,28,4,58542,10,30.1,-1.3108783,36.8392726,-1.2963097,36.7688221,607,2031,638,1644
12577,25297,346,3,Business,14,2,57752,14,2,57895,14,2,58059,14,2,58359,14,2,59989,10,23.25888921888938,-1.28878,36.8168312,-1.3246455,36.8754415,276,1630,143,464
12578,1737,2154,3,Business,21,1,56001,21,1,59103,21,1,59679,21,1,59822,21,1,63436,20,25.2,-1.3165542,36.700067,-1.2765736,36.8513646,509,3614,3102,719
12579,18724,186,3,Business,9,3,31002,9,3,31082,9,3,31868,9,3,32362,9,3,33063,6,20.0,-1.2571472,36.7950633,-1.298529,36.816482,178,701,80,1280
12580,8162,1162,3,Business,6,5,34463,6,5,34871,6,5,35811,6,5,36170,6,5,38258,5,14.9,-1.312261,36.794658,-1.281577,36.7938293,465,2088,408,1299
12581,21867,3283,3,Business,17,4,39037,17,4,39064,17,4,39697,17,4,40674,17,4,41864,13,25.6,-1.2296618,36.8438272,-1.2628473,36.781805,902,1190,27,1610
12582,23898,2402,3,Business,19,2,57419,19,2,57488,19,2,58570,19,2,58939,19,2,59997,7,29.5,-1.2963097,36.7688221,-1.2905407,36.8221856,855,1058,69,1451
12583,14282,136,3,Business,31,4,31556,31,4,31581,31,4,34196,31,4,34339,31,4,38877,16,20.6,-1.3254522,36.7216584,-1.281614,36.8275424,831,4538,25,2758
12584,67,517,3,Business,30,4,48995,30,4,49012,30,4,49192,30,4,49426,30,4,51206,14,23.25888921888938,-1.3228003,36.8306435,-1.2991441,36.7528804,349,1780,17,414
12585,23936,517,3,Business,29,3,36971,29,3,37196,29,3,37537,29,3,38312,29,3,39719,11,23.25888921888938,-1.3228003,36.8306435,-1.2638185,36.7930057,16,1407,225,1116
12586,5162,543,3,Business,19,6,38372,19,6,38661,19,6,39334,19,6,39654,19,6,40440,5,21.5,-1.306654,36.841897,-1.3094562,36.8167806,892,786,289,993
12587,23719,3291,3,Business,15,3,33929,15,3,33969,15,3,34319,15,3,35441,15,3,36883,11,16.5,-1.303596,36.778378,-1.2600926,36.8088685,88,1442,40,1472
12588,15266,3744,3,Business,3,4,48392,3,4,48456,3,4,49144,3,4,49505,3,4,52132,20,25.9,-1.2701979,36.8138177,-1.3361484,36.9161128,812,2627,64,1049
12589,6220,190,3,Business,27,3,44608,27,3,44628,27,3,44740,27,3,44828,27,3,45690,8,26.3,-1.3270347,36.8667362,-1.332624,36.913187,813,862,20,200
12590,19939,2616,3,Personal,5,6,56565,5,6,56963,5,6,58147,5,6,59518,5,6,61717,14,23.9,-1.1891303,36.896427,-1.27871,36.8751139,304,2199,398,2555
12591,8189,693,2,Personal,15,1,52041,15,1,52052,15,1,52783,15,1,53549,15,1,56551,21,23.25888921888938,-1.3791465,36.7514836,-1.2580991,36.7941519,228,3002,11,1497
12592,25262,2042,3,Business,9,4,47133,9,4,47184,9,4,47857,9,4,50867,9,4,52346,18,25.7,-1.2860183,36.8975338,-1.2592428,36.7894541,874,1479,51,3683
12593,27286,1329,3,Business,6,3,39388,6,3,39421,6,3,39801,6,3,39891,6,3,40561,3,23.25888921888938,-1.273056,36.811298,-1.2641579,36.8216792,660,670,33,470
12594,7262,567,3,Business,14,4,49950,14,4,49980,14,4,50266,14,4,50780,14,4,51756,9,27.8,-1.309056,36.8277209,-1.2963097,36.7688221,206,976,30,800
12595,24452,393,3,Business,8,5,40389,8,5,40439,8,5,41088,8,5,41949,8,5,42507,4,28.6,-1.3167113,36.8301563,-1.3004062,36.829741,701,558,50,1510
12596,3127,3560,3,Business,6,2,53190,6,2,57481,6,2,58606,6,2,59699,6,2,60244,2,23.25888921888938,-1.2882184,36.826346,-1.279395,36.825364,237,545,4291,2218
12597,5115,136,3,Business,3,5,56665,3,5,57178,3,5,58079,3,5,58183,3,5,59269,9,23.25888921888938,-1.2654716,36.7983635,-1.2313147,36.8016863,205,1086,513,1005
12598,8227,248,3,Business,27,3,51305,27,3,51325,27,3,52898,27,3,53201,27,3,54943,9,29.6,-1.304735,36.7846054,-1.2635089,36.7887337,314,1742,20,1876
12599,27834,393,3,Business,2,5,51075,2,5,57292,2,5,57326,2,5,57791,2,5,59472,10,25.1,-1.3177547,36.8303703,-1.2574219,36.7927073,731,1681,6217,499
12600,18,1205,3,Business,11,4,40612,11,4,40627,11,4,40924,11,4,41344,11,4,42583,8,25.4,-1.2495931,36.8065087,-1.2942896,36.8020525,205,1239,15,717
12601,4403,1245,3,Business,22,6,33108,22,6,33116,22,6,33821,22,6,35788,22,6,37179,19,19.9,-1.300921,36.828195,-1.3198615,36.7110323,424,1391,8,2672
12602,7110,265,3,Business,12,1,50377,12,1,50471,12,1,51015,12,1,54270,12,1,54593,16,26.8,-1.300921,36.828195,-1.2285995,36.9012372,70,323,94,3799
12603,17149,3262,3,Personal,12,2,61978,12,2,62034,12,2,62906,12,2,63640,12,2,66460,36,28.6,-1.306219,36.8699124,-1.0921599,37.005025,675,2820,56,1606
12604,27138,517,3,Business,5,6,38048,5,6,38065,5,6,38269,5,6,38382,5,6,38830,4,22.5,-1.3177547,36.8303703,-1.3004062,36.829741,543,448,17,317
12605,6681,3674,3,Business,12,2,37412,12,2,37423,12,2,37787,12,2,38141,12,2,40786,13,28.0,-1.2551895,36.7822034,-1.3184737,36.862645,520,2645,11,718
12606,14909,2330,3,Business,26,2,45048,26,2,45134,26,2,46083,26,2,46519,26,2,47457,7,27.5,-1.2325706,36.8083923,-1.2536275,36.7987932,318,938,86,1385
12607,15296,868,3,Business,8,2,45444,8,2,45498,8,2,45698,8,2,46087,8,2,47170,8,23.3,-1.303596,36.778378,-1.265715,36.823815,878,1083,54,589
12608,26056,661,3,Business,15,3,55355,15,3,57440,15,3,58279,15,3,58638,15,3,60048,4,21.8,-1.2950044,36.7512209,-1.2963097,36.7688221,140,1410,2085,1198
12609,8483,393,3,Business,26,2,44771,26,2,44793,26,2,44960,26,2,45313,26,2,48012,11,27.4,-1.3167113,36.8301563,-1.2638185,36.7930057,168,2699,22,520
12610,23136,1075,3,Business,18,1,60035,18,1,60648,18,1,61629,18,1,61800,18,1,64190,13,29.4,-1.2285835,36.8826468,-1.2527958,36.8003131,452,2390,613,1152
12611,25033,3747,1,Personal,24,2,44032,24,2,44056,24,2,44581,24,2,44658,24,2,47357,20,17.5,-1.2602386,36.7503491,-1.2628424,36.8950641,735,2699,24,602
12612,3028,1544,3,Business,23,4,37029,23,4,37074,23,4,37853,23,4,38189,23,4,39866,14,23.1,-1.3184737,36.862645,-1.2748221,36.7817865,440,1677,45,1115
12613,12976,1209,3,Business,4,6,40837,4,6,41076,4,6,41089,4,6,42323,4,6,42950,5,23.25888921888938,-1.2770708,36.8231093,-1.3004062,36.829741,68,627,239,1247
12614,15376,1133,3,Business,28,4,51441,28,4,51506,28,4,52316,28,4,52640,28,4,54562,13,27.4,-1.2944292,36.7793569,-1.3263105,36.8622904,599,1922,65,1134
12615,18393,3686,3,Business,24,3,36354,24,3,37096,24,3,37182,24,3,37266,24,3,39448,8,16.8,-1.2551895,36.7822034,-1.296814,36.8162263,263,2182,742,170
12616,19362,3080,3,Business,5,5,55322,5,5,55335,5,5,55357,5,5,56077,5,5,58794,16,26.4,-1.2551895,36.7822034,-1.3194518,36.869396,450,2717,13,742
12617,20472,3291,3,Business,4,6,44071,4,6,45073,4,6,46443,4,6,47391,4,6,49093,17,23.25888921888938,-1.344446,36.756597,-1.2600926,36.8088685,538,1702,1002,2318
12618,17755,533,3,Business,21,2,43951,21,2,44056,21,2,44059,21,2,44420,21,2,45063,7,22.7,-1.2551895,36.7822034,-1.2763494,36.7671783,576,643,105,364
12619,15174,3765,1,Personal,13,1,50111,13,1,50117,13,1,50503,13,1,50914,13,1,52020,5,19.3,-1.279161,36.7692332,-1.2858511,36.7946184,329,1106,6,797
12620,9384,2464,3,Business,31,5,61740,31,5,62020,31,5,62023,31,5,62113,31,5,62901,7,23.5,-1.279395,36.825364,-1.2551895,36.7822034,79,788,280,93
12621,6822,978,1,Personal,11,1,50385,11,1,50474,11,1,50985,11,1,52132,11,1,53370,10,23.1,-1.3084067,36.8345014,-1.3295083,36.8844022,726,1238,89,1658
12622,4278,1280,3,Business,6,4,32365,6,4,32434,6,4,32635,6,4,33001,6,4,36452,15,16.3,-1.2551895,36.7822034,-1.3288106,36.8697344,155,3451,69,567
12623,3966,939,2,Personal,4,2,34362,4,2,34389,4,2,35757,4,2,35828,4,2,36545,5,16.5,-1.268499,36.746882,-1.281722,36.762926,116,717,27,1439
12624,5087,265,3,Business,12,2,53357,12,2,53377,12,2,53749,12,2,54072,12,2,55750,19,27.2,-1.300921,36.828195,-1.3886344,36.9372718,283,1678,20,695
12625,111,1809,3,Business,6,2,42544,6,2,42551,6,2,42995,6,2,44397,6,2,44986,2,25.1,-1.2527958,36.8003131,-1.2571472,36.7950633,720,589,7,1846
12626,6794,868,3,Business,31,4,34205,31,4,34261,31,4,34837,31,4,35506,31,4,36410,6,17.5,-1.307143,36.825009,-1.265715,36.823815,100,904,56,1245
12627,3695,1544,3,Business,18,6,47119,18,6,47350,18,6,47779,18,6,48079,18,6,50242,7,21.0,-1.2873431,36.8236273,-1.2924173,36.7797814,868,2163,231,729
12628,27363,722,3,Business,29,1,53989,29,1,54070,29,1,55230,29,1,56966,29,1,58540,15,23.25888921888938,-1.32943,36.894243,-1.3041129,36.8104939,856,1574,81,2896
12629,10197,3547,3,Business,7,4,40387,7,4,40401,7,4,41316,7,4,41550,7,4,45505,18,24.5,-1.3189252,36.8617269,-1.2856319,36.7672998,876,3955,14,1149
12630,7960,3291,3,Business,11,6,55217,11,6,55253,11,6,56058,11,6,56309,11,6,56994,5,23.25888921888938,-1.2628473,36.781805,-1.2600926,36.8088685,256,685,36,1056
12631,4075,3239,3,Personal,31,2,32880,31,2,32893,31,2,33286,31,2,33659,31,2,35358,14,16.8,-1.2836832,36.8306719,-1.3094179,36.7185918,414,1699,13,766
12632,8636,2912,2,Personal,27,1,47149,27,1,47178,27,1,47455,27,1,47798,27,1,49380,17,24.0,-1.2601,36.796528,-1.2036664,36.8192622,898,1582,29,620
12633,28234,893,3,Business,3,1,45277,3,1,45370,3,1,46150,3,1,46394,3,1,47843,13,21.7,-1.2663194,36.809901,-1.247957,36.879598,574,1449,93,1024
12634,7779,1500,3,Business,3,3,49203,3,3,49225,3,3,50516,3,3,53320,3,3,53330,8,28.0,-1.3004062,36.829741,-1.2638185,36.7930057,216,10,22,4095
12635,19333,2227,3,Personal,17,4,40752,17,4,40809,17,4,41764,17,4,41940,17,4,43408,5,25.6,-1.2541275,36.8263055,-1.2546709,36.798938,589,1468,57,1131
12636,11632,1985,1,Personal,15,2,40952,15,2,41002,15,2,43570,15,2,43734,15,2,47387,17,22.7,-1.265568,36.882778,-1.3374229,36.9091381,661,3653,50,2732
12637,3116,830,3,Business,27,4,52015,27,4,52442,27,4,52564,27,4,53680,27,4,55307,7,25.1,-1.2551895,36.7822034,-1.2822909,36.8193456,96,1627,427,1238
12638,23735,635,3,Business,7,1,42548,7,1,42629,7,1,42761,7,1,43693,7,1,45171,11,24.9,-1.2599563,36.7993439,-1.3229345,36.8566974,541,1478,81,1064
12639,12698,3674,3,Business,26,2,36162,26,2,36170,26,2,36194,26,2,36490,26,2,36805,2,21.8,-1.2551895,36.7822034,-1.2657756,36.7926481,291,315,8,320
12640,208,2700,3,Business,8,6,64578,8,6,68960,8,6,69842,8,6,71412,8,6,72565,8,17.8,-1.3052672,36.7538539,-1.2845835,36.8079121,267,1153,4382,2452
12641,16451,1880,3,Business,23,3,46086,23,3,46166,23,3,47526,23,3,47624,23,3,48918,7,23.25888921888938,-1.2571472,36.7950633,-1.2981102,36.8293513,660,1294,80,1458
12642,25624,393,3,Business,5,5,37227,5,5,37251,5,5,37264,5,5,39299,5,5,39301,14,24.5,-1.3167113,36.8301563,-1.2991441,36.7528804,515,2,24,2048
12643,7189,186,3,Business,13,3,44813,13,3,44829,13,3,45245,13,3,45783,13,3,46815,7,23.25888921888938,-1.2825816,36.8092346,-1.2571472,36.7950633,343,1032,16,954
12644,6529,2066,3,Business,23,5,47654,23,5,47771,23,5,49669,23,5,50033,23,5,52922,14,26.6,-1.3210189,36.8410551,-1.2751598,36.9229874,31,2889,117,2262
12645,10705,868,3,Business,15,6,39010,15,6,39114,15,6,40705,15,6,41424,15,6,43360,14,19.3,-1.293515,36.897607,-1.2663631,36.8163329,709,1936,104,2310
12646,16743,421,3,Business,18,2,48001,18,2,48029,18,2,49220,18,2,49419,18,2,52978,28,25.7,-1.2975066,36.7689423,-1.1605816,36.8977958,457,3559,28,1390
12647,3674,716,3,Personal,6,1,40520,6,1,42030,6,1,42886,6,1,43064,6,1,44524,14,20.7,-1.257309,36.8060084,-1.218673,36.8888713,726,1460,1510,1034
12648,4897,3647,3,Business,29,2,59041,29,2,59121,29,2,60344,29,2,60602,29,2,62977,8,23.25888921888938,-1.272639,36.794723,-1.2965924,36.8179314,755,2375,80,1481
12649,15412,723,1,Personal,31,2,44814,31,2,44860,31,2,45509,31,2,45965,31,2,46407,3,18.3,-1.3034735,36.7986213,-1.2985749,36.8088,88,442,46,1105
12650,230,1809,3,Business,15,2,53541,15,2,53576,15,2,53855,15,2,54697,15,2,55078,2,24.8,-1.2527958,36.8003131,-1.2571472,36.7950633,634,381,35,1121
12651,4743,2828,3,Business,26,3,51368,26,3,51414,26,3,51870,26,3,52329,26,3,53047,5,27.0,-1.3346773,36.8842734,-1.3207349,36.8819157,770,718,46,915
12652,11615,1482,3,Business,18,1,37842,18,1,37973,18,1,38077,18,1,39363,18,1,40455,6,27.8,-1.2990813,36.8034213,-1.2649605,36.7981777,71,1092,131,1390
12653,7646,60,3,Business,14,5,59329,14,5,59370,14,5,59387,14,5,60458,14,5,62160,14,21.6,-1.2628473,36.781805,-1.2296618,36.8438272,564,1702,41,1088
12654,16632,2154,3,Business,29,4,51806,29,4,56602,29,4,57164,29,4,58100,29,4,59939,8,24.9,-1.2527958,36.8003131,-1.2765736,36.8513646,434,1839,4796,1498
12655,11123,510,3,Business,20,1,46688,20,1,46805,20,1,46887,20,1,47937,20,1,50247,15,20.3,-1.2860183,36.8975338,-1.2668734,36.8054026,179,2310,117,1132
12656,7028,2330,3,Business,2,4,62722,2,4,62731,2,4,62783,2,4,63751,2,4,65117,9,23.25888921888938,-1.2536275,36.7987932,-1.2687407,36.7373043,205,1366,9,1020
12657,21469,700,3,Business,25,2,36634,25,2,36696,25,2,37951,25,2,38266,25,2,39732,11,23.7,-1.3205164,36.8098882,-1.2551856,36.7822492,329,1466,62,1570
12658,15918,2626,3,Business,27,6,39176,27,6,39192,27,6,40173,27,6,40738,27,6,42868,3,23.25888921888938,-1.3043649,36.7816132,-1.2954956,36.7603858,948,2130,16,1546
12659,19268,2829,3,Business,24,5,50503,24,5,50543,24,5,51266,24,5,51918,24,5,54388,21,22.9,-1.2571472,36.7950633,-1.3562374,36.9042954,564,2470,40,1375
12660,9422,2927,2,Personal,3,3,55942,3,3,56217,3,3,57453,3,3,57936,3,3,59417,12,26.8,-1.3472066,36.7692638,-1.285382,36.8162878,726,1481,275,1719
12661,23905,53,3,Business,10,1,51389,10,1,52580,10,1,54828,10,1,55446,10,1,57774,8,18.2,-1.3167113,36.8301563,-1.2770708,36.8231093,55,2328,1191,2866
12662,9593,2587,3,Business,7,1,29958,7,1,30037,7,1,30521,7,1,30700,7,1,33014,5,21.2,-1.28878,36.8168312,-1.2591019,36.800577,404,2314,79,663
12663,24012,3300,3,Business,1,1,45722,1,1,47136,1,1,48003,1,1,49532,1,1,50843,8,23.25888921888938,-1.272828,36.816608,-1.303596,36.778378,61,1311,1414,2396
12664,4529,1873,3,Business,5,2,51925,5,2,51970,5,2,52100,5,2,52539,5,2,56783,21,23.25888921888938,-1.2571472,36.7950633,-1.3190102,36.9230693,620,4244,45,569
12665,21423,2750,3,Business,13,2,36742,13,2,36887,13,2,37260,13,2,37367,13,2,38395,7,19.8,-1.275442,36.7660207,-1.289235,36.8135805,778,1028,145,480
12666,22355,633,3,Business,4,1,43571,4,1,43594,4,1,43742,4,1,44396,4,1,45153,4,25.4,-1.3077869,36.8443207,-1.3004062,36.829741,829,757,23,802
12667,14822,2677,3,Business,24,4,34910,24,4,34930,24,4,35410,24,4,36148,24,4,39955,14,19.2,-1.3228003,36.8306435,-1.306378,36.7519845,216,3807,20,1218
12668,5883,718,3,Business,11,2,58299,11,2,58496,11,2,58752,11,2,58951,11,2,61023,12,21.2,-1.2551895,36.7822034,-1.3114499,36.7425836,80,2072,197,455
12669,23666,1245,3,Business,2,6,31808,2,6,31854,2,6,32906,2,6,33903,2,6,36403,17,21.0,-1.300921,36.828195,-1.3198615,36.7110323,468,2500,46,2049
12670,4371,1148,3,Business,5,6,31318,5,6,32984,5,6,34042,5,6,34532,5,6,35884,9,18.9,-1.3100586,36.8500329,-1.2703428,36.8336071,742,1352,1666,1548
12671,18930,46,3,Business,19,2,38279,19,2,38346,19,2,39939,19,2,40691,19,2,42564,7,27.7,-1.2836832,36.8306719,-1.3056581,36.8445565,849,1873,67,2345
12672,7578,563,1,Personal,25,2,58404,25,2,58603,25,2,59515,25,2,60204,25,2,61186,9,24.2,-1.2595707,36.7634701,-1.2747337,36.8320368,812,982,199,1601
12673,16975,886,3,Personal,15,3,56505,15,3,56564,15,3,57123,15,3,57288,15,3,57971,4,21.7,-1.2918246,36.801585,-1.2818812,36.8268142,857,683,59,724
12674,15278,2393,1,Personal,11,4,36156,11,4,36179,11,4,37735,11,4,38094,11,4,40459,19,23.8,-1.2518057,36.7997135,-1.3337086,36.7658431,446,2365,23,1915
12675,1238,3232,3,Business,31,3,59716,31,3,59748,31,3,59937,31,3,60039,31,3,62174,8,24.4,-1.2551895,36.7822034,-1.3010059,36.8216816,199,2135,32,291
12676,1529,3222,3,Business,4,4,42735,4,4,42770,4,4,43134,4,4,43828,4,4,47614,16,25.4,-1.2551895,36.7822034,-1.3189252,36.8617269,932,3786,35,1058
12677,11257,3283,3,Business,22,5,48874,22,5,50051,22,5,51192,22,5,51636,22,5,53040,13,31.0,-1.2296618,36.8438272,-1.2628473,36.781805,770,1404,1177,1585
12678,990,2066,3,Business,27,5,53092,27,5,53097,27,5,53540,27,5,58203,27,5,58865,7,24.2,-1.316961,36.820337,-1.299313,36.7831488,857,662,5,5106
12679,27377,3661,3,Business,8,4,34717,8,4,34725,8,4,37371,8,4,37508,8,4,39374,19,20.6,-1.2134646,36.8755266,-1.3208162,36.8451209,265,1866,8,2783
12680,26250,2828,3,Business,22,3,59295,22,3,59513,22,3,62686,22,3,62819,22,3,64153,7,23.3,-1.2918239,36.8235665,-1.2615888,36.7928732,674,1334,218,3306
12681,1673,2677,3,Business,17,4,36237,17,4,36260,17,4,37167,17,4,37805,17,4,39759,4,23.25888921888938,-1.2784722,36.7556652,-1.306378,36.7519845,761,1954,23,1545
12682,13758,3689,3,Business,8,6,53405,8,6,53427,8,6,53548,8,6,53894,8,6,54819,5,24.8,-1.2527958,36.8003131,-1.2793686,36.8259233,820,925,22,467
12683,20890,3718,3,Business,17,1,37087,17,1,37097,17,1,37478,17,1,37639,17,1,38689,3,18.9,-1.2650027,36.8126242,-1.272639,36.794723,259,1050,10,542
12684,27877,743,1,Personal,29,3,60444,29,3,60647,29,3,62118,29,3,62806,29,3,65303,18,19.3,-1.4099456,36.9458118,-1.32189,36.8589727,350,2497,203,2159
12685,1284,262,3,Business,24,4,37690,24,4,37710,24,4,38426,24,4,39395,24,4,41920,14,21.2,-1.320673,36.865661,-1.263194,36.797624,620,2525,20,1685
12686,13170,3115,3,Business,7,3,49485,7,3,49516,7,3,50367,7,3,50662,7,3,53203,17,28.1,-1.2963097,36.7688221,-1.2482465,36.8889062,131,2541,31,1146
12687,24134,136,3,Business,4,2,56226,4,2,57632,4,2,57651,4,2,58898,4,2,58900,9,23.6,-1.2326041,36.8009029,-1.2649605,36.7981777,598,2,1406,1266
12688,16719,2069,3,Business,6,4,38528,6,4,38555,6,4,38705,6,4,39246,6,4,40497,12,24.3,-1.2600926,36.8088685,-1.228911,36.881876,31,1251,27,691
12689,19338,136,3,Business,21,4,35633,21,4,37281,21,4,38314,21,4,38642,21,4,40970,11,25.1,-1.3254522,36.7216584,-1.2913552,36.7875945,831,2328,1648,1361
12690,1361,633,3,Business,8,5,55613,8,5,56496,8,5,56950,8,5,57159,8,5,58217,9,30.5,-1.2638185,36.7930057,-1.3004062,36.829741,245,1058,883,663
12691,21405,394,3,Personal,26,5,41591,26,5,41807,26,5,43301,26,5,43710,26,5,45186,6,23.25888921888938,-1.2741662,36.7969144,-1.2908945,36.8246514,953,1476,216,1903
12692,21109,1459,3,Business,16,2,58587,16,2,58715,16,2,59521,16,2,60275,16,2,60978,6,25.1,-1.2764786,36.8194788,-1.264945,36.784678,427,703,128,1560
12693,631,2102,3,Business,5,1,53137,5,1,53194,5,1,54289,5,1,54741,5,1,56748,15,26.0,-1.3323107,36.8692616,-1.2613768,36.8019418,485,2007,57,1547
12694,22723,311,3,Business,16,2,52513,16,2,52536,16,2,53556,16,2,55874,16,2,55876,21,23.25888921888938,-1.3700383,36.9190174,-1.2917868,36.7872675,863,2,23,3338
12695,25098,3647,3,Business,5,1,58701,5,1,59219,5,1,59916,5,1,61666,5,1,62038,8,24.6,-1.272639,36.794723,-1.305399,36.8221849,403,372,518,2447
12696,11135,1245,3,Business,28,4,36887,28,4,36903,28,4,36911,28,4,38070,28,4,40168,17,28.2,-1.300921,36.828195,-1.3198615,36.7110323,581,2098,16,1167
12697,26442,1612,1,Personal,8,5,33322,8,5,35692,8,5,37028,8,5,37477,8,5,39116,9,15.4,-1.260232,36.807334,-1.3066143,36.8161046,908,1639,2370,1785
12698,21286,1209,3,Business,18,4,52404,18,4,52424,18,4,52428,18,4,53365,18,4,54457,9,23.25888921888938,-1.2638185,36.7930057,-1.3004062,36.829741,349,1092,20,941
12699,17422,3183,1,Personal,29,3,55598,29,3,60124,29,3,60632,29,3,60916,29,3,62466,16,19.2,-1.2994855,36.8164026,-1.364627,36.7410927,216,1550,4526,792
12700,19489,393,3,Business,8,2,37068,8,2,37114,8,2,37293,8,2,37653,8,2,39380,14,19.0,-1.3167113,36.8301563,-1.306378,36.7519845,523,1727,46,539
12701,24845,2894,3,Business,30,5,60716,30,5,61012,30,5,61637,30,5,61942,30,5,62549,3,22.2,-1.2906618,36.8131222,-1.2961952,36.7876396,79,607,296,930
12702,16423,2216,3,Business,5,3,41313,5,3,42249,5,3,44477,5,3,44755,5,3,45737,5,22.6,-1.2551895,36.7822034,-1.2658053,36.7920955,167,982,936,2506
12703,22431,1502,3,Business,18,4,37859,18,4,37883,18,4,38501,18,4,38614,18,4,40218,13,23.25888921888938,-1.2584143,36.8048002,-1.2232123,36.8932547,797,1604,24,731
12704,14915,1955,3,Business,27,3,49998,27,3,50203,27,3,50603,27,3,51164,27,3,52591,7,29.5,-1.2551895,36.7822034,-1.2878961,36.8305648,910,1427,205,961
12705,10947,3727,3,Business,9,3,44227,9,3,44255,9,3,44338,9,3,44821,9,3,45894,3,25.1,-1.2963097,36.7688221,-1.2860203,36.7832538,952,1073,28,566
12706,14513,2200,3,Business,5,5,47629,5,5,47682,5,5,50639,5,5,51680,5,5,52182,2,26.8,-1.279395,36.825364,-1.290894,36.822971,736,502,53,3998
12707,15748,393,3,Business,13,3,45569,13,3,45581,13,3,45586,13,3,46223,13,3,47922,14,24.9,-1.3167113,36.8301563,-1.306378,36.7519845,901,1699,12,642
12708,20824,1502,3,Business,7,5,45774,7,5,48260,7,5,48386,7,5,49783,7,5,50721,12,26.9,-1.2856017,36.8129897,-1.2232123,36.8932547,450,938,2486,1523
12709,27432,604,3,Business,16,4,31028,16,4,31559,16,4,32087,16,4,32326,16,4,32931,9,23.25888921888938,-1.2551895,36.7822034,-1.256731,36.7525716,103,605,531,767
12710,13158,1245,3,Business,6,6,41456,6,6,41473,6,6,44449,6,6,45117,6,6,47323,15,26.8,-1.300921,36.828195,-1.2121659,36.8112437,448,2206,17,3644
12711,25204,84,3,Business,10,1,58419,10,1,58691,10,1,60259,10,1,60404,10,1,63293,22,18.9,-1.2551895,36.7822034,-1.3562374,36.9042954,150,2889,272,1713
12712,12396,553,3,Business,5,4,51118,5,4,52405,5,4,52797,5,4,53502,5,4,54692,7,22.1,-1.2551895,36.7822034,-1.2815072,36.82096,629,1190,1287,1097
12713,327,1205,3,Business,10,4,41234,10,4,41267,10,4,42151,10,4,43680,10,4,45163,16,24.8,-1.2810807,36.8144229,-1.3395432,36.7230183,31,1483,33,2413
12714,6843,59,3,Business,28,4,49825,28,4,50496,28,4,51338,28,4,55373,28,4,55575,4,27.4,-1.2765736,36.8513646,-1.290894,36.822971,436,202,671,4877
12715,16,346,3,Business,5,2,43623,5,2,44017,5,2,44029,5,2,45114,5,2,45122,3,23.8,-1.28878,36.8168312,-1.2676593,36.8103939,70,8,394,1097
12716,7100,3147,3,Business,31,4,42825,31,4,44215,31,4,45126,31,4,46325,31,4,47868,18,26.7,-1.3456196,36.9070132,-1.3467389,36.7690312,191,1543,1390,2110
12717,14214,2412,3,Business,2,2,43385,2,2,43405,2,2,43421,2,2,43709,2,2,45059,13,21.0,-1.2571472,36.7950633,-1.2297202,36.8819507,31,1350,20,304
12718,494,2189,1,Personal,25,5,40653,25,5,40736,25,5,42663,25,5,43953,25,5,45553,11,20.9,-1.2777824,36.8977804,-1.3226302,36.8719901,116,1600,83,3217
12719,26534,633,3,Business,25,1,43902,25,1,43961,25,1,44757,25,1,45065,25,1,46861,12,25.7,-1.2991441,36.7528804,-1.3004062,36.829741,761,1796,59,1104
12720,19426,868,3,Business,25,6,41754,25,6,42400,25,6,43334,25,6,43697,25,6,44359,9,23.25888921888938,-1.2296618,36.8438272,-1.265715,36.823815,676,662,646,1297
12721,8138,2592,1,Personal,25,5,31030,25,5,32075,25,5,35413,25,5,36937,25,5,38437,10,16.9,-1.3359536,36.8534787,-1.28433,36.802593,742,1500,1045,4862
12722,20173,562,3,Business,13,4,57293,13,4,57644,13,4,58724,13,4,60033,13,4,60982,6,22.6,-1.3227181,36.8528097,-1.3233496,36.8139159,156,949,351,2389
12723,12542,633,3,Business,14,4,57132,14,4,57219,14,4,57566,14,4,59139,14,4,59208,4,27.4,-1.3077869,36.8443207,-1.3004062,36.829741,411,69,87,1920
12724,25701,1500,3,Business,9,6,30710,9,6,30769,9,6,32209,9,6,33154,9,6,34435,8,19.9,-1.3004062,36.829741,-1.2638185,36.7930057,206,1281,59,2385
12725,22914,393,3,Business,4,1,57530,4,1,57552,4,1,57557,4,1,59665,4,1,59667,14,27.5,-1.3167113,36.8301563,-1.306378,36.7519845,239,2,22,2113
12726,19175,3507,3,Personal,28,5,39642,28,5,39668,28,5,40337,28,5,40685,28,5,41726,5,25.1,-1.2944628,36.7522739,-1.2941024,36.79578,412,1041,26,1017
12727,11982,2154,3,Business,2,2,38922,2,2,39042,2,2,39530,2,2,39635,2,2,41399,10,26.2,-1.2551895,36.7822034,-1.2765736,36.8513646,690,1764,120,593
12728,2345,1304,3,Business,5,5,57770,5,5,59361,5,5,60184,5,5,60318,5,5,61658,9,24.9,-1.2551895,36.7822034,-1.2977565,36.8025534,107,1340,1591,957
12729,22864,1990,3,Business,24,5,52014,24,5,52046,24,5,52066,24,5,53667,24,5,54728,4,22.8,-1.2767064,36.8227148,-1.2658315,36.809049,704,1061,32,1621
12730,7083,391,3,Business,29,2,54101,29,2,54150,29,2,54609,29,2,55330,29,2,57697,11,27.2,-1.2784063,36.8222933,-1.229597,36.8678736,462,2367,49,1180
12731,10064,868,3,Business,27,6,45530,27,6,45600,27,6,45866,27,6,46297,27,6,47066,5,23.25888921888938,-1.2600926,36.8088685,-1.265715,36.823815,178,769,70,697
12732,15538,3698,3,Business,28,2,42868,28,2,42935,28,2,45322,28,2,45756,28,2,49200,26,21.5,-1.3107918,36.761794,-1.3190102,36.9230693,584,3444,67,2821
12733,12285,3496,3,Business,14,5,41173,14,5,41327,14,5,42672,14,5,44693,14,5,45375,4,21.7,-1.300921,36.828195,-1.3173869,36.8112044,267,682,154,3366
12734,16058,2154,3,Business,24,4,46908,24,4,47578,24,4,48092,24,4,49493,24,4,51003,5,28.5,-1.290894,36.822971,-1.2765736,36.8513646,156,1510,670,1915
12735,4352,1162,3,Business,30,3,51437,30,3,51499,30,3,53319,30,3,54096,30,3,57042,16,28.9,-1.21275,36.8051314,-1.312261,36.794658,362,2946,62,2597
12736,19335,1578,3,Business,5,4,47017,5,4,47411,5,4,47711,5,4,48518,5,4,53434,10,23.25888921888938,-1.290894,36.822971,-1.2413316,36.8785525,851,4916,394,1107
12737,26353,1346,3,Business,28,4,57975,28,4,58012,28,4,58553,28,4,58841,28,4,59869,2,29.9,-1.2917868,36.7872675,-1.2985749,36.8088,649,1028,37,829
12738,11768,136,3,Business,25,1,33005,25,1,33019,25,1,35556,25,1,35661,25,1,37760,17,23.25888921888938,-1.3254522,36.7216584,-1.290641,36.812941,831,2099,14,2642
12739,27739,2523,3,Business,11,2,35214,11,2,35438,11,2,35960,11,2,36259,11,2,37480,7,16.7,-1.2551895,36.7822034,-1.2545163,36.8243717,247,1221,224,821
12740,12247,3354,3,Business,22,1,41101,22,1,41199,22,1,41594,22,1,42077,22,1,43893,17,24.9,-1.3700383,36.9190174,-1.3173869,36.8112044,101,1816,98,878
12741,16533,3222,3,Business,21,2,55068,21,2,55189,21,2,56077,21,2,56428,21,2,57086,4,25.1,-1.2551895,36.7822034,-1.2695287,36.7981777,930,658,121,1239
12742,2774,186,3,Business,8,4,57760,8,4,57804,8,4,58719,8,4,59184,8,4,61425,20,27.2,-1.2571472,36.7950633,-1.3700383,36.9190174,38,2241,44,1380
12743,3226,2150,3,Business,31,5,35022,31,5,35062,31,5,35070,31,5,36080,31,5,36729,7,23.25888921888938,-1.3188359,36.7038526,-1.344446,36.756597,855,649,40,1018
12744,19155,972,3,Business,13,4,37892,13,4,37954,13,4,40844,13,4,41657,13,4,43181,13,22.1,-1.2862033,36.8152966,-1.3446058,36.7605178,448,1524,62,3703
12745,3931,3083,1,Personal,12,5,46678,12,5,48725,12,5,49125,12,5,49296,12,5,50953,5,27.1,-1.2524976,36.8062935,-1.280665,36.8154325,844,1657,2047,571
12746,14223,1304,3,Business,9,4,45324,9,4,45406,9,4,46159,9,4,46416,9,4,49543,14,23.6,-1.2551895,36.7822034,-1.242902,36.870334,116,3127,82,1010
12747,18623,265,3,Business,21,4,40744,21,4,40768,21,4,41298,21,4,42661,21,4,45500,15,28.0,-1.300921,36.828195,-1.2057494,36.837181,519,2839,24,1893
12748,26785,3291,3,Business,31,1,34949,31,1,34979,31,1,35172,31,1,35782,31,1,36346,4,18.7,-1.272828,36.816608,-1.2600926,36.8088685,670,564,30,803
12749,4203,1209,3,Business,24,3,55835,24,3,56051,24,3,56542,24,3,56846,24,3,57921,5,23.25888921888938,-1.2770708,36.8231093,-1.3004062,36.829741,956,1075,216,795
12750,24717,2532,3,Business,7,5,53521,7,5,53549,7,5,53871,7,5,54230,7,5,56273,14,23.25888921888938,-1.2551895,36.7822034,-1.329568,36.8520825,690,2043,28,681
12751,6866,346,3,Business,11,2,50150,11,2,50328,11,2,50745,11,2,50870,11,2,51361,1,21.4,-1.28878,36.8168312,-1.2795827,36.8197262,265,491,178,542
12752,22311,909,3,Business,29,5,48172,29,5,48721,29,5,49068,29,5,49423,29,5,51160,13,21.4,-1.2887938,36.8285832,-1.225322,36.80855,844,1737,549,702
12753,9865,1329,3,Business,25,4,54972,25,4,55069,25,4,55406,25,4,56086,25,4,56626,6,23.25888921888938,-1.273056,36.811298,-1.2467205,36.7724432,119,540,97,1017
12754,26980,3599,3,Business,9,4,42697,9,4,42729,9,4,43610,9,4,44149,9,4,46251,14,23.25888921888938,-1.3302996,36.8707935,-1.2976287,36.7744015,675,2102,32,1420
12755,10282,68,1,Personal,1,2,49914,1,2,52173,1,2,52656,1,2,54021,1,2,55458,9,20.4,-1.2141875,36.791039,-1.2161358,36.8429293,648,1437,2259,1848
12756,21285,3295,3,Business,31,4,30788,31,4,30855,31,4,31526,31,4,31770,31,4,32221,2,17.3,-1.2579304,36.8019667,-1.255392,36.792539,808,451,67,915
12757,10881,2066,3,Business,21,4,44451,21,4,44510,21,4,45578,21,4,46114,21,4,47532,12,28.1,-1.3210189,36.8410551,-1.314193,36.916132,448,1418,59,1604
12758,27177,393,3,Business,22,5,58623,22,5,58635,22,5,58639,22,5,59381,22,5,59774,4,27.5,-1.3167113,36.8301563,-1.3004062,36.829741,901,393,12,746
12759,7084,1850,3,Business,9,4,42093,9,4,42139,9,4,42305,9,4,42467,9,4,43788,8,23.25888921888938,-1.2551895,36.7822034,-1.3047132,36.8089553,92,1321,46,328
12760,27614,598,1,Business,22,3,59981,22,3,60118,22,3,63513,22,3,63574,22,3,65029,8,23.2,-1.2329501,36.8083852,-1.2536797,36.7995085,384,1455,137,3456
12761,22625,970,3,Business,20,3,34234,20,3,34425,20,3,35032,20,3,35214,20,3,35824,5,16.4,-1.2551895,36.7822034,-1.2477887,36.7960085,409,610,191,789
12762,12793,111,3,Business,19,2,45798,19,2,45834,19,2,45839,19,2,46344,19,2,49503,13,26.5,-1.2551895,36.7822034,-1.3270347,36.8667362,576,3159,36,510
12763,6534,1882,3,Business,11,4,39100,11,4,39189,11,4,39731,11,4,39832,11,4,41034,8,25.6,-1.3014461,36.7661381,-1.287781,36.817866,198,1202,89,643
12764,20898,928,3,Business,24,4,54885,24,4,55022,24,4,55880,24,4,55993,24,4,57520,10,28.4,-1.2551895,36.7822034,-1.2963097,36.7688221,269,1527,137,971
12765,14540,1253,2,Personal,22,5,44300,22,5,44383,22,5,45740,22,5,46136,22,5,46832,5,21.6,-1.2861765,36.8209086,-1.2785622,36.8541857,906,696,83,1753
12766,20576,2989,3,Business,29,2,52622,29,2,52679,29,2,54107,29,2,54532,29,2,56078,12,27.2,-1.3472066,36.7692638,-1.300392,36.847352,246,1546,57,1853
12767,12837,198,3,Business,28,4,53838,28,4,54238,28,4,57207,28,4,57871,28,4,59615,11,27.3,-1.3396256,36.8863135,-1.3047852,36.8512721,507,1744,400,3633
12768,8116,3686,3,Business,30,4,34907,30,4,34942,30,4,35309,30,4,35583,30,4,36337,4,16.2,-1.2551895,36.7822034,-1.2695287,36.7981777,882,754,35,641
12769,15414,2436,3,Business,29,1,61699,29,1,61746,29,1,61923,29,1,62153,29,1,62164,3,23.4,-1.2551895,36.7822034,-1.268027,36.8037005,541,11,47,407
12770,15781,1393,1,Business,13,3,57862,13,3,61750,13,3,61926,13,3,62712,13,3,64238,12,22.2,-1.2297202,36.8745508,-1.2601709,36.8002238,101,1526,3888,962
12771,16116,71,3,Business,21,1,41087,21,1,41587,21,1,42904,21,1,43260,21,1,44990,10,19.8,-1.2248308,36.8012573,-1.2821108,36.8250555,186,1730,500,1673
12772,6567,2801,3,Business,11,4,34470,11,4,34567,11,4,36380,11,4,37597,11,4,40052,22,18.3,-1.3219125,36.714515,-1.3104506,36.8687235,565,2455,97,3030
12773,8581,3283,3,Business,9,3,33439,9,3,33620,9,3,34152,9,3,35071,9,3,36012,5,20.2,-1.2600926,36.8088685,-1.2628473,36.781805,319,941,181,1451
12774,25622,1329,3,Business,4,2,40968,4,2,40977,4,2,41330,4,2,41662,4,2,42161,2,18.6,-1.273056,36.811298,-1.2667532,36.8024002,16,499,9,685
12775,12735,136,3,Business,6,4,40290,6,4,40501,6,4,44804,6,4,45315,6,4,48253,12,24.0,-1.2738338,36.782403,-1.3319269,36.7142325,200,2938,211,4814
12776,7882,2008,3,Business,15,4,32178,15,4,32239,15,4,32762,15,4,33023,15,4,34595,13,19.8,-1.2508229,36.7895263,-1.3270347,36.8667362,387,1572,61,784
12777,24947,2212,3,Business,17,5,37261,17,5,37334,17,5,38173,17,5,38434,17,5,39351,3,23.25888921888938,-1.2571472,36.7950633,-1.2611642,36.7949932,172,917,73,1100
12778,23817,1856,3,Business,28,1,33966,28,1,34096,28,1,35338,28,1,35542,28,1,36587,11,18.0,-1.273009,36.802807,-1.2359565,36.7622728,103,1045,130,1446
12779,18625,1227,1,Personal,4,2,38963,4,2,39057,4,2,40665,4,2,41356,4,2,42823,8,18.8,-1.269534,36.80697,-1.2929747,36.7646358,117,1467,94,2299
12780,16480,3359,3,Business,18,2,60098,18,2,60108,18,2,60361,18,2,61318,18,2,62063,4,23.25888921888938,-1.2551895,36.7822034,-1.269534,36.80697,116,745,10,1210
12781,15635,393,3,Business,13,3,34599,13,3,34609,13,3,34616,13,3,35514,13,3,37027,14,17.5,-1.3167113,36.8301563,-1.306378,36.7519845,523,1513,10,905
12782,25698,2066,3,Business,26,4,48358,26,4,50165,26,4,50703,26,4,50890,26,4,52105,9,21.8,-1.316961,36.820337,-1.3014461,36.7661381,844,1215,1807,725
12783,639,1329,3,Business,3,5,38181,3,5,38198,3,5,38232,3,5,38983,3,5,39495,2,23.25888921888938,-1.273056,36.811298,-1.262073,36.7985503,119,512,17,785
12784,15033,391,3,Business,10,1,42509,10,1,43180,10,1,45205,10,1,45913,10,1,46919,5,18.7,-1.300921,36.828195,-1.2867454,36.8259017,410,1006,671,2733
12785,5002,2789,3,Business,21,4,36912,21,4,36995,21,4,37590,21,4,37862,21,4,38533,8,22.0,-1.304735,36.7846054,-1.2623495,36.8049247,125,671,83,867
12786,22758,393,3,Business,8,5,43733,8,5,43866,8,5,44702,8,5,44835,8,5,46632,8,28.4,-1.3167113,36.8301563,-1.2770708,36.8231093,349,1797,133,969
12787,13256,393,3,Business,8,2,40999,8,2,41042,8,2,41487,8,2,42086,8,2,42830,4,23.3,-1.3167113,36.8301563,-1.3004062,36.829741,523,744,43,1044
12788,4551,3283,3,Business,7,1,32563,7,1,32587,7,1,32874,7,1,33438,7,1,34561,7,21.3,-1.2628473,36.781805,-1.265715,36.823815,512,1123,24,851
12789,10450,3300,3,Business,22,3,47770,22,3,48158,22,3,48437,22,3,48679,22,3,49535,7,23.3,-1.2628473,36.781805,-1.303596,36.778378,952,856,388,521
12790,22217,606,1,Personal,1,3,50912,1,3,50934,1,3,51342,1,3,51584,1,3,52028,3,23.7,-1.290908,36.7578336,-1.2934527,36.7755139,273,444,22,650
12791,2498,3669,3,Business,15,5,54015,15,5,54982,15,5,56134,15,5,56861,15,5,59073,9,28.1,-1.2560455,36.7800867,-1.3107918,36.761794,411,2212,967,1879
12792,9124,1363,3,Business,21,4,57321,21,4,57355,21,4,57719,21,4,57791,21,4,58250,5,26.1,-1.3004062,36.829741,-1.3228003,36.8306435,136,459,34,436
12793,6583,3154,1,Business,11,2,55127,11,2,55250,11,2,57081,11,2,57402,11,2,61975,21,25.5,-1.2914795,36.8248973,-1.3326173,36.7146233,268,4573,123,2152
12794,18306,1591,2,Personal,27,4,52550,27,4,52576,27,4,52701,27,4,52900,27,4,53515,5,25.0,-1.262359,36.822946,-1.2771989,36.8089752,427,615,26,324
12795,21257,627,3,Business,27,3,54144,27,3,54172,27,3,54195,27,3,54512,27,3,55719,11,29.1,-1.2551895,36.7822034,-1.3108386,36.7555239,523,1207,28,340
12796,26632,3491,3,Business,27,3,47079,27,3,47137,27,3,48660,27,3,49071,27,3,50401,14,29.3,-1.225322,36.80855,-1.2283403,36.8822756,445,1330,58,1934
12797,1337,273,2,Personal,14,4,55629,14,4,56148,14,4,56570,14,4,60730,14,4,62486,8,21.2,-1.2803499,36.8273403,-1.2751745,36.7657676,526,1756,519,4582
12798,10351,1858,1,Personal,28,5,24699,28,5,25619,28,5,27932,28,5,28093,28,5,30861,21,20.4,-1.253653,36.684954,-1.304119,36.819649,228,2768,920,2474
12799,26570,948,3,Business,15,3,47254,15,3,47274,15,3,47524,15,3,48382,15,3,48389,1,23.25888921888938,-1.2684667,36.8002891,-1.2594474,36.8089122,424,7,20,1108
12800,16995,2271,3,Business,2,3,36651,2,3,36656,2,3,36663,2,3,37672,2,3,38871,16,18.1,-1.272828,36.816608,-1.293515,36.897607,397,1199,5,1016
12801,8273,1995,3,Business,1,4,40048,1,4,40056,1,4,41213,1,4,41325,1,4,42122,3,23.25888921888938,-1.2584143,36.8048002,-1.2551895,36.7822034,620,797,8,1269
12802,2588,3291,3,Business,1,5,53527,1,5,53617,1,5,53979,1,5,54617,1,5,55481,5,31.9,-1.2628473,36.781805,-1.2600926,36.8088685,663,864,90,1000
12803,12731,635,3,Business,5,6,34183,5,6,34265,5,6,34868,5,6,35644,5,6,37149,9,19.0,-1.2599563,36.7993439,-1.312124,36.8154885,753,1505,82,1379
12804,7198,2160,2,Personal,24,5,48464,24,5,48480,24,5,48512,24,5,49273,24,5,50026,5,23.1,-1.2881035,36.8142095,-1.2549653,36.797868,74,753,16,793
12805,20750,1809,3,Business,30,3,43627,30,3,43637,30,3,44865,30,3,45503,30,3,45958,2,22.6,-1.2584143,36.8048002,-1.2646084,36.8028645,216,455,10,1866
12806,13364,3283,3,Business,20,3,36739,20,3,38824,20,3,39661,20,3,39993,20,3,40559,6,27.3,-1.272828,36.816608,-1.2628473,36.781805,240,566,2085,1169
12807,15385,1329,3,Business,2,2,61375,2,2,61436,2,2,61680,2,2,61752,2,2,63714,18,28.6,-1.273056,36.811298,-1.3557944,36.7471367,250,1962,61,316
12808,3375,53,3,Business,12,1,52957,12,1,53989,12,1,54316,12,1,54682,12,1,56671,5,26.9,-1.3004062,36.829741,-1.2770708,36.8231093,148,1989,1032,693
12809,1832,111,3,Business,3,4,42194,3,4,42204,3,4,42483,3,4,42893,3,4,43740,7,23.3,-1.2551895,36.7822034,-1.2732604,36.823046,477,847,10,689
12810,18057,111,3,Business,10,5,51011,10,5,51030,10,5,51034,10,5,51293,10,5,52020,5,23.25888921888938,-1.2551895,36.7822034,-1.2726925,36.7951829,576,727,19,263
12811,14626,2992,1,Personal,25,3,60345,25,3,60386,25,3,60995,25,3,61473,25,3,62511,6,17.6,-1.2911796,36.8215068,-1.296268,36.785084,808,1038,41,1087
12812,2368,2521,3,Business,29,6,37591,29,6,37598,29,6,37606,29,6,37690,29,6,38091,4,19.4,-1.3167113,36.8301563,-1.3004062,36.829741,523,401,7,92
12813,25773,2982,3,Business,7,1,57744,7,1,57757,7,1,59010,7,1,59963,7,1,62342,18,24.5,-1.300921,36.828195,-1.177202,36.8351183,516,2379,13,2206
12814,126,1148,3,Business,23,5,40972,23,5,43395,23,5,43405,23,5,45664,23,5,47785,10,24.2,-1.3100586,36.8500329,-1.2664428,36.809453,848,2121,2423,2269
12815,4477,2804,3,Business,25,4,46642,25,4,46857,25,4,47777,25,4,48022,25,4,49436,12,20.2,-1.2551895,36.7822034,-1.2128205,36.8026175,612,1414,215,1165
12816,19210,2423,3,Business,13,3,46890,13,3,47055,13,3,47515,13,3,47974,13,3,49893,5,24.7,-1.2551895,36.7822034,-1.270054,36.815164,658,1919,165,919
12817,26955,1039,1,Personal,7,7,57412,7,7,57423,7,7,58990,7,7,60556,7,7,62290,14,23.2,-1.2343087,36.84749,-1.3220724,36.8933648,208,1734,11,3133
12818,19177,2412,3,Business,17,5,49807,17,5,49842,17,5,50363,17,5,51073,17,5,51589,3,23.25888921888938,-1.2232123,36.8932547,-1.2283403,36.8822756,126,516,35,1231
12819,16020,496,3,Business,10,1,48307,10,1,48318,10,1,48690,10,1,48828,10,1,53549,23,18.6,-1.2551895,36.7822034,-1.374163,36.913444,498,4721,11,510
12820,20676,2081,1,Personal,27,5,50454,27,5,51504,27,5,52398,27,5,52578,27,5,54836,15,23.9,-1.3149338,36.7135703,-1.2802872,36.8286311,726,2258,1050,1074
12821,13718,3222,3,Business,26,1,46025,26,1,47234,26,1,48104,26,1,48586,26,1,49704,5,22.9,-1.2971154,36.7963489,-1.2821378,36.7740428,38,1118,1209,1352
12822,18394,706,3,Business,18,5,33713,18,5,33723,18,5,33727,18,5,35084,18,5,35595,5,19.9,-1.298331,36.822614,-1.3077869,36.8443207,26,511,10,1361
12823,27826,1244,3,Business,11,1,39526,11,1,39535,11,1,42056,11,1,43930,11,1,45272,22,26.4,-1.3343129,36.8854175,-1.303596,36.778378,242,1342,9,4395
12824,8394,237,3,Business,26,1,45153,26,1,48443,26,1,48716,26,1,49039,26,1,50078,6,22.3,-1.2551895,36.7822034,-1.276957,36.824521,208,1039,3290,596
12825,20748,2801,3,Business,6,3,36473,6,3,36486,6,3,36531,6,3,37008,6,3,38925,15,16.6,-1.3104506,36.8687235,-1.2595422,36.7871178,501,1917,13,522
12826,5895,3326,3,Business,31,3,46291,31,3,53238,31,3,54211,31,3,54300,31,3,55163,8,27.2,-1.2551895,36.7822034,-1.2812624,36.7714609,866,863,6947,1062
12827,11829,3517,3,Business,21,4,42510,21,4,43678,21,4,43851,21,4,45091,21,4,48201,16,25.2,-1.300921,36.828195,-1.3882008,36.7699445,362,3110,1168,1413
12828,19811,2523,3,Business,24,3,38142,24,3,38149,24,3,38595,24,3,38695,24,3,39739,10,20.1,-1.2551895,36.7822034,-1.2299678,36.8153079,370,1044,7,546
12829,4339,733,3,Business,14,4,47017,14,4,55883,14,4,56861,14,4,56952,14,4,58434,9,28.1,-1.2551895,36.7822034,-1.304078,36.83014,571,1482,8866,1069
12830,13920,880,3,Personal,9,4,51026,9,4,51388,9,4,51923,9,4,52185,9,4,53019,5,25.8,-1.2868546,36.824811,-1.2995135,36.7933633,343,834,362,797
12831,8497,3599,3,Business,12,5,39984,12,5,41143,12,5,41262,12,5,42894,12,5,44524,11,24.6,-1.3302996,36.8707935,-1.3103985,36.9114173,533,1630,1159,1751
12832,23542,970,3,Business,18,4,37523,18,4,37563,18,4,38129,18,4,38832,18,4,40886,4,23.25888921888938,-1.2571472,36.7950633,-1.2904753,36.8144721,422,2054,40,1269
12833,8456,2987,3,Business,8,4,42864,8,4,43050,8,4,43376,8,4,43571,8,4,44546,7,26.1,-1.270212,36.8210877,-1.3043821,36.7840586,744,975,186,521
12834,26087,2627,3,Business,22,4,38652,22,4,38680,22,4,38995,22,4,39596,22,4,39679,2,22.5,-1.2571472,36.7950633,-1.2591019,36.800577,353,83,28,916
12835,5568,2808,3,Business,8,3,36158,8,3,36577,8,3,37361,8,3,38176,8,3,39667,5,22.0,-1.263499,36.8014548,-1.278612,36.8195876,882,1491,419,1599
12836,11109,552,3,Business,20,3,59357,20,3,59381,20,3,60835,20,3,62047,20,3,64005,17,27.7,-1.291768,36.8297208,-1.335477,36.9308297,785,1958,24,2666
12837,6858,928,3,Business,14,2,38508,14,2,39137,14,2,39590,14,2,40113,14,2,40975,7,23.25888921888938,-1.2551895,36.7822034,-1.2938211,36.8270021,953,862,629,976
12838,27707,2659,3,Business,29,5,45491,29,5,45577,29,5,46374,29,5,46637,29,5,47560,6,26.6,-1.2917868,36.7872675,-1.2695287,36.7981777,206,923,86,1060
12839,7948,764,3,Personal,13,4,62721,13,4,62758,13,4,63372,13,4,63738,13,4,64507,3,22.4,-1.3039706,36.7688174,-1.2800978,36.7769171,161,769,37,980
12840,26246,391,3,Business,20,1,53660,20,1,55216,20,1,55274,20,1,56613,20,1,60995,5,23.25888921888938,-1.300921,36.828195,-1.2784063,36.8222933,740,4382,1556,1397
12841,17559,2866,3,Business,24,1,44132,24,1,45260,24,1,45398,24,1,45929,24,1,47242,15,22.7,-1.2551895,36.7822034,-1.2178922,36.8881236,848,1313,1128,669
12842,18311,1527,3,Business,6,6,32991,6,6,33004,6,6,33016,6,6,35019,6,6,35083,4,19.5,-1.3077869,36.8443207,-1.3004062,36.829741,206,64,13,2015
12843,6954,567,3,Business,5,2,53691,5,2,53749,5,2,55734,5,2,55857,5,2,57269,10,22.5,-1.2583484,36.8129524,-1.2963097,36.7688221,474,1412,58,2108
12844,15531,391,3,Business,29,4,34575,29,4,38904,29,4,39258,29,4,40394,29,4,42655,5,21.6,-1.2777924,36.8231577,-1.3016417,36.8271679,725,2261,4329,1490
12845,27387,1925,2,Personal,15,2,33624,15,2,34708,15,2,36303,15,2,36769,15,2,38718,12,17.8,-1.2494503,36.8531852,-1.2860183,36.8975338,397,1949,1084,2061
12846,7694,2800,2,Personal,6,1,34299,6,1,34351,6,1,35207,6,1,35492,6,1,37074,6,14.8,-1.272704,36.7931279,-1.2942764,36.7969749,791,1582,52,1141
12847,20808,1809,3,Business,10,5,54816,10,5,54937,10,5,55421,10,5,56152,10,5,56653,2,23.25888921888938,-1.2603403,36.7998848,-1.2571472,36.7950633,882,501,121,1215
12848,17011,3291,3,Business,2,2,44884,2,2,44917,2,2,45916,2,2,46752,2,2,47959,4,26.1,-1.265715,36.823815,-1.2600926,36.8088685,52,1207,33,1835
12849,13406,1754,3,Business,3,7,49529,3,7,49570,3,7,50710,3,7,51515,3,7,52793,11,22.8,-1.2297202,36.8745508,-1.2860183,36.8975338,408,1278,41,1945
12850,24579,2885,1,Personal,25,2,59078,25,2,59459,25,2,60923,25,2,61395,25,2,63706,6,24.1,-1.2681732,36.8150364,-1.291412,36.8096125,519,2311,381,1936
12851,374,1500,3,Business,16,4,40794,16,4,40842,16,4,41396,16,4,41515,16,4,42608,9,23.25888921888938,-1.2638185,36.7930057,-1.3004062,36.829741,161,1093,48,673
12852,7523,2066,3,Business,6,3,55407,6,3,55504,6,3,58074,6,3,58430,6,3,59099,5,23.25888921888938,-1.3270716,36.8406371,-1.3231725,36.8640177,247,669,97,2926
12853,28101,1329,3,Business,6,4,52388,6,4,52409,6,4,52779,6,4,52997,6,4,53955,5,21.1,-1.273056,36.811298,-1.2677061,36.7776554,435,958,21,588
12854,25538,2330,3,Business,11,1,62991,11,1,63002,11,1,63280,11,1,63598,11,1,64188,2,23.25888921888938,-1.2873232,36.7658572,-1.3015197,36.7658456,368,590,11,596
12855,3306,265,3,Business,22,5,34574,22,5,34616,22,5,35764,22,5,35884,22,5,37254,13,22.0,-1.3450936,36.7457914,-1.300921,36.828195,506,1370,42,1268
12856,23527,3326,3,Business,14,4,50042,14,4,50133,14,4,50655,14,4,51083,14,4,52143,4,27.7,-1.2551895,36.7822034,-1.2738522,36.7992818,432,1060,91,950
12857,13709,3222,3,Business,14,1,51884,14,1,51892,14,1,52049,14,1,52387,14,1,52881,4,26.0,-1.2551895,36.7822034,-1.255956,36.772901,620,494,8,495
12858,17055,2089,3,Business,11,1,39112,11,1,39350,11,1,39884,11,1,40393,11,1,41661,7,18.2,-1.2615584,36.8149506,-1.3010059,36.8216816,116,1268,238,1043
12859,7017,1450,1,Personal,25,1,30120,25,1,32089,25,1,35046,25,1,35212,25,1,36997,5,14.9,-1.3211235,36.7765164,-1.3108386,36.7555239,752,1785,1969,3123
12860,11222,1329,3,Business,30,6,40056,30,6,40071,30,6,40311,30,6,40579,30,6,41739,3,26.6,-1.273056,36.811298,-1.2534301,36.8000983,751,1160,15,508
12861,14388,1850,3,Business,11,1,50066,11,1,50187,11,1,50825,11,1,51935,11,1,52921,6,28.9,-1.2571472,36.7950633,-1.2896399,36.8124498,378,986,121,1748
12862,26920,298,3,Personal,5,5,41699,5,5,43374,5,5,43835,5,5,44266,5,5,46560,21,24.5,-1.3561118,36.9045824,-1.2658315,36.809049,373,2294,1675,892
12863,13143,2330,3,Business,24,4,64960,24,4,64970,24,4,65709,24,4,66062,24,4,68080,15,25.9,-1.3143328,36.8137434,-1.3270197,36.7037303,519,2018,10,1092
12864,23823,248,3,Business,3,3,41732,3,3,41743,3,3,41856,3,3,42196,3,3,44620,7,24.2,-1.304735,36.7846054,-1.2603996,36.7972272,663,2424,11,453
12865,8333,3560,3,Business,27,1,57998,27,1,58082,27,1,58633,27,1,58897,27,1,59903,5,23.1,-1.2584143,36.8048002,-1.279395,36.825364,386,1006,84,815
12866,4575,2150,3,Business,10,5,32868,10,5,32896,10,5,33636,10,5,34260,10,5,36041,12,23.25888921888938,-1.331619,36.847976,-1.344446,36.756597,376,1781,28,1364
12867,27051,1133,3,Business,28,5,37709,28,5,37824,28,5,38045,28,5,38288,28,5,38976,9,25.0,-1.2571472,36.7950633,-1.267694,36.7576115,882,688,115,464
12868,6024,3434,3,Business,18,1,43864,18,1,44541,18,1,44918,18,1,45050,18,1,46733,10,23.25888921888938,-1.2963097,36.7688221,-1.304969,36.846623,937,1683,677,509
12869,23611,3439,3,Business,24,5,44305,24,5,44377,24,5,45274,24,5,46373,24,5,48658,7,21.5,-1.282937,36.7816984,-1.2393157,36.7668877,55,2285,72,1996
12870,23378,3569,3,Personal,1,1,50603,1,1,51270,1,1,51895,1,1,52794,1,1,55574,28,23.25888921888938,-1.2472011,36.8800307,-1.3858142,36.7641498,691,2780,667,1524
12871,27074,1017,3,Business,14,3,56701,14,3,58084,14,3,58807,14,3,59750,14,3,61201,11,23.7,-1.322064,36.817157,-1.2551895,36.7822034,178,1451,1383,1666
12872,28226,3491,3,Business,21,5,36478,21,5,36499,21,5,38974,21,5,39761,21,5,41267,14,20.1,-1.2297202,36.8819507,-1.2551895,36.7822034,925,1506,21,3262
12873,6338,1959,1,Business,3,3,67035,3,3,67068,3,3,67427,3,3,69124,3,3,69792,14,23.8,-1.255956,36.789867,-1.1882752,36.772118,56,668,33,2056
12874,2038,1927,3,Business,28,3,49597,28,3,49602,28,3,49628,28,3,50948,28,3,52096,15,23.25888921888938,-1.3332749,36.8708147,-1.3463042,36.768164,622,1148,5,1346
12875,2286,2150,3,Business,8,6,37611,8,6,37629,8,6,39300,8,6,39749,8,6,41229,13,20.0,-1.3040553,36.8092658,-1.344446,36.756597,790,1480,18,2120
12876,26335,1402,3,Business,18,4,35236,18,4,35270,18,4,36924,18,4,37721,18,4,42457,15,20.5,-1.3417,36.73493,-1.2891922,36.825189,565,4736,34,2451
12877,6058,3647,3,Business,19,1,57513,19,1,57520,19,1,57557,19,1,57857,19,1,57861,1,25.2,-1.272639,36.794723,-1.2741728,36.7969108,647,4,7,337
12878,18859,3032,3,Business,26,2,41499,26,2,41530,26,2,41607,26,2,42199,26,2,43262,8,27.5,-1.2571472,36.7950633,-1.2320609,36.752092,268,1063,31,669
12879,6976,2069,3,Business,20,3,39406,20,3,39448,20,3,41452,20,3,42338,20,3,43345,9,27.0,-1.265715,36.823815,-1.228911,36.881876,683,1007,42,2890
12880,9223,2330,3,Business,21,4,53908,21,4,54351,21,4,54913,21,4,55023,21,4,56303,8,26.1,-1.2291477,36.8440295,-1.2325706,36.8083923,8,1280,443,672
12881,22341,928,3,Business,30,2,40013,30,2,40112,30,2,41864,30,2,42095,30,2,43042,5,23.25888921888938,-1.2551895,36.7822034,-1.2657199,36.7914391,570,947,99,1983
12882,11145,635,3,Business,26,2,40191,26,2,40223,26,2,40610,26,2,41194,26,2,41639,5,27.4,-1.2602337,36.7990548,-1.25681,36.7730826,177,445,32,971
12883,20225,2866,3,Business,4,4,41504,4,4,41765,4,4,42906,4,4,43562,4,4,44567,8,25.3,-1.2551895,36.7822034,-1.2894649,36.8048486,855,1005,261,1797
12884,22103,2417,2,Personal,11,5,33898,11,5,33919,11,5,34718,11,5,37266,11,5,38911,24,17.9,-1.3243811,36.8761802,-1.3958588,36.7701901,663,1645,21,3347
12885,7982,53,3,Business,13,1,52473,13,1,52733,13,1,53593,13,1,55673,13,1,55678,5,23.25888921888938,-1.3004062,36.829741,-1.2770708,36.8231093,921,5,260,2940
12886,188,3201,3,Business,13,3,57670,13,3,57690,13,3,57922,13,3,58826,13,3,59894,3,27.0,-1.2584143,36.8048002,-1.2551895,36.7822034,547,1068,20,1136
12887,17785,1317,3,Personal,25,5,46682,25,5,46795,25,5,47361,25,5,47809,25,5,49299,7,26.2,-1.2924173,36.7797814,-1.2596241,36.762407,328,1490,113,1014
12888,5847,3291,3,Business,16,1,44674,16,1,44705,16,1,45493,16,1,46015,16,1,46832,11,19.2,-1.303596,36.778378,-1.2600926,36.8088685,851,817,31,1310
12889,22924,1753,2,Business,12,5,53573,12,5,53584,12,5,53625,12,5,54230,12,5,55094,5,27.1,-1.2551895,36.7822034,-1.2696908,36.81519,875,864,11,646
12890,3692,2433,2,Personal,29,3,46859,29,3,47483,29,3,47815,29,3,48127,29,3,49941,10,18.5,-1.2295205,36.8120426,-1.2728069,36.7962362,320,1814,624,644
12891,11597,1245,3,Business,5,5,49070,5,5,49099,5,5,49964,5,5,52045,5,5,53697,14,27.6,-1.300921,36.828195,-1.3374394,36.7339115,863,1652,29,2946
12892,7608,3521,3,Business,17,3,53051,17,3,53109,17,3,53843,17,3,55509,17,3,56914,5,28.2,-1.255956,36.772901,-1.2768326,36.8073804,727,1405,58,2400
12893,21174,2772,3,Personal,13,6,48656,13,6,48838,13,6,49817,13,6,50061,13,6,53339,18,28.0,-1.216212,36.841799,-1.292188,36.764855,882,3278,182,1223
12894,11650,2564,3,Business,25,6,33611,25,6,33672,25,6,35933,25,6,36826,25,6,38207,9,23.25888921888938,-1.2795195,36.8234694,-1.2271998,36.8084905,119,1381,61,3154
12895,2139,1245,3,Business,7,4,51990,7,4,52005,7,4,52869,7,4,53628,7,4,56040,21,31.2,-1.300921,36.828195,-1.236927,36.702786,718,2412,15,1623
12896,8466,2344,3,Business,14,4,46194,14,4,50402,14,4,53118,14,4,53359,14,4,55868,9,27.9,-1.2551895,36.7822034,-1.2453158,36.8100828,547,2509,4208,2957
12897,14371,540,3,Business,25,4,44218,25,4,44485,25,4,45943,25,4,46216,25,4,47041,8,20.2,-1.2551895,36.7822034,-1.3044313,36.818504,946,825,267,1731
12898,1430,1205,3,Business,12,2,49627,12,2,49685,12,2,50005,12,2,50116,12,2,51285,8,23.25888921888938,-1.2495931,36.8065087,-1.2839651,36.7891704,318,1169,58,431
12899,27314,868,3,Business,15,4,36635,15,4,36758,15,4,37116,15,4,37475,15,4,38155,9,19.4,-1.2296618,36.8438272,-1.265715,36.823815,871,680,123,717
12900,927,909,3,Business,6,6,43519,6,6,43540,6,6,44351,6,6,47169,6,6,47395,16,24.2,-1.225322,36.80855,-1.3014461,36.7661381,137,226,21,3629
12901,19772,2344,3,Business,9,1,34511,9,1,34520,9,1,34726,9,1,34912,9,1,35302,2,15.1,-1.2551895,36.7822034,-1.2592428,36.7894541,103,390,9,392
12902,11202,1154,3,Business,13,1,36414,13,1,36424,13,1,36577,13,1,36924,13,1,38794,20,23.25888921888938,-1.2917868,36.7872675,-1.3700383,36.9190174,900,1870,10,500
12903,12093,2523,3,Business,8,4,35686,8,4,35763,8,4,36553,8,4,36682,8,4,41288,19,20.7,-1.2551895,36.7822034,-1.3285517,36.9018,715,4606,77,919
12904,12516,53,3,Business,17,3,44695,17,3,44889,17,3,45119,17,3,45654,17,3,46503,7,23.25888921888938,-1.2638185,36.7930057,-1.2770708,36.8231093,291,849,194,765
12905,22715,20,3,Business,6,2,55975,6,2,56048,6,2,58526,6,2,60002,6,2,62008,11,23.25888921888938,-1.3140948,36.850972,-1.258693,36.801757,399,2006,73,3954
12906,13498,3689,3,Business,21,3,48398,21,3,54178,21,3,55403,21,3,55608,21,3,56037,3,23.0,-1.2527958,36.8003131,-1.2615888,36.7928732,557,429,5780,1430
12907,2614,3295,3,Business,26,5,59305,26,5,59314,26,5,59696,26,5,59806,26,5,60535,4,23.25888921888938,-1.2760915,36.8081029,-1.2571472,36.7950633,620,729,9,492
12908,3399,393,3,Business,2,6,37520,2,6,37570,2,6,38196,2,6,38708,2,6,39811,11,27.7,-1.3167113,36.8301563,-1.2636051,36.7850995,783,1103,50,1138
12909,7057,3115,3,Business,5,5,34579,5,5,34658,5,5,35525,5,5,36139,5,5,36954,6,17.7,-1.255956,36.772901,-1.2963097,36.7688221,336,815,79,1481
12910,5300,635,3,Business,13,3,51269,13,3,51416,13,3,52054,13,3,52536,13,3,54231,8,27.1,-1.2944363,36.7983424,-1.2602337,36.7990548,513,1695,147,1120
12911,18261,265,3,Business,14,4,56999,14,4,57232,14,4,58188,14,4,58261,14,4,61108,12,28.1,-1.300921,36.828195,-1.2332989,36.8130698,248,2847,233,1029
12912,23104,1714,3,Personal,24,4,42151,24,4,42182,24,4,42877,24,4,44179,24,4,45897,7,24.7,-1.3012619,36.8213697,-1.255597,36.830024,622,1718,31,1997
12913,13995,248,3,Business,9,5,41156,9,5,41237,9,5,41698,9,5,42482,9,5,43440,8,25.9,-1.304735,36.7846054,-1.2729652,36.8064396,726,958,81,1245
12914,15250,3355,3,Business,11,2,42560,11,2,42676,11,2,43470,11,2,43909,11,2,45548,10,19.6,-1.3014461,36.7661381,-1.3052491,36.8223899,457,1639,116,1233
12915,3142,346,3,Business,28,4,45618,28,4,50095,28,4,53166,28,4,53503,28,4,54745,5,29.8,-1.28878,36.8168312,-1.2591019,36.800577,304,1242,4477,3408
12916,23610,1646,3,Business,9,2,52292,9,2,52314,9,2,53833,9,2,54146,9,2,56288,10,30.6,-1.2894616,36.7826531,-1.2517448,36.7924971,76,2142,22,1832
12917,26655,2956,3,Business,2,5,49486,2,5,49539,2,5,49567,2,5,51875,2,5,51876,1,25.3,-1.2571472,36.7950633,-1.2584143,36.8048002,598,1,53,2336
12918,23787,1753,2,Business,28,5,60732,28,5,60836,28,5,61258,28,5,61901,28,5,63286,10,23.25888921888938,-1.2551895,36.7822034,-1.301769,36.757993,905,1385,104,1065
12919,8843,496,3,Business,19,3,56104,19,3,56219,19,3,56584,19,3,56650,19,3,60985,23,24.3,-1.2551895,36.7822034,-1.374163,36.913444,11,4335,115,431
12920,21731,2763,3,Business,2,5,45961,2,5,46011,2,5,46159,2,5,46434,2,5,47987,11,23.3,-1.2551895,36.7822034,-1.3250103,36.8388817,498,1553,50,423
12921,24424,53,3,Business,19,2,42876,19,2,43163,19,2,44467,19,2,45265,19,2,46907,8,26.5,-1.3167113,36.8301563,-1.2770708,36.8231093,154,1642,287,2102
12922,25729,2587,3,Business,13,2,45469,13,2,46778,13,2,47374,13,2,47932,13,2,51475,4,22.5,-1.28878,36.8168312,-1.2857247,36.7894293,447,3543,1309,1154
12923,24351,2330,3,Business,7,5,44370,7,5,44452,7,5,44940,7,5,46033,7,5,46231,14,23.25888921888938,-1.2890715,36.8157588,-1.2199518,36.8032133,472,198,82,1581
12924,17184,1280,3,Business,20,3,56742,20,3,56762,20,3,56788,20,3,57004,20,3,57831,4,29.4,-1.2551895,36.7822034,-1.2768326,36.8073804,576,827,20,242
12925,26528,1047,3,Personal,4,1,39713,4,1,39843,4,1,40439,4,1,40874,4,1,42601,9,26.5,-1.3077869,36.8443207,-1.26071,36.8206332,416,1727,130,1031
12926,1984,265,3,Business,15,2,46138,15,2,46278,15,2,48603,15,2,53663,15,2,56825,7,24.4,-1.2642978,36.819261,-1.300921,36.828195,554,3162,140,7385
12927,28034,718,3,Business,29,3,32247,29,3,32260,29,3,32501,29,3,32698,29,3,34621,5,17.8,-1.2551895,36.7822034,-1.2684816,36.8085622,155,1923,13,438
12928,14991,136,3,Business,6,1,39294,6,1,39351,6,1,39845,6,1,40105,6,1,40983,4,23.25888921888938,-1.2965045,36.7913036,-1.3009676,36.7657189,952,878,57,754
12929,26829,1500,3,Business,9,2,31662,9,2,31751,9,2,32717,9,2,33756,9,2,34428,6,20.8,-1.2770708,36.8231093,-1.2638185,36.7930057,438,672,89,2005
12930,6091,3404,3,Business,8,5,36202,8,5,38336,8,5,41462,8,5,45082,8,5,45538,11,24.0,-1.225322,36.80855,-1.279395,36.825364,436,456,2134,6746
12931,26092,1603,1,Personal,11,6,36445,11,6,36547,11,6,37575,11,6,37941,11,6,39070,6,20.8,-1.2830603,36.8298283,-1.3217456,36.8471431,754,1129,102,1394
12932,5647,2523,3,Business,20,3,53039,20,3,53056,20,3,53243,20,3,53528,20,3,55080,8,29.2,-1.2551895,36.7822034,-1.3038156,36.8122733,709,1552,17,472
12933,8498,591,3,Business,2,3,44291,2,3,44408,2,3,44715,2,3,45931,2,3,48849,10,22.0,-1.2864374,36.8202657,-1.22606,36.80039,406,2918,117,1523
12934,8122,635,3,Business,21,5,37796,21,5,37836,21,5,37971,21,5,38399,21,5,39017,2,20.0,-1.2599563,36.7993439,-1.2618264,36.8141179,147,618,40,563
12935,3535,928,3,Business,10,5,61906,10,5,62035,10,5,62761,10,5,63047,10,5,63934,2,23.25888921888938,-1.2551895,36.7822034,-1.2652708,36.7971508,689,887,129,1012
12936,19008,53,3,Business,25,4,39542,25,4,44322,25,4,44543,25,4,48570,25,4,50312,11,19.8,-1.306378,36.7519845,-1.2770708,36.8231093,731,1742,4780,4248
12937,6135,346,3,Business,14,4,37047,14,4,37068,14,4,38087,14,4,38426,14,4,45917,15,25.2,-1.28878,36.8168312,-1.216682,36.9085778,119,7491,21,1358
12938,26969,2974,3,Business,25,5,43312,25,5,43426,25,5,44021,25,5,44316,25,5,45119,6,21.0,-1.2621261,36.8079755,-1.287428,36.7800821,412,803,114,890
12939,76,3355,3,Business,28,3,44634,28,3,44796,28,3,45371,28,3,45467,28,3,45849,3,23.25888921888938,-1.3052491,36.8223899,-1.3197099,36.8312312,679,382,162,671
12940,6825,3235,1,Personal,17,5,35413,17,5,35428,17,5,36031,17,5,36324,17,5,37350,6,14.1,-1.310011,36.820824,-1.2677588,36.8169359,956,1026,15,896
12941,24043,3771,3,Personal,4,2,55302,4,2,55438,4,2,56040,4,2,56257,4,2,58016,4,22.6,-1.2664491,36.8102685,-1.2786221,36.8240639,584,1759,136,819
12942,10028,3149,3,Business,16,3,38556,16,3,38563,16,3,39109,16,3,40795,16,3,41633,6,22.8,-1.3004062,36.829741,-1.3167113,36.8301563,111,838,7,2232
12943,4543,53,3,Business,30,3,31047,30,3,35973,30,3,36358,30,3,37124,30,3,38059,5,19.5,-1.3004062,36.829741,-1.2770708,36.8231093,576,935,4926,1151
12944,13667,1959,3,Business,3,5,47954,3,5,47993,3,5,48714,3,5,48994,3,5,51067,9,23.25888921888938,-1.2945179,36.7685349,-1.2551895,36.7822034,197,2073,39,1001
12945,17811,1205,3,Business,22,5,48373,22,5,48433,22,5,50075,22,5,50881,22,5,52430,9,31.0,-1.2973188,36.7895013,-1.2495931,36.8065087,263,1549,60,2448
12946,2994,1209,3,Business,23,2,58721,23,2,59717,23,2,60501,23,2,60715,23,2,62557,12,23.25888921888938,-1.2991441,36.7528804,-1.3004062,36.829741,161,1842,996,998
12947,26289,972,3,Business,24,5,33439,24,5,33457,24,5,33909,24,5,34254,24,5,35068,4,15.7,-1.2862033,36.8152966,-1.2973949,36.816038,531,814,18,797
12948,19649,1724,3,Business,3,1,55385,3,1,59111,3,1,60794,3,1,61249,3,1,63764,15,22.6,-1.2551895,36.7822034,-1.3267689,36.8756255,427,2515,3726,2138
12949,16554,2308,3,Business,2,2,45450,2,2,45475,2,2,45911,2,2,46981,2,2,49441,20,21.1,-1.2963097,36.7688221,-1.3123562,36.9157558,247,2460,25,1506
12950,17372,2986,3,Personal,12,3,46091,12,3,46349,12,3,47340,12,3,47846,12,3,48950,4,19.5,-1.2878773,36.7818102,-1.2903886,36.8063847,582,1104,258,1497
12951,9094,2216,3,Business,3,1,52512,3,1,54098,3,1,55356,3,1,55914,3,1,57505,11,23.2,-1.2831602,36.880967,-1.306431,36.812042,237,1591,1586,1816
12952,23503,1368,3,Business,28,2,55444,28,2,55487,28,2,59319,28,2,59482,28,2,60075,4,23.4,-1.2571472,36.7950633,-1.2674274,36.7870827,491,593,43,3995
12953,15487,1169,1,Personal,4,1,51358,4,1,52345,4,1,52353,4,1,53385,4,1,54608,4,22.6,-1.2977387,36.8031447,-1.2868838,36.8284259,777,1223,987,1040
12954,22235,3557,3,Business,4,1,33056,4,1,33071,4,1,33521,4,1,34630,4,1,35520,7,21.9,-1.3047132,36.8089553,-1.2546732,36.8086796,72,890,15,1559
12955,5997,1764,1,Personal,31,5,51203,31,5,51282,31,5,52044,31,5,52502,31,5,53383,7,20.0,-1.3321038,36.8012564,-1.2887816,36.8088885,249,881,79,1220
12956,17740,2423,3,Business,15,5,54528,15,5,54553,15,5,54563,15,5,54792,15,5,55938,9,18.0,-1.2551895,36.7822034,-1.294869,36.815327,576,1146,25,239
12957,25279,3517,3,Business,18,1,49744,18,1,49785,18,1,50074,18,1,53825,18,1,55249,16,31.0,-1.300921,36.828195,-1.3882008,36.7699445,580,1424,41,4040
12958,15596,2154,3,Business,14,5,45836,14,5,45936,14,5,47385,14,5,47951,14,5,49842,17,21.7,-1.269767,36.7351068,-1.2765736,36.8513646,197,1891,100,2015
12959,21076,1363,3,Business,7,1,31613,7,1,31677,7,1,31899,7,1,32315,7,1,32757,4,18.6,-1.3004062,36.829741,-1.3177547,36.8303703,397,442,64,638
12960,9461,718,3,Business,8,5,42550,8,5,42894,8,5,44129,8,5,44525,8,5,47561,9,28.2,-1.2551895,36.7822034,-1.2786703,36.826044,103,3036,344,1631
12961,12560,3213,1,Personal,30,4,33881,30,4,33923,30,4,34107,30,4,37221,30,4,38515,8,16.3,-1.2630828,36.8050538,-1.3007534,36.7964576,131,1294,42,3298
12962,20244,1133,3,Business,1,1,40101,1,1,40124,1,1,41116,1,1,41364,1,1,44519,16,23.25888921888938,-1.3263105,36.8622904,-1.2551895,36.7822034,168,3155,23,1240
12963,1599,633,3,Business,7,4,39022,7,4,39048,7,4,41644,7,4,42030,7,4,42586,4,24.4,-1.3228003,36.8306435,-1.3004062,36.829741,842,556,26,2982
12964,23020,2627,3,Business,7,4,38965,7,4,38978,7,4,39493,7,4,43097,7,4,43367,2,27.4,-1.2527958,36.8003131,-1.2571472,36.7950633,489,270,13,4119
12965,24550,633,3,Business,5,2,51045,5,2,51071,5,2,52120,5,2,52361,5,2,52777,4,27.6,-1.3004062,36.829741,-1.3077869,36.8443207,433,416,26,1290
12966,2541,742,3,Personal,14,1,39404,14,1,39447,14,1,39697,14,1,39866,14,1,41622,18,23.0,-1.2804664,36.7701111,-1.2343236,36.8861,756,1756,43,419
12967,378,393,3,Business,26,2,46079,26,2,46104,26,2,46108,26,2,47423,26,2,47427,4,26.3,-1.3167113,36.8301563,-1.3004062,36.829741,10,4,25,1319
12968,7428,2577,2,Personal,18,6,61873,18,6,61881,18,6,63403,18,6,64366,18,6,66120,16,19.2,-1.1891303,36.896427,-1.2007275,36.7771863,384,1754,8,2485
12969,4374,3674,3,Business,7,4,34769,7,4,34783,7,4,36658,7,4,37045,7,4,40944,10,14.4,-1.2551895,36.7822034,-1.2951386,36.7970089,720,3899,14,2262
12970,3718,522,1,Personal,2,2,32410,2,2,32438,2,2,36466,2,2,36705,2,2,40090,19,15.3,-1.2643343,36.7447423,-1.2402455,36.8791753,755,3385,28,4267
12971,19409,3291,3,Business,10,1,34681,10,1,34707,10,1,35954,10,1,36573,10,1,37098,4,16.7,-1.2663631,36.8163329,-1.2600926,36.8088685,829,525,26,1866
12972,17223,2030,3,Business,28,2,30191,28,2,37344,28,2,37834,28,2,38748,28,2,40007,5,17.4,-1.3100586,36.8500329,-1.29658,36.823699,329,1259,7153,1404
12973,2493,1075,3,Business,11,5,50554,11,5,50563,11,5,50897,11,5,52160,11,5,53960,10,26.5,-1.3014461,36.7661381,-1.2527958,36.8003131,52,1800,9,1597
12974,26306,1066,1,Personal,20,5,42120,20,5,42270,20,5,44877,20,5,44954,20,5,46783,7,18.4,-1.2794426,36.8253733,-1.2885713,36.7649818,951,1829,150,2684
12975,23363,2190,3,Business,8,3,46127,8,3,46139,8,3,47296,8,3,47801,8,3,51330,15,23.25888921888938,-1.301953,36.788458,-1.2247423,36.8340921,599,3529,12,1662
12976,11526,3647,3,Business,7,4,54445,7,4,54532,7,4,55130,7,4,55491,7,4,56857,9,27.9,-1.272639,36.794723,-1.2486795,36.8156824,89,1366,87,959
12977,10464,346,3,Business,4,5,64715,4,5,65009,4,5,65267,4,5,65429,4,5,65942,2,22.3,-1.2885529,36.8160141,-1.2951243,36.8281344,742,513,294,420
12978,17995,20,3,Business,6,1,51701,6,1,52535,6,1,52814,6,1,52914,6,1,53919,5,23.25888921888938,-1.2629666,36.8068369,-1.276495,36.8205966,281,1005,834,379
12979,11253,3372,3,Business,9,1,40026,9,1,40052,9,1,40118,9,1,40956,9,1,42502,11,20.1,-1.3169591,36.7000029,-1.2969741,36.7856612,101,1546,26,904
12980,4626,3355,3,Business,7,6,60256,7,6,60565,7,6,61235,7,6,61697,7,6,62893,11,20.9,-1.339046,36.762596,-1.3052491,36.8223899,629,1196,309,1132
12981,221,2200,3,Business,1,4,44656,1,4,45199,1,4,45797,1,4,46286,1,4,47846,6,23.25888921888938,-1.2584143,36.8048002,-1.290894,36.822971,726,1560,543,1087
12982,23605,3404,3,Business,21,4,40718,21,4,40774,21,4,42662,21,4,43223,21,4,43619,7,28.0,-1.279395,36.825364,-1.2551895,36.7822034,61,396,56,2449
12983,4655,2523,3,Business,21,4,59593,21,4,59617,21,4,59635,21,4,59888,21,4,60476,4,28.7,-1.2551895,36.7822034,-1.2679514,36.8095213,576,588,24,271
12984,14281,685,3,Business,13,4,35163,13,4,35194,13,4,35578,13,4,36220,13,4,38032,14,18.7,-1.265432,36.795034,-1.3278522,36.8711134,131,1812,31,1026
12985,13247,3434,3,Business,8,5,30916,8,5,30986,8,5,32266,8,5,32795,8,5,33573,5,20.6,-1.3253826,36.8822315,-1.3189344,36.9087593,329,778,70,1809
12986,15916,2523,3,Business,13,3,53302,13,3,53605,13,3,53692,13,3,53909,13,3,55670,7,29.2,-1.2551895,36.7822034,-1.2989934,36.8136694,709,1761,303,304
12987,17271,3149,3,Business,29,3,36166,29,3,36184,29,3,36191,29,3,38626,29,3,39843,5,23.25888921888938,-1.3004062,36.829741,-1.3167113,36.8301563,399,1217,18,2442
12988,10358,1142,1,Personal,6,1,35232,6,1,36697,6,1,37294,6,1,37800,6,1,39892,15,14.9,-1.2561398,36.8194374,-1.291264,36.8887041,427,2092,1465,1103
12989,24023,718,1,Business,4,3,45268,4,3,45279,4,3,45632,4,3,46052,4,3,46559,6,17.2,-1.2551895,36.7822034,-1.2758541,36.7738616,103,507,11,773
12990,13094,3291,3,Business,27,6,37573,27,6,37606,27,6,37881,27,6,38079,27,6,38484,2,23.25888921888938,-1.2673935,36.8030328,-1.2600926,36.8088685,655,405,33,473
12991,2482,3621,3,Business,7,5,48797,7,5,48848,7,5,49485,7,5,49693,7,5,50865,10,23.25888921888938,-1.2836583,36.7886014,-1.2614967,36.7420697,161,1172,51,845
12992,17632,2602,3,Personal,13,4,52040,13,4,52470,13,4,53143,13,4,53390,13,4,54615,8,22.6,-1.270766,36.810988,-1.3228162,36.8226414,247,1225,430,920
12993,15471,2801,3,Business,7,5,50549,7,5,50614,7,5,51440,7,5,51823,7,5,52923,3,23.25888921888938,-1.2658373,36.8018598,-1.2674274,36.7870827,690,1100,65,1209
12994,16294,1873,3,Business,12,2,40306,12,2,40465,12,2,41260,12,2,43626,12,2,45476,5,24.4,-1.2571472,36.7950633,-1.2934657,36.8212737,678,1850,159,3161
12995,617,1859,1,Business,15,3,40812,15,3,40862,15,3,41439,15,3,41619,15,3,43681,8,18.1,-1.2993666,36.8232195,-1.2825804,36.8775087,402,2062,50,757
12996,8121,1874,3,Business,19,2,37485,19,2,37572,19,2,37848,19,2,38391,19,2,39724,7,26.5,-1.2571472,36.7950633,-1.3041019,36.8105732,31,1333,87,819
12997,17222,635,3,Business,29,1,44476,29,1,44687,29,1,45069,29,1,46179,29,1,48039,7,23.25888921888938,-1.2602337,36.7990548,-1.3081376,36.8329772,435,1860,211,1492
12998,9986,2763,3,Business,10,3,40810,10,3,40912,10,3,41112,10,3,41239,10,3,43591,14,27.6,-1.2551895,36.7822034,-1.3015998,36.8764939,835,2352,102,327
12999,22351,3186,3,Business,1,4,51981,1,4,52049,1,4,52865,1,4,52968,1,4,54727,7,23.25888921888938,-1.2980229,36.78865,-1.2574088,36.799712,722,1759,68,919
13000,2333,2987,3,Business,5,1,55128,5,1,56094,5,1,56493,5,1,56841,5,1,57731,10,26.0,-1.270212,36.8210877,-1.2297202,36.8819507,427,890,966,747
13001,13647,2335,3,Business,12,5,51233,12,5,51253,12,5,52931,12,5,53058,12,5,55169,22,23.25888921888938,-1.2551895,36.7822034,-1.3562374,36.9042954,955,2111,20,1805
13002,13835,3688,3,Business,14,5,49445,14,5,49457,14,5,50870,14,5,51300,14,5,54168,21,22.9,-1.215326,36.8919938,-1.3194518,36.869396,510,2868,12,1843
13003,19950,1271,3,Business,21,3,42623,21,3,44367,21,3,44812,21,3,45959,21,3,47353,11,21.8,-1.3244885,36.897792,-1.2715944,36.9114173,675,1394,1744,1592
13004,19796,867,3,Business,9,2,29722,9,2,29772,9,2,31028,9,2,31965,9,2,33009,10,21.0,-1.2996533,36.8292629,-1.2991441,36.7528804,61,1044,50,2193
13005,12572,3647,3,Business,20,4,34946,20,4,40061,20,4,40572,20,4,40715,20,4,42277,7,24.6,-1.272639,36.794723,-1.2816547,36.8283405,156,1562,5115,654
13006,12945,3517,3,Business,16,4,40926,16,4,40953,16,4,40967,16,4,43297,16,4,43924,16,23.25888921888938,-1.300921,36.828195,-1.3882008,36.7699445,137,627,27,2344
13007,24149,1402,3,Business,22,5,40136,22,5,40224,22,5,41987,22,5,42476,22,5,42628,1,28.4,-1.2813012,36.8323962,-1.2882247,36.8238821,377,152,88,2252
13008,18257,517,3,Business,30,4,34041,30,4,34071,30,4,34222,30,4,34466,30,4,35365,7,19.5,-1.3228003,36.8306435,-1.3012842,36.8561033,709,899,30,395
13009,9913,3757,3,Personal,10,3,45371,10,3,46375,10,3,47756,10,3,49138,10,3,50298,9,30.5,-1.2655381,36.8354648,-1.3173869,36.8112044,383,1160,1004,2763
13010,20834,79,1,Personal,5,5,58498,5,5,64615,5,5,67079,5,5,67524,5,5,69731,15,24.9,-1.3372002,36.7538932,-1.2684319,36.8165853,268,2207,6117,2909
13011,3137,1635,3,Personal,18,2,31274,18,2,31341,18,2,32765,18,2,33664,18,2,35787,11,19.7,-1.2483726,36.8901617,-1.2684816,36.8085622,467,2123,67,2323
13012,5274,503,3,Business,14,4,37587,14,4,37799,14,4,38403,14,4,38748,14,4,44167,15,19.1,-1.2601709,36.8002238,-1.2859912,36.8756811,865,5419,212,949
13013,6078,2008,3,Business,4,5,55690,4,5,55762,4,5,56524,4,5,57135,4,5,57987,9,23.25888921888938,-1.2508229,36.7895263,-1.2696795,36.8640088,307,852,72,1373
13014,21014,867,3,Business,15,2,51211,15,2,51667,15,2,52170,15,2,52542,15,2,53691,9,24.4,-1.2574219,36.7927073,-1.2991441,36.7528804,523,1149,456,875
13015,21409,627,3,Business,16,4,56447,16,4,56470,16,4,56525,16,4,56699,16,4,58113,8,23.25888921888938,-1.2551895,36.7822034,-1.2858059,36.7876302,177,1414,23,229
13016,17377,3725,2,Personal,7,5,62780,7,5,63018,7,5,63651,7,5,63972,7,5,64965,7,22.2,-1.2619527,36.806749,-1.2637102,36.7610487,449,993,238,954
13017,4143,1329,3,Business,18,5,36894,18,5,36955,18,5,37270,18,5,37526,18,5,39421,13,20.3,-1.273056,36.811298,-1.1989344,36.8360887,205,1895,61,571
13018,6004,3087,2,Personal,19,3,53668,19,3,54597,19,3,56291,19,3,56671,19,3,58680,17,25.4,-1.1855066,36.8254646,-1.2619538,36.8087637,882,2009,929,2074
13019,1007,733,3,Business,6,1,31037,6,1,31043,6,1,31717,6,1,32256,6,1,34306,17,14.8,-1.2551895,36.7822034,-1.3472066,36.7692638,400,2050,6,1213
13020,8418,2207,3,Business,16,4,53553,16,4,53588,16,4,53909,16,4,54364,16,4,57200,1,19.2,-1.2696908,36.81519,-1.2724096,36.8135361,498,2836,35,776
13021,9205,2899,3,Personal,14,5,40343,14,5,40393,14,5,41826,14,5,42137,14,5,43234,4,21.9,-1.2862436,36.791017,-1.298762,36.7636456,655,1097,50,1744
13022,10463,2956,3,Business,19,1,38556,19,1,38567,19,1,38919,19,1,39137,19,1,39486,1,24.6,-1.2584143,36.8048002,-1.2597529,36.806629,247,349,11,570
13023,21853,1899,3,Business,15,2,37443,15,2,40097,15,2,40581,15,2,41024,15,2,41038,6,22.6,-1.318062,36.849326,-1.331619,36.847976,408,14,2654,927
13024,27022,3127,3,Business,13,4,56871,13,4,56903,13,4,57757,13,4,58319,13,4,59142,4,26.6,-1.2789156,36.8171348,-1.2918246,36.801585,847,823,32,1416
13025,1455,575,1,Personal,4,4,58796,4,4,58823,4,4,59500,4,4,60987,4,4,62466,7,23.25888921888938,-1.2684962,36.8079433,-1.285769,36.760073,178,1479,27,2164
13026,12413,1687,3,Business,3,1,30549,3,1,30583,3,1,31077,3,1,31505,3,1,32279,6,15.1,-1.2888684,36.816867,-1.2915472,36.7746964,726,774,34,922
13027,20435,3517,3,Business,7,4,33630,7,4,36452,7,4,37570,7,4,38411,7,4,39916,16,27.7,-1.3882008,36.7699445,-1.300921,36.828195,885,1505,2822,1959
13028,1676,3674,3,Business,18,4,56667,18,4,58512,18,4,59610,18,4,59847,18,4,62409,9,23.25888921888938,-1.2551895,36.7822034,-1.2786703,36.826044,709,2562,1845,1335
13029,25499,3650,3,Business,7,5,50997,7,5,53142,7,5,53439,7,5,53760,7,5,54777,6,26.8,-1.2848376,36.8027622,-1.2905113,36.7591138,920,1017,2145,618
13030,23430,2983,1,Personal,23,6,37964,23,6,38599,23,6,39933,23,6,40635,23,6,42381,13,23.25888921888938,-1.2789537,36.8286392,-1.2835228,36.7437619,752,1746,635,2036
13031,26999,2630,2,Personal,30,3,44296,30,3,45152,30,3,45908,30,3,46209,30,3,47165,5,22.6,-1.2782498,36.8251128,-1.301796,36.8012024,480,956,856,1057
13032,24067,1882,3,Business,3,3,40506,3,3,40524,3,3,41921,3,3,42165,3,3,42753,1,27.5,-1.2588775,36.8079744,-1.253784,36.79907,194,588,18,1641
13033,16418,2869,3,Business,23,6,40019,23,6,40045,23,6,42004,23,6,42107,23,6,43235,3,26.5,-1.3025826,36.7670807,-1.2765492,36.7669809,112,1128,26,2062
13034,5720,2523,3,Business,27,3,34987,27,3,35000,27,3,35057,27,3,35870,27,3,37600,10,23.25888921888938,-1.2551895,36.7822034,-1.2287282,36.8115304,908,1730,13,870
13035,17020,867,3,Business,10,5,42740,10,5,42826,10,5,44545,10,5,45645,10,5,46840,14,23.25888921888938,-1.3077869,36.8443207,-1.2991441,36.7528804,544,1195,86,2819
13036,12105,393,3,Business,13,3,45014,13,3,45047,13,3,45056,13,3,46254,13,3,46798,4,23.25888921888938,-1.3167113,36.8301563,-1.3004062,36.829741,120,544,33,1207
13037,10677,868,3,Business,2,3,47936,2,3,47987,2,3,48344,2,3,48802,2,3,49803,7,26.1,-1.2628473,36.781805,-1.265715,36.823815,521,1001,51,815
13038,16006,635,3,Business,21,1,51678,21,1,51732,21,1,52134,21,1,52232,21,1,53288,7,27.5,-1.2599563,36.7993439,-1.3081376,36.8329772,933,1056,54,500
13039,7422,2975,2,Personal,3,5,42409,3,5,42559,3,5,42824,3,5,43553,3,5,44555,7,21.4,-1.2809914,36.8123591,-1.2632929,36.785618,754,1002,150,994
13040,16604,868,3,Business,4,6,40929,4,6,40970,4,6,42088,4,6,42900,4,6,45085,14,23.25888921888938,-1.293515,36.897607,-1.265715,36.823815,377,2185,41,1930
13041,25956,3194,3,Business,23,5,49326,23,5,49349,23,5,49369,23,5,49614,23,5,51895,3,26.3,-1.2551895,36.7822034,-1.2652916,36.8076704,322,2281,23,265
13042,4047,3689,3,Business,3,3,65263,3,3,65282,3,3,65456,3,3,65748,3,3,67383,10,23.8,-1.2527958,36.8003131,-1.2248308,36.8012573,178,1635,19,466
13043,13722,1882,3,Business,11,4,42986,11,4,43004,11,4,43377,11,4,45398,11,4,46416,7,25.5,-1.2956882,36.7861845,-1.2591019,36.800577,832,1018,18,2394
13044,26559,868,3,Business,4,3,36345,4,3,36477,4,3,37871,4,3,38399,4,3,39872,8,16.8,-1.303596,36.778378,-1.265715,36.823815,951,1473,132,1922
13045,26152,2330,3,Business,26,5,51199,26,5,51248,26,5,53313,26,5,53562,26,5,54558,7,23.25888921888938,-1.2326041,36.8009029,-1.2291477,36.8440295,263,996,49,2314
13046,23575,1402,3,Business,6,6,47845,6,6,47939,6,6,48031,6,6,49527,6,6,49532,1,28.2,-1.279395,36.825364,-1.2813012,36.8323962,102,5,94,1588
13047,25295,2030,3,Business,28,4,48596,28,4,49575,28,4,50501,28,4,51056,28,4,51937,2,23.25888921888938,-1.2972654,36.8330766,-1.29658,36.823699,752,881,979,1481
13048,16979,393,3,Business,30,2,58991,30,2,59005,30,2,59301,30,2,59796,30,2,61883,14,23.7,-1.3177547,36.8303703,-1.306378,36.7519845,208,2087,14,791
13049,3887,1280,3,Business,8,5,42738,8,5,42955,8,5,44123,8,5,44587,8,5,45295,5,28.5,-1.2551895,36.7822034,-1.2731645,36.7900343,103,708,217,1632
13050,15038,3647,3,Business,11,1,48337,11,1,48404,11,1,48844,11,1,49578,11,1,52381,29,29.1,-1.272639,36.794723,-1.2905202,36.9774058,932,2803,67,1174
13051,17761,393,3,Business,18,2,38722,18,2,43297,18,2,43314,18,2,44673,18,2,45923,11,23.25888921888938,-1.3167113,36.8301563,-1.2574219,36.7927073,10,1250,4575,1376
13052,25095,269,3,Business,30,3,56222,30,3,57887,30,3,58785,30,3,59435,30,3,60891,12,25.3,-1.3332749,36.8708147,-1.3886344,36.9372718,474,1456,1665,1548
13053,23971,2069,3,Business,18,4,37864,18,4,37896,18,4,39455,18,4,40498,18,4,41640,9,23.25888921888938,-1.272828,36.816608,-1.228911,36.881876,435,1142,32,2602
13054,19558,1361,1,Personal,28,1,33844,28,1,33875,28,1,34588,28,1,34796,28,1,36223,8,17.8,-1.2948784,36.7766328,-1.2688997,36.8014613,726,1427,31,921
13055,19125,265,3,Business,18,5,53636,18,5,53759,18,5,55067,18,5,55257,18,5,56299,4,27.0,-1.305791,36.8111627,-1.300921,36.828195,654,1042,123,1498
13056,25467,2677,3,Business,2,5,35998,2,5,36005,2,5,36657,2,5,36985,2,5,40143,26,17.8,-1.306378,36.7519845,-1.3440557,36.9099653,536,3158,7,980
13057,7392,1329,3,Business,7,2,40519,7,2,42388,7,2,43464,7,2,44169,7,2,50266,9,23.25888921888938,-1.273056,36.811298,-1.2940769,36.7491574,864,6097,1869,1781
13058,13194,3291,3,Business,22,2,53400,22,2,53424,22,2,54256,22,2,55010,22,2,56013,5,25.8,-1.2783849,36.8163445,-1.2600926,36.8088685,365,1003,24,1586
13059,13728,633,3,Business,17,4,56530,17,4,56541,17,4,57209,17,4,57382,17,4,58148,4,27.8,-1.3077869,36.8443207,-1.3004062,36.829741,523,766,11,841
13060,1018,1584,3,Business,14,5,50214,14,5,50392,14,5,51502,14,5,51879,14,5,55611,17,23.9,-1.2969741,36.7856612,-1.2970848,36.8878229,272,3732,178,1487
13061,10783,3380,3,Personal,19,4,45320,19,4,45513,19,4,45844,19,4,46048,19,4,47330,7,20.2,-1.296797,36.7764525,-1.2824911,36.8218042,634,1282,193,535
13062,27796,1459,3,Business,29,4,51942,29,4,52484,29,4,52767,29,4,52962,29,4,53731,7,25.0,-1.264945,36.784678,-1.2479362,36.772759,123,769,542,478
13063,23105,1244,3,Business,3,4,31986,3,4,32101,3,4,32286,3,4,33310,3,4,34365,11,20.2,-1.331619,36.847976,-1.303596,36.778378,404,1055,115,1209
13064,15436,517,3,Business,28,5,36338,28,5,36350,28,5,36355,28,5,36748,28,5,37735,11,19.5,-1.3167113,36.8301563,-1.2574219,36.7927073,619,987,12,398
13065,585,1958,3,Business,11,2,41777,11,2,42339,11,2,43696,11,2,43974,11,2,46997,23,19.4,-1.3700383,36.9190174,-1.2571472,36.7950633,583,3023,562,1635
13066,19294,2677,3,Business,28,2,33872,28,2,33885,28,2,34048,28,2,35059,28,2,36615,10,18.8,-1.3004062,36.829741,-1.2991441,36.7528804,591,1556,13,1174
13067,12792,281,2,Personal,18,6,56860,18,6,56870,18,6,57294,18,6,57713,18,6,59297,7,20.5,-1.3002897,36.7601637,-1.3353385,36.7778749,452,1584,10,843
13068,9707,465,2,Personal,22,5,50490,22,5,50716,22,5,54373,22,5,55096,22,5,57320,7,23.25888921888938,-1.2551973,36.7781743,-1.2765299,36.8220306,268,2224,226,4380
13069,26768,3758,1,Personal,14,6,33973,14,6,33988,14,6,35919,14,6,36733,14,6,39635,12,15.0,-1.3083851,36.9058552,-1.2782058,36.8311888,329,2902,15,2745
13070,17733,3565,3,Business,23,2,38697,23,2,38913,23,2,41084,23,2,41586,23,2,43797,11,18.2,-1.2770168,36.8331774,-1.3142011,36.8993879,532,2211,216,2673
13071,15255,1992,3,Business,2,4,42326,2,4,42346,2,4,42512,2,4,42677,2,4,45047,5,23.25888921888938,-1.2899816,36.7846439,-1.3025826,36.7670807,327,2370,20,331
13072,897,3295,3,Business,28,4,37207,28,4,37224,28,4,37242,28,4,37866,28,4,38461,3,22.5,-1.2571472,36.7950633,-1.2753109,36.8130185,623,595,17,642
13073,12842,635,3,Business,13,3,52732,13,3,52805,13,3,53409,13,3,54386,13,3,57041,24,27.0,-1.2602337,36.7990548,-1.161385,36.94731,571,2655,73,1581
13074,6492,2801,3,Business,24,1,39339,24,1,39354,24,1,39775,24,1,39920,24,1,41323,7,22.5,-1.2595422,36.7871178,-1.281577,36.7938293,38,1403,15,566
13075,8362,60,3,Business,3,4,41112,3,4,41146,3,4,41744,3,4,41973,3,4,43079,6,23.4,-1.228911,36.881876,-1.22978,36.836215,75,1106,34,827
13076,19788,1961,3,Business,29,3,47764,29,3,47800,29,3,48278,29,3,48574,29,3,49962,9,23.25888921888938,-1.303596,36.778378,-1.3188359,36.7038526,176,1388,36,774
13077,10030,1899,3,Business,23,3,34139,23,3,36636,23,3,39467,23,3,39807,23,3,40826,15,21.6,-1.344446,36.756597,-1.331619,36.847976,846,1019,2497,3171
13078,16666,3439,3,Business,20,1,56136,20,1,56193,20,1,57380,20,1,57686,20,1,58837,11,23.25888921888938,-1.2393157,36.7668877,-1.2128248,36.8029667,689,1151,57,1493
13079,13787,3417,1,Personal,31,2,46964,31,2,46984,31,2,47571,31,2,48355,31,2,50113,14,18.4,-1.3240062,36.8490097,-1.3851908,36.9428319,520,1758,20,1371
13080,13839,2216,3,Business,5,5,48690,5,5,48722,5,5,48758,5,5,49469,5,5,50627,8,27.7,-1.2551895,36.7822034,-1.2964348,36.8182757,576,1158,32,747
13081,1759,496,3,Business,23,4,41438,23,4,41470,23,4,41560,23,4,43834,23,4,46332,23,18.5,-1.2551895,36.7822034,-1.374163,36.913444,223,2498,32,2364
13082,27729,237,3,Business,13,6,36720,13,6,36954,13,6,38651,13,6,39173,13,6,42584,37,25.8,-1.1962799,36.9521972,-1.3516579,36.7298363,484,3411,234,2219
13083,6047,1859,3,Business,22,2,47016,22,2,47045,22,2,47134,22,2,47569,22,2,49658,13,19.6,-1.2993666,36.8232195,-1.2470959,36.8729823,561,2089,29,524
13084,23859,1143,1,Personal,17,3,30507,17,3,30543,17,3,30606,17,3,31299,17,3,33052,13,21.0,-1.2551895,36.7822034,-1.29928,36.85631,726,1753,36,756
13085,8336,1207,3,Business,22,6,37993,22,6,38008,22,6,38221,22,6,38724,22,6,40488,13,23.1,-1.2629666,36.8068369,-1.2156006,36.8916865,685,1764,15,716
13086,1691,3560,3,Business,13,6,40453,13,6,40515,13,6,41437,13,6,42202,13,6,43028,5,25.9,-1.2584143,36.8048002,-1.279395,36.825364,394,826,62,1687
13087,24034,2982,3,Business,14,4,57998,14,4,58022,14,4,58040,14,4,59693,14,4,62370,18,26.5,-1.300921,36.828195,-1.177202,36.8351183,661,2677,24,1671
13088,1698,1705,3,Business,10,4,49258,10,4,49360,10,4,49613,10,4,50172,10,4,51222,7,25.1,-1.2571472,36.7950633,-1.2404104,36.8104486,268,1050,102,812
13089,18350,2992,1,Personal,10,5,66454,10,5,66532,10,5,67431,10,5,67658,10,5,68802,5,21.1,-1.2883158,36.8199114,-1.307774,36.8407541,213,1144,78,1126
13090,20963,2066,3,Business,17,6,48665,17,6,49070,17,6,49613,17,6,50255,17,6,52254,18,24.0,-1.3270716,36.8406371,-1.2156006,36.8916865,882,1999,405,1185
13091,24908,1304,3,Business,4,2,50013,4,2,52378,4,2,54464,4,2,54593,4,2,56159,13,24.0,-1.3226302,36.8719901,-1.29387,36.7907813,936,1566,2365,2215
13092,6255,868,3,Business,25,4,51891,25,4,51899,25,4,51904,25,4,52306,25,4,53090,5,23.25888921888938,-1.2600926,36.8088685,-1.265715,36.823815,709,784,8,407
13093,3101,2523,3,Business,12,2,54234,12,2,54370,12,2,54825,12,2,55311,12,2,57190,8,23.25888921888938,-1.2551895,36.7822034,-1.3021707,36.8168444,495,1879,136,941
13094,19544,762,3,Personal,25,1,33898,25,1,33985,25,1,34436,25,1,35270,25,1,36607,7,21.2,-1.2793831,36.7620574,-1.2994772,36.804825,269,1337,87,1285
13095,11320,2271,3,Business,2,4,40349,2,4,40404,2,4,41120,2,4,41654,2,4,43902,14,23.25888921888938,-1.272828,36.816608,-1.293515,36.897607,930,2248,55,1250
13096,19463,3647,3,Business,17,4,35658,17,4,35725,17,4,36924,17,4,37816,17,4,38632,4,23.25888921888938,-1.272639,36.794723,-1.2686614,36.8031594,49,816,67,2091
13097,21019,1974,3,Personal,15,5,41298,15,5,41318,15,5,41710,15,5,42682,15,5,43935,7,26.3,-1.301953,36.788458,-1.2715686,36.8023526,856,1253,20,1364
13098,2005,3560,3,Business,20,3,57109,20,3,57263,20,3,59039,20,3,59309,20,3,60943,5,28.5,-1.2658424,36.8101804,-1.279395,36.825364,411,1634,154,2046
13099,5008,1787,3,Business,21,2,35979,21,2,35991,21,2,36245,21,2,37056,21,2,39442,18,23.25888921888938,-1.3014461,36.7661381,-1.2283403,36.8822756,161,2386,12,1065
13100,23790,3147,3,Business,8,4,34105,8,4,34112,8,4,35058,8,4,35237,8,4,38293,17,20.5,-1.3472066,36.7692638,-1.2551895,36.7822034,533,3056,7,1125
13101,27798,1209,3,Business,20,4,48106,20,4,48772,20,4,49603,20,4,50656,20,4,53127,9,25.2,-1.2574219,36.7927073,-1.3004062,36.829741,812,2471,666,1884
13102,10284,1877,3,Personal,23,4,48285,23,4,48389,23,4,49139,23,4,50199,23,4,54395,32,20.8,-1.2156006,36.8916865,-1.371951,36.7268649,882,4196,104,1810
13103,20326,552,3,Business,18,4,43526,18,4,43589,18,4,43595,18,4,43681,18,4,46558,7,23.25888921888938,-1.335477,36.9308297,-1.3562374,36.9042954,346,2877,63,92
13104,14582,136,3,Business,8,5,32057,8,5,32765,8,5,33339,8,5,33533,8,5,35996,19,20.7,-1.2768704,36.8251777,-1.3254522,36.7216584,758,2463,708,768
13105,20397,1829,3,Personal,19,3,43200,19,3,43241,19,3,43903,19,3,44318,19,3,45338,8,23.25888921888938,-1.3056847,36.8101341,-1.2590031,36.8078168,648,1020,41,1077
13106,18368,1271,3,Business,13,4,40480,13,4,40509,13,4,41675,13,4,42573,13,4,46183,24,22.0,-1.3107918,36.761794,-1.2209733,36.9045746,268,3610,29,2064
13107,3986,2587,3,Business,8,6,47573,8,6,47590,8,6,48061,8,6,48898,8,6,48927,1,24.7,-1.28878,36.8168312,-1.2803414,36.8265456,74,29,17,1308
13108,26151,3686,3,Business,7,7,41942,7,7,42063,7,7,42984,7,7,43170,7,7,44380,13,25.4,-1.2551895,36.7822034,-1.2025741,36.7865517,453,1210,121,1107
13109,12225,1954,3,Business,31,4,34714,31,4,34744,31,4,36890,31,4,40192,31,4,40820,4,21.6,-1.289498,36.818878,-1.269534,36.80697,216,628,30,5448
13110,7543,3487,3,Business,29,1,54572,29,1,54635,29,1,54886,29,1,55113,29,1,55743,6,23.25888921888938,-1.279395,36.825364,-1.2615888,36.7928732,291,630,63,478
13111,1076,1484,3,Business,5,2,59112,5,2,59284,5,2,60257,5,2,60919,5,2,63202,11,21.7,-1.2579304,36.8019667,-1.3083777,36.8590077,101,2283,172,1635
13112,18685,2092,1,Personal,27,3,70468,27,3,70544,27,3,71178,27,3,71890,27,3,72792,5,23.25888921888938,-1.2912918,36.758141,-1.2657709,36.7305746,832,902,76,1346
13113,3701,2330,3,Business,12,5,52988,12,5,53027,12,5,54322,12,5,54858,12,5,56301,20,23.25888921888938,-1.2505902,36.8651126,-1.380892,36.923378,8,1443,39,1831
13114,16101,242,3,Business,7,4,41119,7,4,41473,7,4,42178,7,4,42574,7,4,43755,9,16.8,-1.2551895,36.7822034,-1.306245,36.8192978,752,1181,354,1101
13115,19111,2306,3,Business,11,1,36977,11,1,37038,11,1,37920,11,1,38495,11,1,41301,21,26.4,-1.2271998,36.8084905,-1.3503196,36.7666408,882,2806,61,1457
13116,2083,1500,3,Business,6,3,34510,6,3,34552,6,3,34559,6,3,35815,6,3,35936,8,23.25888921888938,-1.3004062,36.829741,-1.2638185,36.7930057,70,121,42,1263
13117,27645,3560,3,Business,7,3,55814,7,3,56917,7,3,57692,7,3,58183,7,3,60036,18,28.4,-1.3705766,36.9120742,-1.279395,36.825364,237,1853,1103,1266
13118,13204,1642,3,Business,25,4,60226,25,4,60376,25,4,60854,25,4,61741,25,4,63452,5,23.25888921888938,-1.2855799,36.8176209,-1.2728069,36.7962362,889,1711,150,1365
13119,10646,2200,3,Business,9,6,55553,9,6,55560,9,6,56381,9,6,56754,9,6,58869,12,29.8,-1.290894,36.822971,-1.2927792,36.9053492,278,2115,7,1194
13120,19777,3283,3,Business,7,4,40818,7,4,41703,7,4,42142,7,4,42287,7,4,43378,6,27.4,-1.272828,36.816608,-1.2628473,36.781805,563,1091,885,584
13121,6260,1976,3,Business,21,4,38712,21,4,38732,21,4,39797,21,4,40000,21,4,40881,8,25.2,-1.257028,36.7810435,-1.2882073,36.8237673,411,881,20,1268
13122,9693,3131,3,Personal,14,1,40807,14,1,40816,14,1,42743,14,1,43638,14,1,45487,10,23.3,-1.3261306,36.850596,-1.263419,36.8060348,926,1849,9,2822
13123,14786,3009,1,Personal,30,1,42468,30,1,42495,30,1,43351,30,1,45694,30,1,46412,8,22.4,-1.3034413,36.7770106,-1.2576952,36.7969797,465,718,27,3199
13124,13923,1874,3,Business,12,3,43558,12,3,43607,12,3,44021,12,3,44688,12,3,45614,7,23.0,-1.2871938,36.8195031,-1.2571472,36.7950633,338,926,49,1081
13125,2861,302,3,Business,2,2,49092,2,2,49120,2,2,49377,2,2,49950,2,2,50360,7,26.3,-1.2649605,36.7981777,-1.2563793,36.7850151,882,410,28,830
13126,28088,269,3,Business,24,5,47180,24,5,47199,24,5,50056,24,5,50522,24,5,51484,11,23.2,-1.2810586,36.8838294,-1.3332749,36.8708147,549,962,19,3323
13127,27341,3560,3,Business,15,5,56076,15,5,56099,15,5,58053,15,5,58740,15,5,59123,1,17.7,-1.290894,36.822971,-1.2871938,36.8195031,456,383,23,2641
13128,10566,1281,3,Business,15,3,40870,15,3,40879,15,3,42300,15,3,42701,15,3,44223,13,18.3,-1.2707742,36.7578609,-1.3184421,36.6911394,179,1522,9,1822
13129,22008,20,3,Business,10,5,44204,10,5,44243,10,5,44508,10,5,44893,10,5,45289,1,23.25888921888938,-1.2616841,36.801999,-1.2629666,36.8068369,96,396,39,650
13130,22042,3689,3,Business,5,1,45668,5,1,45741,5,1,46162,5,1,47119,5,1,47142,6,24.4,-1.2527958,36.8003131,-1.290894,36.822971,660,23,73,1378
13131,24251,1089,1,Personal,10,5,59097,10,5,59113,10,5,59410,10,5,59900,10,5,63547,23,21.3,-1.2799394,36.8192374,-1.259447,36.6739213,414,3647,16,787
13132,23349,1280,3,Business,8,5,45640,8,5,45781,8,5,48249,8,5,48668,8,5,51015,5,28.5,-1.2551895,36.7822034,-1.2694398,36.7624483,228,2347,141,2887
13133,21408,3064,3,Business,22,1,43143,22,1,43189,22,1,44106,22,1,44201,22,1,45640,10,24.8,-1.3011151,36.8391222,-1.2571472,36.7950633,38,1439,46,1012
13134,5520,2236,1,Personal,23,3,52031,23,3,53412,23,3,54185,23,3,54404,23,3,55751,8,22.2,-1.3245486,36.7961418,-1.283714,36.8212782,79,1347,1381,992
13135,12304,439,3,Business,23,5,41764,23,5,41806,23,5,41857,23,5,42410,23,5,45764,15,23.9,-1.2696824,36.8026164,-1.3323107,36.8692616,120,3354,42,604
13136,5668,393,3,Business,3,3,34502,3,3,34517,3,3,34627,3,3,35778,3,3,37610,10,18.3,-1.3177547,36.8303703,-1.2574219,36.7927073,623,1832,15,1261
13137,11540,1049,3,Personal,5,2,36094,5,2,36156,5,2,36725,5,2,37792,5,2,38838,8,21.1,-1.300334,36.7974957,-1.258685,36.805292,267,1046,62,1636
13138,7362,3201,3,Business,28,4,33514,28,4,33559,28,4,35459,28,4,36070,28,4,41444,15,19.3,-1.2285835,36.8826468,-1.2584143,36.8048002,686,5374,45,2511
13139,26822,1245,3,Business,18,2,39544,18,2,39685,18,2,40332,18,2,41392,18,2,43595,19,23.25888921888938,-1.300921,36.828195,-1.3198615,36.7110323,519,2203,141,1707
13140,4440,3295,3,Business,12,2,56885,12,2,57207,12,2,57857,12,2,57961,12,2,58890,8,26.9,-1.2571472,36.7950633,-1.3025667,36.7803495,489,929,322,754
13141,19605,1473,3,Business,9,1,27926,9,1,29354,9,1,31833,9,1,32162,9,1,33903,17,15.4,-1.27871,36.819573,-1.3700383,36.9190174,654,1741,1428,2808
13142,3312,2509,3,Business,11,1,52863,11,1,52955,11,1,53592,11,1,53929,11,1,57903,20,27.8,-1.2571472,36.7950633,-1.3700383,36.9190174,404,3974,92,974
13143,4726,2514,3,Business,13,2,40287,13,2,42658,13,2,44078,13,2,44925,13,2,49826,4,22.3,-1.2830057,36.8175478,-1.266294,36.8057971,612,4901,2371,2267
13144,29,2207,3,Business,6,3,51299,6,3,51359,6,3,52789,6,3,53652,6,3,55906,17,23.25888921888938,-1.3234404,36.7087633,-1.2696908,36.81519,604,2254,60,2293
13145,18615,2748,1,Personal,13,7,40947,13,7,42813,13,7,45022,13,7,45182,13,7,48030,21,23.4,-1.269103,36.8223998,-1.2544687,36.9485028,95,2848,1866,2369
13146,683,2129,1,Personal,28,2,44919,28,2,49327,28,2,52102,28,2,52567,28,2,54382,7,19.5,-1.2834899,36.820437,-1.2595422,36.7871178,107,1815,4408,3240
13147,9417,1410,3,Business,8,1,55992,8,1,56033,8,1,56352,8,1,57780,8,1,61787,20,29.6,-1.300921,36.828195,-1.2847613,36.967084,883,4007,41,1747
13148,3156,3487,3,Business,6,4,49512,6,4,49669,6,4,50319,6,4,50942,6,4,52835,5,21.1,-1.2527958,36.7976244,-1.279395,36.825364,788,1893,157,1273
13149,11529,7,1,Personal,28,4,59274,28,4,59312,28,4,59880,28,4,60259,28,4,61144,4,23.25888921888938,-1.2551895,36.7822034,-1.2738167,36.8157821,434,885,38,947
13150,5760,393,3,Business,13,3,46946,13,3,46975,13,3,47770,13,3,48258,13,3,50374,11,24.7,-1.3167113,36.8301563,-1.2638185,36.7930057,858,2116,29,1283
13151,25102,348,3,Business,23,1,45720,23,1,45895,23,1,48143,23,1,48703,23,1,49972,7,18.5,-1.2922364,36.7895538,-1.2739208,36.8310153,844,1269,175,2808
13152,18251,3487,3,Business,8,3,42829,8,3,42890,8,3,43198,8,3,43736,8,3,44597,5,23.25888921888938,-1.279395,36.825364,-1.2917868,36.7872675,289,861,61,846
13153,18225,3326,3,Business,21,4,38045,21,4,38055,21,4,38195,21,4,38613,21,4,39429,9,25.2,-1.2938875,36.7774083,-1.2551895,36.7822034,854,816,10,558
13154,3796,3168,3,Personal,19,2,30802,19,2,32557,19,2,34524,19,2,34682,19,2,36462,12,15.3,-1.2895718,36.7844688,-1.3255736,36.7275277,752,1780,1755,2125
13155,14148,53,3,Business,25,1,53310,25,1,53346,25,1,54687,25,1,57265,25,1,57401,8,28.0,-1.3167113,36.8301563,-1.2770708,36.8231093,262,136,36,3919
13156,15843,824,3,Business,28,2,37653,28,2,37661,28,2,37670,28,2,39129,28,2,39844,4,17.5,-1.2248308,36.8012573,-1.2143387,36.7914548,882,715,8,1468
13157,6560,1004,3,Business,9,4,53448,9,4,53566,9,4,54618,9,4,56356,9,4,59522,22,23.25888921888938,-1.2152529,36.7911336,-1.3250048,36.8697188,7,3166,118,2790
13158,11288,1469,3,Business,20,1,30180,20,1,30283,20,1,32185,20,1,32477,20,1,33816,15,19.0,-1.2551895,36.7822034,-1.2343236,36.8861,155,1339,103,2194
13159,4874,1271,3,Business,18,1,33647,18,1,33716,18,1,37738,18,1,37804,18,1,40063,22,21.3,-1.3244885,36.897792,-1.261403,36.7692242,580,2259,69,4088
13160,7853,3647,3,Business,12,5,45837,12,5,45884,12,5,46920,12,5,47179,12,5,48049,3,24.6,-1.272639,36.794723,-1.2655477,36.8001682,755,870,47,1295
13161,15173,81,3,Business,10,1,57998,10,1,58048,10,1,58092,10,1,58396,10,1,58429,2,18.7,-1.259697,36.800664,-1.2641496,36.7914139,651,33,50,348
13162,20353,391,3,Business,22,3,31014,22,3,31065,22,3,33006,22,3,35477,22,3,37047,19,18.8,-1.300921,36.828195,-1.3334681,36.7116093,654,1570,51,4412
13163,21709,393,3,Business,7,2,37736,7,2,37766,7,2,37772,7,2,41512,7,2,41514,4,23.25888921888938,-1.3167113,36.8301563,-1.3004062,36.829741,39,2,30,3746
13164,19547,393,3,Business,12,6,33604,12,6,33624,12,6,33632,12,6,34477,12,6,35573,10,18.6,-1.3177547,36.8303703,-1.2569006,36.7925141,173,1096,20,853
13165,1507,1195,3,Business,12,5,55745,12,5,55875,12,5,57109,12,5,57288,12,5,57763,4,23.25888921888938,-1.3228003,36.8306435,-1.3004062,36.829741,304,475,130,1413
13166,24807,3647,3,Business,26,2,52231,26,2,52246,26,2,52875,26,2,53161,26,2,54041,5,29.9,-1.272639,36.794723,-1.2896563,36.7822822,576,880,15,915
13167,23884,3291,3,Business,4,6,46649,4,6,46666,4,6,46836,4,6,47741,4,6,49909,17,23.25888921888938,-1.3181159,36.7101559,-1.2600926,36.8088685,205,2168,17,1075
13168,23339,510,3,Business,26,6,39127,26,6,39157,26,6,39162,26,6,39877,26,6,41068,11,22.4,-1.2860183,36.8975338,-1.325808,36.861664,408,1191,30,720
13169,6432,3686,3,Business,3,3,36427,3,3,36435,3,3,36521,3,3,36867,3,3,38119,10,21.3,-1.2551895,36.7822034,-1.303148,36.792768,709,1252,8,432
13170,21448,283,3,Business,5,4,43958,5,4,44006,5,4,44012,5,4,45077,5,4,45814,6,23.25888921888938,-1.2804227,36.8250375,-1.2731645,36.7902246,345,737,48,1071
13171,13079,649,3,Business,26,2,42939,26,2,42987,26,2,43405,26,2,43825,26,2,45002,10,26.4,-1.2551895,36.7822034,-1.2529072,36.8525066,831,1177,48,838
13172,27992,186,3,Business,24,5,56320,24,5,56363,24,5,57272,24,5,57609,24,5,58073,7,22.9,-1.2825816,36.8092346,-1.2571472,36.7950633,800,464,43,1246
13173,114,265,3,Business,1,6,45329,1,6,45338,1,6,45550,1,6,46673,1,6,50577,18,18.7,-1.300921,36.828195,-1.3623272,36.9410845,890,3904,9,1335
13174,7473,1352,3,Personal,30,4,39702,30,4,39745,30,4,40743,30,4,41198,30,4,42508,6,20.2,-1.2655306,36.828148,-1.298529,36.816482,882,1310,43,1453
13175,9052,2931,3,Business,16,3,33163,16,3,33173,16,3,35261,16,3,37099,16,3,39377,23,19.5,-1.3433181,36.9138018,-1.2452664,36.8028541,404,2278,10,3926
13176,6139,3283,3,Business,25,5,51512,25,5,51634,25,5,52220,25,5,53274,25,5,53552,5,23.2,-1.2600926,36.8088685,-1.2628473,36.781805,116,278,122,1640
13177,18131,3201,3,Business,9,4,51043,9,4,51155,9,4,51309,9,4,52355,9,4,52947,2,23.25888921888938,-1.2551895,36.7822034,-1.2584143,36.8048002,361,592,112,1200
13178,6405,2150,3,Business,31,4,50156,31,4,50196,31,4,50214,31,4,51274,31,4,53813,15,29.0,-1.344446,36.756597,-1.265715,36.823815,925,2539,40,1078
13179,3833,1872,1,Personal,4,6,39441,4,6,39456,4,6,40077,4,6,41699,4,6,42626,5,20.0,-1.2540707,36.8186208,-1.2865677,36.8253346,754,927,15,2243
13180,20325,2827,3,Business,24,1,36497,24,1,36614,24,1,37067,24,1,37270,24,1,38245,5,19.6,-1.2850644,36.8343657,-1.2544664,36.8224273,576,975,117,656
13181,4648,3239,3,Personal,4,3,33093,4,3,33595,4,3,36223,4,3,36478,4,3,38053,9,14.9,-1.2835525,36.8296382,-1.2912419,36.8775284,752,1575,502,2883
13182,16001,3599,3,Business,12,5,50954,12,5,51079,12,5,52231,12,5,52918,12,5,55615,14,23.25888921888938,-1.3302996,36.8707935,-1.2538731,36.7850223,856,2697,125,1839
13183,3364,3778,3,Personal,17,1,44031,17,1,44049,17,1,44688,17,1,45474,17,1,47182,20,25.2,-1.2775276,36.8140021,-1.1825557,36.9331107,105,1708,18,1425
13184,681,1882,3,Business,29,2,60700,29,2,60773,29,2,60850,29,2,62048,29,2,62898,4,23.25888921888938,-1.2958783,36.7928125,-1.3011335,36.7658946,322,850,73,1275
13185,1620,2784,3,Business,8,2,32720,8,2,32765,8,2,33220,8,2,33466,8,2,36539,17,19.1,-1.2963097,36.7688221,-1.2482465,36.8889062,436,3073,45,701
13186,22702,393,3,Business,9,4,56464,9,4,57182,9,4,57184,9,4,60853,9,4,60855,11,23.25888921888938,-1.3167113,36.8301563,-1.2638185,36.7930057,39,2,718,3671
13187,22582,2804,3,Business,25,4,42412,25,4,42467,25,4,43151,25,4,43370,25,4,49232,12,19.9,-1.2551895,36.7822034,-1.2128205,36.8026175,290,5862,55,903
13188,6420,1329,3,Business,12,2,55519,12,2,55592,12,2,56054,12,2,56494,12,2,57954,18,27.2,-1.273056,36.811298,-1.3681253,36.9155298,62,1460,73,902
13189,3205,868,3,Business,21,5,56933,21,5,57590,21,5,57908,21,5,58571,21,5,60009,8,24.6,-1.303596,36.778378,-1.265715,36.823815,279,1438,657,981
13190,5291,2285,3,Personal,18,4,51587,18,4,51718,18,4,53090,18,4,53208,18,4,54622,5,23.25888921888938,-1.3008826,36.8378114,-1.2950041,36.8143583,924,1414,131,1490
13191,3508,1144,3,Personal,7,1,51159,7,1,51183,7,1,52423,7,1,53505,7,1,55188,18,20.7,-1.2860049,36.8155045,-1.3656047,36.7414061,406,1683,24,2322
13192,19839,246,3,Business,29,1,62413,29,1,63619,29,1,63893,29,1,64513,29,1,66325,17,23.4,-1.2156006,36.8916865,-1.2584143,36.8048002,867,1812,1206,894
13193,18166,393,3,Business,28,4,30596,28,4,30615,28,4,31517,28,4,33262,28,4,33264,8,19.5,-1.3167113,36.8301563,-1.2770708,36.8231093,910,2,19,2647
13194,14514,136,3,Business,8,4,48232,8,4,49263,8,4,49285,8,4,49918,8,4,51923,15,27.3,-1.3254522,36.7216584,-1.2781133,36.8162168,633,2005,1031,655
13195,7627,393,3,Business,11,4,42007,11,4,42053,11,4,42067,11,4,44752,11,4,45839,10,23.9,-1.3177547,36.8303703,-1.2574219,36.7927073,731,1087,46,2699
13196,12202,393,3,Business,13,3,41272,13,3,41282,13,3,41295,13,3,44194,13,3,44196,4,24.7,-1.3167113,36.8301563,-1.3004062,36.829741,515,2,10,2912
13197,20081,3222,3,Business,24,4,36682,24,4,36693,24,4,38016,24,4,38292,24,4,38978,5,24.7,-1.2768326,36.8073804,-1.2551895,36.7822034,755,686,11,1599
13198,12830,1222,3,Personal,21,4,48093,21,4,49032,21,4,50222,21,4,50419,21,4,51890,8,22.4,-1.2898709,36.7519182,-1.2707179,36.7979713,465,1471,939,1387
13199,15364,111,3,Business,6,1,54466,6,1,54481,6,1,54517,6,1,55141,6,1,57356,16,23.25888921888938,-1.2551895,36.7822034,-1.3194518,36.869396,386,2215,15,660
13200,18287,2069,3,Business,25,6,47465,25,6,47477,25,6,47931,25,6,48994,25,6,50149,9,23.25888921888938,-1.265715,36.823815,-1.228911,36.881876,309,1155,12,1517
13201,21822,2523,3,Business,15,3,35691,15,3,35713,15,3,35730,15,3,36185,15,3,38551,20,23.25888921888938,-1.2551895,36.7822034,-1.3251247,36.8995926,709,2366,22,472
13202,9330,435,3,Business,29,3,43234,29,3,43297,29,3,44615,29,3,45259,29,3,47396,8,23.25888921888938,-1.3081376,36.8329772,-1.2567295,36.784224,2,2137,63,1962
13203,21559,1245,3,Business,2,3,49490,2,3,49506,2,3,50155,2,3,51655,2,3,56188,31,25.9,-1.300921,36.828195,-1.3844264,36.676747,718,4533,16,2149
13204,11460,3611,1,Personal,3,1,54831,3,1,54893,3,1,55526,3,1,55798,3,1,57460,5,23.2,-1.2824911,36.8218042,-1.2740814,36.7953121,447,1662,62,905
13205,24132,1329,3,Business,1,4,46101,1,4,46159,1,4,46708,1,4,46791,1,4,47626,4,23.25888921888938,-1.273056,36.811298,-1.2548181,36.7888636,434,835,58,632
13206,7913,2306,3,Business,14,4,52941,14,4,53020,14,4,54349,14,4,55449,14,4,57973,19,28.2,-1.2271998,36.8084905,-1.3241108,36.8692908,703,2524,79,2429
13207,16599,3350,1,Personal,25,3,39549,25,3,39570,25,3,39708,25,3,39798,25,3,41248,6,23.25888921888938,-1.2551895,36.7822034,-1.2886385,36.8240195,89,1450,21,228
13208,19698,246,3,Business,22,2,50352,22,2,50442,22,2,50724,22,2,51297,22,2,54363,5,25.8,-1.2584143,36.8048002,-1.2929499,36.8180835,903,3066,90,855
13209,16539,2523,3,Business,20,1,41632,20,1,41821,20,1,42086,20,1,42399,20,1,42845,3,20.3,-1.2551895,36.7822034,-1.263194,36.797624,415,446,189,578
13210,19738,633,3,Business,24,4,46967,24,4,47039,24,4,47574,24,4,47755,24,4,48220,4,24.3,-1.3077869,36.8443207,-1.3004062,36.829741,576,465,72,716
13211,20428,3355,3,Business,15,1,47892,15,1,47964,15,1,48940,15,1,49995,15,1,50974,8,23.25888921888938,-1.2527958,36.8003131,-1.3052491,36.8223899,22,979,72,2031
13212,27949,2030,3,Business,30,2,53501,30,2,54457,30,2,55319,30,2,55392,30,2,56661,4,23.25888921888938,-1.335316,36.8845063,-1.3333725,36.8717613,76,1269,956,935
13213,11771,1792,3,Business,24,5,63070,24,5,63089,24,5,63116,24,5,63519,24,5,65487,14,23.25888921888938,-1.2809121,36.7852524,-1.2291315,36.7852269,215,1968,19,430
13214,23376,186,3,Business,3,3,37527,3,3,43523,3,3,43544,3,3,43746,3,3,46326,23,27.3,-1.3700383,36.9190174,-1.2571472,36.7950633,831,2580,5996,223
13215,24956,3340,3,Business,6,2,41885,6,2,42299,6,2,42820,6,2,44497,6,2,48736,30,25.2,-1.3510811,36.894806,-1.2095044,36.7832064,518,4239,414,2198
13216,8119,1363,3,Business,13,3,40833,13,3,42478,13,3,43408,13,3,43594,13,3,46061,3,24.6,-1.3004062,36.829741,-1.2897368,36.8226783,928,2467,1645,1116
13217,7508,2523,3,Business,4,1,39830,4,1,39932,4,1,40270,4,1,40581,4,1,41270,6,25.7,-1.2551895,36.7822034,-1.2357748,36.7900524,178,689,102,649
13218,5417,201,3,Business,25,4,42343,25,4,42430,25,4,43142,25,4,43364,25,4,44694,8,20.2,-1.2551895,36.7822034,-1.271672,36.783604,50,1330,87,934
13219,7729,868,3,Business,30,2,48374,30,2,48494,30,2,49005,30,2,49374,30,2,50467,7,23.25888921888938,-1.2628473,36.781805,-1.265715,36.823815,484,1093,120,880
13220,23274,2150,3,Business,14,4,54035,14,4,54174,14,4,55026,14,4,55421,14,4,56486,12,27.4,-1.331619,36.847976,-1.344446,36.756597,856,1065,139,1247
13221,19112,2358,4,Business,27,5,42424,27,5,42433,27,5,43894,27,5,44274,27,5,47842,19,22.6,-1.3256904,36.8747943,-1.1903523,36.9064927,844,3568,9,1841
13222,13250,1502,3,Business,6,1,50678,6,1,50733,6,1,51164,6,1,51430,6,1,52220,6,23.25888921888938,-1.2232123,36.8932547,-1.2475028,36.8774697,341,790,55,697
13223,12611,1978,2,Personal,4,6,45358,4,6,45374,4,6,46045,4,6,46683,4,6,47080,2,20.0,-1.2881186,36.7958595,-1.2874314,36.7764912,400,397,16,1309
13224,5231,248,3,Business,12,2,40457,12,2,40478,12,2,42220,12,2,42753,12,2,45335,17,28.2,-1.2101672,36.8336094,-1.304735,36.7846054,8,2582,21,2275
13225,14597,3140,1,Personal,27,4,41388,27,4,41664,27,4,43085,27,4,43282,27,4,44893,9,22.8,-1.2850644,36.8343657,-1.3032409,36.8815432,817,1611,276,1618
13226,27862,3560,3,Business,27,3,50419,27,3,50446,27,3,50786,27,3,51213,27,3,52021,5,29.1,-1.2584143,36.8048002,-1.279395,36.825364,436,808,27,767
13227,26189,1687,3,Business,21,1,50961,21,1,51021,21,1,51435,21,1,52413,21,1,53530,16,21.6,-1.2886381,36.81718309,-1.2185721,36.9000783,633,1117,60,1392
13228,2751,2223,2,Personal,6,5,36179,6,5,36194,6,5,36447,6,5,36784,6,5,37560,4,15.1,-1.3022056,36.787139,-1.2945074,36.8083195,116,776,15,590
13229,11595,1642,3,Business,10,1,30886,10,1,30915,10,1,30933,10,1,31832,10,1,33296,10,18.0,-1.2728069,36.7962362,-1.2421591,36.8153854,387,1464,29,917
13230,26115,635,3,Business,10,6,44463,10,6,44494,10,6,44789,10,6,46201,10,6,48277,14,23.7,-1.2599563,36.7993439,-1.3164992,36.7793132,620,2076,31,1707
13231,21524,3404,3,Business,26,2,61410,26,2,61477,26,2,61765,26,2,62090,26,2,63608,13,29.4,-1.2232123,36.8932547,-1.279395,36.825364,26,1518,67,613
13232,9154,475,3,Business,24,5,39139,24,5,39220,24,5,40296,24,5,40820,24,5,41977,7,21.6,-1.2571472,36.7950633,-1.3024794,36.8228284,155,1157,81,1600
13233,27353,944,1,Personal,9,4,59201,9,4,59353,9,4,62172,9,4,63342,9,4,64080,6,23.0,-1.2327522,36.8018823,-1.255597,36.830024,213,738,152,3989
13234,5517,3283,3,Business,11,2,46139,11,2,46357,11,2,47033,11,2,47566,11,2,48592,6,19.4,-1.2663631,36.8163329,-1.2628473,36.781805,75,1026,218,1209
13235,25546,1502,3,Business,19,2,43332,19,2,43458,19,2,44236,19,2,44973,19,2,45751,9,26.5,-1.264627,36.842259,-1.2562809,36.792382,247,778,126,1515
13236,15330,302,3,Business,21,1,50440,21,1,50465,21,1,51097,21,1,52131,21,1,53832,4,27.8,-1.2649605,36.7981777,-1.2546637,36.8248917,428,1701,25,1666
13237,14882,1244,3,Business,16,6,53703,16,6,53713,16,6,54477,16,6,55345,16,6,56406,9,23.25888921888938,-1.2600926,36.8088685,-1.303596,36.778378,427,1061,10,1632
13238,14709,1346,3,Business,13,1,41245,13,1,41281,13,1,41855,13,1,42621,13,1,43634,6,23.25888921888938,-1.2695287,36.7981777,-1.2917868,36.7872675,435,1013,36,1340
13239,16863,2195,3,Business,3,3,54011,3,3,54028,3,3,55566,3,3,55821,3,3,56703,6,28.3,-1.2296618,36.8438272,-1.228911,36.881876,843,882,17,1793
13240,17056,3698,3,Business,29,3,52155,29,3,53036,29,3,53304,29,3,54740,29,3,55604,7,20.9,-1.3244885,36.897792,-1.34364,36.8925345,856,864,881,1704
13241,15483,3081,1,Personal,12,5,47853,12,5,47864,12,5,48850,12,5,49018,12,5,51125,14,27.3,-1.2916556,36.8262516,-1.2627007,36.9136956,74,2107,11,1154
13242,18575,1796,3,Business,2,2,32990,2,2,33846,2,2,35367,2,2,36247,2,2,37284,13,20.3,-1.303596,36.778378,-1.331619,36.847976,61,1037,856,2401
13243,25358,246,3,Business,11,1,53173,11,1,53404,11,1,53428,11,1,54112,11,1,55159,9,23.2,-1.2584143,36.8048002,-1.272975,36.7482377,268,1047,231,708
13244,7263,1257,3,Business,13,4,49643,13,4,49718,13,4,51158,13,4,51298,13,4,53834,12,22.5,-1.264384,36.7674128,-1.3178524,36.7139804,811,2536,75,1580
13245,16113,1087,3,Business,21,5,47295,21,5,47714,21,5,48719,21,5,48802,21,5,50965,11,24.6,-1.2679971,36.8088937,-1.2482465,36.8889062,857,2163,419,1088
13246,10488,3161,1,Personal,3,1,64101,3,1,64200,3,1,64756,3,1,66411,3,1,68697,13,22.4,-1.3434862,36.6895464,-1.2710754,36.6757137,857,2286,99,2211
13247,27164,1123,1,Personal,12,4,31519,12,4,31607,12,4,32040,12,4,33036,12,4,34107,4,15.9,-1.2658335,36.8042867,-1.2609186,36.7938342,752,1071,88,1429
13248,23428,393,3,Business,17,4,57908,17,4,57951,17,4,58655,17,4,59079,17,4,60767,10,27.8,-1.3231001,36.8283559,-1.2574219,36.7927073,518,1688,43,1128
13249,24218,909,3,Business,5,5,48412,5,5,48510,5,5,51468,5,5,52053,5,5,55222,14,26.5,-1.290894,36.822971,-1.225322,36.80855,812,3169,98,3543
13250,12038,867,3,Business,4,4,37625,4,4,37836,4,4,38506,4,4,38797,4,4,40462,10,25.5,-1.2996533,36.8292629,-1.2991441,36.7528804,263,1665,211,961
13251,89,393,3,Business,24,3,34503,24,3,36787,24,3,37606,24,3,38264,24,3,40857,14,19.8,-1.3177547,36.8303703,-1.306378,36.7519845,796,2593,2284,1477
13252,1074,1244,3,Business,6,3,44223,6,3,44357,6,3,44798,6,3,45127,6,3,46152,8,22.7,-1.272828,36.816608,-1.303596,36.778378,85,1025,134,770
13253,12992,733,3,Business,18,2,46718,18,2,46762,18,2,48006,18,2,48629,18,2,50479,25,22.7,-1.2604833,36.7352777,-1.3194518,36.869396,756,1850,44,1867
13254,5915,1527,3,Business,10,3,31647,10,3,31683,10,3,32207,10,3,32694,10,3,33292,4,21.9,-1.3077869,36.8443207,-1.3004062,36.829741,709,598,36,1011
13255,220,649,3,Business,26,5,54301,26,5,54431,26,5,55254,26,5,56511,26,5,57706,7,23.25888921888938,-1.2901786,36.824294,-1.2551895,36.7822034,19,1195,130,2080
13256,19391,2869,3,Business,13,4,43592,13,4,43946,13,4,44855,13,4,45429,13,4,46712,9,22.1,-1.2649605,36.7981777,-1.3025826,36.7670807,344,1283,354,1483
13257,12875,3326,3,Business,7,4,53649,7,4,53680,7,4,54150,7,4,54385,7,4,55732,8,27.5,-1.2571472,36.7950633,-1.3025667,36.7803495,295,1347,31,705
13258,20835,1559,2,Personal,31,2,44086,31,2,44542,31,2,45590,31,2,46436,31,2,47419,4,18.4,-1.2423801,36.8478805,-1.221696,36.8270195,229,983,456,1894
13259,235,2112,3,Business,4,1,37248,4,1,37274,4,1,37746,4,1,38801,4,1,39622,7,21.1,-1.2765736,36.8513646,-1.306245,36.8192978,124,821,26,1527
13260,3523,2578,1,Personal,19,5,57289,19,5,57783,19,5,58755,19,5,58946,19,5,60398,5,27.6,-1.2808667,36.7883545,-1.2939501,36.801818,708,1452,494,1163
13261,15001,136,3,Business,3,2,53512,3,2,54007,3,2,55461,3,2,55613,3,2,57388,10,20.2,-1.2649605,36.7981777,-1.3025826,36.7670807,726,1775,495,1606
13262,13085,865,3,Business,4,2,56147,4,2,56755,4,2,57429,4,2,57517,4,2,59294,6,22.7,-1.2456412,36.7955298,-1.2765641,36.793782,706,1777,608,762
13263,3147,1363,3,Business,18,2,57313,18,2,57613,18,2,58007,18,2,58199,18,2,60376,10,25.8,-1.3004062,36.829741,-1.2991441,36.7528804,343,2177,300,586
13264,8556,1133,3,Business,31,2,31820,31,2,33360,31,2,34756,31,2,35450,31,2,39515,20,17.0,-1.3508657,36.9019028,-1.2571472,36.7950633,877,4065,1540,2090
13265,2955,2154,3,Business,27,6,52136,27,6,52306,27,6,52905,27,6,54085,27,6,55403,8,23.25888921888938,-1.2527958,36.8003131,-1.2765736,36.8513646,709,1318,170,1779
13266,14204,3194,3,Business,30,3,38041,30,3,38053,30,3,38482,30,3,38612,30,3,39879,5,24.8,-1.2551895,36.7822034,-1.273754,36.8005579,428,1267,12,559
13267,5046,2804,3,Business,15,2,50124,15,2,50194,15,2,50635,15,2,51729,15,2,53036,14,24.8,-1.2551895,36.7822034,-1.2450205,36.8853338,517,1307,70,1535
13268,6415,3781,3,Business,25,5,53273,25,5,55740,25,5,56211,25,5,56436,25,5,57362,5,23.4,-1.2610959,36.8281022,-1.2889576,36.8183358,874,926,2467,696
13269,24244,2344,3,Business,11,3,35591,11,3,35670,11,3,36243,11,3,36873,11,3,37898,7,15.5,-1.2857685,36.7866843,-1.2551895,36.7822034,74,1025,79,1203
13270,8978,3259,3,Business,13,2,40426,13,2,40999,13,2,41798,13,2,42101,13,2,43206,8,22.3,-1.2956517,36.8036292,-1.263441,36.840808,744,1105,573,1102
13271,1390,478,3,Business,25,5,50453,25,5,50696,25,5,51232,25,5,51304,25,5,51975,5,23.5,-1.2899659,36.769412,-1.2973682,36.7859878,334,671,243,608
13272,4966,554,1,Personal,23,3,39092,23,3,39168,23,3,39591,23,3,39875,23,3,41220,6,21.9,-1.269059,36.8108027,-1.2942764,36.7969749,531,1345,76,707
13273,19117,3693,1,Personal,2,2,46815,2,2,46860,2,2,47495,2,2,48884,2,2,49912,6,26.1,-1.2854453,36.8188363,-1.297171,36.783278,343,1028,45,2024
13274,22375,3293,1,Personal,19,3,37907,19,3,37952,19,3,38505,19,3,39065,19,3,40569,10,23.25888921888938,-1.3273028,36.8739571,-1.2852868,36.8781288,543,1504,45,1113
13275,26947,1072,1,Personal,25,1,58632,25,1,58852,25,1,59170,25,1,59312,25,1,60339,8,23.25888921888938,-1.261849,36.808254,-1.2337192,36.8141193,427,1027,220,460
13276,18117,1424,3,Business,30,5,53580,30,5,54003,30,5,54565,30,5,54824,30,5,58198,11,24.5,-1.30157,36.7871,-1.257984,36.745016,685,3374,423,821
13277,27964,3291,3,Business,17,2,48345,17,2,50087,17,2,50974,17,2,51540,17,2,53865,13,24.3,-1.3313643,36.8577422,-1.2600926,36.8088685,670,2325,1742,1453
13278,16914,3291,3,Business,22,5,34869,22,5,34893,22,5,37109,22,5,38518,22,5,40965,18,23.25888921888938,-1.293515,36.897607,-1.2600926,36.8088685,377,2447,24,3625
13279,7983,706,3,Business,18,1,37658,18,1,37672,18,1,38442,18,1,38657,18,1,40709,13,23.25888921888938,-1.3077869,36.8443207,-1.2758254,36.8944551,858,2052,14,985
13280,8063,718,3,Business,22,5,36459,22,5,36561,22,5,36676,22,5,37063,22,5,38323,11,22.1,-1.2551895,36.7822034,-1.3034451,36.7523126,854,1260,102,502
13281,8869,2271,3,Business,8,1,46448,8,1,46461,8,1,47964,8,1,49071,8,1,52339,12,29.5,-1.331619,36.847976,-1.293515,36.897607,155,3268,13,2610
13282,13065,1274,3,Personal,13,3,59239,13,3,59309,13,3,61191,13,3,63455,13,3,65370,9,25.8,-1.2836832,36.8306719,-1.328762,36.8534414,513,1915,70,4146
13283,24963,2271,3,Business,14,1,40843,14,1,40853,14,1,40858,14,1,41745,14,1,42600,11,22.8,-1.307143,36.825009,-1.293515,36.897607,589,855,10,892
13284,24061,3017,3,Business,9,6,69627,9,6,69704,9,6,70167,9,6,70668,9,6,71406,5,17.1,-1.299313,36.7831488,-1.3095597,36.797295,116,738,77,964
13285,8491,1488,1,Personal,6,1,29429,6,1,29441,6,1,30017,6,1,30385,6,1,31625,12,14.8,-1.3128657,36.7024749,-1.290499,36.784363,636,1240,12,944
13286,3347,1787,3,Business,2,7,44644,2,7,48114,2,7,48120,2,7,48913,2,7,50594,17,25.1,-1.2283403,36.8822756,-1.15135,36.9566534,517,1681,3470,799
13287,21190,393,3,Business,13,4,35814,13,4,35832,13,4,35968,13,4,36503,13,4,39018,14,18.7,-1.3228003,36.8306435,-1.2991441,36.7528804,157,2515,18,671
13288,15002,3647,3,Business,26,5,57041,26,5,57144,26,5,57694,26,5,57948,26,5,59121,4,23.25888921888938,-1.272639,36.794723,-1.2676759,36.801804,620,1173,103,804
13289,15923,1367,3,Business,12,3,40833,12,3,40833,12,3,43887,12,3,44554,12,3,46402,10,19.3,-1.2733311,36.8133602,-1.275442,36.7660207,247,1848,0,3721
13290,8306,788,3,Business,10,4,55241,10,4,55282,10,4,55667,10,4,56010,10,4,58765,14,25.0,-1.311173,36.827569,-1.225322,36.80855,136,2755,41,728
13291,16521,2749,1,Personal,17,3,45316,17,3,45367,17,3,45933,17,3,46052,17,3,46778,6,25.4,-1.288897,36.771189,-1.2700476,36.8049204,299,726,51,685
13292,460,2978,3,Business,27,1,55687,27,1,55701,27,1,56082,27,1,56421,27,1,57645,6,23.25888921888938,-1.2677819,36.8006922,-1.2977768,36.8110285,88,1224,14,720
13293,18395,867,3,Business,17,4,35787,17,4,35790,17,4,35793,17,4,36740,17,4,39004,15,23.25888921888938,-1.2991441,36.7528804,-1.3228003,36.8306435,914,2264,3,950
13294,14614,633,3,Business,25,5,42141,25,5,42174,25,5,42373,25,5,42768,25,5,44097,9,26.3,-1.2574219,36.7927073,-1.3004062,36.829741,523,1329,33,594
13295,23848,2462,3,Personal,8,2,58176,8,2,58421,8,2,60726,8,2,61074,8,2,63609,17,23.6,-1.2778747,36.8831829,-1.2832281,36.9706668,584,2535,245,2653
13296,2963,633,3,Business,16,3,31989,16,3,32000,16,3,32016,16,3,33427,16,3,35022,11,19.6,-1.2991441,36.7528804,-1.3004062,36.829741,571,1595,11,1427
13297,12694,393,3,Business,18,1,33483,18,1,33542,18,1,34311,18,1,36463,18,1,37080,4,22.0,-1.3167113,36.8301563,-1.3004062,36.829741,448,617,59,2921
13298,6713,1548,1,Personal,30,3,35472,30,3,35784,30,3,36445,30,3,36513,30,3,37213,7,17.3,-1.2950408,36.8098172,-1.32571,36.805533,941,700,312,729
13299,12840,570,3,Business,6,4,49526,6,4,49609,6,4,50989,6,4,52180,6,4,53397,7,21.3,-1.290894,36.822971,-1.2551895,36.7822034,20,1217,83,2571
13300,14463,2900,3,Business,19,2,37672,19,2,37698,19,2,38182,19,2,38329,19,2,41060,31,26.7,-1.2963097,36.7688221,-1.1399609,36.9472164,299,2731,26,631
13301,4563,3355,3,Business,31,2,42545,31,2,42919,31,2,44690,31,2,46522,31,2,47447,10,18.3,-1.3472066,36.7692638,-1.3052491,36.8223899,414,925,374,3603
13302,23146,346,3,Business,5,2,41420,5,2,41437,5,2,41780,5,2,42638,5,2,45372,20,23.5,-1.3169591,36.7000029,-1.28878,36.8168312,496,2734,17,1201
13303,8002,3492,3,Business,28,2,46798,28,2,46855,28,2,47743,28,2,48440,28,2,49743,7,21.1,-1.2728947,36.8079426,-1.299207,36.8414337,907,1303,57,1585
13304,23857,1874,3,Business,19,3,50037,19,3,50093,19,3,50201,19,3,50625,19,3,53434,27,25.5,-1.2571472,36.7950633,-1.1305126,36.6767002,74,2809,56,532
13305,26229,723,1,Personal,16,3,49831,16,3,49906,16,3,50825,16,3,51529,16,3,53102,10,25.6,-1.2569006,36.7925141,-1.3034735,36.7986213,209,1573,75,1623
13306,1000,2721,1,Personal,8,5,44504,8,5,44978,8,5,46690,8,5,47714,8,5,49663,20,23.25888921888938,-1.3178524,36.7139804,-1.3205669,36.8362168,107,1949,474,2736
13307,9535,1809,3,Business,19,4,55968,19,4,55981,19,4,56786,19,4,57004,19,4,57640,1,20.7,-1.2646084,36.8028645,-1.263987,36.798891,898,636,13,1023
13308,7064,2174,3,Business,31,5,44049,31,5,44049,31,5,44667,31,5,48307,31,5,48312,16,21.8,-1.2482781,36.884092,-1.2016077,36.930397,86,5,0,4258
13309,11591,3217,3,Business,18,1,63240,18,1,63661,18,1,66749,18,1,68584,18,1,70886,10,23.25888921888938,-1.2601709,36.8002238,-1.214328,36.7911903,549,2302,421,4923
13310,10047,3560,3,Business,4,2,35310,4,2,40245,4,2,40481,4,2,41051,4,2,42266,5,20.5,-1.2527958,36.7976244,-1.279395,36.825364,139,1215,4935,806
13311,18432,2307,3,Business,6,4,65538,6,4,65568,6,4,66537,6,4,67215,6,4,69115,14,21.7,-1.3359536,36.8534787,-1.2513591,36.7947674,910,1900,30,1647
13312,5617,788,3,Business,5,1,58587,5,1,59150,5,1,59802,5,1,60132,5,1,61735,11,24.2,-1.2584143,36.8048002,-1.225322,36.80855,909,1603,563,982
13313,17731,286,3,Business,30,5,62003,30,5,62117,30,5,62179,30,5,62604,30,5,63214,3,22.0,-1.2551895,36.7822034,-1.2666153,36.8015124,259,610,114,487
13314,8400,3404,3,Business,1,5,49827,1,5,49926,1,5,50929,1,5,51093,1,5,52909,11,28.3,-1.279395,36.825364,-1.3291155,36.8861,548,1816,99,1167
13315,26319,1246,3,Business,2,4,58828,2,4,59000,2,4,59926,2,4,60137,2,4,60750,2,23.9,-1.2571472,36.7950633,-1.2682478,36.8072852,651,613,172,1137
13316,12564,1209,3,Business,17,3,35943,17,3,36508,17,3,37253,17,3,37928,17,3,38740,9,23.25888921888938,-1.2638185,36.7930057,-1.3004062,36.829741,438,812,565,1420
13317,21949,414,1,Personal,1,3,56591,1,3,56614,1,3,57039,1,3,57973,1,3,59123,4,24.1,-1.2861765,36.8209086,-1.3001374,36.8209298,857,1150,23,1359
13318,4033,2216,3,Business,21,4,55940,21,4,56034,21,4,56212,21,4,58227,21,4,59069,3,26.1,-1.2551895,36.7822034,-1.2568411,36.8012533,822,842,94,2193
13319,17758,3647,3,Business,25,4,57492,25,4,57717,25,4,58405,25,4,61598,25,4,62508,6,23.25888921888938,-1.272639,36.794723,-1.3023756,36.7949276,119,910,225,3881
13320,18908,1215,2,Personal,30,1,68305,30,1,68355,30,1,69717,30,1,70279,30,1,71983,6,16.2,-1.3094838,36.8206907,-1.2969741,36.7856612,939,1704,50,1924
13321,16149,1500,3,Business,2,5,56472,2,5,56697,2,5,56874,2,5,58141,2,5,61510,8,25.0,-1.3004062,36.829741,-1.2574219,36.7927073,445,3369,225,1444
13322,20158,3647,3,Business,12,1,57069,12,1,57285,12,1,57897,12,1,58334,12,1,60635,21,26.7,-1.272639,36.794723,-1.191752,36.9152737,620,2301,216,1049
13323,11328,1791,3,Personal,2,7,36772,2,7,36817,2,7,38385,2,7,40259,2,7,42394,16,24.4,-1.3496012,36.6698157,-1.2947685,36.7785834,533,2135,45,3442
13324,24854,1998,3,Personal,16,3,44482,16,3,44502,16,3,44564,16,3,46118,16,3,47433,8,22.8,-1.2557779,36.7879648,-1.2945179,36.7685349,451,1315,20,1616
13325,7626,867,3,Business,19,1,40135,19,1,45579,19,1,46363,19,1,47297,19,1,48821,10,24.9,-1.2996533,36.8292629,-1.306378,36.7519845,952,1524,5444,1718
13326,21614,2350,1,Personal,5,2,50891,5,2,50969,5,2,51776,5,2,52108,5,2,52470,2,22.9,-1.2745107,36.7974503,-1.2631296,36.79567,407,362,78,1139
13327,18239,3283,3,Business,4,1,49789,4,1,49819,4,1,50474,4,1,51929,4,1,53310,14,23.25888921888938,-1.228911,36.881876,-1.2628473,36.781805,75,1381,30,2110
13328,20352,136,3,Business,26,5,35344,26,5,35522,26,5,36260,26,5,37003,26,5,39376,11,23.25888921888938,-1.2965045,36.7913036,-1.3254522,36.7216584,559,2373,178,1481
13329,17747,9,1,Personal,23,4,29864,23,4,29879,23,4,30398,23,4,30688,23,4,31817,7,15.8,-1.2761126,36.7668191,-1.2697141,36.7981777,735,1129,15,809
13330,25525,3647,3,Business,3,4,37277,3,4,37353,3,4,37906,3,4,38045,3,4,39003,6,21.9,-1.272639,36.794723,-1.290789,36.8024859,345,958,76,692
13331,16342,1205,3,Business,13,1,35773,13,1,35804,13,1,37275,13,1,38047,13,1,39561,9,17.0,-1.2707742,36.7578609,-1.2989934,36.8136694,726,1514,31,2243
13332,8714,1903,3,Personal,9,3,49309,9,3,49321,9,3,49989,9,3,50389,9,3,53739,26,25.3,-1.2960064,36.7582367,-1.3533402,36.9078924,457,3350,12,1068
13333,13131,868,3,Business,4,2,38636,4,2,42411,4,2,42456,4,2,43127,4,2,46805,17,20.4,-1.3188359,36.7038526,-1.265715,36.823815,821,3678,3775,716
13334,11604,3398,3,Business,31,4,48226,31,4,48237,31,4,49135,31,4,49339,31,4,51239,16,22.8,-1.3108107,36.8244221,-1.3169591,36.7000029,219,1900,11,1102
13335,7144,1796,3,Business,14,4,54606,14,4,54796,14,4,55351,14,4,55883,14,4,57380,11,27.6,-1.331619,36.847976,-1.303596,36.778378,276,1497,190,1087
13336,22692,987,2,Personal,6,1,65335,6,1,65408,6,1,66671,6,1,67311,6,1,68761,8,22.5,-1.2866544,36.8217978,-1.3193552,36.8012769,956,1450,73,1903
13337,3879,2804,3,Business,30,4,36445,30,4,41815,30,4,42687,30,4,43213,30,4,44643,6,23.25888921888938,-1.2551895,36.7822034,-1.282543,36.824618,829,1430,5370,1398
13338,21389,3201,3,Business,25,1,43900,25,1,43914,25,1,44034,25,1,44236,25,1,44729,2,23.25888921888938,-1.2649605,36.7981777,-1.2632534,36.7993427,103,493,14,322
13339,6097,2822,1,Personal,13,4,49786,13,4,51916,13,4,52603,13,4,53049,13,4,54553,6,26.7,-1.2863504,36.8277928,-1.288148,36.7850276,713,1504,2130,1133
13340,5104,2546,1,Personal,28,2,32948,28,2,32967,28,2,34134,28,2,34295,28,2,36120,17,15.8,-1.304127,36.805743,-1.304842,36.90576,680,1825,19,1328
13341,5832,2516,1,Personal,28,1,44351,28,1,44408,28,1,44662,28,1,45142,28,1,46391,6,22.8,-1.2860203,36.7832538,-1.2934657,36.8212737,409,1249,57,734
13342,18317,633,3,Business,8,2,59122,8,2,59529,8,2,60161,8,2,60233,8,2,60883,4,23.4,-1.3077869,36.8443207,-1.3004062,36.829741,523,650,407,704
13343,25981,103,3,Business,31,3,37496,31,3,37516,31,3,37881,31,3,38526,31,3,40503,19,24.7,-1.2844665,36.7866113,-1.2162532,36.7095449,735,1977,20,1010
13344,16896,3569,3,Personal,14,2,50138,14,2,50171,14,2,50216,14,2,51391,14,2,54312,28,23.25888921888938,-1.2472011,36.8800307,-1.3858142,36.7641498,75,2921,33,1220
13345,19449,187,3,Business,31,3,62512,31,3,66312,31,3,66677,31,3,67153,31,3,69347,17,24.6,-1.3169591,36.7000029,-1.2584143,36.8048002,647,2194,3800,841
13346,2638,2956,3,Business,23,5,42992,23,5,43455,23,5,46226,23,5,46580,23,5,48437,14,24.2,-1.207546,36.7913976,-1.2584143,36.8048002,870,1857,463,3125
13347,14737,2250,1,Personal,31,5,65186,31,5,65275,31,5,65991,31,5,66216,31,5,66652,2,19.7,-1.2712385,36.8072852,-1.260232,36.807334,427,436,89,941
13348,22376,633,3,Business,16,6,41494,16,6,41507,16,6,41624,16,6,41966,16,6,42648,5,25.6,-1.3004062,36.829741,-1.3228003,36.8306435,206,682,13,459
13349,13363,1850,3,Business,12,5,44799,12,5,45198,12,5,46371,12,5,46638,12,5,49708,11,26.6,-1.3173869,36.8112044,-1.2566586,36.7929682,778,3070,399,1440
13350,13483,1620,1,Personal,28,6,31333,28,6,31363,28,6,32455,28,6,33240,28,6,34445,12,17.7,-1.235348,36.760016,-1.227132,36.8374277,103,1205,30,1877
13351,8190,1691,2,Personal,11,6,39775,11,6,39793,11,6,40783,11,6,40999,11,6,43170,22,21.2,-1.2978795,36.7508321,-1.2124619,36.8739332,45,2171,18,1206
13352,9276,627,3,Business,12,3,36462,12,3,36547,12,3,36716,12,3,37473,12,3,39379,17,23.25888921888938,-1.2551895,36.7822034,-1.2387935,36.6715957,409,1906,85,926
13353,4942,111,3,Business,16,3,36222,16,3,36270,16,3,36617,16,3,36840,16,3,36844,4,19.8,-1.2551895,36.7822034,-1.255956,36.772901,932,4,48,570
13354,12405,2987,3,Business,6,2,61608,6,2,61659,6,2,61698,6,2,61887,6,2,64604,8,23.25888921888938,-1.2649605,36.7981777,-1.2946558,36.7908316,188,2717,51,228
13355,24436,2112,3,Business,19,3,53543,19,3,53963,19,3,54300,19,3,54907,19,3,55565,4,24.4,-1.2285835,36.8826468,-1.2156006,36.8916865,250,658,420,944
13356,3495,265,3,Business,11,4,46320,11,4,46720,11,4,47258,11,4,49039,11,4,51261,18,26.9,-1.3204931,36.7043102,-1.300921,36.828195,520,2222,400,2319
13357,16547,3291,3,Business,23,4,32680,23,4,32703,23,4,33153,23,4,33864,23,4,34664,4,23.25888921888938,-1.265715,36.823815,-1.2600926,36.8088685,624,800,23,1161
13358,10905,633,3,Business,13,3,56583,13,3,56611,13,3,57003,13,3,57196,13,3,57798,4,29.1,-1.3077869,36.8443207,-1.3004062,36.829741,206,602,28,585
13359,1103,2987,3,Business,4,3,48043,4,3,48082,4,3,48458,4,3,48702,4,3,51567,3,17.0,-1.270212,36.8210877,-1.2635487,36.8177196,379,2865,39,620
13360,15964,2866,3,Business,30,5,54439,30,5,54525,30,5,55412,30,5,56306,30,5,61107,11,24.7,-1.2571472,36.7950633,-1.3322618,36.8045412,523,4801,86,1781
13361,5299,2226,3,Personal,15,1,36565,15,1,36584,15,1,37349,15,1,37669,15,1,39216,9,23.25888921888938,-1.3104734,36.7363698,-1.2985749,36.8088,337,1547,19,1085
13362,25255,1341,3,Business,15,5,35418,15,5,35466,15,5,38903,15,5,39830,15,5,40974,13,26.0,-1.303596,36.778378,-1.331619,36.847976,267,1144,48,4364
13363,5607,1435,3,Personal,24,1,60398,24,1,60428,24,1,61095,24,1,61534,24,1,62896,19,22.5,-1.2948092,36.8869203,-1.3014461,36.7661381,440,1362,30,1106
13364,23828,2924,3,Personal,17,1,40500,17,1,40585,17,1,41501,17,1,41562,17,1,42417,10,23.7,-1.2808705,36.7684824,-1.2664227,36.7453671,932,855,85,977
13365,23967,1584,3,Business,30,5,34127,30,5,35336,30,5,35700,30,5,36469,30,5,38016,7,19.2,-1.2811695,36.8200313,-1.2969741,36.7856612,14,1547,1209,1133
13366,2970,867,3,Business,14,4,48092,14,4,50908,14,4,50966,14,4,51286,14,4,52383,9,28.0,-1.2638185,36.7930057,-1.2991441,36.7528804,156,1097,2816,378
13367,21422,2987,3,Business,24,1,61358,24,1,61392,24,1,62130,24,1,62441,24,1,63635,10,24.7,-1.270212,36.8210877,-1.2297202,36.8819507,427,1194,34,1049
13368,15187,1927,3,Business,8,2,56259,8,2,56393,8,2,57307,8,2,57822,8,2,61806,15,25.3,-1.264272,36.7978791,-1.3467389,36.7690312,421,3984,134,1429
13369,3827,3506,1,Personal,2,2,47378,2,2,47410,2,2,47461,2,2,48379,2,2,49864,14,20.9,-1.2563531,36.7896742,-1.3104734,36.7363698,446,1485,32,969
13370,10511,199,1,Personal,21,1,53396,21,1,53654,21,1,54027,21,1,54713,21,1,55967,6,21.5,-1.2873639,36.8256076,-1.26325,36.788,777,1254,258,1059
13371,6355,2069,3,Business,6,3,37724,6,3,37735,6,3,38265,6,3,38463,6,3,40588,16,23.25888921888938,-1.303596,36.778378,-1.228911,36.881876,599,2125,11,728
13372,25954,136,3,Business,27,4,47794,27,4,47811,27,4,48494,27,4,49959,27,4,51698,17,23.7,-1.2531983,36.8069669,-1.3165104,36.7077726,427,1739,17,2148
13373,13055,1244,3,Business,24,1,37811,24,1,37821,24,1,37997,24,1,38716,24,1,39833,8,22.7,-1.272828,36.816608,-1.303596,36.778378,829,1117,10,895
13374,6580,2985,2,Personal,28,5,53608,28,5,54163,28,5,55265,28,5,55651,28,5,57384,10,25.7,-1.3019857,36.7860087,-1.333076,36.75697,919,1733,555,1488
13375,20684,2801,3,Business,3,3,55216,3,3,55366,3,3,55913,3,3,57657,3,3,58621,8,28.1,-1.2925919,36.8170577,-1.2595422,36.7871178,206,964,150,2291
13376,4417,635,3,Business,8,3,40890,8,3,41018,8,3,41986,8,3,43852,8,3,46425,6,22.4,-1.300921,36.828195,-1.2709138,36.85387862,301,2573,128,2834
13377,18522,287,1,Personal,1,3,59718,1,3,59795,1,3,60486,1,3,63446,1,3,64926,5,23.3,-1.2765299,36.8220306,-1.3004846,36.7901591,414,1480,77,3651
13378,15322,1724,3,Business,11,2,56463,11,2,56961,11,2,59220,11,2,59427,11,2,61398,15,21.5,-1.2551895,36.7822034,-1.3259468,36.8650665,567,1971,498,2466
13379,22564,53,3,Business,8,4,52594,8,4,53493,8,4,54246,8,4,55982,8,4,57172,6,27.3,-1.2770708,36.8231093,-1.2475788,36.8215438,333,1190,899,2489
13380,10187,788,3,Business,23,5,44277,23,5,44950,23,5,46510,23,5,46659,23,5,47820,7,24.0,-1.2527958,36.8003131,-1.225322,36.80855,343,1161,673,1709
13381,8660,1304,3,Business,5,1,42303,5,1,42328,5,1,42384,5,1,42952,5,1,43748,6,24.3,-1.3332749,36.8708147,-1.2999305,36.843617,848,796,25,624
13382,11850,2008,3,Business,20,4,33954,20,4,35041,20,4,37645,20,4,38236,20,4,44477,16,22.0,-1.2508229,36.7895263,-1.2434951,36.6760986,88,6241,1087,3195
13383,22948,2069,3,Business,27,3,41212,27,3,41502,27,3,42271,27,3,42845,27,3,43558,6,26.1,-1.2296618,36.8438272,-1.228911,36.881876,8,713,290,1343
13384,21138,186,3,Business,13,3,36721,13,3,36739,13,3,36932,13,3,37100,13,3,41585,23,20.3,-1.3700383,36.9190174,-1.2571472,36.7950633,231,4485,18,361
13385,5669,3283,3,Business,22,2,38454,22,2,38971,22,2,40230,22,2,41592,22,2,43293,9,19.5,-1.303596,36.778378,-1.2628473,36.781805,844,1701,517,2621
13386,16201,867,3,Business,6,3,38177,6,3,38312,6,3,38340,6,3,39760,6,3,41408,10,22.5,-1.3004062,36.829741,-1.2991441,36.7528804,842,1648,135,1448
13387,15167,1340,3,Business,12,1,49510,12,1,49612,12,1,50778,12,1,54718,12,1,56821,19,26.7,-1.3277669,36.8975169,-1.2707179,36.7979713,276,2103,102,5106
13388,6662,557,3,Business,27,6,69178,27,6,69208,27,6,71519,27,6,71794,27,6,74087,24,23.25888921888938,-1.2809424,36.8950141,-1.1630034,36.8263292,461,2293,30,2586
13389,17924,3426,3,Business,28,1,45478,28,1,45552,28,1,45770,28,1,46439,28,1,47448,8,23.6,-1.3012008,36.764868,-1.2551895,36.7822034,829,1009,74,887
13390,3838,735,1,Personal,14,6,59945,14,6,60140,14,6,60980,14,6,61511,14,6,62696,10,19.1,-1.2519787,36.8096802,-1.3174417,36.8198414,539,1185,195,1371
13391,4132,391,3,Business,26,5,46493,26,5,47338,26,5,51133,26,5,52674,26,5,54068,5,23.25888921888938,-1.300921,36.828195,-1.2867454,36.8259017,237,1394,845,5336
13392,11842,2330,1,Business,4,6,37504,4,6,37555,4,6,38062,4,6,38855,4,6,40390,7,19.6,-1.2602688,36.7992556,-1.2915247,36.8055757,882,1535,51,1300
13393,17689,2869,3,Business,24,5,65545,24,5,65628,24,5,67614,24,5,68369,24,5,70655,9,20.0,-1.291768,36.8297208,-1.3025826,36.7670807,567,2286,83,2741
13394,17966,868,3,Business,7,5,36348,7,5,38085,7,5,38962,7,5,40768,7,5,42567,9,25.0,-1.331619,36.847976,-1.265715,36.823815,829,1799,1737,2683
13395,6406,1482,3,Business,22,5,29233,22,5,29254,22,5,29338,22,5,29914,22,5,32193,18,22.2,-1.2649605,36.7981777,-1.324731,36.907109,793,2279,21,660
13396,26821,2625,1,Personal,6,5,58962,6,5,58996,6,5,59526,6,5,60042,6,5,60617,3,23.25888921888938,-1.263987,36.798891,-1.2670213,36.7994482,312,575,34,1046
13397,9921,2987,3,Business,6,3,61156,6,3,61387,6,3,61907,6,3,62044,6,3,62649,4,20.1,-1.270212,36.8210877,-1.2649605,36.7981777,103,605,231,657
13398,18559,1473,3,Business,10,3,38435,10,3,40898,10,3,41573,10,3,41777,10,3,43223,12,27.8,-1.3700383,36.9190174,-1.3231187,36.9033708,233,1446,2463,879
13399,11956,3091,3,Business,14,4,24184,14,4,24497,14,4,29666,14,4,29846,14,4,32389,9,17.7,-1.3012008,36.764868,-1.290894,36.822971,926,2543,313,5349
13400,3762,2827,3,Business,3,4,45875,3,4,46403,3,4,47246,3,4,47552,3,4,48250,5,23.3,-1.2850644,36.8343657,-1.2692689,36.8055169,404,698,528,1149
13401,22182,246,3,Business,13,4,39166,13,4,39188,13,4,39294,13,4,39694,13,4,39773,1,21.8,-1.2584143,36.8048002,-1.2597529,36.806629,56,79,22,506
13402,7126,1724,3,Business,15,5,39798,15,5,39829,15,5,40131,15,5,40619,15,5,40729,3,26.3,-1.2551895,36.7822034,-1.2594539,36.8067841,881,110,31,790
13403,15662,1271,3,Business,1,1,46937,1,1,47375,1,1,47674,1,1,49181,1,1,50426,11,25.7,-1.2864733,36.8239937,-1.2927792,36.9053492,785,1245,438,1806
13404,11998,3565,3,Business,2,7,43132,2,7,43143,2,7,44546,2,7,46204,2,7,48155,21,22.6,-1.2844665,36.7866113,-1.398531,36.767365,267,1951,11,3061
13405,26866,2383,3,Business,16,4,59747,16,4,59763,16,4,60089,16,4,60637,16,4,61833,10,23.25888921888938,-1.2608993,36.799246,-1.295319,36.760178,484,1196,16,874
13406,26027,2523,3,Business,21,5,53935,21,5,54733,21,5,55362,21,5,55465,21,5,59052,21,24.4,-1.2551895,36.7822034,-1.3688433,36.7402114,596,3587,798,732
13407,9219,1642,3,Business,21,5,36955,21,5,36981,21,5,37429,21,5,37816,21,5,38371,3,20.0,-1.2728069,36.7962362,-1.2655332,36.8094648,343,555,26,835
13408,7536,1795,3,Personal,22,2,53894,22,2,54086,22,2,54908,22,2,55079,22,2,56482,7,25.5,-1.2744387,36.7849057,-1.2951169,36.823896,428,1403,192,993
13409,12294,438,3,Personal,13,4,61336,13,4,61354,13,4,61724,13,4,61990,13,4,63025,6,22.7,-1.256431,36.779887,-1.2563576,36.7881585,709,1035,18,636
13410,3292,246,3,Business,25,2,58512,25,2,58538,25,2,58760,25,2,59261,25,2,61514,20,26.9,-1.2584143,36.8048002,-1.3632162,36.9108253,648,2253,26,723
13411,20144,1899,3,Business,5,3,44276,5,3,44293,5,3,44430,5,3,46927,5,3,48016,13,22.4,-1.293515,36.897607,-1.331619,36.847976,900,1089,17,2634
13412,26545,795,3,Personal,12,2,40059,12,2,40097,12,2,41137,12,2,41421,12,2,43138,11,20.8,-1.3104734,36.7363698,-1.2551895,36.7822034,140,1717,38,1324
13413,1510,478,3,Business,1,1,53247,1,1,53274,1,1,54105,1,1,54758,1,1,56075,8,23.25888921888938,-1.3045333,36.8228072,-1.2534301,36.8000983,907,1317,27,1484
13414,26804,1205,3,Business,16,2,54854,16,2,54953,16,2,55443,16,2,56792,16,2,57767,8,23.25888921888938,-1.2707623,36.7581285,-1.2495931,36.8065087,363,975,99,1839
13415,26216,2987,3,Business,20,5,48433,20,5,53962,20,5,54324,20,5,54636,20,5,55735,7,20.4,-1.270212,36.8210877,-1.3043821,36.7840586,427,1099,5529,674
13416,16325,1075,3,Business,18,1,45357,18,1,45426,18,1,46121,18,1,46237,18,1,46872,1,27.8,-1.2649605,36.7981777,-1.2527958,36.8003131,318,635,69,811
13417,24258,393,3,Business,18,2,28997,18,2,37936,18,2,38462,18,2,38679,18,2,39652,4,23.25888921888938,-1.3167113,36.8301563,-1.3004062,36.829741,436,973,8939,743
13418,10664,3557,3,Business,8,5,54235,8,5,54283,8,5,54911,8,5,57530,8,5,58102,7,27.1,-1.266264,36.762418,-1.2546732,36.8086796,720,572,48,3247
13419,4911,3496,3,Business,7,4,52612,7,4,52662,7,4,53172,7,4,54167,7,4,56454,14,27.5,-1.3081376,36.8329772,-1.282907,36.738903,105,2287,50,1505
13420,17536,1792,3,Business,23,1,56161,23,1,56290,23,1,57215,23,1,57373,23,1,58411,5,23.25888921888938,-1.2805537,36.7920739,-1.2689015,36.7986106,844,1038,129,1083
13421,5215,540,3,Business,11,5,47900,11,5,48013,11,5,48495,11,5,48649,11,5,49583,7,20.8,-1.2551895,36.7822034,-1.2897399,36.8270975,878,934,113,636
13422,10586,1594,3,Business,16,2,54714,16,2,54767,16,2,55376,16,2,56323,16,2,58054,12,23.25888921888938,-1.28878,36.8168312,-1.2156006,36.8916865,709,1731,53,1556
13423,28129,393,3,Business,22,5,36214,22,5,36291,22,5,37780,22,5,38799,22,5,39382,4,23.25888921888938,-1.3167113,36.8301563,-1.3004062,36.829741,399,583,77,2508
13424,23367,1271,3,Business,9,2,33689,9,2,33697,9,2,35197,9,2,37344,9,2,39998,25,17.4,-1.3244885,36.897792,-1.1708105,36.8336102,598,2654,8,3647
13425,11104,1304,3,Business,25,5,53715,25,5,53821,25,5,54310,25,5,54562,25,5,54877,3,23.5,-1.2553615,36.7895376,-1.2607765,36.8080021,103,315,106,741
13426,9338,3222,3,Business,24,3,39036,24,3,39071,24,3,39276,24,3,39454,24,3,41390,6,19.7,-1.2551895,36.7822034,-1.2608848,36.7551607,405,1936,35,383
13427,27991,1484,3,Business,22,2,54709,22,2,54808,22,2,55545,22,2,56213,22,2,57645,13,21.4,-1.2579304,36.8019667,-1.2343236,36.8861,580,1432,99,1405
13428,7188,928,3,Business,4,1,49075,4,1,49113,4,1,49988,4,1,50498,4,1,52617,10,23.25888921888938,-1.3263105,36.8622904,-1.290894,36.822971,926,2119,38,1385
13429,25056,111,3,Business,14,4,56970,14,4,58219,14,4,58735,14,4,58890,14,4,60061,5,28.2,-1.2551895,36.7822034,-1.26071,36.8206332,19,1171,1249,671
13430,15101,412,3,Business,8,6,44190,8,6,44208,8,6,44213,8,6,44549,8,6,44767,2,20.1,-1.2600926,36.8088685,-1.266837,36.799249,531,218,18,341
13431,32,3382,1,Personal,16,3,55950,16,3,55972,16,3,56951,16,3,57510,16,3,59537,14,25.3,-1.2261913,36.8368117,-1.322859,36.8462877,410,2027,22,1538
13432,10343,2884,3,Personal,3,1,46629,3,1,46660,3,1,47364,3,1,47898,3,1,48369,3,21.7,-1.3021968,36.7874256,-1.3039411,36.7695316,146,471,31,1238
13433,9839,909,3,Business,11,1,44713,11,1,44743,11,1,45269,11,1,45659,11,1,47507,10,26.7,-1.279395,36.825364,-1.225322,36.80855,504,1848,30,916
13434,17551,733,3,Business,18,1,42363,18,1,42400,18,1,42890,18,1,43613,18,1,44239,4,27.9,-1.2551895,36.7822034,-1.2692689,36.8055169,205,626,37,1213
13435,10287,1280,3,Business,7,4,51355,7,4,51378,7,4,51469,7,4,52111,7,4,53967,15,27.8,-1.2551895,36.7822034,-1.3288106,36.8697344,958,1856,23,733
13436,4423,3669,3,Business,16,3,36810,16,3,37208,16,3,37633,16,3,38924,16,3,41763,19,23.0,-1.2615888,36.7928732,-1.2708104,36.910537,379,2839,398,1716
13437,25450,3291,3,Business,1,5,38059,1,5,38085,1,5,39024,1,5,39317,1,5,40021,4,26.7,-1.272828,36.816608,-1.2600926,36.8088685,276,704,26,1232
13438,17427,861,3,Personal,28,1,45508,28,1,45546,28,1,45893,28,1,46688,28,1,48813,20,22.9,-1.2661264,36.8030359,-1.335477,36.9308297,103,2125,38,1142
13439,19714,3222,3,Business,1,4,45392,1,4,46050,1,4,46056,1,4,46698,1,4,49542,9,23.25888921888938,-1.2551895,36.7822034,-1.2959605,36.7873854,268,2844,658,648
13440,11584,3688,3,Business,18,1,43867,18,1,43889,18,1,44242,18,1,44371,18,1,44397,5,27.1,-1.2551895,36.7822034,-1.2629296,36.7878798,498,26,22,482
13441,5818,3521,3,Business,25,1,34130,25,1,34155,25,1,34918,25,1,35186,25,1,35798,2,23.25888921888938,-1.2701582,36.8074433,-1.2696908,36.81519,953,612,25,1031
13442,197,2330,3,Business,20,3,58323,20,3,58346,20,3,58596,20,3,58676,20,3,61386,13,28.5,-1.2533885,36.8165128,-1.2284323,36.8757058,660,2710,23,330
13443,2191,2310,1,Business,12,5,59420,12,5,59740,12,5,59755,12,5,61258,12,5,61839,6,25.7,-1.2927792,36.9053492,-1.2859912,36.8756811,179,581,320,1518
13444,9161,1578,3,Business,29,1,48409,29,1,51248,29,1,52053,29,1,52812,29,1,53705,10,24.6,-1.225322,36.80855,-1.28878,36.8168312,101,893,2839,1564
13445,1212,1205,3,Business,15,1,33093,15,1,33111,15,1,33727,15,1,34083,15,1,36287,20,23.25888921888938,-1.257309,36.8060084,-1.3085443,36.6884314,754,2204,18,972
13446,5650,2757,3,Business,5,1,61372,5,1,62000,5,1,64154,5,1,64809,5,1,65570,4,24.4,-1.2891922,36.825189,-1.2765737,36.8175399,237,761,628,2809
13447,15794,3547,3,Business,4,1,38939,4,1,39018,4,1,40057,4,1,40608,4,1,43840,16,26.5,-1.3194518,36.869396,-1.2717021,36.7650838,675,3232,79,1590
13448,21123,3599,3,Business,2,2,43028,2,2,43096,2,2,46218,2,2,46778,2,2,50407,17,26.1,-1.3302996,36.8707935,-1.2619185,36.759662,787,3629,68,3682
13449,19902,496,3,Business,2,4,53594,2,4,53859,2,4,54027,2,4,55703,2,4,56999,8,23.25888921888938,-1.2571472,36.7950633,-1.3004846,36.7901591,681,1296,265,1844
13450,4820,830,3,Business,26,5,60664,26,5,60681,26,5,62169,26,5,62605,26,5,65069,17,23.25888921888938,-1.2551895,36.7822034,-1.2859912,36.8756811,840,2464,17,1924
13451,12184,1075,3,Business,22,5,49612,22,5,49672,22,5,50184,22,5,50758,22,5,53541,10,31.1,-1.3014461,36.7661381,-1.2527958,36.8003131,952,2783,60,1086
13452,22140,598,2,Business,14,7,42349,14,7,42507,14,7,42901,14,7,43345,14,7,46092,24,25.2,-1.2329501,36.8083852,-1.3157001,36.7075432,453,2747,158,838
13453,3324,3283,3,Business,12,3,38753,12,3,39064,12,3,40490,12,3,41045,12,3,43395,19,19.3,-1.293515,36.897607,-1.2628473,36.781805,883,2350,311,1981
13454,24664,3647,3,Business,27,1,53981,27,1,54097,27,1,55229,27,1,55570,27,1,56720,9,22.9,-1.272639,36.794723,-1.2703375,36.8247799,835,1150,116,1473
13455,10785,393,3,Business,20,1,38940,20,1,38953,20,1,39052,20,1,39565,20,1,40463,5,23.25888921888938,-1.3167113,36.8301563,-1.3077869,36.8443207,591,898,13,612
13456,3255,1544,3,Business,3,4,39378,3,4,40771,3,4,42949,3,4,43486,3,4,44900,10,21.9,-1.2870774,36.8259832,-1.3052672,36.7538539,409,1414,1393,2715
13457,15206,3680,2,Personal,21,1,48123,21,1,48892,21,1,49883,21,1,50081,21,1,50989,5,21.6,-1.2759536,36.8077214,-1.2844713,36.8106871,742,908,769,1189
13458,8067,1075,3,Business,18,2,42846,18,2,42886,18,2,43210,18,2,43416,18,2,44102,3,23.25888921888938,-1.2527958,36.8003131,-1.2551895,36.7822034,658,686,40,530
13459,9734,857,1,Personal,23,4,39681,23,4,39768,23,4,40561,23,4,40683,23,4,41875,8,18.7,-1.2850644,36.8343657,-1.314945,36.8411437,85,1192,87,915
13460,1477,2587,3,Business,2,5,52588,2,5,53608,2,5,54766,2,5,54978,2,5,56546,2,25.3,-1.290894,36.822971,-1.28878,36.8168312,569,1568,1020,1370
13461,12681,409,3,Personal,15,5,44914,15,5,45028,15,5,46792,15,5,47396,15,5,48708,6,26.6,-1.312469,36.815177,-1.304735,36.7846054,328,1312,114,2368
13462,2366,186,3,Business,17,4,55250,17,4,55269,17,4,55655,17,4,55850,17,4,59415,22,27.9,-1.3700383,36.9190174,-1.2615888,36.7928732,296,3565,19,581
13463,26302,3145,3,Business,9,4,36338,9,4,36353,9,4,37120,9,4,37350,9,4,39119,11,23.25888921888938,-1.272639,36.794723,-1.22155,36.7848476,147,1769,15,997
13464,8468,1934,2,Personal,21,5,45877,21,5,47493,21,5,47763,21,5,48594,21,5,49694,6,20.2,-1.2862252,36.8234218,-1.2502923,36.7887568,156,1100,1616,1101
13465,1134,2931,3,Business,21,4,34439,21,4,34449,21,4,35106,21,4,35230,21,4,37501,14,21.8,-1.2452664,36.8028541,-1.3139038,36.8580987,770,2271,10,781
13466,16529,510,3,Business,21,5,35928,21,5,37949,21,5,38896,21,5,39576,21,5,43328,12,22.6,-1.2860183,36.8975338,-1.281754,36.8324229,554,3752,2021,1627
13467,23845,3283,3,Business,12,4,41140,12,4,43764,12,4,44363,12,4,46086,12,4,48323,14,19.1,-1.228911,36.881876,-1.2628473,36.781805,510,2237,2624,2322
13468,20395,768,1,Personal,28,5,26715,28,5,26800,28,5,28141,28,5,28289,28,5,29795,18,20.7,-1.2849763,36.7841767,-1.2000518,36.7805946,726,1506,85,1489
13469,21325,2532,3,Business,17,4,35836,17,4,36249,17,4,37269,17,4,38308,17,4,40252,7,25.4,-1.2551895,36.7822034,-1.2870235,36.8201986,725,1944,413,2059
13470,18523,142,3,Business,5,2,36258,5,2,36280,5,2,37307,5,2,37586,5,2,39489,8,17.9,-1.2595422,36.7871178,-1.3039411,36.7695316,735,1903,22,1306
13471,15453,1764,1,Personal,27,3,41704,27,3,41856,27,3,43161,27,3,43399,27,3,44890,10,23.25888921888938,-1.3307951,36.7977548,-1.2833534,36.8165865,338,1491,152,1543
13472,7357,3635,1,Business,11,2,35808,11,2,35816,11,2,37567,11,2,38205,11,2,39633,8,24.1,-1.3052491,36.8223899,-1.2615888,36.7928732,848,1428,8,2389
13473,22142,540,3,Business,7,1,46590,7,1,46659,7,1,46819,7,1,47119,7,1,48272,8,24.7,-1.2551895,36.7822034,-1.2862436,36.791017,382,1153,69,460
13474,19684,3718,3,Business,27,4,40485,27,4,40497,27,4,40800,27,4,41117,27,4,41992,4,22.6,-1.2650027,36.8126242,-1.2699091,36.7885552,795,875,12,620
13475,8167,1075,3,Business,6,3,49907,6,3,50926,6,3,51752,6,3,53179,6,3,54887,15,27.7,-1.2156006,36.8916865,-1.2527958,36.8003131,958,1708,1019,2253
13476,993,496,3,Business,2,2,60620,2,2,60731,2,2,61015,2,2,61380,2,2,62792,10,28.6,-1.2551895,36.7822034,-1.2948533,36.7991616,85,1412,111,649
13477,4222,2454,3,Business,10,3,50454,10,3,51311,10,3,51759,10,3,51905,10,3,52246,2,30.5,-1.2941413,36.7958937,-1.2985749,36.8088,783,341,857,594
13478,20037,868,3,Business,2,3,36030,2,3,36068,2,3,38218,2,3,38862,2,3,38984,3,24.2,-1.2783849,36.8163445,-1.265715,36.823815,88,122,38,2794
13479,9224,3606,3,Business,5,2,59039,5,2,59310,5,2,59673,5,2,59811,5,2,60934,6,23.25888921888938,-1.2628638,36.8070399,-1.2623805,36.7805404,575,1123,271,501
13480,22836,2310,1,Business,8,3,42534,8,3,42562,8,3,43740,8,3,43843,8,3,43882,11,22.3,-1.2859912,36.8756811,-1.2479903,36.9579838,397,39,28,1281
13481,19869,3295,3,Business,12,3,53965,12,3,54165,12,3,54238,12,3,55292,12,3,58575,33,21.2,-1.2571472,36.7950633,-1.4097093,36.9532082,875,3283,200,1127
13482,25453,201,3,Business,24,3,55007,24,3,55371,24,3,56029,24,3,56343,24,3,58825,6,18.2,-1.2551895,36.7822034,-1.2857248,36.8228262,916,2482,364,972
13483,16434,2423,3,Business,13,3,46936,13,3,47010,13,3,47544,13,3,48004,13,3,48977,4,24.7,-1.2551895,36.7822034,-1.269534,36.80697,913,973,74,994
13484,5963,393,3,Business,2,5,28519,2,5,30438,2,5,32529,2,5,35338,2,5,36046,4,18.2,-1.3177547,36.8303703,-1.3004062,36.829741,208,708,1919,4900
13485,18813,2174,3,Business,22,3,34543,22,3,34544,22,3,34968,22,3,38696,22,3,39317,20,23.2,-1.2482781,36.884092,-1.1707617,36.9675086,86,621,1,4152
13486,12035,2523,3,Business,17,2,60926,17,2,60935,17,2,60952,17,2,61828,17,2,63311,9,24.0,-1.2551895,36.7822034,-1.2977565,36.8025534,510,1483,9,893
13487,9668,1500,3,Business,16,3,29958,16,3,30014,16,3,30530,16,3,31450,16,3,32645,8,19.6,-1.3004062,36.829741,-1.2574219,36.7927073,436,1195,56,1436
13488,17751,1146,3,Business,4,4,47035,4,4,47127,4,4,47435,4,4,48160,4,4,48972,5,25.7,-1.3004062,36.829741,-1.3083266,36.8494756,136,812,92,1033
13489,2424,1500,3,Business,11,1,51149,11,1,51250,11,1,51296,11,1,51641,11,1,53059,8,28.7,-1.3004062,36.829741,-1.2638185,36.7930057,177,1418,101,391
13490,26478,1912,3,Business,29,3,59256,29,3,59407,29,3,60080,29,3,60399,29,3,61289,5,21.2,-1.279395,36.825364,-1.2571472,36.7950633,907,890,151,992
13491,22803,3186,3,Business,6,4,51223,6,4,51250,6,4,52231,6,4,52524,6,4,52904,2,21.3,-1.2980229,36.78865,-1.2987732,36.7932128,277,380,27,1274
13492,3276,2956,3,Business,10,2,34533,10,2,35161,10,2,35174,10,2,35769,10,2,36800,11,16.2,-1.2584143,36.8048002,-1.225322,36.80855,51,1031,628,608
13493,2668,478,3,Business,30,2,38372,30,2,38898,30,2,39365,30,2,39803,30,2,40197,2,23.25888921888938,-1.2551895,36.7822034,-1.2571472,36.7950633,690,394,526,905
13494,18738,3232,3,Business,26,5,46387,26,5,46476,26,5,49561,26,5,52962,26,5,56590,17,23.25888921888938,-1.2551895,36.7822034,-1.3472066,36.7692638,755,3628,89,6486
13495,1914,2330,3,Business,9,3,45501,9,3,45544,9,3,45947,9,3,46027,9,3,46881,10,25.1,-1.2687407,36.7373043,-1.2642903,36.8002137,512,854,43,483
13496,15379,3487,3,Business,10,3,37031,10,3,37246,10,3,37491,10,3,37687,10,3,39539,5,21.9,-1.2584143,36.8048002,-1.279395,36.825364,660,1852,215,441
13497,11119,2691,3,Business,14,3,45229,14,3,45265,14,3,45848,14,3,46352,14,3,47101,8,24.7,-1.2857671,36.7875614,-1.2571472,36.7950633,85,749,36,1087
13498,12069,706,3,Business,6,3,39849,6,3,40453,6,3,41307,6,3,42333,6,3,42968,12,22.4,-1.3559093,36.9100452,-1.3077869,36.8443207,206,635,604,1880
13499,6200,627,3,Business,27,3,54985,27,3,55000,27,3,55768,27,3,56237,27,3,58381,21,28.9,-1.2571472,36.7950633,-1.3440557,36.9099653,206,2144,15,1237
13500,14210,2523,3,Business,10,5,53921,10,5,53946,10,5,54049,10,5,54864,10,5,54870,2,22.0,-1.2551895,36.7822034,-1.2629944,36.7998816,541,6,25,918
13501,14340,2360,3,Business,13,3,33265,13,3,33299,13,3,33537,13,3,35472,13,3,36903,7,20.4,-1.2708857,36.8135766,-1.3207146,36.8305771,678,1431,34,2173
13502,4006,53,3,Business,10,1,53311,10,1,53729,10,1,53757,10,1,53920,10,1,55678,12,18.5,-1.3167113,36.8301563,-1.276954,36.765926,800,1758,418,191
13503,20064,2509,3,Business,3,3,58367,3,3,58471,3,3,59916,3,3,60366,3,3,63492,14,23.7,-1.2571472,36.7950633,-1.2238103,36.8772588,578,3126,104,1895
13504,27020,1500,3,Business,22,3,39496,22,3,39541,22,3,39620,22,3,41171,22,3,41345,8,23.0,-1.3004062,36.829741,-1.2638185,36.7930057,403,174,45,1630
13505,5183,1450,3,Personal,17,1,33886,17,1,33964,17,1,35471,17,1,35939,17,1,36827,6,18.2,-1.2995135,36.7933633,-1.3108386,36.7555239,328,888,78,1975
13506,6042,510,3,Business,26,2,45249,26,2,52660,26,2,53526,26,2,53976,26,2,55953,12,31.0,-1.290894,36.822971,-1.2860183,36.8975338,953,1977,7411,1316
13507,16212,2532,3,Business,7,5,46074,7,5,46082,7,5,46294,7,5,46421,7,5,46585,3,25.2,-1.2551895,36.7822034,-1.256522,36.7864132,353,164,8,339
13508,1582,867,3,Business,25,1,52268,25,1,52277,25,1,52419,25,1,52514,25,1,55000,20,30.2,-1.2991441,36.7528804,-1.3228003,36.8306435,349,2486,9,237
13509,18900,3080,3,Business,13,4,56582,13,4,56702,13,4,57195,13,4,57482,13,4,59416,4,23.3,-1.2551895,36.7822034,-1.2689426,36.8060017,269,1934,120,780
13510,28190,2174,3,Business,5,5,35099,5,5,35137,5,5,35212,5,5,37114,5,5,39903,12,17.8,-1.2482781,36.884092,-1.2981239,36.8367977,216,2789,38,1977
13511,15505,1081,3,Business,13,3,51447,13,3,51462,13,3,52285,13,3,52613,13,3,54465,3,27.4,-1.2551895,36.7822034,-1.25537,36.7756,875,1852,15,1151
13512,24810,3686,3,Business,11,4,54043,11,4,57879,11,4,59251,11,4,59453,11,4,60392,4,26.8,-1.261733,36.809971,-1.2551895,36.7822034,913,939,3836,1574
13513,7444,2271,3,Business,8,2,54724,8,2,54747,8,2,55741,8,2,56077,8,2,58691,17,25.5,-1.2560184,36.7934342,-1.293515,36.897607,244,2614,23,1330
13514,26371,2587,3,Business,3,4,53324,3,4,53346,3,4,53927,3,4,54687,3,4,56074,13,26.0,-1.2232123,36.8932547,-1.28878,36.8168312,101,1387,22,1341
13515,20639,1209,3,Business,25,4,37939,25,4,37968,25,4,38156,25,4,38754,25,4,39201,5,23.25888921888938,-1.3004062,36.829741,-1.3077869,36.8443207,206,447,29,786
13516,1995,1850,3,Business,13,4,41889,13,4,41964,13,4,42607,13,4,42854,13,4,43862,7,21.9,-1.2551895,36.7822034,-1.2785434,36.8215327,365,1008,75,890
13517,23166,1142,1,Personal,5,4,38384,5,4,38486,5,4,39141,5,4,40585,5,4,42952,11,23.25888921888938,-1.2801233,36.8300102,-1.291264,36.8887041,844,2367,102,2099
13518,7352,187,3,Business,5,5,57157,5,5,57165,5,5,57381,5,5,57827,5,5,61176,27,26.7,-1.3169591,36.7000029,-1.2413316,36.8785525,520,3349,8,662
13519,16593,2801,3,Business,12,2,48235,12,2,48300,12,2,48548,12,2,48932,12,2,50137,9,23.25888921888938,-1.2674274,36.7870827,-1.2864746,36.8302421,674,1205,65,632
13520,9323,3194,3,Business,30,3,38173,30,3,38237,30,3,38556,30,3,39084,30,3,40095,8,25.1,-1.2551895,36.7822034,-1.2597436,36.8282526,691,1011,64,847
13521,11713,3417,1,Personal,4,1,36730,4,1,36942,4,1,37257,4,1,42027,4,1,43409,9,20.8,-1.2817945,36.8258051,-1.2809666,36.8765961,618,1382,212,5085
13522,11594,1469,3,Business,23,4,54937,23,4,54972,23,4,55282,23,4,55955,23,4,57534,16,24.5,-1.2551895,36.7822034,-1.3194518,36.869396,484,1579,35,983
13523,11333,1073,3,Business,20,3,59697,20,3,59724,20,3,59743,20,3,60627,20,3,61215,5,28.2,-1.2561964,36.7885001,-1.2753109,36.8130185,576,588,27,903
13524,12014,3017,3,Business,15,7,64255,15,7,64275,15,7,64746,15,7,64994,15,7,65470,3,20.5,-1.299313,36.7831488,-1.2905113,36.7591138,45,476,20,719
13525,5889,2330,3,Business,15,6,52977,15,6,52996,15,6,53373,15,6,54727,15,6,57267,21,23.5,-1.2637057,36.80517,-1.3800951,36.9297274,720,2540,19,1731
13526,22348,1535,1,Business,3,5,53527,3,5,53598,3,5,55170,3,5,55651,3,5,57778,5,25.4,-1.2897368,36.8226783,-1.2643994,36.812919,96,2127,71,2053
13527,11674,706,3,Business,30,5,52386,30,5,52416,30,5,52745,30,5,54766,30,5,55058,3,24.8,-1.3079928,36.8389933,-1.3077869,36.8443207,661,292,30,2350
13528,27743,286,3,Business,22,4,67392,22,4,67746,22,4,68479,22,4,69026,22,4,69837,7,24.2,-1.2551895,36.7822034,-1.2962967,36.8020231,38,811,354,1280
13529,6517,3496,3,Business,27,4,37455,27,4,37459,27,4,37477,27,4,39400,27,4,41247,15,23.0,-1.300921,36.828195,-1.3882008,36.7699445,167,1847,4,1941
13530,5795,391,3,Business,23,2,44667,23,2,44792,23,2,45563,23,2,47323,23,2,51205,13,23.25888921888938,-1.2867454,36.8259017,-1.2121839,36.8924274,99,3882,125,2531
13531,27957,3091,3,Business,9,4,54295,9,4,54754,9,4,55700,9,4,58568,9,4,58574,18,23.25888921888938,-1.290894,36.822971,-1.3190102,36.9230693,921,6,459,3814
13532,24301,1926,3,Business,25,1,49004,25,1,49082,25,1,50003,25,1,51122,25,1,51582,4,30.0,-1.2897368,36.8226783,-1.263706,36.812036,119,460,78,2040
13533,18746,1500,3,Business,23,4,45987,23,4,46285,23,4,48921,23,4,50572,23,4,50626,5,24.7,-1.2638185,36.7930057,-1.282937,36.7816984,2,54,298,4287
13534,21068,637,1,Business,17,2,51138,17,2,51276,17,2,52114,17,2,53398,17,2,54575,8,24.6,-1.2551895,36.7822034,-1.2577289,36.7410772,100,1177,138,2122
13535,14321,136,3,Business,29,5,37301,29,5,37359,29,5,38914,29,5,39206,29,5,41794,16,26.6,-1.3254522,36.7216584,-1.281614,36.8275424,448,2588,58,1847
13536,24215,3283,3,Business,19,6,31980,19,6,34220,19,6,35241,19,6,35754,19,6,37176,6,16.7,-1.272828,36.816608,-1.2628473,36.781805,327,1422,2240,1534
13537,27674,2509,3,Business,29,5,32475,29,5,32494,29,5,32655,29,5,33220,29,5,35077,17,20.7,-1.2571472,36.7950633,-1.2852569,36.8976121,770,1857,19,726
13538,3108,635,3,Business,7,1,41282,7,1,42213,7,1,44203,7,1,46354,7,1,47374,8,24.6,-1.3016417,36.8271679,-1.2599563,36.7993439,72,1020,931,4141
13539,5938,142,3,Business,8,4,25790,8,4,25836,8,4,27874,8,4,28214,8,4,30835,11,20.4,-1.2963097,36.7688221,-1.3314048,36.8229367,303,2621,46,2378
13540,17492,1133,3,Business,16,3,39637,16,3,40183,16,3,40747,16,3,40966,16,3,41775,4,23.0,-1.3323107,36.8692616,-1.335957,36.8717418,559,809,546,783
13541,25765,3091,3,Business,17,3,56357,17,3,56429,17,3,57809,17,3,58074,17,3,59326,8,28.6,-1.3025826,36.7670807,-1.2615888,36.7928732,352,1252,72,1645
13542,699,1458,1,Personal,10,1,35618,10,1,35739,10,1,36787,10,1,37099,10,1,37935,6,17.9,-1.3043649,36.7816132,-1.2862984,36.8293971,754,836,121,1360
13543,915,2457,3,Business,26,5,54033,26,5,54267,26,5,55289,26,5,55665,26,5,56661,4,23.25888921888938,-1.2551895,36.7822034,-1.2753109,36.8130185,467,996,234,1398
13544,17822,3215,3,Personal,25,4,53608,25,4,53664,25,4,54455,25,4,54591,25,4,56102,10,23.25888921888938,-1.2454036,36.7866654,-1.29387,36.7907813,411,1511,56,927
13545,15370,958,3,Business,3,1,47356,3,1,47423,3,1,47558,3,1,49389,3,1,50650,15,23.2,-1.3263105,36.8622904,-1.2826972,36.9702813,25,1261,67,1966
13546,6279,1363,3,Business,18,1,45566,18,1,45607,18,1,45750,18,1,45887,18,1,46913,5,27.0,-1.3004062,36.829741,-1.3083266,36.8494756,660,1026,41,280
13547,16902,2513,3,Personal,16,4,48772,16,4,48818,16,4,50250,16,4,50759,16,4,51668,4,18.9,-1.2865508,36.8238701,-1.292163,36.8000995,754,909,46,1941
13548,27459,2691,3,Business,19,3,38396,19,3,39117,19,3,40572,19,3,41372,19,3,42659,8,22.2,-1.2857671,36.7875614,-1.2571472,36.7950633,337,1287,721,2255
13549,7450,3186,3,Business,30,4,49029,30,4,49043,30,4,49351,30,4,49518,30,4,50308,4,23.25888921888938,-1.2980229,36.78865,-1.2950041,36.8143583,209,790,14,475
13550,27528,3201,3,Business,18,5,54588,18,5,54605,18,5,56643,18,5,57099,18,5,57493,2,27.0,-1.2584143,36.8048002,-1.2591019,36.800577,19,394,17,2494
13551,9585,2154,3,Business,7,4,49922,7,4,49954,7,4,50675,7,4,51350,7,4,52919,5,31.2,-1.2765736,36.8513646,-1.28878,36.8168312,118,1569,32,1396
13552,5536,391,3,Business,11,6,43254,11,6,43939,11,6,45950,11,6,46854,11,6,48203,5,23.25888921888938,-1.300921,36.828195,-1.2784063,36.8222933,491,1349,685,2915
13553,1333,1390,1,Personal,30,4,40947,30,4,40954,30,4,41669,30,4,42151,30,4,43558,9,20.1,-1.3080784,36.776235,-1.3092311,36.8328403,447,1407,7,1197
13554,18517,788,3,Business,20,5,57518,20,5,57551,20,5,57985,20,5,58180,20,5,59268,11,20.7,-1.2605938,36.8073235,-1.225322,36.80855,379,1088,33,629
13555,27737,412,3,Business,17,4,55844,17,4,55853,17,4,55855,17,4,57235,17,4,57787,3,27.9,-1.272828,36.816608,-1.266837,36.799249,886,552,9,1382
13556,23667,1796,3,Business,24,3,34589,24,3,35005,24,3,35711,24,3,36128,24,3,39571,11,23.25888921888938,-1.265715,36.823815,-1.331619,36.847976,13,3443,416,1123
13557,384,3503,2,Personal,3,3,50826,3,3,52053,3,3,52395,3,3,54139,3,3,55834,14,26.6,-1.3299841,36.8466903,-1.2828204,36.7842621,427,1695,1227,2086
13558,17589,3404,3,Business,27,4,57575,27,4,57598,27,4,58457,27,4,58997,27,4,60648,7,23.8,-1.279395,36.825364,-1.2551895,36.7822034,579,1651,23,1399
13559,6125,393,3,Business,20,4,44001,20,4,44488,20,4,44492,20,4,46951,20,4,49419,11,22.0,-1.3167113,36.8301563,-1.2574219,36.7927073,239,2468,487,2463
13560,7894,3422,3,Business,31,4,38897,31,4,38963,31,4,39517,31,4,39772,31,4,40868,13,26.3,-1.31553,36.863732,-1.3731701,36.9262851,418,1096,66,809
13561,17236,111,3,Business,9,4,34107,9,4,34697,9,4,34934,9,4,35480,9,4,37608,6,16.9,-1.2551895,36.7822034,-1.281337,36.818968,74,2128,590,783
13562,1086,3669,3,Business,29,2,39438,29,2,39462,29,2,39797,29,2,40198,29,2,40935,3,23.5,-1.2641662,36.8136393,-1.2615888,36.7928732,79,737,24,736
13563,12172,202,1,Personal,2,4,64352,2,4,64381,2,4,65760,2,4,66535,2,4,67410,7,23.5,-1.287428,36.7800821,-1.2795796,36.819062,636,875,29,2154
13564,1001,2066,3,Business,1,1,55536,1,1,55587,1,1,55969,1,1,56461,1,1,58291,12,25.7,-1.316961,36.820337,-1.3610501,36.7520889,402,1830,51,874
13565,6315,868,3,Business,24,4,32127,24,4,33831,24,4,34766,24,4,35419,24,4,36978,9,17.1,-1.331619,36.847976,-1.265715,36.823815,742,1559,1704,1588
13566,6995,2828,2,Business,2,1,44736,2,1,44793,2,1,45504,2,1,46399,2,1,47899,3,19.0,-1.2584143,36.8048002,-1.2615888,36.7928732,908,1500,57,1606
13567,16997,3007,3,Personal,1,5,66010,1,5,66175,1,5,66333,1,5,69090,1,5,69672,5,26.5,-1.277551,36.8273641,-1.2913382,36.8018508,237,582,165,2915
13568,23248,2869,3,Business,5,3,50102,5,3,50116,5,3,50642,5,3,50920,5,3,52119,9,18.8,-1.2649605,36.7981777,-1.3025826,36.7670807,96,1199,14,804
13569,8964,1062,3,Business,24,1,64434,24,1,64456,24,1,64620,24,1,65017,24,1,66071,7,22.3,-1.238874,36.807889,-1.266116,36.8088644,674,1054,22,561
13570,17774,868,3,Business,2,2,40455,2,2,40497,2,2,41406,2,2,41893,2,2,42829,5,20.8,-1.2600926,36.8088685,-1.265715,36.823815,532,936,42,1396
13571,20286,3586,3,Business,6,2,50808,6,2,53010,6,2,54244,6,2,54797,6,2,58299,9,27.3,-1.2854453,36.8188363,-1.275442,36.7660207,548,3502,2202,1787
13572,247,2523,3,Business,13,5,53828,13,5,53839,13,5,53951,13,5,54751,13,5,55741,8,19.1,-1.2551895,36.7822034,-1.2860372,36.7549573,101,990,11,912
13573,8373,2676,3,Business,27,4,34245,27,4,34292,27,4,35873,27,4,37038,27,4,38690,8,18.8,-1.2862659,36.8264616,-1.2963097,36.7688221,726,1652,47,2746
13574,18265,1099,3,Business,26,4,46554,26,4,46561,26,4,47127,26,4,47208,26,4,48079,2,18.7,-1.2699491,36.8135968,-1.2661949,36.8205307,754,871,7,647
13575,19966,1146,3,Business,6,4,50147,6,4,50637,6,4,52000,6,4,52752,6,4,54043,6,21.2,-1.3167113,36.8301563,-1.3083266,36.8494756,2,1291,490,2115
13576,17294,2241,1,Personal,25,6,48677,25,6,48702,25,6,50348,25,6,50716,25,6,52407,12,23.25888921888938,-1.2248308,36.8012573,-1.255513,36.752422,400,1691,25,2014
13577,11220,1469,3,Business,19,3,43490,19,3,43556,19,3,43891,19,3,44193,19,3,45492,7,22.3,-1.2551895,36.7822034,-1.2896399,36.8124498,445,1299,66,637
13578,3069,3201,3,Business,5,2,47163,5,2,47198,5,2,47335,5,2,48813,5,2,48820,2,23.25888921888938,-1.2584143,36.8048002,-1.2561334,36.7990458,875,7,35,1615
13579,17530,928,3,Business,9,4,57953,9,4,59223,9,4,59759,9,4,60544,9,4,62817,11,23.25888921888938,-1.2571472,36.7950633,-1.3039222,36.8534707,155,2273,1270,1321
13580,11402,1250,1,Personal,20,3,46713,20,3,46746,20,3,49752,20,3,50245,20,3,52540,9,23.4,-1.2620741,36.8158147,-1.2743743,36.7657321,906,2295,33,3499
13581,27256,53,3,Business,11,1,55375,11,1,57191,11,1,58212,11,1,58927,11,1,59750,5,28.1,-1.3004062,36.829741,-1.2770708,36.8231093,953,823,1816,1736
13582,19538,2828,1,Business,28,5,49087,28,5,49146,28,5,49264,28,5,50179,28,5,52491,14,25.5,-1.2615888,36.7928732,-1.326774,36.7878069,651,2312,59,1033
13583,13767,758,3,Business,18,5,35600,18,5,35680,18,5,36310,18,5,36447,18,5,38250,8,17.8,-1.299813,36.7871392,-1.2696908,36.81519,16,1803,80,767
13584,20216,1075,3,Business,30,2,57524,30,2,59942,30,2,60940,30,2,62103,30,2,63733,5,23.25888921888938,-1.279395,36.825364,-1.2527958,36.8003131,456,1630,2418,2161
13585,8858,873,1,Personal,1,1,31531,1,1,31636,1,1,32110,1,1,32382,1,1,33977,9,18.6,-1.3308747,36.8567485,-1.2878149,36.8146245,263,1595,105,746
13586,6389,116,3,Personal,7,4,40962,7,4,41010,7,4,44520,7,4,46668,7,4,51616,17,27.8,-1.3433181,36.9138018,-1.2897399,36.8270975,300,4948,48,5658
13587,19965,3686,3,Business,25,1,48972,25,1,49017,25,1,49489,25,1,50631,25,1,51226,6,23.25888921888938,-1.2551895,36.7822034,-1.2729217,36.7624829,101,595,45,1614
13588,25805,1787,3,Business,8,6,33268,8,6,33373,8,6,36415,8,6,36710,8,6,38097,10,16.0,-1.2765736,36.8513646,-1.2283403,36.8822756,781,1387,105,3337
13589,16875,2330,3,Business,23,4,48350,23,4,48745,23,4,49440,23,4,50013,23,4,50514,4,24.6,-1.2680363,36.7990466,-1.2890715,36.8157588,448,501,395,1268
13590,11895,1363,3,Business,12,5,52312,12,5,52817,12,5,53777,12,5,55032,12,5,56409,8,23.25888921888938,-1.2545163,36.8243717,-1.3004062,36.829741,435,1377,505,2215
13591,3310,867,3,Business,14,5,33664,14,5,33901,14,5,34921,14,5,37126,14,5,39409,10,17.1,-1.2996533,36.8292629,-1.2991441,36.7528804,896,2283,237,3225
13592,9142,1271,3,Business,20,2,34580,20,2,35555,20,2,37904,20,2,39201,20,2,42677,32,19.7,-1.3244885,36.897792,-1.243638,36.684333,669,3476,975,3646
13593,3914,788,3,Business,28,5,52096,28,5,52137,28,5,52152,28,5,52664,28,5,53695,7,25.2,-1.2584143,36.8048002,-1.225322,36.80855,685,1031,41,527
13594,1164,3689,3,Business,2,5,51741,2,5,51817,2,5,52231,2,5,52835,2,5,53609,1,25.1,-1.2527958,36.8003131,-1.2677278,36.8001549,112,774,76,1018
13595,6302,1280,3,Business,15,2,37589,15,2,37596,15,2,38007,15,2,38144,15,2,38741,3,24.5,-1.2551895,36.7822034,-1.265338,36.8088155,322,597,7,548
13596,25947,3599,3,Business,22,3,46225,22,3,47628,22,3,48707,22,3,49256,22,3,51644,14,24.2,-1.3302996,36.8707935,-1.2886434,36.7709868,211,2388,1403,1628
13597,3878,830,3,Business,25,1,40238,25,1,40255,25,1,41093,25,1,41466,25,1,41472,8,25.3,-1.2551895,36.7822034,-1.271672,36.783604,56,6,17,1211
13598,26165,3091,3,Business,5,4,56764,5,4,57628,5,4,58701,5,4,59061,5,4,60319,10,22.0,-1.2584143,36.8048002,-1.3014461,36.7661381,379,1258,864,1433
13599,452,2212,3,Business,21,2,43417,21,2,43482,21,2,43992,21,2,44183,21,2,46493,13,22.7,-1.2571472,36.7950633,-1.302453,36.8668919,190,2310,65,701
13600,18358,59,3,Business,29,1,60889,29,1,60901,29,1,61249,29,1,61598,29,1,63245,19,23.5,-1.290894,36.822971,-1.1917753,36.9211989,865,1647,12,697
13601,9486,704,1,Business,18,3,35105,18,3,35111,18,3,35345,18,3,35970,18,3,37549,13,14.5,-1.2860183,36.8975338,-1.320157,36.830887,589,1579,6,859
13602,17956,1500,3,Business,22,5,56592,22,5,56729,22,5,56735,22,5,59201,22,5,59265,9,27.1,-1.2638185,36.7930057,-1.3004062,36.829741,472,64,137,2472
13603,8064,136,3,Business,21,4,62096,21,4,62108,21,4,62976,21,4,63920,21,4,65159,21,23.25888921888938,-1.2874648,36.8271985,-1.3254522,36.7216584,336,1239,12,1812
13604,4019,2335,3,Business,19,2,35622,19,2,35639,19,2,36282,19,2,36584,19,2,39296,22,21.2,-1.2551895,36.7822034,-1.3562374,36.9042954,177,2712,17,945
13605,18168,246,3,Business,20,5,41172,20,5,41183,20,5,41246,20,5,42135,20,5,43788,10,18.5,-1.2584143,36.8048002,-1.2413316,36.8785525,229,1653,11,952
13606,19075,1527,3,Business,8,3,34634,8,3,34845,8,3,35293,8,3,35944,8,3,36542,5,23.25888921888938,-1.3004062,36.829741,-1.3228003,36.8306435,843,598,211,1099
13607,4930,1850,3,Business,2,4,58541,2,4,58703,2,4,59397,2,4,59752,2,4,62332,8,23.25888921888938,-1.2551895,36.7822034,-1.3027475,36.8178196,815,2580,162,1049
13608,6572,1085,3,Business,21,5,62387,21,5,64879,21,5,66710,21,5,67033,21,5,68025,7,22.8,-1.2534301,36.8000983,-1.2985749,36.8088,489,992,2492,2154
13609,14415,2069,3,Business,26,2,58026,26,2,58093,26,2,58974,26,2,59625,26,2,61689,16,28.3,-1.303596,36.778378,-1.228911,36.881876,678,2064,67,1532
13610,16078,3510,1,Business,31,2,48542,31,2,48601,31,2,49185,31,2,50057,31,2,51420,9,22.1,-1.2472211,36.7826109,-1.2892898,36.7874315,273,1363,59,1456
13611,21918,2676,3,Business,25,1,36830,25,1,36894,25,1,38637,25,1,40360,25,1,40364,2,25.3,-1.304033,36.7848695,-1.2963097,36.7688221,267,4,64,3466
13612,14795,286,3,Business,22,4,58669,22,4,58803,22,4,59586,22,4,59669,22,4,60536,5,24.3,-1.2970034,36.8333214,-1.2962967,36.8020231,216,867,134,866
13613,4855,1245,3,Business,8,1,55388,8,1,55410,8,1,56567,8,1,57466,8,1,59389,17,29.7,-1.300921,36.828195,-1.3198615,36.7110323,519,1923,22,2056
13614,15708,1146,3,Business,5,2,47748,5,2,47824,5,2,47830,5,2,50430,5,2,51615,6,27.3,-1.3167113,36.8301563,-1.3083266,36.8494756,809,1185,76,2606
13615,12452,3560,3,Business,3,1,55730,3,1,59901,3,1,59966,3,1,60763,3,1,62452,11,17.5,-1.2283403,36.8822756,-1.279395,36.825364,812,1689,4171,862
13616,24940,2691,3,Business,27,2,36902,27,2,37399,27,2,38311,27,2,38801,27,2,40891,8,23.7,-1.2857671,36.7875614,-1.2571472,36.7950633,164,2090,497,1402
13617,10639,2330,3,Business,15,4,60970,15,4,61515,15,4,62744,15,4,63165,15,4,65089,15,25.5,-1.2291477,36.8440295,-1.2868601,36.7738025,237,1924,545,1650
13618,27216,549,2,Personal,22,3,45893,22,3,46383,22,3,48255,22,3,48470,22,3,51115,26,22.8,-1.1923911,36.9447333,-1.3108674,36.795817,384,2645,490,2087
13619,22275,2200,3,Business,30,5,61642,30,5,64038,30,5,64393,30,5,66675,30,5,68708,7,21.8,-1.2551895,36.7822034,-1.2412189,36.7760433,267,2033,2396,2637
13620,22580,3572,1,Personal,3,3,37199,3,3,37241,3,3,37566,3,3,38301,3,3,38702,2,23.9,-1.3129945,36.8318245,-1.3088824,36.8311983,848,401,42,1060
13621,26237,972,3,Business,15,2,41216,15,2,41795,15,2,42499,15,2,43152,15,2,43698,3,23.0,-1.2862033,36.8152966,-1.305716,36.809882,100,546,579,1357
13622,8572,1073,3,Business,25,3,47689,25,3,47700,25,3,48867,25,3,49169,25,3,50405,5,17.5,-1.2559294,36.788465,-1.2658534,36.8242971,88,1236,11,1469
13623,1797,2423,3,Business,7,1,55371,7,1,57784,7,1,59579,7,1,59679,7,1,63656,8,19.9,-1.255956,36.789867,-1.2985032,36.7841906,937,3977,2413,1895
13624,7140,1927,3,Business,27,3,54944,27,3,55910,27,3,56720,27,3,57504,27,3,60128,17,29.7,-1.3472066,36.7692638,-1.2620912,36.8013562,755,2624,966,1594
13625,9013,1482,3,Business,15,5,33628,15,5,33640,15,5,34395,15,5,34764,15,5,35724,8,20.3,-1.338579,36.8963038,-1.3324865,36.8938303,863,960,12,1124
13626,21250,868,3,Business,16,6,36857,16,6,37974,16,6,38723,16,6,40115,16,6,41391,9,25.9,-1.331619,36.847976,-1.265715,36.823815,660,1276,1117,2141
13627,1505,416,3,Business,5,5,53375,5,5,53605,5,5,56937,5,5,57340,5,5,60138,5,27.4,-1.290021,36.828206,-1.2917868,36.7872675,155,2798,230,3735
13628,25811,940,1,Personal,4,1,47064,4,1,47363,4,1,47626,4,1,47981,4,1,50154,5,21.0,-1.2861765,36.8209086,-1.2766169,36.791816,845,2173,299,618
13629,13359,2216,3,Business,25,1,46004,25,1,46069,25,1,48317,25,1,48489,25,1,50595,17,25.6,-1.2551895,36.7822034,-1.3398006,36.717935,399,2106,65,2420
13630,17171,1342,3,Business,6,2,42279,6,2,42621,6,2,42645,6,2,45239,6,2,48342,9,24.9,-1.290894,36.822971,-1.3025826,36.7670807,268,3103,342,2618
13631,15306,1075,3,Business,13,3,45997,13,3,46040,13,3,47409,13,3,47512,13,3,48233,2,23.25888921888938,-1.2679657,36.8081617,-1.2527958,36.8003131,448,721,43,1472
13632,25264,2504,3,Business,15,1,39567,15,1,39595,15,1,40324,15,1,41332,15,1,44594,8,23.25888921888938,-1.2963097,36.7688221,-1.2736169,36.8078703,148,3262,28,1737
13633,22754,1250,1,Personal,23,3,38422,23,3,38465,23,3,39525,23,3,40024,23,3,40894,11,21.9,-1.2620741,36.8158147,-1.2743743,36.7657321,633,870,43,1559
13634,25819,552,3,Business,12,2,37836,12,2,37849,12,2,40357,12,2,40597,12,2,44340,15,24.7,-1.2859912,36.8756811,-1.3632162,36.9108253,513,3743,13,2748
13635,3462,2564,3,Business,9,4,53348,9,4,53652,9,4,53994,9,4,54555,9,4,57084,9,23.25888921888938,-1.2795195,36.8234694,-1.2271998,36.8084905,416,2529,304,903
13636,5175,635,3,Business,3,4,52452,3,4,52495,3,4,53044,3,4,53400,3,4,56098,11,26.0,-1.2599563,36.7993439,-1.2610117,36.7236153,647,2698,43,905
13637,15112,1995,3,Business,20,2,57930,20,2,58225,20,2,58650,20,2,58946,20,2,59566,3,23.9,-1.2657464,36.7801144,-1.2765492,36.7669809,536,620,295,721
13638,6348,970,3,Business,14,1,56602,14,1,56610,14,1,56623,14,1,57424,14,1,57743,3,25.6,-1.255956,36.789867,-1.2629594,36.8077626,900,319,8,814
13639,24865,868,3,Business,15,6,60006,15,6,60028,15,6,60492,15,6,61351,15,6,62226,7,23.25888921888938,-1.2628473,36.781805,-1.2663631,36.8163329,484,875,22,1323
13640,11167,1329,3,Business,9,6,62513,9,6,62563,9,6,62888,9,6,63065,9,6,64403,8,23.25888921888938,-1.273056,36.811298,-1.304033,36.7848695,26,1338,50,502
13641,20988,2195,3,Business,15,1,42737,15,1,42758,15,1,43250,15,1,44770,15,1,46841,16,23.25888921888938,-1.303596,36.778378,-1.228911,36.881876,923,2071,21,2012
13642,23259,1484,3,Business,21,4,50908,21,4,50920,21,4,50933,21,4,51232,21,4,53477,13,31.0,-1.2551895,36.7822034,-1.3083777,36.8590077,931,2245,12,312
13643,16182,1271,3,Business,8,1,58124,8,1,58157,8,1,58744,8,1,59347,8,1,61039,24,29.6,-1.3244885,36.897792,-1.3107918,36.761794,418,1692,33,1190
13644,27830,640,3,Business,14,2,39439,14,2,39526,14,2,39814,14,2,40208,14,2,40934,5,21.3,-1.304033,36.7848695,-1.2884997,36.8183895,249,726,87,682
13645,27954,322,3,Business,5,1,62981,5,1,63019,5,1,63913,5,1,64123,5,1,64785,3,24.6,-1.2452664,36.8028541,-1.260624,36.807159,287,662,38,1104
13646,900,391,3,Business,12,2,57517,12,2,57720,12,2,58454,12,2,58805,12,2,59958,2,23.25888921888938,-1.2867454,36.8259017,-1.279658,36.817699,448,1153,203,1085
13647,14576,197,3,Business,7,4,52950,7,4,52960,7,4,53697,7,4,54617,7,4,56626,21,31.3,-1.206696,36.847709,-1.3282758,36.8590281,466,2009,10,1657
13648,9275,2801,3,Business,29,1,57579,29,1,57610,29,1,57744,29,1,58968,29,1,60663,15,23.25888921888938,-1.2889373,36.8604464,-1.297694,36.749788,564,1695,31,1358
13649,26081,432,3,Business,14,5,52151,14,5,52252,14,5,52324,14,5,55048,14,5,55049,9,23.1,-1.279395,36.825364,-1.3012008,36.764868,36,1,101,2796
13650,25093,1396,2,Personal,24,1,58609,24,1,58763,24,1,59457,24,1,60067,24,1,61410,8,24.6,-1.2768829,36.7965104,-1.3223922,36.837966,857,1343,154,1304
13651,9833,1146,3,Business,3,1,40892,3,1,41001,3,1,42398,3,1,44190,3,1,45102,7,21.5,-1.3167113,36.8301563,-1.3083266,36.8494756,643,912,109,3189
13652,489,2291,2,Personal,23,3,55995,23,3,56100,23,3,57009,23,3,57738,23,3,60102,8,22.1,-1.2641724,36.8014198,-1.2994194,36.7647917,366,2364,105,1638
13653,25325,3688,3,Business,23,5,44868,23,5,44921,23,5,45310,23,5,45584,23,5,46689,6,24.1,-1.2551895,36.7822034,-1.2655306,36.828148,228,1105,53,663
13654,9782,393,3,Business,25,2,42454,25,2,43187,25,2,43501,25,2,44615,25,2,46440,10,23.7,-1.3177547,36.8303703,-1.2574219,36.7927073,623,1825,733,1428
13655,18271,2497,3,Business,26,5,37793,26,5,39351,26,5,41005,26,5,41186,26,5,42512,9,23.25888921888938,-1.3235519,36.7211193,-1.2956756,36.7719383,829,1326,1558,1835
13656,4368,2454,3,Business,17,4,37605,17,4,39185,17,4,39232,17,4,41514,17,4,41951,6,22.5,-1.2865096,36.8169364,-1.299313,36.7831488,805,437,1580,2329
13657,14886,1458,1,Personal,9,4,48657,9,4,48707,9,4,48763,9,4,49180,9,4,50723,13,25.7,-1.263499,36.8014548,-1.2540878,36.7044367,379,1543,50,473
13658,1358,3698,3,Business,17,3,42707,17,3,42784,17,3,43890,17,3,45673,17,3,47937,23,23.25888921888938,-1.3244885,36.897792,-1.1933341,36.9271667,863,2264,77,2889
13659,570,391,3,Business,28,1,51550,28,1,51575,28,1,52399,28,1,53312,28,1,54219,5,26.2,-1.2784063,36.8222933,-1.300921,36.828195,336,907,25,1737
13660,3478,190,3,Business,27,1,55398,27,1,55508,27,1,55986,27,1,59102,27,1,59358,2,22.9,-1.328762,36.8534414,-1.3270347,36.8667362,402,256,110,3594
13661,5841,3689,3,Business,9,3,60057,9,3,60068,9,3,60339,9,3,60757,9,3,62102,2,24.4,-1.2527958,36.8003131,-1.2562809,36.792382,909,1345,11,689
13662,6145,1329,3,Business,9,3,48872,9,3,48927,9,3,50937,9,3,51676,9,3,52652,5,23.2,-1.273056,36.811298,-1.303664,36.818777,159,976,55,2749
13663,5469,188,1,Personal,28,5,61577,28,5,62936,28,5,64135,28,5,64937,28,5,65790,9,23.25888921888938,-1.2994194,36.7647917,-1.2910023,36.8310071,674,853,1359,2001
13664,14284,3621,3,Business,6,1,49720,6,1,49754,6,1,50102,6,1,50263,6,1,52596,14,23.25888921888938,-1.2836583,36.7886014,-1.3181159,36.7101559,161,2333,34,509
13665,25333,1029,2,Personal,9,1,55381,9,1,55397,9,1,55542,9,1,56058,9,1,56719,7,21.0,-1.2639238,36.7889646,-1.2507752,36.7556628,379,661,16,661
13666,2559,774,3,Business,14,4,55807,14,4,56253,14,4,57573,14,4,58631,14,4,59335,5,21.4,-1.298574,36.793572,-1.2753902,36.808223,474,704,446,2378
13667,2269,3521,3,Business,3,5,35751,3,5,35795,3,5,38053,3,5,39030,3,5,40421,10,23.25888921888938,-1.3234709,36.8493194,-1.2696908,36.81519,790,1391,44,3235
13668,26977,3091,3,Business,22,5,55464,22,5,56017,22,5,57466,22,5,57839,22,5,59310,9,27.3,-1.3014461,36.7661381,-1.290894,36.822971,448,1471,553,1822
13669,19452,2801,3,Business,25,1,50016,25,1,50088,25,1,51215,25,1,51427,25,1,51433,3,30.0,-1.2595422,36.7871178,-1.2566689,36.7796952,56,6,72,1339
13670,4618,970,3,Business,17,3,52863,17,3,52869,17,3,52875,17,3,53169,17,3,54415,4,23.25888921888938,-1.2551895,36.7822034,-1.2693662,36.8085295,576,1246,6,300
13671,5492,20,3,Business,28,3,32595,28,3,32636,28,3,32826,28,3,33180,28,3,34191,8,20.5,-1.2628638,36.8070399,-1.2749662,36.7658781,551,1011,41,544
13672,7018,3506,3,Personal,9,2,36672,9,2,36716,9,2,37310,9,2,37602,9,2,38584,10,17.5,-1.2563531,36.7896742,-1.2873232,36.7658572,720,982,44,886
13673,962,970,3,Business,18,4,37606,18,4,37911,18,4,38281,18,4,38532,18,4,39511,4,23.25888921888938,-1.2571472,36.7950633,-1.2850638,36.813096,709,979,305,621
13674,13704,2066,3,Business,1,3,51365,1,3,51450,1,3,52688,1,3,53063,1,3,54169,5,23.25888921888938,-1.3210189,36.8410551,-1.2983805,36.8198439,106,1106,85,1613
13675,20735,3326,3,Business,31,4,56245,31,4,56294,31,4,56602,31,4,57470,31,4,58923,9,28.7,-1.2551895,36.7822034,-1.2987732,36.7932128,225,1453,49,1176
13676,18184,3496,3,Business,19,4,46398,19,4,48659,19,4,50570,19,4,53329,19,4,54972,9,20.4,-1.2949652,36.7687874,-1.300921,36.828195,88,1643,2261,4670
13677,7349,1993,2,Personal,5,5,33703,5,5,33710,5,5,33766,5,5,34414,5,5,35318,5,17.6,-1.2900727,36.7890059,-1.2871938,36.8195031,722,904,7,704
13678,24619,3201,3,Business,20,3,34573,20,3,34607,20,3,34622,20,3,35294,20,3,35777,2,23.25888921888938,-1.2584143,36.8048002,-1.2561334,36.7990458,31,483,34,687
13679,26652,1142,1,Personal,23,3,39075,23,3,39157,23,3,40127,23,3,40885,23,3,41941,9,21.6,-1.2850417,36.8074973,-1.2463211,36.789487,499,1056,82,1728
13680,5789,1719,3,Business,11,5,48045,11,5,48055,11,5,48162,11,5,48261,11,5,49174,3,21.0,-1.2963097,36.7688221,-1.2931728,36.7888371,205,913,10,206
13681,22867,2509,3,Business,19,5,37605,19,5,37623,19,5,38036,19,5,38550,19,5,40456,20,24.8,-1.2571472,36.7950633,-1.3700383,36.9190174,383,1906,18,927
13682,8355,3291,3,Business,30,2,34695,30,2,34761,30,2,35803,30,2,38055,30,2,39047,4,23.25888921888938,-1.272828,36.816608,-1.2600926,36.8088685,106,992,66,3294
13683,14975,867,3,Business,9,5,42489,9,5,42496,9,5,42502,9,5,43065,9,5,44987,14,25.9,-1.306378,36.7519845,-1.3177547,36.8303703,97,1922,7,569
13684,10183,3647,3,Business,16,2,40703,16,2,40773,16,2,41078,16,2,41303,16,2,44520,6,23.5,-1.272639,36.794723,-1.2876643,36.8248768,208,3217,70,530
13685,21553,2457,3,Business,26,5,54139,26,5,60211,26,5,61136,26,5,61957,26,5,64747,8,23.25888921888938,-1.2551895,36.7822034,-1.3025131,36.817387,656,2790,6072,1746
13686,4918,393,3,Business,5,2,31841,5,2,31857,5,2,31896,5,2,34711,5,2,34713,14,21.2,-1.3167113,36.8301563,-1.306378,36.7519845,619,2,16,2854
13687,2986,3560,3,Business,9,3,50761,9,3,52222,9,3,53549,9,3,53790,9,3,56722,12,25.5,-1.2860183,36.8975338,-1.279395,36.825364,235,2932,1461,1568
13688,23470,517,3,Business,3,4,35344,3,4,35387,3,4,35891,3,4,36355,3,4,37352,11,20.4,-1.3167113,36.8301563,-1.2574219,36.7927073,576,997,43,968
13689,8930,1880,3,Business,12,5,55110,12,5,55282,12,5,55380,12,5,55819,12,5,57376,12,26.9,-1.2571472,36.7950633,-1.31553,36.863732,698,1557,172,537
13690,12206,1809,3,Business,25,3,50839,25,3,50848,25,3,51672,25,3,52869,25,3,53370,2,17.5,-1.2527958,36.8003131,-1.2646084,36.8028645,616,501,9,2021
13691,10083,1029,2,Personal,28,4,54420,28,4,54498,28,4,55815,28,4,55982,28,4,56914,8,23.25888921888938,-1.2507752,36.7556628,-1.2745187,36.7876436,334,932,78,1484
13692,16749,2521,3,Business,16,6,32239,16,6,32246,16,6,32250,16,6,33291,16,6,33292,6,20.0,-1.3167113,36.8301563,-1.3077869,36.8443207,62,1,7,1045
13693,28237,3635,1,Business,23,4,49074,23,4,49124,23,4,49587,23,4,49879,23,4,50261,1,20.9,-1.2551895,36.7822034,-1.2615888,36.7928732,857,382,50,755
13694,6860,3352,3,Personal,18,5,34532,18,5,34551,18,5,34780,18,5,34887,18,5,36921,20,20.3,-1.3127304,36.8189817,-1.1855066,36.8254646,551,2034,19,336
13695,26738,3246,3,Business,28,4,59305,28,4,59346,28,4,59389,28,4,60847,28,4,65364,28,23.25888921888938,-1.2156006,36.8916865,-1.3232626,36.7077125,661,4517,41,1501
13696,11641,136,3,Business,17,4,44727,17,4,44748,17,4,44882,17,4,45058,17,4,47114,10,25.2,-1.2531983,36.8069669,-1.3009676,36.7657189,205,2056,21,310
13697,189,1687,3,Business,30,2,37332,30,2,37393,30,2,37703,30,2,38001,30,2,41609,13,22.1,-1.2649605,36.7981777,-1.3147071,36.8644977,676,3608,61,608
13698,13827,705,3,Personal,4,1,31895,4,1,31919,4,1,33957,4,1,34267,4,1,35982,9,22.2,-1.3175119,36.8058513,-1.2706815,36.7646286,548,1715,24,2348
13699,24690,1340,3,Business,5,4,53902,5,4,53915,5,4,54542,5,4,54896,5,4,55990,9,22.1,-1.2707179,36.7979713,-1.2602386,36.7503491,951,1094,13,981
13700,17218,3032,3,Business,12,5,59930,12,5,60100,12,5,60556,12,5,61910,12,5,63423,2,26.7,-1.2571472,36.7950633,-1.2728058,36.8049903,523,1513,170,1810
13701,8416,3647,3,Business,7,5,51153,7,5,51218,7,5,51317,7,5,51591,7,5,51641,3,26.8,-1.272639,36.794723,-1.2729843,36.8105717,544,50,65,373
13702,10699,816,3,Business,25,3,35420,25,3,35475,25,3,36258,25,3,36560,25,3,39162,7,13.7,-1.290894,36.822971,-1.2551895,36.7822034,338,2602,55,1085
13703,22304,1923,2,Personal,14,7,53817,14,7,53835,14,7,54089,14,7,54744,14,7,55751,4,28.5,-1.2919665,36.7961087,-1.3086197,36.8167787,858,1007,18,909
13704,26490,2701,3,Business,9,5,43920,9,5,44184,9,5,44498,9,5,44691,9,5,46182,8,25.5,-1.2527958,36.8003131,-1.2765736,36.8513646,660,1491,264,507
13705,26623,3689,3,Business,31,4,43806,31,4,43820,31,4,44336,31,4,44470,31,4,46247,9,26.5,-1.225322,36.80855,-1.2551895,36.7822034,857,1777,14,650
13706,25849,1271,3,Business,6,3,43658,6,3,43675,6,3,44419,6,3,45172,6,3,48097,22,23.25888921888938,-1.3108386,36.7555239,-1.2227615,36.8989174,327,2925,17,1497
13707,10175,84,3,Business,10,5,50135,10,5,50152,10,5,50180,10,5,52310,10,5,54749,22,21.9,-1.2551895,36.7822034,-1.3562374,36.9042954,116,2439,17,2158
13708,19323,847,3,Business,3,5,26814,3,5,26827,3,5,28476,3,5,28588,3,5,31222,13,23.25888921888938,-1.3290949,36.8767589,-1.287353,36.826992,956,2634,13,1761
13709,27015,2271,3,Business,24,3,47423,24,3,48240,24,3,49817,24,3,51170,24,3,52573,10,23.25888921888938,-1.3346773,36.8842734,-1.293515,36.897607,855,1403,817,2930
13710,27220,1384,3,Business,26,5,31968,26,5,31978,26,5,32649,26,5,32999,26,5,34731,18,23.25888921888938,-1.2517448,36.7924971,-1.3296677,36.8845876,96,1732,10,1021
13711,13042,1456,3,Business,24,5,56566,24,5,56897,24,5,57427,24,5,58746,24,5,59658,6,23.0,-1.2859912,36.8756811,-1.2860183,36.8975338,126,912,331,1849
13712,24957,3283,3,Business,20,4,36486,20,4,37222,20,4,38106,20,4,39198,20,4,42893,19,22.1,-1.293515,36.897607,-1.2628473,36.781805,496,3695,736,1976
13713,14971,1363,3,Business,24,4,53930,24,4,54005,24,4,54369,24,4,54514,24,4,56088,10,28.3,-1.3004062,36.829741,-1.2991441,36.7528804,576,1574,75,509
13714,22703,865,3,Business,19,2,55972,19,2,57673,19,2,58336,19,2,59856,19,2,61405,7,28.1,-1.2452664,36.8028541,-1.2855654,36.8244835,336,1549,1701,2183
13715,8751,1953,3,Personal,5,6,51564,5,6,51669,5,6,52522,5,6,53117,5,6,55732,8,23.8,-1.287494,36.819503,-1.2982423,36.8719867,742,2615,105,1448
13716,12951,633,3,Business,14,3,30247,14,3,30278,14,3,30932,14,3,31253,14,3,32021,4,18.4,-1.3077869,36.8443207,-1.3004062,36.829741,620,768,31,975
13717,1222,1996,3,Business,21,4,36158,21,4,36214,21,4,37375,21,4,38320,21,4,39312,6,28.0,-1.2946359,36.8352718,-1.3272104,36.8528418,206,992,56,2106
13718,25471,1073,3,Business,19,2,41308,19,2,41386,19,2,42549,19,2,42778,19,2,45226,8,27.5,-1.2561964,36.7885001,-1.2860152,36.826003,831,2448,78,1392
13719,792,1271,3,Business,28,3,50952,28,3,51256,28,3,52121,28,3,54826,28,3,55537,8,23.25888921888938,-1.303924,36.8758792,-1.3244885,36.897792,675,711,304,3570
13720,18877,2956,3,Business,20,3,39693,20,3,39729,20,3,42275,20,3,43218,20,3,48476,13,26.3,-1.207546,36.7913976,-1.2527958,36.8003131,391,5258,36,3489
13721,8926,1075,3,Business,11,6,43361,11,6,43670,11,6,44423,11,6,45021,11,6,47283,5,23.25888921888938,-1.2527958,36.8003131,-1.279395,36.825364,422,2262,309,1351
13722,1321,733,3,Business,5,5,45089,5,5,45099,5,5,45179,5,5,45350,5,5,47372,15,24.5,-1.2551895,36.7822034,-1.2224188,36.8868824,709,2022,10,251
13723,10574,1809,3,Business,19,2,34033,19,2,34042,19,2,34486,19,2,36344,19,2,36706,1,15.6,-1.2646084,36.8028645,-1.2620912,36.8013562,290,362,9,2302
13724,18360,2671,1,Personal,20,6,35314,20,6,35323,20,6,35874,20,6,38993,20,6,41222,18,25.7,-1.2975439,36.756396,-1.2070474,36.7854119,299,2229,9,3670
13725,20869,192,1,Personal,21,1,40777,21,1,41412,21,1,42757,21,1,43087,21,1,43654,5,20.0,-1.28469,36.8317048,-1.312406,36.827447,888,567,635,1675
13726,20443,990,1,Business,6,5,39067,6,5,39092,6,5,39462,6,5,43366,6,5,45985,19,20.2,-1.272675,36.8129051,-1.3628038,36.714921,379,2619,25,4274
13727,19874,2987,3,Business,7,3,39848,7,3,39884,7,3,40060,7,3,40183,7,3,40186,3,25.2,-1.270212,36.8210877,-1.263987,36.798891,390,3,36,299
13728,19995,90,1,Personal,18,3,49990,18,3,50055,18,3,50318,18,3,50679,18,3,52408,7,20.5,-1.256958,36.8144929,-1.294624,36.814874,415,1729,65,624
13729,8359,1073,3,Business,7,3,34328,7,3,34417,7,3,35267,7,3,35775,7,3,37147,9,23.25888921888938,-1.2559185,36.79171804,-1.2698168,36.7421898,770,1372,89,1358
13730,15839,246,3,Business,18,2,64678,18,2,64736,18,2,65399,18,2,66405,18,2,67775,8,23.25888921888938,-1.290894,36.822971,-1.2584143,36.8048002,736,1370,58,1669
13731,3049,111,3,Business,20,1,52603,20,1,52620,20,1,53643,20,1,53969,20,1,54598,8,23.25888921888938,-1.2551895,36.7822034,-1.2856664,36.7559838,448,629,17,1349
13732,6807,383,3,Business,21,5,47784,21,5,48203,21,5,48581,21,5,49022,21,5,53115,17,24.4,-1.374163,36.913444,-1.2882411,36.8274955,685,4093,419,819
13733,7082,343,3,Personal,25,5,56785,25,5,56961,25,5,57957,25,5,58598,25,5,60029,5,23.3,-1.2858511,36.7946184,-1.2663778,36.8076024,474,1431,176,1637
13734,16697,2828,3,Business,1,5,33667,1,5,37041,1,5,38143,1,5,39858,1,5,43253,14,28.8,-1.2710687,36.8142839,-1.2137605,36.8788137,716,3395,3374,2817
13735,21198,20,3,Business,10,1,35563,10,1,35592,10,1,35802,10,1,36499,10,1,36872,2,16.6,-1.265338,36.8088155,-1.2603403,36.7998848,96,373,29,907
13736,11405,1370,3,Personal,18,5,56704,18,5,57609,18,5,59027,18,5,59359,18,5,61808,8,24.6,-1.261692,36.80161,-1.3108674,36.795817,749,2449,905,1750
13737,9904,598,2,Business,5,5,53589,5,5,53698,5,5,54271,5,5,54369,5,5,55867,8,26.8,-1.2311903,36.8102105,-1.257309,36.8060084,754,1498,109,671
13738,17905,1927,3,Business,3,1,41120,3,1,41197,3,1,41867,3,1,44107,3,1,44311,12,21.3,-1.279395,36.825364,-1.3472066,36.7692638,778,204,77,2910
13739,21443,2000,3,Business,11,5,31826,11,5,31955,11,5,33455,11,5,33651,11,5,35101,7,18.0,-1.255956,36.789867,-1.292044,36.821938,159,1450,129,1696
13740,16545,1471,3,Business,21,3,46157,21,3,46187,21,3,46502,21,3,48807,21,3,50940,14,23.1,-1.2551895,36.7822034,-1.329568,36.8520825,520,2133,30,2620
13741,7817,1341,3,Business,6,4,46678,6,4,47381,6,4,48452,6,4,51878,6,4,52802,20,21.2,-1.3188359,36.7038526,-1.3306113,36.8480521,364,924,703,4497
13742,23507,2360,3,Business,26,2,39165,26,2,39190,26,2,39794,26,2,40065,26,2,40970,8,27.5,-1.2551895,36.7822034,-1.2897215,36.7945959,576,905,25,875
13743,24958,1765,1,Personal,20,1,58890,20,1,58998,20,1,59087,20,1,60508,20,1,61412,4,20.3,-1.2802618,36.8191684,-1.302922,36.816383,698,904,108,1510
13744,12553,1075,3,Business,1,5,33265,1,5,33301,1,5,33959,1,5,34969,1,5,37859,17,23.25888921888938,-1.2852569,36.8976121,-1.2527958,36.8003131,772,2890,36,1668
13745,5754,1809,3,Business,6,3,48125,6,3,48187,6,3,48968,6,3,49043,6,3,50317,9,23.25888921888938,-1.2964063,36.8281083,-1.2571472,36.7950633,99,1274,62,856
13746,13938,2523,3,Business,19,3,35529,19,3,35631,19,3,36217,19,3,36435,19,3,37806,12,19.7,-1.2551895,36.7822034,-1.320157,36.830887,205,1371,102,804
13747,18560,3404,3,Business,25,5,46446,25,5,46549,25,5,47925,25,5,48287,25,5,49430,7,26.4,-1.279395,36.825364,-1.2551895,36.7822034,88,1143,103,1738
13748,587,1637,3,Business,23,5,47169,23,5,53090,23,5,54500,23,5,54816,23,5,55421,2,26.2,-1.2615888,36.7928732,-1.2527958,36.8003131,434,605,5921,1726
13749,10275,393,3,Business,26,2,49660,26,2,49671,26,2,49775,26,2,50318,26,2,51430,11,29.9,-1.3167113,36.8301563,-1.2638185,36.7930057,26,1112,11,647
13750,18423,2263,1,Personal,18,2,39137,18,2,39167,18,2,40283,18,2,40492,18,2,42425,16,22.5,-1.2134646,36.8755266,-1.308126,36.8532641,74,1933,30,1325
13751,17636,3247,3,Business,27,2,42786,27,2,44096,27,2,45422,27,2,45802,27,2,49882,9,23.9,-1.2571472,36.7950633,-1.2343087,36.84749,928,4080,1310,1706
13752,5203,635,3,Business,28,4,33971,28,4,34004,28,4,34498,28,4,37430,28,4,42090,20,19.4,-1.3081376,36.8329772,-1.2339926,36.7176351,448,4660,33,3426
13753,24551,393,3,Business,12,2,41640,12,2,41665,12,2,42123,12,2,42318,12,2,45697,14,28.3,-1.3167113,36.8301563,-1.2991441,36.7528804,349,3379,25,653
13754,24271,635,3,Business,19,6,36886,19,6,36920,19,6,37658,19,6,38019,19,6,39961,8,25.4,-1.3081376,36.8329772,-1.2602337,36.7990548,899,1942,34,1099
13755,17390,2059,1,Personal,11,4,41015,11,4,41099,11,4,41149,11,4,42472,11,4,43209,9,23.8,-1.2741728,36.7969108,-1.2217641,36.788444,179,737,84,1373
13756,5534,1450,3,Personal,18,4,47765,18,4,47793,18,4,48188,18,4,48472,18,4,49800,11,25.4,-1.2583017,36.8023526,-1.3108386,36.7555239,648,1328,28,679
13757,3848,393,3,Business,31,3,29701,31,3,29748,31,3,29755,31,3,32233,31,3,33761,10,19.2,-1.3177547,36.8303703,-1.2574219,36.7927073,239,1528,47,2485
13758,24808,2102,3,Business,28,1,38544,28,1,38554,28,1,38636,28,1,39716,28,1,41595,15,22.9,-1.3323107,36.8692616,-1.2613768,36.8019418,543,1879,10,1162
13759,431,3517,3,Business,14,4,47501,14,4,47781,14,4,49196,14,4,51901,14,4,53317,16,27.8,-1.300921,36.828195,-1.3882008,36.7699445,164,1416,280,4120
13760,17081,1724,3,Business,8,4,35047,8,4,35112,8,4,35890,8,4,36270,8,4,37941,9,20.4,-1.2551895,36.7822034,-1.2980272,36.7838837,279,1671,65,1158
13761,19039,393,3,Business,2,4,40023,2,4,40068,2,4,41363,2,4,41833,2,4,43803,11,23.25888921888938,-1.3167113,36.8301563,-1.2638185,36.7930057,815,1970,45,1765
13762,9231,2696,3,Personal,30,4,31188,30,4,31204,30,4,31340,30,4,32066,30,4,34924,19,16.4,-1.2778523,36.9094543,-1.296797,36.7764525,848,2858,16,862
13763,20279,478,3,Business,6,3,38284,6,3,38340,6,3,38787,6,3,39665,6,3,40432,3,23.25888921888938,-1.2551895,36.7822034,-1.2665558,36.8056479,245,767,56,1325
13764,16047,3051,3,Personal,27,5,34804,27,5,34930,27,5,35392,27,5,35688,27,5,36571,7,16.0,-1.2702333,36.80065,-1.2965824,36.8153022,726,883,126,758
13765,2414,2289,3,Business,11,5,61866,11,5,61949,11,5,62058,11,5,62639,11,5,63657,7,24.5,-1.2551895,36.7822034,-1.2961143,36.815843,510,1018,83,690
13766,17116,1127,1,Personal,12,5,38244,12,5,38284,12,5,38917,12,5,39028,12,5,40660,14,24.3,-1.2917868,36.7872675,-1.2874367,36.8804447,328,1632,40,744
13767,3459,2277,3,Business,27,5,40713,27,5,40885,27,5,40905,27,5,42638,27,5,45900,4,22.2,-1.2894521,36.8263668,-1.3030546,36.8101808,698,3262,172,1753
13768,27866,633,3,Business,14,3,53361,14,3,54006,14,3,54160,14,3,56604,14,3,56607,4,25.7,-1.3177547,36.8303703,-1.3004062,36.829741,239,3,645,2598
13769,9226,1502,3,Business,6,1,35892,6,1,35920,6,1,36759,6,1,37382,6,1,39161,12,23.25888921888938,-1.2765736,36.8513646,-1.2232123,36.8932547,206,1779,28,1462
13770,14523,3689,3,Business,17,5,64963,17,5,65605,17,5,65696,17,5,67743,17,5,69672,12,18.9,-1.2297202,36.8819507,-1.2527958,36.8003131,272,1929,642,2138
13771,13023,1205,3,Business,12,3,59715,12,3,59731,12,3,59887,12,3,60151,12,3,62677,17,24.0,-1.2810807,36.8144229,-1.3085443,36.6884314,266,2526,16,420
13772,8963,1146,3,Business,13,4,45741,13,4,47305,13,4,47591,13,4,48340,13,4,49157,7,22.1,-1.3167113,36.8301563,-1.3083266,36.8494756,2,817,1564,1035
13773,23167,3606,3,Business,5,2,56884,5,2,56929,5,2,57469,5,2,57740,5,2,58940,2,23.25888921888938,-1.2628638,36.8070399,-1.2733047,36.8109744,318,1200,45,811
13774,17999,517,3,Business,29,2,32421,29,2,32455,29,2,32461,29,2,35209,29,2,35212,4,18.1,-1.3167113,36.8301563,-1.3004062,36.829741,239,3,34,2754
13775,14178,2521,3,Business,26,6,32632,26,6,32646,26,6,32758,26,6,33867,26,6,34481,4,20.3,-1.3167113,36.8301563,-1.3004062,36.829741,523,614,14,1221
13776,15272,3659,1,Personal,8,1,38396,8,1,38506,8,1,38742,8,1,38964,8,1,41091,5,24.3,-1.2582368,36.7986818,-1.2790289,36.8039715,881,2127,110,458
13777,18440,1244,3,Business,19,3,41123,19,3,41150,19,3,41790,19,3,42453,19,3,43412,6,23.25888921888938,-1.2628473,36.781805,-1.303596,36.778378,116,959,27,1303
13778,10702,1046,1,Personal,11,4,45194,11,4,45569,11,4,45919,11,4,46063,11,4,47407,6,24.0,-1.2858016,36.8226814,-1.2571651,36.8032207,208,1344,375,494
13779,23747,3407,3,Business,16,6,40482,16,6,40533,16,6,40763,16,6,41117,16,6,42676,5,25.6,-1.2810889,36.8247135,-1.3077517,36.8385817,89,1559,51,584
13780,18943,3222,3,Business,3,1,56124,3,1,56332,3,1,57328,3,1,57703,3,1,59585,10,23.0,-1.2551895,36.7822034,-1.2973682,36.7859878,161,1882,208,1371
13781,19385,1271,3,Business,17,1,62663,17,1,62819,17,1,63036,17,1,63853,17,1,65696,20,22.8,-1.3244885,36.897792,-1.2637057,36.80517,871,1843,156,1034
13782,27849,238,3,Business,30,6,42581,30,6,42590,30,6,42594,30,6,44207,30,6,44734,5,26.4,-1.3167113,36.8301563,-1.3077869,36.8443207,842,527,9,1617
13783,22862,1473,3,Business,27,3,58841,27,3,58895,27,3,60782,27,3,62909,27,3,66521,15,23.25888921888938,-1.2156006,36.8916865,-1.3153122,36.8965598,208,3612,54,4014
13784,10856,928,3,Business,1,1,46051,1,1,46082,1,1,46516,1,1,47431,1,1,49039,8,24.2,-1.2945041,36.8151527,-1.2551895,36.7822034,847,1608,31,1349
13785,4413,510,3,Business,20,2,35612,20,2,35654,20,2,35883,20,2,36298,20,2,37838,12,19.2,-1.279395,36.825364,-1.2860183,36.8975338,878,1540,42,644
13786,1454,868,3,Business,23,5,49526,23,5,51602,23,5,52767,23,5,54277,23,5,54284,10,26.2,-1.228911,36.881876,-1.265715,36.823815,708,7,2076,2675
13787,21561,393,3,Business,29,1,30582,29,1,30720,29,1,31968,29,1,32393,29,1,34459,8,23.25888921888938,-1.3167113,36.8301563,-1.2770708,36.8231093,155,2066,138,1673
13788,5485,393,3,Business,20,4,50748,20,4,50771,20,4,50776,20,4,54492,20,4,54497,4,25.0,-1.3167113,36.8301563,-1.3004062,36.829741,515,5,23,3721
13789,4634,1402,3,Business,27,1,41256,27,1,41568,27,1,43520,27,1,43635,27,1,43637,2,21.0,-1.2813012,36.8323962,-1.286895,36.8150045,27,2,312,2067
13790,10421,1469,3,Business,26,2,42412,26,2,42463,26,2,42645,26,2,42827,26,2,43336,3,27.5,-1.2551895,36.7822034,-1.273488,36.804158,576,509,51,364
13791,18888,635,3,Business,5,6,43488,5,6,43577,5,6,44179,5,6,46166,5,6,46798,7,22.6,-1.3007481,36.8341778,-1.2599563,36.7993439,406,632,89,2589
13792,11211,3621,3,Business,6,1,46722,6,1,46747,6,1,47180,6,1,47273,6,1,48827,11,23.25888921888938,-1.2836583,36.7886014,-1.2647206,36.7259313,858,1554,25,526
13793,17900,388,1,Personal,29,5,60463,29,5,63502,29,5,64195,29,5,65140,29,5,66959,16,20.5,-1.2115009,36.8417431,-1.285996,36.797048,101,1819,3039,1638
13794,2664,635,3,Business,26,6,43620,26,6,43749,26,6,44746,26,6,44885,26,6,45713,5,22.4,-1.2857764,36.8236622,-1.2599563,36.7993439,88,828,129,1136
13795,16152,393,3,Business,20,1,54559,20,1,54574,20,1,54613,20,1,55638,20,1,56599,4,23.25888921888938,-1.3167113,36.8301563,-1.3004062,36.829741,206,961,15,1064
13796,17734,868,3,Business,28,2,31970,28,2,34911,28,2,36839,28,2,37775,28,2,39227,10,18.5,-1.228911,36.881876,-1.265715,36.823815,864,1452,2941,2864
13797,9623,1724,3,Business,14,4,42071,14,4,42120,14,4,42192,14,4,44026,14,4,44572,8,24.8,-1.2907854,36.7774108,-1.2551895,36.7822034,708,546,49,1906
13798,5461,640,3,Business,26,5,56854,26,5,56864,26,5,57069,26,5,57392,26,5,59968,17,23.25888921888938,-1.2969741,36.7856612,-1.216212,36.841799,96,2576,10,528
13799,4074,265,3,Business,23,4,34993,23,4,35009,23,4,35066,23,4,40474,23,4,40656,16,18.6,-1.300921,36.828195,-1.3711733,36.7319722,589,182,16,5465
13800,17383,2587,3,Business,18,4,49744,18,4,49989,18,4,50561,18,4,51111,18,4,55061,18,23.25888921888938,-1.28878,36.8168312,-1.3562374,36.9042954,299,3950,245,1122
13801,15564,1482,3,Business,17,1,39261,17,1,39266,17,1,39274,17,1,39550,17,1,41130,18,23.7,-1.338579,36.8963038,-1.2637057,36.80517,345,1580,5,284
13802,3805,1153,2,Personal,27,1,36377,27,1,36394,27,1,37254,27,1,37382,27,1,39181,15,16.5,-1.3178263,36.7141818,-1.2620159,36.7956487,412,1799,17,988
13803,6687,435,3,Business,11,2,44319,11,2,44336,11,2,44807,11,2,47030,11,2,48439,10,19.4,-1.300921,36.828195,-1.2539849,36.8247209,158,1409,17,2694
13804,28181,517,3,Business,3,1,32698,3,1,32737,3,1,34498,3,1,35288,3,1,37200,14,18.1,-1.3228003,36.8306435,-1.2991441,36.7528804,448,1912,39,2551
13805,12100,1589,3,Business,9,7,44939,9,7,44957,9,7,45475,9,7,45848,9,7,49110,14,18.7,-1.3014461,36.7661381,-1.225322,36.80855,371,3262,18,891
13806,22472,2956,3,Business,21,2,64070,21,2,64092,21,2,64141,21,2,64571,21,2,64950,2,23.8,-1.2527958,36.8003131,-1.2584143,36.8048002,205,379,22,479
13807,4952,1471,3,Business,30,2,40703,30,2,40750,30,2,41174,30,2,41748,30,2,43604,21,23.25888921888938,-1.2551895,36.7822034,-1.3688433,36.7402114,125,1856,47,998
13808,4748,391,3,Business,10,5,32434,10,5,32468,10,5,33382,10,5,36139,10,5,36679,21,23.25888921888938,-1.2847613,36.967084,-1.2867454,36.8259017,819,540,34,3671
13809,19033,868,3,Business,23,4,52916,23,4,52931,23,4,52949,23,4,53829,23,4,54610,5,24.6,-1.259478,36.8017813,-1.265715,36.823815,178,781,15,898
13810,857,393,3,Business,18,5,37152,18,5,37538,18,5,39026,18,5,39781,18,5,41117,8,20.3,-1.3167113,36.8301563,-1.2770708,36.8231093,725,1336,386,2243
13811,15098,3291,3,Business,4,2,43095,4,2,45691,4,2,46297,4,2,46522,4,2,50332,12,20.7,-1.228911,36.881876,-1.2600926,36.8088685,362,3810,2596,831
13812,22761,3727,3,Business,16,2,54273,16,2,54546,16,2,54779,16,2,55145,16,2,59563,6,23.25888921888938,-1.2963097,36.7688221,-1.2825816,36.8092346,678,4418,273,599
13813,10384,3517,3,Business,8,3,38592,8,3,38663,8,3,39012,8,3,41222,8,3,42798,16,23.25888921888938,-1.300921,36.828195,-1.3882008,36.7699445,583,1576,71,2559
13814,3311,478,3,Business,8,5,47235,8,5,47253,8,5,47498,8,5,48197,8,5,52289,8,24.0,-1.2551895,36.7822034,-1.2985749,36.8088,26,4092,18,944
13815,20422,1847,1,Personal,26,3,46674,26,3,47243,26,3,48656,26,3,49859,26,3,51146,7,27.2,-1.3109313,36.8544181,-1.3214562,36.8100828,532,1287,569,2616
13816,13304,439,3,Business,14,5,34529,14,5,37924,14,5,38720,14,5,39458,14,5,42671,15,21.7,-1.251511,36.8148595,-1.3323107,36.8692616,93,3213,3395,1534
13817,28079,733,3,Business,6,3,44858,6,3,44880,6,3,45362,6,3,45558,6,3,48562,20,22.5,-1.2551895,36.7822034,-1.3251247,36.8995926,279,3004,22,678
13818,16171,246,3,Business,29,4,55220,29,4,57459,29,4,57956,29,4,58200,29,4,59533,4,24.6,-1.2584143,36.8048002,-1.2848174,36.826163,436,1333,2239,741
13819,3686,2143,3,Business,18,4,36771,18,4,36804,18,4,37285,18,4,37666,18,4,40537,9,20.4,-1.296797,36.7764525,-1.2575407,36.7868197,854,2871,33,862
13820,11354,1357,1,Personal,18,1,36502,18,1,36629,18,1,38230,18,1,38368,18,1,40186,30,23.25888921888938,-1.2776622,36.8202213,-1.1552028,36.9605628,88,1818,127,1739
13821,12417,2956,3,Business,29,3,61756,29,3,61827,29,3,61969,29,3,62163,29,3,63048,3,21.1,-1.2584143,36.8048002,-1.2551895,36.7822034,849,885,71,336
13822,15473,867,3,Business,21,4,52789,21,4,52801,21,4,52849,21,4,53351,21,4,54363,9,26.5,-1.2638185,36.7930057,-1.2991441,36.7528804,545,1012,12,550
13823,8957,639,3,Business,30,5,61481,30,5,63041,30,5,63751,30,5,64059,30,5,67463,17,22.2,-1.3169591,36.7000029,-1.2551895,36.7822034,205,3404,1560,1018
13824,18721,1352,3,Personal,5,2,34639,5,2,34661,5,2,35178,5,2,35751,5,2,37983,19,17.9,-1.2655306,36.828148,-1.3459625,36.9073925,813,2232,22,1090
13825,24384,1880,3,Business,30,4,53385,30,4,53439,30,4,54059,30,4,54487,30,4,56261,10,23.25888921888938,-1.2571472,36.7950633,-1.2919683,36.8500706,221,1774,54,1048
13826,19918,323,3,Business,21,4,45880,21,4,46115,21,4,46774,21,4,47607,21,4,48928,7,25.1,-1.2813973,36.8289204,-1.2551895,36.7822034,452,1321,235,1492
13827,23641,2425,1,Personal,21,5,46868,21,5,46887,21,5,47316,21,5,47493,21,5,51085,15,19.8,-1.3195185,36.8180902,-1.2475028,36.8774697,612,3592,19,606
13828,12675,2849,1,Personal,19,6,28043,19,6,29030,19,6,30732,19,6,30918,19,6,33274,20,16.5,-1.1972198,36.8142205,-1.2836933,36.7606941,4,2356,987,1888
13829,9891,265,3,Business,17,1,52807,17,1,53905,17,1,56018,17,1,57359,17,1,58397,5,24.5,-1.3042113,36.8683022,-1.300921,36.828195,47,1038,1098,3454
13830,6896,627,3,Business,1,5,51948,1,5,52010,1,5,52264,1,5,52689,1,5,53747,7,28.5,-1.2571472,36.7950633,-1.2924639,36.7795798,903,1058,62,679
13831,17540,3434,3,Business,25,5,50453,25,5,50481,25,5,51080,25,5,51481,25,5,53321,20,29.1,-1.2963097,36.7688221,-1.3189344,36.9087593,674,1840,28,1000
13832,2616,3283,3,Business,14,4,35352,14,4,35364,14,4,35667,14,4,37848,14,4,38629,5,18.9,-1.2600926,36.8088685,-1.2628473,36.781805,107,781,12,2484
13833,7945,788,3,Business,9,5,51874,9,5,52789,9,5,53214,9,5,53429,9,5,54378,9,26.1,-1.2653185,36.8358841,-1.225322,36.80855,949,949,915,640
13834,15467,1271,3,Business,12,2,62177,12,2,62252,12,2,62733,12,2,63042,12,2,65953,23,28.4,-1.3107918,36.761794,-1.2927792,36.9053492,343,2911,75,790
13835,23658,2588,3,Personal,2,1,33368,2,1,33403,2,1,33920,2,1,34574,2,1,35376,7,16.7,-1.2607156,36.8145367,-1.2983124,36.8104456,103,802,35,1171
13836,1982,1687,3,Business,25,5,56347,25,5,57143,25,5,59618,25,5,60328,25,5,62050,4,26.4,-1.28164,36.816867,-1.2676176,36.7956644,277,1722,796,3185
13837,4205,552,3,Business,25,3,44012,25,3,44022,25,3,44027,25,3,45396,25,3,46662,13,23.25888921888938,-1.2860183,36.8975338,-1.3632162,36.9108253,589,1266,10,1374
13838,19668,1205,3,Business,21,5,48914,21,5,49151,21,5,50389,21,5,51055,21,5,52823,14,24.7,-1.2645258,36.7683387,-1.2230806,36.8148937,655,1768,237,1904
13839,1999,3429,2,Personal,10,4,33783,10,4,34599,10,4,34804,10,4,34897,10,4,36695,5,18.4,-1.3043728,36.8044157,-1.2911753,36.7753923,105,1798,816,298
13840,10416,393,3,Business,24,5,37371,24,5,37385,24,5,37390,24,5,40262,24,5,40267,11,21.2,-1.3228003,36.8306435,-1.2638185,36.7930057,619,5,14,2877
13841,19736,2008,3,Business,5,5,60013,5,5,60146,5,5,61755,5,5,61851,5,5,63572,7,26.3,-1.2508229,36.7895263,-1.285244,36.832159,507,1721,133,1705
13842,17992,3426,3,Business,31,1,50905,31,1,50923,31,1,51536,31,1,51869,31,1,52977,9,24.1,-1.3014461,36.7661381,-1.2551895,36.7822034,854,1108,18,946
13843,22197,304,1,Personal,16,2,30058,16,2,30075,16,2,30582,16,2,31244,16,2,32133,7,23.25888921888938,-1.2854174,36.7951152,-1.2580991,36.7941519,875,889,17,1169
13844,22963,835,3,Business,19,1,56350,19,1,56600,19,1,57993,19,1,58415,19,1,58968,1,25.3,-1.284982,36.7863938,-1.2917868,36.7872675,322,553,250,1815
13845,17321,2789,3,Business,7,4,63096,7,4,63120,7,4,63297,7,4,63600,7,4,65353,6,29.4,-1.304735,36.7846054,-1.2787767,36.8171894,411,1753,24,480
13846,10673,3120,1,Personal,11,1,48882,11,1,49074,11,1,51423,11,1,51950,11,1,53725,7,23.4,-1.3255193,36.8258719,-1.2885417,36.8100523,46,1775,192,2876
13847,2001,3348,3,Business,5,1,49031,5,1,49137,5,1,49779,5,1,50036,5,1,53978,12,25.9,-1.2196878,36.851447,-1.2695287,36.7981777,268,3942,106,899
13848,1246,970,3,Business,18,2,42802,18,2,42831,18,2,42935,18,2,44201,18,2,45837,5,23.25888921888938,-1.2551895,36.7822034,-1.2715611,36.7953541,651,1636,29,1370
13849,8693,1502,3,Business,16,3,64649,16,3,65101,16,3,65830,16,3,66400,16,3,68221,6,23.2,-1.2232123,36.8932547,-1.1898857,36.9103054,75,1821,452,1299
13850,2158,2021,3,Business,3,4,42286,3,4,49482,3,4,50390,3,4,51168,3,4,51862,5,25.9,-1.2951297,36.8335521,-1.2836832,36.8306719,14,694,7196,1686
13851,6033,1724,3,Business,24,5,38055,24,5,38112,24,5,38755,24,5,38960,24,5,39710,6,21.2,-1.2551895,36.7822034,-1.2805309,36.7944074,205,750,57,848
13852,11208,2066,3,Business,9,4,35597,9,4,35605,9,4,35882,9,4,35948,9,4,37117,10,17.0,-1.316961,36.820337,-1.3239725,36.8827383,754,1169,8,343
13853,2542,1329,3,Business,28,5,35536,28,5,35615,28,5,36144,28,5,36233,28,5,38022,17,19.2,-1.273056,36.811298,-1.3103985,36.9114173,648,1789,79,618
13854,8656,302,3,Business,27,7,47962,27,7,47981,27,7,48118,27,7,48603,27,7,50289,3,23.25888921888938,-1.2649605,36.7981777,-1.2653906,36.8134406,611,1686,19,622
13855,4135,393,3,Business,8,1,45679,8,1,45726,8,1,46156,8,1,47080,8,1,47748,4,27.8,-1.3167113,36.8301563,-1.3004062,36.829741,687,668,47,1354
13856,16756,3669,3,Business,7,2,51351,7,2,51381,7,2,52620,7,2,53289,7,2,56677,24,23.25888921888938,-1.2615888,36.7928732,-1.34364,36.8925345,427,3388,30,1908
13857,13227,3291,3,Business,4,4,34930,4,4,35657,4,4,36525,4,4,37222,4,4,38681,12,18.6,-1.228911,36.881876,-1.2600926,36.8088685,847,1459,727,1565
13858,24707,3017,1,Business,8,3,56772,8,3,56852,8,3,57450,8,3,57670,8,3,58809,8,25.8,-1.3123782,36.8181528,-1.299313,36.7831488,726,1139,80,818
13859,27582,3689,3,Business,12,2,46455,12,2,46469,12,2,46817,12,2,47292,12,2,50596,3,21.0,-1.2601709,36.8002238,-1.2697141,36.7981777,334,3304,14,823
13860,2312,1209,3,Business,9,3,34900,9,3,35199,9,3,35704,9,3,35941,9,3,36311,4,20.0,-1.3077869,36.8443207,-1.3004062,36.829741,358,370,299,742
13861,10755,1827,3,Business,29,2,38421,29,2,38475,29,2,38784,29,2,39990,29,2,41984,17,21.2,-1.2600926,36.8088685,-1.293515,36.897607,888,1994,54,1515
13862,17970,2207,3,Business,29,4,54714,29,4,55009,29,4,55419,29,4,55843,29,4,56852,3,24.7,-1.265981,36.7936121,-1.2768326,36.8073804,829,1009,295,834
13863,14642,3695,1,Personal,25,2,40461,25,2,40496,25,2,41054,25,2,42100,25,2,42615,3,23.6,-1.2923919,36.7951531,-1.2894917,36.8056192,754,515,35,1604
13864,24164,3525,3,Business,27,2,36352,27,2,43060,27,2,43063,27,2,44066,27,2,44761,12,24.0,-1.3700383,36.9190174,-1.3194518,36.869396,345,695,6708,1006
13865,1196,432,3,Business,28,2,30293,28,2,30326,28,2,30452,28,2,30704,28,2,35385,9,18.9,-1.3012008,36.764868,-1.2584143,36.8048002,855,4681,33,378
13866,6393,2137,1,Personal,28,2,56176,28,2,56209,28,2,56597,28,2,56863,28,2,58168,8,19.4,-1.2661264,36.8030359,-1.276902,36.76611,334,1305,33,654
13867,1769,420,3,Business,6,4,46364,6,4,51751,6,4,54414,6,4,54876,6,4,55760,6,23.5,-1.2785723,36.8153585,-1.2657464,36.7801144,561,884,5387,3125
13868,15690,3291,3,Business,24,3,34559,24,3,36628,24,3,36798,24,3,37478,24,3,39154,12,23.25888921888938,-1.331619,36.847976,-1.2600926,36.8088685,291,1676,2069,850
13869,2301,265,3,Business,24,3,53561,24,3,55253,24,3,56537,24,3,56675,24,3,58979,7,23.25888921888938,-1.300921,36.828195,-1.3154845,36.7912475,843,2304,1692,1422
13870,21886,2066,3,Business,27,3,39009,27,3,39072,27,3,40017,27,3,40599,27,3,42675,15,26.3,-1.3210189,36.8410551,-1.3287648,36.7445732,519,2076,63,1527
13871,6859,785,1,Personal,11,5,30413,11,5,30687,11,5,31181,11,5,31790,11,5,32669,3,18.1,-1.2910747,36.8317849,-1.3012173,36.8093987,79,879,274,1103
13872,20169,2412,3,Business,4,4,39157,4,4,40800,4,4,41422,4,4,41821,4,4,42898,10,23.25888921888938,-1.2696795,36.8640088,-1.2297202,36.8819507,100,1077,1643,1021
13873,11933,3570,2,Personal,18,6,70470,18,6,70507,18,6,72887,18,6,73292,18,6,74578,8,16.8,-1.2732869,36.832159,-1.2817426,36.7846148,4,1286,37,2785
13874,13322,747,1,Personal,4,4,49841,4,4,49907,4,4,50715,4,4,51052,4,4,52976,10,24.6,-1.3009173,36.7959207,-1.2698168,36.7421898,328,1924,66,1145
13875,5366,736,3,Business,22,1,37587,22,1,37656,22,1,38861,22,1,39111,22,1,41829,13,24.7,-1.2943818,36.7858765,-1.3332749,36.8708147,532,2718,69,1455
13876,7532,1536,1,Personal,21,5,54128,21,5,54142,21,5,54578,21,5,56939,21,5,58997,20,27.3,-1.3028448,36.7625787,-1.3205335,36.8789718,449,2058,14,2797
13877,19454,1000,1,Personal,4,1,53452,4,1,53516,4,1,54137,4,1,54299,4,1,54578,2,22.8,-1.3090189,36.7720102,-1.298043,36.771853,312,279,64,783
13878,10568,323,3,Business,4,2,35118,4,2,35128,4,2,36741,4,2,37404,4,2,41058,26,16.4,-1.2659447,36.7508667,-1.3632162,36.9108253,832,3654,10,2276
13879,23393,1532,3,Personal,8,2,65930,8,2,65975,8,2,67240,8,2,67302,8,2,70189,8,23.5,-1.3105877,36.817283,-1.2536042,36.8064895,235,2887,45,1327
13880,26388,1341,3,Business,27,1,48457,27,1,48500,27,1,48867,27,1,50070,27,1,50867,9,23.3,-1.3040553,36.8092658,-1.331619,36.847976,72,797,43,1570
13881,15504,816,3,Business,5,2,32195,5,2,32304,5,2,33149,5,2,34458,5,2,36250,11,20.9,-1.2927792,36.9053492,-1.290894,36.822971,411,1792,109,2154
13882,5660,265,3,Business,23,3,40605,23,3,40612,23,3,40891,23,3,41801,23,3,43325,18,23.25888921888938,-1.3081376,36.8329772,-1.3117864,36.6973045,871,1524,7,1189
13883,5713,560,1,Personal,24,1,44534,24,1,44554,24,1,44866,24,1,45681,24,1,49805,15,22.7,-1.2242368,36.8148681,-1.2962832,36.7849683,101,4124,20,1127
13884,15022,3264,3,Business,15,4,46196,15,4,47673,15,4,47730,15,4,49295,15,4,50374,8,27.6,-1.2551895,36.7822034,-1.2963316,36.7863289,167,1079,1477,1622
13885,2907,3295,3,Business,28,4,49818,28,4,49865,28,4,50653,28,4,53087,28,4,54028,13,29.9,-1.3126476,36.831455,-1.2571472,36.7950633,365,941,47,3222
13886,5097,2154,3,Business,12,2,58501,12,2,58980,12,2,60276,12,2,60466,12,2,61628,9,28.4,-1.2860183,36.8975338,-1.2765736,36.8513646,377,1162,479,1486
13887,26126,2203,2,Personal,26,4,58871,26,4,58930,26,4,59405,26,4,59680,26,4,60831,8,19.4,-1.3129578,36.8463197,-1.2925919,36.8170577,427,1151,59,750
13888,11130,3212,1,Personal,20,5,43351,20,5,43364,20,5,44669,20,5,44948,20,5,48412,20,18.7,-1.3273028,36.8739571,-1.253621,36.7991917,379,3464,13,1584
13889,19259,1502,3,Business,7,3,39650,7,3,39764,7,3,40417,7,3,41393,7,3,43192,13,25.1,-1.2822934,36.8226529,-1.2232123,36.8932547,669,1799,114,1629
13890,24098,867,3,Business,15,4,39531,15,4,39554,15,4,40573,15,4,42574,15,4,44119,15,24.5,-1.306378,36.7519845,-1.3177547,36.8303703,588,1545,23,3020
13891,6892,419,3,Business,7,1,58314,7,1,58395,7,1,58572,7,1,59340,7,1,61160,6,26.9,-1.2571472,36.7950633,-1.3001813,36.811122,436,1820,81,945
13892,5871,3130,1,Personal,8,1,53963,8,1,54074,8,1,54690,8,1,55098,8,1,56771,13,25.1,-1.2128205,36.8026175,-1.2885417,36.8100523,578,1673,111,1024
13893,5091,2112,3,Business,2,3,57930,2,3,57943,2,3,58500,2,3,62882,2,3,63848,14,25.0,-1.2571472,36.7950633,-1.2156006,36.8916865,38,966,13,4939
13894,23060,2030,3,Business,11,5,53116,11,5,53226,11,5,55038,11,5,55541,11,5,57073,9,26.4,-1.22589,36.7822548,-1.2753109,36.8130185,547,1532,110,2315
13895,3160,2000,3,Business,11,1,55177,11,1,55253,11,1,55984,11,1,56137,11,1,57630,8,28.1,-1.2551895,36.7822034,-1.293393,36.790237,631,1493,76,884
13896,12904,391,3,Business,17,5,58502,17,5,58994,17,5,60731,17,5,63987,17,5,66659,5,23.25888921888938,-1.300921,36.828195,-1.2784063,36.8222933,868,2672,492,4993
13897,19092,2676,3,Business,24,4,61077,24,4,61115,24,4,61779,24,4,62197,24,4,63310,9,21.0,-1.2963097,36.7688221,-1.262423,36.8016471,103,1113,38,1082
13898,28213,3291,3,Business,1,1,52319,1,1,52456,1,1,53200,1,1,54641,1,1,55498,5,23.25888921888938,-1.2628473,36.781805,-1.2600926,36.8088685,306,857,137,2185
13899,23837,2279,3,Business,23,4,50825,23,4,50854,23,4,51387,23,4,51595,23,4,52502,5,24.5,-1.2897368,36.8226783,-1.2571472,36.7950633,19,907,29,741
13900,16915,1725,3,Business,2,3,40609,2,3,40728,2,3,40742,2,3,41100,2,3,41914,4,22.0,-1.2652108,36.8056075,-1.2865096,36.8169364,633,814,119,372
13901,7211,2854,3,Business,19,6,52534,19,6,53361,19,6,54168,19,6,54345,19,6,55294,4,24.4,-1.2963097,36.7688221,-1.2950044,36.7512209,103,949,827,984
13902,10933,1207,1,Business,7,6,59635,7,6,59650,7,6,59805,7,6,62549,7,6,64329,18,20.6,-1.2745321,36.765088,-1.2293754,36.8624324,45,1780,15,2899
13903,13228,2525,1,Personal,15,5,51204,15,5,51408,15,5,52095,15,5,52679,15,5,53465,7,22.7,-1.3037587,36.8076138,-1.2765492,36.7669809,409,786,204,1271
13904,5842,1787,3,Business,6,4,35788,6,4,35812,6,4,38303,6,4,38979,6,4,41007,15,23.9,-1.2283403,36.8822756,-1.2551895,36.7822034,669,2028,24,3167
13905,16711,2548,3,Business,18,3,48015,18,3,48082,18,3,49759,18,3,50757,18,3,51874,6,20.9,-1.2768759,36.8477557,-1.3096278,36.8533243,88,1117,67,2675
13906,19014,3458,3,Business,29,1,40471,29,1,40565,29,1,41300,29,1,41667,29,1,42861,8,23.25888921888938,-1.3025299,36.7901963,-1.2970762,36.8453541,46,1194,94,1102
13907,20584,1500,3,Business,2,1,49866,2,1,51890,2,1,51916,2,1,54979,2,1,54987,8,19.9,-1.3004062,36.829741,-1.2574219,36.7927073,656,8,2024,3089
13908,14707,1148,3,Business,22,4,35995,22,4,39641,22,4,41094,22,4,42309,22,4,43660,9,22.4,-1.3100586,36.8500329,-1.2675238,36.8127148,268,1351,3646,2668
13909,6119,3283,3,Business,4,1,48168,4,1,48234,4,1,49194,4,1,49606,4,1,50517,7,23.25888921888938,-1.303596,36.778378,-1.2628473,36.781805,205,911,66,1372
13910,14026,1944,1,Personal,8,6,66002,8,6,66048,8,6,67567,8,6,67768,8,6,70119,15,23.1,-1.2909634,36.7813995,-1.2049707,36.7858957,465,2351,46,1720
13911,13903,3560,3,Business,15,5,45060,15,5,45132,15,5,45141,15,5,46461,15,5,46476,1,26.1,-1.28878,36.8168312,-1.279395,36.825364,320,15,72,1329
13912,11775,265,3,Business,20,3,52033,20,3,52738,20,3,53600,20,3,54293,20,3,55210,5,28.4,-1.3049875,36.8633418,-1.300921,36.828195,576,917,705,1555
13913,16041,154,2,Business,14,4,56713,14,4,56923,14,4,59699,14,4,60068,14,4,61319,9,21.3,-1.2551895,36.7822034,-1.2984591,36.7855438,312,1251,210,3145
13914,11117,640,3,Business,14,2,41739,14,2,41777,14,2,42330,14,2,42532,14,2,44986,21,23.25888921888938,-1.2969741,36.7856612,-1.207546,36.7913976,299,2454,38,755
13915,11939,443,1,Personal,22,6,47970,22,6,48024,22,6,48626,22,6,48817,22,6,49422,5,23.25888921888938,-1.2857764,36.8236622,-1.274755,36.7906585,85,605,54,793
13916,4719,1075,3,Business,29,5,53519,29,5,53672,29,5,54252,29,5,54389,29,5,55776,8,29.0,-1.2765736,36.8513646,-1.2527958,36.8003131,326,1387,153,717
13917,25188,1502,3,Business,20,3,56119,20,3,56130,20,3,56589,20,3,60298,20,3,61054,23,27.6,-1.3472066,36.7692638,-1.2232123,36.8932547,436,756,11,4168
13918,18342,1329,3,Business,29,4,62580,29,4,63784,29,4,63786,29,4,65082,29,4,65681,6,20.9,-1.273056,36.811298,-1.2623805,36.7805404,345,599,1204,1298
13919,11445,344,1,Personal,5,5,42875,5,5,43046,5,5,43538,5,5,43628,5,5,44534,5,23.6,-1.2848376,36.8027622,-1.2901669,36.7685878,383,906,171,582
13920,24895,633,3,Business,19,2,41538,19,2,41556,19,2,42534,19,2,44069,19,2,45387,11,27.5,-1.2991441,36.7528804,-1.3004062,36.829741,855,1318,18,2513
13921,20285,867,3,Business,20,3,53749,20,3,53831,20,3,54904,20,3,55076,20,3,56434,10,29.5,-1.2996533,36.8292629,-1.2991441,36.7528804,728,1358,82,1245
13922,16220,2314,2,Personal,26,4,67729,26,4,67773,26,4,68044,26,4,68295,26,4,70013,12,19.5,-1.2911123,36.7921078,-1.2482518,36.7550829,937,1718,44,522
13923,26294,2469,3,Business,5,5,54743,5,5,55537,5,5,56647,5,5,56752,5,5,60333,12,27.7,-1.303924,36.8758792,-1.2734248,36.8202136,233,3581,794,1215
13924,17693,3647,3,Business,12,1,32557,12,1,33271,12,1,33768,12,1,34113,12,1,34624,4,19.2,-1.272639,36.794723,-1.2707373,36.805441,881,511,714,842
13925,20981,868,3,Business,18,4,51836,18,4,51981,18,4,52324,18,4,53054,18,4,53343,3,23.25888921888938,-1.2783849,36.8163445,-1.265715,36.823815,695,289,145,1073
13926,16099,1329,3,Business,26,5,42618,26,5,42684,26,5,42849,26,5,43098,26,5,43692,4,23.25888921888938,-1.273056,36.811298,-1.2624633,36.786519,875,594,66,414
13927,134,1204,1,Personal,6,4,43864,6,4,43884,6,4,46546,6,4,46868,6,4,48923,21,21.9,-1.1937538,36.9268653,-1.2977387,36.8031447,561,2055,20,2984
13928,8720,2674,3,Personal,22,2,72045,22,2,72052,22,2,72208,22,2,72527,22,2,73828,6,21.7,-1.2963097,36.7688221,-1.2797013,36.7299371,202,1301,7,475
13929,12874,393,3,Business,10,1,36170,10,1,36242,10,1,36975,10,1,37648,10,1,39139,11,16.6,-1.3228003,36.8306435,-1.2638185,36.7930057,155,1491,72,1406
13930,17812,889,3,Business,23,2,29510,23,2,32584,23,2,35652,23,2,35920,23,2,36707,3,15.2,-1.2985153,36.7876043,-1.2938713,36.7917214,89,787,3074,3336
13931,6057,3420,3,Business,27,3,62475,27,3,62512,27,3,64095,27,3,65446,27,3,65449,8,27.4,-1.3046007,36.8211743,-1.326774,36.7878069,613,3,37,2934
13932,5555,3291,3,Business,8,5,48840,8,5,52937,8,5,53942,8,5,57516,8,5,60953,22,30.4,-1.335477,36.9308297,-1.2600926,36.8088685,99,3437,4097,4579
13933,3245,1959,3,Business,18,4,39834,18,4,39866,18,4,40628,18,4,40734,18,4,42532,15,23.25888921888938,-1.2551895,36.7822034,-1.2286931,36.881603,779,1798,32,868
13934,16264,733,3,Business,11,1,52236,11,1,52391,11,1,52592,11,1,52949,11,1,53471,3,29.1,-1.2551895,36.7822034,-1.2649605,36.7981777,576,522,155,558
13935,26625,2154,3,Business,8,5,58213,8,5,58271,8,5,58917,8,5,59299,8,5,60097,9,30.3,-1.2285835,36.8826468,-1.2765736,36.8513646,675,798,58,1028
13936,17679,1417,3,Business,13,3,39628,13,3,39677,13,3,40254,13,3,40421,13,3,41921,14,24.6,-1.2741728,36.7969108,-1.3323107,36.8692616,880,1500,49,744
13937,17326,15,1,Personal,31,4,55606,31,4,56023,31,4,57161,31,4,57362,31,4,60859,15,22.9,-1.2022306,36.7893305,-1.2808748,36.8289823,144,3497,417,1339
13938,24931,391,3,Business,3,5,39014,3,5,39129,3,5,39859,3,5,44108,3,5,45367,5,23.25888921888938,-1.300921,36.828195,-1.2867454,36.8259017,709,1259,115,4979
13939,13034,1724,3,Business,5,1,55110,5,1,55147,5,1,56304,5,1,56636,5,1,57600,8,25.8,-1.2985559,36.783791,-1.2551895,36.7822034,937,964,37,1489
13940,24144,1380,3,Business,3,5,32890,3,5,40902,3,5,42379,3,5,44757,3,5,46820,12,23.25888921888938,-1.2261716,36.8005617,-1.2994162,36.8334887,68,2063,8012,3855
13941,23405,1915,2,Personal,20,4,41167,20,4,41198,20,4,41856,20,4,42291,20,4,43264,9,24.2,-1.2797886,36.8169389,-1.2295205,36.8120426,88,973,31,1093
13942,24764,2330,3,Business,29,3,55515,29,3,55712,29,3,56971,29,3,57419,29,3,59659,14,21.3,-1.2925641,36.8976449,-1.3798085,36.9290528,660,2240,197,1707
13943,15542,2216,3,Business,11,5,42488,11,5,42624,11,5,43654,11,5,45445,11,5,46771,8,20.9,-1.2551895,36.7822034,-1.2965924,36.8179314,101,1326,136,2821
13944,19791,1148,3,Business,13,3,43876,13,3,44006,13,3,44774,13,3,45054,13,3,46873,9,23.25888921888938,-1.3100586,36.8500329,-1.2762965,36.8211047,61,1819,130,1048
13945,12481,3647,3,Business,5,2,49096,5,2,49117,5,2,49324,5,2,52094,5,2,52097,17,27.3,-1.272639,36.794723,-1.3382067,36.677339,295,3,21,2977
13946,27357,2987,3,Business,4,2,47387,4,2,47499,4,2,48346,4,2,48602,4,2,49333,10,18.6,-1.270212,36.8210877,-1.2297202,36.8819507,116,731,112,1103
13947,16609,1209,3,Business,15,1,50661,15,1,50685,15,1,51177,15,1,51789,15,1,52235,4,23.25888921888938,-1.3077869,36.8443207,-1.3004062,36.829741,206,446,24,1104
13948,16656,3647,3,Business,17,1,31780,17,1,31803,17,1,32303,17,1,32656,17,1,33668,8,19.0,-1.3011234,36.830237,-1.272639,36.794723,674,1012,23,853
13949,5632,457,3,Personal,28,2,50916,28,2,50976,28,2,51115,28,2,51595,28,2,52988,10,23.6,-1.2697893,36.8124106,-1.2990731,36.8488058,959,1393,60,619
13950,9104,3149,3,Business,9,5,37477,9,5,37655,9,5,37667,9,5,42907,9,5,43460,6,25.7,-1.3004062,36.829741,-1.3177547,36.8303703,69,553,178,5252
13951,2014,816,3,Business,17,4,28732,17,4,29856,17,4,30771,17,4,31293,17,4,32015,1,23.25888921888938,-1.2813012,36.8323962,-1.290894,36.822971,725,722,1124,1437
13952,25864,20,3,Business,9,3,43025,9,3,43041,9,3,43269,9,3,43704,9,3,46749,8,21.0,-1.3090533,36.8371502,-1.2629666,36.8068369,100,3045,16,663
13953,25638,3688,3,Business,28,1,55248,28,1,55336,28,1,55674,28,1,56300,28,1,58080,16,26.2,-1.2551895,36.7822034,-1.3326173,36.7146233,74,1780,88,964
13954,10250,1966,3,Business,11,1,46308,11,1,46350,11,1,47185,11,1,49198,11,1,51294,21,29.0,-1.3700383,36.9190174,-1.2917868,36.7872675,238,2096,42,2848
13955,28211,1075,3,Business,14,4,46313,14,4,46391,14,4,47281,14,4,48044,14,4,49102,8,25.0,-1.2326041,36.8009029,-1.2527958,36.8003131,318,1058,78,1653
13956,5558,2207,3,Business,19,1,32964,19,1,33060,19,1,35947,19,1,36234,19,1,37977,12,19.2,-1.3142866,36.8618036,-1.2768326,36.8073804,699,1743,96,3174
13957,2043,1850,3,Business,25,1,49773,25,1,50026,25,1,50295,25,1,51878,25,1,54037,7,30.2,-1.2551895,36.7822034,-1.289498,36.818878,686,2159,253,1852
13958,20133,1561,3,Business,3,3,56647,3,3,57353,3,3,58555,3,3,59278,3,3,60222,7,28.3,-1.233018,36.8004477,-1.257227,36.8253892,7,944,706,1925
13959,12480,1271,3,Business,3,2,58606,3,2,58701,3,2,60872,3,2,61071,3,2,62165,12,18.6,-1.3244885,36.897792,-1.3280091,36.8524146,895,1094,95,2370
13960,3125,1422,3,Business,9,3,51345,9,3,51719,9,3,51746,9,3,52400,9,3,56252,8,25.3,-1.3181843,36.8394827,-1.286553,36.8273374,48,3852,374,681
13961,25762,2154,3,Business,5,5,63985,5,5,64208,5,5,64858,5,5,65092,5,5,66474,9,26.3,-1.2492395,36.7986032,-1.2765736,36.8513646,96,1382,223,884
13962,15244,793,3,Personal,14,1,36463,14,1,40056,14,1,41625,14,1,42295,14,1,45667,29,23.3,-1.3813211,36.7725266,-1.2643343,36.7447423,798,3372,3593,2239
13963,15427,2523,3,Business,2,2,43976,2,2,43998,2,2,44511,2,2,44725,2,2,46707,4,26.3,-1.2551895,36.7822034,-1.2651643,36.8072214,690,1982,22,727
13964,4681,295,3,Business,26,5,41304,26,5,47139,26,5,47213,26,5,48805,26,5,50100,6,23.25888921888938,-1.2967108,36.7871135,-1.2868599,36.821542,330,1295,5835,1666
13965,7998,1153,2,Personal,7,2,68941,7,2,69021,7,2,69540,7,2,70045,7,2,71864,11,22.8,-1.2620159,36.7956487,-1.3159017,36.783604,329,1819,80,1024
13966,4470,248,3,Business,1,5,29491,1,5,29536,1,5,29568,1,5,30960,1,5,32298,8,23.3,-1.2635089,36.7887337,-1.304735,36.7846054,523,1338,45,1424
13967,7928,238,3,Business,28,3,49154,28,3,49258,28,3,49263,28,3,49534,28,3,49541,4,23.25888921888938,-1.3004062,36.829741,-1.3077869,36.8443207,39,7,104,276
13968,13947,1244,3,Business,4,3,50252,4,3,50302,4,3,50988,4,3,51665,4,3,52740,8,18.1,-1.272828,36.816608,-1.303596,36.778378,312,1075,50,1363
13969,6588,1750,1,Personal,3,3,42987,3,3,43007,3,3,43440,3,3,43881,3,3,46948,11,24.0,-1.3339943,36.7263409,-1.3009721,36.7689325,805,3067,20,874
13970,26440,3647,3,Business,7,4,51056,7,4,51071,7,4,51743,7,4,52151,7,4,52820,5,31.0,-1.272639,36.794723,-1.26259,36.77486,315,669,15,1080
13971,7648,2149,1,Personal,19,5,56390,19,5,56626,19,5,57240,19,5,57402,19,5,58906,9,27.6,-1.2675332,36.808561,-1.3086326,36.8080886,45,1504,236,776
13972,7534,2195,3,Business,6,6,58995,6,6,59035,6,6,59867,6,6,60624,6,6,62652,16,27.2,-1.303596,36.778378,-1.228911,36.881876,460,2028,40,1589
13973,21763,893,3,Business,4,1,43641,4,1,43697,4,1,43738,4,1,45505,4,1,46458,5,25.7,-1.2825953,36.8152516,-1.2663194,36.809901,267,953,56,1808
13974,16476,406,1,Personal,28,1,42727,28,1,42815,28,1,43408,28,1,43708,28,1,44526,6,22.6,-1.2890399,36.8164942,-1.2553615,36.7895376,852,818,88,893
13975,20695,3201,3,Business,25,3,47579,25,3,47589,25,3,47986,25,3,48344,25,3,48654,1,23.25888921888938,-1.2527958,36.8003131,-1.2649605,36.7981777,103,310,10,755
13976,10520,3080,3,Business,8,5,46940,8,5,52918,8,5,53411,8,5,53964,8,5,55808,22,30.5,-1.2551895,36.7822034,-1.3342256,36.9106741,328,1844,5978,1046
13977,3334,3647,3,Business,27,2,58693,27,2,58720,27,2,59268,27,2,59374,27,2,61877,27,25.4,-1.272639,36.794723,-1.1523217,36.9620481,647,2503,27,654
13978,23211,640,3,Business,6,1,32921,6,1,32983,6,1,35970,6,1,36548,6,1,37780,3,23.25888921888938,-1.2969741,36.7856612,-1.2858578,36.7747046,155,1232,62,3565
13979,1219,1050,2,Personal,4,3,30482,4,3,30544,4,3,32221,4,3,34785,4,3,35843,8,14.9,-1.294765,36.8472408,-1.3215473,36.8435326,956,1058,62,4241
13980,27878,2572,1,Personal,3,2,60904,3,2,61754,3,2,63652,3,2,64020,3,2,64632,2,18.7,-1.2747247,36.8150014,-1.2659149,36.8054322,951,612,850,2266
13981,3200,988,2,Personal,3,7,44401,3,7,44433,3,7,45718,3,7,47622,3,7,48561,8,21.9,-1.2297202,36.8745508,-1.211356,36.9051898,408,939,32,3189
13982,18037,3017,3,Business,8,5,58413,8,5,58480,8,5,58952,8,5,59311,8,5,59858,1,21.5,-1.299313,36.7831488,-1.2940039,36.7843369,535,547,67,831
13983,26438,1502,3,Business,6,1,54072,6,1,54114,6,1,55234,6,1,56427,6,1,57726,17,23.25888921888938,-1.2232123,36.8932547,-1.2571472,36.7950633,8,1299,42,2313
13984,21495,2069,3,Business,30,3,60183,30,3,60227,30,3,61323,30,3,61801,30,3,64088,17,27.6,-1.331619,36.847976,-1.228911,36.881876,691,2287,44,1574
13985,9341,2553,1,Personal,11,1,62398,11,1,64213,11,1,64787,11,1,66787,11,1,67249,8,21.2,-1.284382,36.7746045,-1.278612,36.8195876,268,462,1815,2574
13986,6980,1304,3,Business,19,3,53716,19,3,53734,19,3,55696,19,3,55887,19,3,59067,16,24.3,-1.2859912,36.8756811,-1.3190102,36.9230693,114,3180,18,2153
13987,23344,419,3,Business,14,2,35872,14,2,35898,14,2,36177,14,2,37629,14,2,39078,14,23.25888921888938,-1.2571472,36.7950633,-1.3189252,36.8617269,520,1449,26,1731
13988,16488,246,3,Business,14,3,55329,14,3,55385,14,3,55790,14,3,56171,14,3,57954,9,25.6,-1.3014461,36.7661381,-1.2584143,36.8048002,671,1783,56,786
13989,12933,2112,3,Business,30,2,58751,30,2,58761,30,2,58780,30,2,59543,30,2,61108,15,23.6,-1.305399,36.8221849,-1.2156006,36.8916865,450,1565,10,782
13990,4756,868,3,Business,6,4,59836,6,4,61254,6,4,61265,6,4,63111,6,4,65103,9,22.6,-1.331619,36.847976,-1.265715,36.823815,345,1992,1418,1857
13991,4267,3080,3,Business,21,4,50779,21,4,50790,21,4,50815,21,4,52643,21,4,56462,19,26.1,-1.2571472,36.7950633,-1.3389279,36.7092201,26,3819,11,1853
13992,19164,3553,1,Personal,25,6,52505,25,6,52522,25,6,52992,25,6,53901,25,6,54673,6,23.25888921888938,-1.2893884,36.828207,-1.2724556,36.7931938,45,772,17,1379
13993,15940,3647,3,Business,27,3,48325,27,3,48367,27,3,49115,27,3,49545,27,3,50771,8,29.5,-1.272639,36.794723,-1.257569,36.842164,907,1226,42,1178
13994,4916,186,3,Business,6,3,40637,6,3,40682,6,3,41185,6,3,42336,6,3,42987,4,23.25888921888938,-1.2571472,36.7950633,-1.2825816,36.8092346,770,651,45,1654
13995,15107,2383,3,Business,13,4,33148,13,4,33195,13,4,34718,13,4,36600,13,4,37827,2,18.0,-1.264865,36.810488,-1.2608993,36.799246,112,1227,47,3405
13996,3589,3560,3,Business,20,3,55460,20,3,55840,20,3,55938,20,3,56968,20,3,59326,13,28.2,-1.2156006,36.8916865,-1.279395,36.825364,539,2358,380,1128
13997,13799,1207,3,Business,1,6,69583,1,6,70070,1,6,71418,1,6,71848,1,6,73524,13,18.5,-1.2629666,36.8068369,-1.2156006,36.8916865,95,1676,487,1778
13998,3172,393,3,Business,20,3,41753,20,3,41815,20,3,41821,20,3,43399,20,3,43990,4,26.3,-1.3167113,36.8301563,-1.3004062,36.829741,111,591,62,1584
13999,23647,437,3,Business,13,3,52300,13,3,52794,13,3,53147,13,3,53576,13,3,54059,1,27.3,-1.2551895,36.7822034,-1.2625272,36.7941625,107,483,494,782
14000,23123,2846,1,Personal,23,6,57235,23,6,57397,23,6,57956,23,6,59314,23,6,59857,4,23.25888921888938,-1.2863907,36.8194287,-1.2780823,36.7960191,340,543,162,1917
14001,17621,2412,3,Business,1,6,58916,1,6,58972,1,6,60469,1,6,61060,1,6,62473,12,19.5,-1.2527958,36.8003131,-1.2297202,36.8819507,427,1413,56,2088
14002,13470,3064,3,Business,17,3,35106,17,3,35130,17,3,35371,17,3,35848,17,3,36516,6,21.0,-1.2571472,36.7950633,-1.263989,36.765174,620,668,24,718
14003,12824,1363,3,Business,1,5,51379,1,5,51508,1,5,54286,1,5,54348,1,5,55100,4,32.0,-1.3004062,36.829741,-1.2974913,36.8054296,89,752,129,2840
14004,13699,718,3,Business,23,5,45238,23,5,45380,23,5,45923,23,5,47363,23,5,48800,6,24.0,-1.2551895,36.7822034,-1.2839568,36.8233106,124,1437,142,1983
14005,17398,1148,3,Business,21,4,45407,21,4,46466,21,4,48593,21,4,49747,21,4,53678,11,30.9,-1.3100586,36.8500329,-1.2549895,36.8265822,181,3931,1059,3281
14006,2282,1244,3,Business,5,2,36539,5,2,36568,5,2,37377,5,2,37745,5,2,38901,8,17.9,-1.272828,36.816608,-1.303596,36.778378,89,1156,29,1177
14007,11255,3718,3,Business,4,2,44755,4,2,48787,4,2,51979,4,2,52419,4,2,53040,2,23.7,-1.2650027,36.8126242,-1.2810205,36.8248105,404,621,4032,3632
14008,14386,1551,1,Personal,10,1,38816,10,1,38825,10,1,39215,10,1,40724,10,1,43016,14,23.25888921888938,-1.2863371,36.8200261,-1.3221853,36.7111258,124,2292,9,1899
14009,28218,2000,3,Business,11,4,41528,11,4,41540,11,4,41558,11,4,42143,11,4,42817,4,25.6,-1.2551895,36.7822034,-1.266294,36.8057971,576,674,12,603
14010,4334,909,3,Business,21,1,46993,21,1,47019,21,1,49152,21,1,50079,21,1,51827,13,27.6,-1.2283403,36.8822756,-1.225322,36.80855,845,1748,26,3060
14011,20575,136,3,Business,20,3,57729,20,3,58127,20,3,59166,20,3,59384,20,3,61697,16,28.6,-1.3254522,36.7216584,-1.3233496,36.8139159,605,2313,398,1257
14012,16435,733,3,Business,26,3,44374,26,3,44380,26,3,44408,26,3,46275,26,3,48343,15,24.0,-1.2551895,36.7822034,-1.207546,36.7913976,449,2068,6,1895
14013,697,704,3,Business,31,5,45830,31,5,46460,31,5,47537,31,5,48099,31,5,49300,9,21.7,-1.2413316,36.8785525,-1.2860183,36.8975338,199,1201,630,1639
14014,10940,700,3,Business,6,4,37983,6,4,37993,6,4,38693,6,4,39449,6,4,40375,5,22.2,-1.294336,36.795332,-1.283527,36.8236512,365,926,10,1456
14015,21106,2154,3,Business,9,6,32889,9,6,32921,9,6,33196,9,6,33587,9,6,34760,8,21.0,-1.2413316,36.8785525,-1.2765736,36.8513646,932,1173,32,666
14016,26451,552,3,Business,16,2,49914,16,2,49965,16,2,51681,16,2,52632,16,2,55388,14,23.25888921888938,-1.2860183,36.8975338,-1.3562374,36.9042954,126,2756,51,2667
14017,3072,970,3,Business,7,3,47890,7,3,48240,7,3,48842,7,3,49208,7,3,51007,9,28.2,-1.2551895,36.7822034,-1.306431,36.812042,952,1799,350,968
14018,28102,3027,1,Personal,8,2,52959,8,2,59256,8,2,60522,8,2,61957,8,2,65438,5,20.8,-1.2827651,36.8433831,-1.2705887,36.8292101,101,3481,6297,2701
14019,9854,2990,1,Personal,10,5,50175,10,5,50191,10,5,51014,10,5,52445,10,5,54202,17,21.6,-1.281342,36.8196838,-1.3668652,36.730459,449,1757,16,2254
14020,5493,393,3,Business,24,5,32027,24,5,32041,24,5,32828,24,5,34038,24,5,34289,1,18.3,-1.3002554,36.8256566,-1.3004062,36.829741,211,251,14,1997
14021,13536,261,2,Personal,31,5,61032,31,5,62298,31,5,63147,31,5,65000,31,5,66058,8,20.0,-1.2789683,36.8284768,-1.296797,36.7764525,857,1058,1266,2702
14022,26827,633,3,Business,1,5,37431,1,5,37480,1,5,37965,1,5,38428,1,5,39706,9,28.8,-1.2638185,36.7930057,-1.3004062,36.829741,452,1278,49,948
14023,15783,1882,3,Business,15,5,30883,15,5,33138,15,5,33349,15,5,35125,15,5,36252,7,20.3,-1.2958783,36.7928125,-1.2588775,36.8079744,326,1127,2255,1987
14024,19231,2854,3,Business,31,4,53181,31,4,57201,31,4,58628,31,4,59855,31,4,64186,23,22.2,-1.1983052,36.9289714,-1.2963097,36.7688221,101,4331,4020,2654
14025,11198,1564,3,Personal,9,6,36929,9,6,36988,9,6,38067,9,6,38290,9,6,39266,6,24.6,-1.2646374,36.7235671,-1.2577289,36.7410772,829,976,59,1302
14026,22229,3002,1,Personal,27,1,37427,27,1,37773,27,1,38697,27,1,38833,27,1,39676,7,23.9,-1.2527469,36.7904333,-1.2868838,36.8284259,754,843,346,1060
14027,25776,811,3,Personal,29,5,61974,29,5,62253,29,5,63064,29,5,63562,29,5,64040,1,27.9,-1.3043377,36.776354,-1.2963097,36.7688221,197,478,279,1309
14028,22614,1792,3,Business,23,2,39002,23,2,39077,23,2,40835,23,2,41136,23,2,42442,10,17.9,-1.2809121,36.7852524,-1.3271684,36.8173021,299,1306,75,2059
14029,11892,2677,3,Business,22,3,43119,22,3,43166,22,3,43170,22,3,45183,22,3,45381,10,22.9,-1.3004062,36.829741,-1.2991441,36.7528804,137,198,47,2017
14030,3588,1477,2,Personal,7,1,44577,7,1,44617,7,1,44846,7,1,46137,7,1,47414,11,21.6,-1.2560455,36.7800867,-1.305716,36.809882,446,1277,40,1520
14031,22931,391,3,Business,30,6,38426,30,6,38779,30,6,39332,30,6,40741,30,6,43502,17,26.8,-1.300921,36.828195,-1.1967675,36.8064464,59,2761,353,1962
14032,10909,2183,3,Business,26,5,42305,26,5,46805,26,5,47094,26,5,47391,26,5,47862,3,23.25888921888938,-1.2527958,36.8003131,-1.2551895,36.7822034,578,471,4500,586
14033,6539,2627,3,Business,4,1,40334,4,1,40374,4,1,40859,4,1,41260,4,1,42632,9,26.8,-1.3014461,36.7661381,-1.2571472,36.7950633,576,1372,40,886
14034,24867,467,3,Business,9,4,32784,9,4,32872,9,4,33452,9,4,33677,9,4,35219,12,23.25888921888938,-1.304735,36.7846054,-1.311818,36.8638544,576,1542,88,805
14035,14339,533,3,Business,8,5,61070,8,5,61089,8,5,61627,8,5,62224,8,5,63326,6,28.1,-1.2765492,36.7669809,-1.2571472,36.7950633,205,1102,19,1135
14036,1054,640,3,Business,19,1,37934,19,1,37977,19,1,38313,19,1,38733,19,1,39571,3,24.9,-1.304033,36.7848695,-1.3005312,36.801878,649,838,43,756
14037,12440,1500,3,Business,20,1,34047,20,1,34098,20,1,34289,20,1,36000,20,1,36088,8,18.9,-1.3004062,36.829741,-1.2638185,36.7930057,137,88,51,1902
14038,4602,3080,3,Business,31,5,38770,31,5,38795,31,5,39112,31,5,39448,31,5,41388,13,17.2,-1.2551895,36.7822034,-1.3025958,36.8614441,611,1940,25,653
14039,5156,1537,3,Personal,19,4,41803,19,4,42495,19,4,44831,19,4,45102,19,4,47422,6,20.3,-1.2812459,36.8302055,-1.3117439,36.8108257,752,2320,692,2607
14040,37,2082,3,Personal,6,1,60769,6,1,60818,6,1,60843,6,1,62097,6,1,64413,11,22.2,-1.270054,36.815164,-1.27034,36.747764,406,2316,49,1279
14041,10662,909,3,Business,25,4,59196,25,4,59371,25,4,60736,25,4,61926,25,4,62896,7,23.25888921888938,-1.207546,36.7913976,-1.225322,36.80855,193,970,175,2555
14042,7560,2279,3,Business,26,2,35420,26,2,35479,26,2,37245,26,2,37323,26,2,38028,8,21.6,-1.2880883,36.8227336,-1.2571472,36.7950633,448,705,59,1844
14043,16153,893,3,Business,2,2,33816,2,2,33875,2,2,34075,2,2,34183,2,2,35047,7,20.6,-1.2663194,36.809901,-1.2847316,36.7658086,205,864,59,308
14044,16786,2805,3,Business,29,2,55221,29,2,55255,29,2,55523,29,2,56161,29,2,59175,17,26.8,-1.2534301,36.8000983,-1.3169591,36.7000029,902,3014,34,906
14045,2370,1882,3,Business,19,2,63377,19,2,63404,19,2,64455,19,2,64634,19,2,65478,5,28.4,-1.287781,36.817866,-1.2591019,36.800577,365,844,27,1230
14046,20036,2528,3,Business,8,1,34765,8,1,34775,8,1,35706,8,1,35945,8,1,36665,3,21.7,-1.2584143,36.8048002,-1.2551895,36.7822034,520,720,10,1170
14047,15848,1075,3,Business,24,3,51400,24,3,51426,24,3,51903,24,3,52184,24,3,52643,3,23.25888921888938,-1.2527958,36.8003131,-1.2551895,36.7822034,205,459,26,758
14048,12848,3295,3,Business,14,4,32655,14,4,32681,14,4,32779,14,4,34347,14,4,35565,11,15.4,-1.2579304,36.8019667,-1.3025043,36.7535329,379,1218,26,1666
14049,11163,635,3,Business,26,5,34431,26,5,35072,26,5,36738,26,5,36996,26,5,39534,18,23.25888921888938,-1.2777924,36.8231577,-1.3190102,36.9230693,99,2538,641,1924
14050,19643,2803,3,Business,8,5,31324,8,5,31343,8,5,31644,8,5,32079,8,5,33671,17,20.6,-1.269767,36.7351068,-1.2765736,36.8513646,880,1592,19,736
14051,16091,2100,3,Business,1,1,58517,1,1,58644,1,1,58683,1,1,58843,1,1,61408,15,25.8,-1.3472066,36.7692638,-1.2765736,36.8513646,857,2565,127,199
14052,13989,1245,3,Business,12,6,38156,12,6,38191,12,6,38594,12,6,39517,12,6,41700,17,23.25888921888938,-1.300921,36.828195,-1.3198615,36.7110323,110,2183,35,1326
14053,1939,1329,3,Business,20,4,58024,20,4,58790,20,4,59161,20,4,59323,20,4,61080,15,25.3,-1.273056,36.811298,-1.2521158,36.6898629,105,1757,766,533
14054,10267,1346,3,Business,14,3,57971,14,3,58233,14,3,59836,14,3,60979,14,3,61223,6,23.3,-1.2695287,36.7981777,-1.2917868,36.7872675,403,244,262,2746
14055,2124,3525,3,Business,28,4,57416,28,4,57516,28,4,58043,28,4,58238,28,4,59137,7,27.2,-1.2571472,36.7950633,-1.263989,36.765174,411,899,100,722
14056,22204,2000,3,Business,10,3,54185,10,3,54213,10,3,54369,10,3,54728,10,3,58107,10,30.8,-1.2551895,36.7822034,-1.312469,36.815177,709,3379,28,515
14057,24405,2074,2,Personal,27,5,33679,27,5,34158,27,5,34863,27,5,35254,27,5,36804,5,16.0,-1.2741728,36.7969108,-1.2949474,36.8270407,519,1550,479,1096
14058,15613,242,3,Business,2,3,44378,2,3,44782,2,3,47183,2,3,47265,2,3,48600,7,22.2,-1.255956,36.789867,-1.2834669,36.8297516,350,1335,404,2483
14059,9105,514,3,Personal,24,1,52127,24,1,52243,24,1,55112,24,1,55628,24,1,56573,4,24.8,-1.2861765,36.8209086,-1.2768326,36.8073804,436,945,116,3385
14060,10928,1112,2,Personal,3,2,39704,3,2,39957,3,2,40572,3,2,41231,3,2,41872,3,18.3,-1.2615584,36.8149506,-1.2621576,36.8103473,467,641,253,1274
14061,2725,2314,2,Personal,20,5,43818,20,5,43834,20,5,44803,20,5,45083,20,5,46442,12,18.3,-1.2895159,36.7884326,-1.2482518,36.7550829,281,1359,16,1249
14062,21110,502,3,Personal,20,3,32275,20,3,32294,20,3,32468,20,3,32635,20,3,33693,6,16.2,-1.3019137,36.7925105,-1.279085,36.819303,88,1058,19,341
14063,10482,2216,3,Business,19,1,47677,19,1,47981,19,1,48833,19,1,49837,19,1,51057,13,25.4,-1.2551895,36.7822034,-1.2443697,36.8690581,41,1220,304,1856
14064,3599,1271,3,Business,3,1,48539,3,1,49776,3,1,50821,3,1,51857,3,1,54179,12,23.6,-1.2927792,36.9053492,-1.3226302,36.8719901,589,2322,1237,2081
14065,5811,1500,3,Business,28,4,47056,28,4,47128,28,4,47530,28,4,49844,28,4,49973,8,30.1,-1.3004062,36.829741,-1.2638185,36.7930057,403,129,72,2716
14066,19396,3621,3,Business,6,4,67234,6,4,67291,6,4,68536,6,4,68835,6,4,70838,9,22.8,-1.2836583,36.7886014,-1.3212497,36.82452021,607,2003,57,1544
14067,27556,756,2,Personal,2,2,52904,2,2,53122,2,2,54738,2,2,55096,2,2,56754,8,26.3,-1.276572,36.810984,-1.284382,36.7746045,532,1658,218,1974
14068,21690,3517,3,Business,24,3,35429,24,3,35472,24,3,37961,24,3,39390,24,3,41355,16,23.25888921888938,-1.300921,36.828195,-1.3882008,36.7699445,950,1965,43,3918
14069,21230,1245,3,Business,4,1,40632,4,1,40665,4,1,40688,4,1,44105,4,1,44378,12,25.6,-1.300921,36.828195,-1.34252,36.739,472,273,33,3440
14070,25110,1792,3,Business,16,4,58618,16,4,58632,16,4,58990,16,4,59218,16,4,61448,14,19.0,-1.2805537,36.7920739,-1.2311903,36.8102105,531,2230,14,586
14071,1439,1509,3,Personal,25,3,52789,25,3,52841,25,3,53394,25,3,54093,25,3,54679,4,17.9,-1.2728058,36.8049903,-1.2709086,36.7929516,100,586,52,1252
14072,21135,1329,3,Business,14,4,33931,14,4,34016,14,4,34644,14,4,34719,14,4,38001,16,17.7,-1.273056,36.811298,-1.361923,36.770045,523,3282,85,703
14073,3685,2587,3,Business,25,5,56404,25,5,56417,25,5,57207,25,5,57480,25,5,59361,8,23.6,-1.225322,36.80855,-1.2579304,36.8019667,144,1881,13,1063
14074,1057,1384,3,Business,2,4,28049,2,4,28117,2,4,30267,2,4,30461,2,4,32694,18,23.25888921888938,-1.2517448,36.7924971,-1.3198543,36.8848254,92,2233,68,2344
14075,13687,751,2,Personal,4,3,30523,4,3,30583,4,3,31282,4,3,31788,4,3,33038,9,15.2,-1.272798,36.8124195,-1.3014461,36.7661381,379,1250,60,1205
14076,23159,1014,1,Business,28,5,32488,28,5,32632,28,5,33333,28,5,33804,28,5,35374,12,20.5,-1.3234104,36.7989459,-1.2733546,36.7696069,188,1570,144,1172
14077,12752,3647,3,Business,26,3,59906,26,3,59913,26,3,60911,26,3,61283,26,3,64641,19,19.4,-1.272639,36.794723,-1.3443917,36.6700333,38,3358,7,1370
14078,7304,52,3,Personal,20,5,50521,20,5,50561,20,5,52029,20,5,52295,20,5,54632,9,20.5,-1.2741347,36.8342163,-1.2963097,36.7688221,398,2337,40,1734
14079,890,733,3,Business,26,5,56830,26,5,56845,26,5,57082,26,5,57194,26,5,60125,10,23.25888921888938,-1.2551895,36.7822034,-1.2903067,36.8375634,422,2931,15,349
14080,6298,640,3,Business,12,1,38177,12,1,38226,12,1,39206,12,1,39639,12,1,42134,14,24.0,-1.3246455,36.8754415,-1.304033,36.7848695,31,2495,49,1413
14081,27231,868,3,Business,5,6,45897,5,6,46448,5,6,46703,5,6,47746,5,6,50369,9,22.4,-1.331619,36.847976,-1.265715,36.823815,487,2623,551,1298
14082,1705,2154,3,Business,13,4,44218,13,4,44612,13,4,45523,13,4,45718,13,4,47733,5,22.0,-1.2765736,36.8513646,-1.2885315,36.8230419,323,2015,394,1106
14083,8361,1716,3,Personal,17,4,36381,17,4,36434,17,4,36723,17,4,37085,17,4,37884,6,23.25888921888938,-1.2738936,36.8035805,-1.3056479,36.7692294,446,799,53,651
14084,8170,3763,3,Business,26,3,45056,26,3,45928,26,3,45956,26,3,46827,26,3,48440,11,24.1,-1.2671001,36.7977185,-1.3039222,36.8534707,857,1613,872,899
14085,24614,3318,3,Business,29,1,39140,29,1,39165,29,1,39210,29,1,40340,29,1,41260,5,23.25888921888938,-1.3004062,36.829741,-1.3083266,36.8494756,206,920,25,1175
14086,689,1304,3,Business,18,3,42427,18,3,42433,18,3,44217,18,3,44376,18,3,45787,9,19.8,-1.2551895,36.7822034,-1.2315181,36.8140543,616,1411,6,1943
14087,15901,3001,3,Business,3,1,47839,3,1,47967,3,1,48820,3,1,49294,3,1,50588,7,23.1,-1.2846195,36.7958316,-1.2675613,36.8133001,161,1294,128,1327
14088,14478,3498,2,Personal,14,5,57333,14,5,57514,14,5,58109,14,5,58222,14,5,59104,4,26.9,-1.2735236,36.7992196,-1.2896399,36.8124498,312,882,181,708
14089,13860,2987,3,Business,6,5,59443,6,5,60637,6,5,60959,6,5,61426,6,5,62213,4,23.25888921888938,-1.270212,36.8210877,-1.263987,36.798891,103,787,1194,789
14090,12970,2582,3,Business,5,2,49837,5,2,49885,5,2,50852,5,2,51011,5,2,51563,2,27.5,-1.2551895,36.7822034,-1.2580991,36.7941519,205,552,48,1126
14091,18006,2122,3,Business,7,7,43585,7,7,44872,7,7,46032,7,7,46491,7,7,47389,3,25.6,-1.2924173,36.7797814,-1.2963097,36.7688221,532,898,1287,1619
14092,13645,2677,3,Business,27,1,36455,27,1,37683,27,1,37721,27,1,40417,27,1,40481,12,20.7,-1.2991441,36.7528804,-1.3004062,36.829741,855,64,1228,2734
14093,20161,1148,3,Business,31,5,52521,31,5,56192,31,5,58055,31,5,59195,31,5,59280,3,19.9,-1.3100586,36.8500329,-1.311818,36.8638544,890,85,3671,3003
14094,8515,1280,3,Business,13,5,39616,13,5,39623,13,5,39690,13,5,40206,13,5,40784,7,23.25888921888938,-1.2551895,36.7822034,-1.2779711,36.7822345,103,578,7,583
14095,12175,3576,2,Personal,19,6,45259,19,6,45319,19,6,45529,19,6,46055,19,6,47754,8,21.9,-1.281223,36.8239,-1.2987748,36.7677418,742,1699,60,736
14096,916,3398,3,Business,5,3,35205,5,3,35610,5,3,36561,5,3,36933,5,3,39084,17,18.2,-1.2534301,36.8000983,-1.3169591,36.7000029,878,2151,405,1323
14097,25789,1075,3,Business,8,1,60226,8,1,60426,8,1,61856,8,1,62302,8,1,65070,15,29.2,-1.2859912,36.8756811,-1.2527958,36.8003131,76,2768,200,1876
14098,8848,432,3,Business,7,4,36467,7,4,36510,7,4,36936,7,4,37015,7,4,39660,4,23.25888921888938,-1.3012008,36.764868,-1.2962832,36.7849683,493,2645,43,505
14099,2648,2066,3,Business,14,5,60752,14,5,60771,14,5,60876,14,5,60950,14,5,62399,9,21.4,-1.3210189,36.8410551,-1.291216,36.8746657,270,1449,19,179
14100,12746,2190,3,Business,26,3,53480,26,3,53519,26,3,53879,26,3,54743,26,3,57778,17,27.2,-1.301953,36.788458,-1.2701894,36.90246,731,3035,39,1224
14101,20459,2222,3,Business,28,1,44624,28,1,44800,28,1,44889,28,1,45274,28,1,47553,10,22.8,-1.2930128,36.8356869,-1.3277669,36.8975169,633,2279,176,474
14102,19104,1721,3,Business,25,5,29782,25,5,29829,25,5,31044,25,5,34847,25,5,35405,2,20.6,-1.2571472,36.7950633,-1.2644694,36.8107125,290,558,47,5018
14103,9171,706,3,Business,4,5,33292,4,5,33298,4,5,33693,4,5,33831,4,5,35329,15,17.6,-1.3077869,36.8443207,-1.3559093,36.9100452,26,1498,6,533
14104,6101,2828,3,Business,22,1,64831,22,1,64977,22,1,65504,22,1,65884,22,1,67889,11,22.1,-1.2615888,36.7928732,-1.3159197,36.8516724,102,2005,146,907
14105,2667,467,3,Business,28,2,44892,28,2,44982,28,2,45656,28,2,45882,28,2,47409,6,21.1,-1.2867843,36.8134769,-1.304735,36.7846054,831,1527,90,900
14106,11537,952,1,Personal,2,7,46157,2,7,46187,2,7,47362,2,7,47650,2,7,48356,4,18.7,-1.2735166,36.8012556,-1.2813498,36.7930729,194,706,30,1463
14107,15638,1527,3,Business,29,3,59005,29,3,59192,29,3,59781,29,3,60068,29,3,61924,12,21.0,-1.2991441,36.7528804,-1.3004062,36.829741,168,1856,187,876
14108,16114,2871,1,Personal,22,7,64745,22,7,64762,22,7,65735,22,7,66368,22,7,67613,10,19.1,-1.2759432,36.7892706,-1.3172903,36.8059349,465,1245,17,1606
14109,12705,1500,3,Business,3,5,54285,3,5,54416,3,5,54420,3,5,55807,3,5,55812,13,23.25888921888938,-1.2638185,36.7930057,-1.3228003,36.8306435,515,5,131,1391
14110,24143,3234,1,Business,1,3,57470,1,3,57644,1,3,61167,1,3,63830,1,3,67129,10,23.1,-1.2862659,36.8264616,-1.3180993,36.8676304,700,3299,174,6186
14111,27716,2523,3,Business,8,5,57286,8,5,57773,8,5,59080,8,5,59309,8,5,60442,7,27.4,-1.2551895,36.7822034,-1.2885417,36.8100523,660,1133,487,1536
14112,19963,2763,3,Business,10,5,54562,10,5,60494,10,5,61465,10,5,61745,10,5,62887,8,23.25888921888938,-1.2551895,36.7822034,-1.2934638,36.7668028,815,1142,5932,1251
14113,175,3355,3,Business,20,2,42571,20,2,42588,20,2,43539,20,2,43779,20,2,45580,12,19.6,-1.2860183,36.8975338,-1.3052491,36.8223899,477,1801,17,1191
14114,16893,1508,2,Personal,19,3,32931,19,3,32977,19,3,32983,19,3,34809,19,3,37016,21,23.25888921888938,-1.226537,36.91563,-1.2874215,36.7767292,813,2207,46,1832
14115,17834,1342,3,Business,23,3,43852,23,3,43887,23,3,44380,23,3,45909,23,3,46721,8,22.0,-1.2962832,36.7849683,-1.2553615,36.7895376,676,812,35,2022
14116,18846,2066,3,Business,1,1,42475,1,1,42578,1,1,43568,1,1,43747,1,1,45103,5,23.25888921888938,-1.3210189,36.8410551,-1.3209207,36.8693699,435,1356,103,1169
14117,15425,3194,3,Business,11,1,36308,11,1,36344,11,1,37093,11,1,37690,11,1,40510,22,20.8,-1.2551895,36.7822034,-1.3835235,36.7649397,148,2820,36,1346
14118,19053,3269,1,Personal,4,3,43189,4,3,43207,4,3,43462,4,3,44562,4,3,47116,15,17.0,-1.3039695,36.7838267,-1.2333,36.82226,312,2554,18,1355
14119,15609,2521,3,Business,3,6,29770,3,6,32611,3,6,32809,3,6,37935,3,6,39587,10,23.6,-1.3177547,36.8303703,-1.2574219,36.7927073,62,1652,2841,5324
14120,7662,1329,3,Business,14,5,33964,14,5,34036,14,5,34044,14,5,34939,14,5,36722,5,17.0,-1.273056,36.811298,-1.3056277,36.8173166,89,1783,72,903
14121,16043,3517,3,Business,17,5,51085,17,5,51168,17,5,51822,17,5,53221,17,5,56645,16,23.25888921888938,-1.300921,36.828195,-1.3882008,36.7699445,332,3424,83,2053
14122,5936,1148,3,Business,28,2,36183,28,2,37196,28,2,37609,28,2,38636,28,2,39172,2,17.8,-1.3100586,36.8500329,-1.3088186,36.8352514,65,536,1013,1440
14123,16778,2532,3,Business,9,4,32119,9,4,37057,9,4,37389,9,4,37944,9,4,39386,6,23.25888921888938,-1.2571472,36.7950633,-1.2824911,36.8218042,953,1442,4938,887
14124,20271,3494,3,Personal,2,4,33759,2,4,33778,2,4,35314,2,4,35379,2,4,36428,8,13.4,-1.2787309,36.8194944,-1.3039411,36.7695316,857,1049,19,1601
14125,18963,816,3,Business,2,3,37352,2,3,37396,2,3,37405,2,3,37874,2,3,38356,2,20.1,-1.2793686,36.8259233,-1.290894,36.822971,456,482,44,478
14126,25660,2283,2,Personal,15,6,62205,15,6,62270,15,6,63312,15,6,63649,15,6,64183,3,25.0,-1.2661959,36.807544,-1.2696341,36.791664,622,534,65,1379
14127,18480,2819,1,Personal,25,2,34845,25,2,34869,25,2,35678,25,2,35855,25,2,37346,14,18.0,-1.2842018,36.832441,-1.338579,36.8963038,449,1491,24,986
14128,314,867,3,Business,1,1,59192,1,1,59391,1,1,60421,1,1,60537,1,1,62445,11,27.6,-1.2991441,36.7528804,-1.2996533,36.8292629,682,1908,199,1146
14129,10989,733,3,Business,20,3,59681,20,3,59738,20,3,60355,20,3,61167,20,3,61484,5,27.7,-1.2551895,36.7822034,-1.2629461,36.7653137,875,317,57,1429
14130,12498,1304,3,Business,19,4,46721,19,4,46967,19,4,48254,19,4,49722,19,4,52642,10,20.4,-1.2909536,36.8407162,-1.2551895,36.7822034,234,2920,246,2755
14131,18691,1205,3,Business,1,5,36499,1,5,36529,1,5,37279,1,5,37732,1,5,38600,6,23.3,-1.2495931,36.8065087,-1.2449522,36.7580025,607,868,30,1203
14132,25617,1539,1,Personal,14,2,72828,14,2,72874,14,2,74413,14,2,74488,14,2,76861,6,18.8,-1.2870003,36.8312206,-1.3148059,36.8449525,86,2373,46,1614
14133,21669,867,3,Business,8,5,35089,8,5,35230,8,5,35236,8,5,37686,8,5,39134,10,20.5,-1.2996533,36.8292629,-1.2991441,36.7528804,828,1448,141,2456
14134,19346,3639,1,Personal,24,5,32568,24,5,32662,24,5,33212,24,5,33588,24,5,34676,11,15.8,-1.2765737,36.8175399,-1.3214253,36.8459327,754,1088,94,926
14135,25236,1402,3,Business,29,5,44808,29,5,44886,29,5,45712,29,5,45808,29,5,49153,16,26.8,-1.3374394,36.7339115,-1.2813012,36.8323962,691,3345,78,922
14136,4063,868,3,Business,30,4,38939,30,4,39975,30,4,42736,30,4,46237,30,4,46245,9,23.25888921888938,-1.331619,36.847976,-1.265715,36.823815,787,8,1036,6262
14137,7564,896,3,Personal,4,1,52241,4,1,54413,4,1,55848,4,1,55945,4,1,57055,6,23.25888921888938,-1.3247683,36.85803,-1.3119324,36.8382423,856,1110,2172,1532
14138,5664,1484,3,Business,31,3,49798,31,3,49876,31,3,51398,31,3,51503,31,3,52671,15,26.8,-1.2551895,36.7822034,-1.2343236,36.8861,583,1168,78,1627
14139,16024,3635,1,Business,8,1,51733,8,1,51743,8,1,51931,8,1,52543,8,1,53206,3,25.0,-1.2584143,36.8048002,-1.2615888,36.7928732,409,663,10,800
14140,7015,1194,1,Personal,18,4,43001,18,4,44355,18,4,46095,18,4,47424,18,4,47435,6,25.6,-1.287353,36.826992,-1.2895311,36.8643373,662,11,1354,3069
14141,5194,2412,3,Business,11,1,40970,11,1,41049,11,1,41400,11,1,41975,11,1,45092,12,26.8,-1.2584143,36.8048002,-1.2283403,36.8822756,383,3117,79,926
14142,3182,393,3,Business,16,2,46977,16,2,47737,16,2,48335,16,2,50507,16,2,50523,11,23.25888921888938,-1.3167113,36.8301563,-1.2638185,36.7930057,709,16,760,2770
14143,406,1146,3,Business,18,1,56862,18,1,56894,18,1,57733,18,1,58614,18,1,59302,6,30.6,-1.3167113,36.8301563,-1.3083266,36.8494756,26,688,32,1720
14144,7642,2996,2,Personal,26,2,54665,26,2,54966,26,2,57262,26,2,57330,26,2,58789,19,23.25888921888938,-1.2294985,36.8775495,-1.1500224,36.9557348,549,1459,301,2364
14145,13951,2869,3,Business,29,5,50104,29,5,50128,29,5,50362,29,5,50496,29,5,51677,9,29.1,-1.3025826,36.7670807,-1.2551895,36.7822034,658,1181,24,368
14146,7875,517,3,Business,6,4,50629,6,4,50636,6,4,50679,6,4,51134,6,4,53492,14,23.25888921888938,-1.3177547,36.8303703,-1.306378,36.7519845,523,2358,7,498
14147,7016,3283,3,Business,26,5,36451,26,5,36462,26,5,37163,26,5,38280,26,5,39097,6,23.25888921888938,-1.272828,36.816608,-1.2628473,36.781805,76,817,11,1818
14148,13032,1025,3,Business,16,2,51534,16,2,51574,16,2,52108,16,2,55585,16,2,55629,2,23.25888921888938,-1.2969741,36.7856612,-1.3039706,36.7688174,324,44,40,4011
14149,24173,1402,3,Business,24,5,49554,24,5,49666,24,5,50019,24,5,50531,24,5,51690,1,23.2,-1.279395,36.825364,-1.2813012,36.8323962,790,1159,112,865
14150,17209,2869,3,Business,10,3,44975,10,3,44999,10,3,46068,10,3,46551,10,3,49723,3,28.0,-1.3025826,36.7670807,-1.2763494,36.7671783,327,3172,24,1552
14151,6074,2683,2,Personal,17,1,50856,17,1,55232,17,1,55955,17,1,56774,17,1,57150,8,28.2,-1.2887269,36.8693112,-1.327371,36.840591,179,376,4376,1542
14152,9583,3108,3,Business,9,5,42968,9,5,43168,9,5,43944,9,5,46050,9,5,47463,17,25.6,-1.2551895,36.7822034,-1.332642,36.8902123,215,1413,200,2882
14153,18449,788,3,Business,16,6,52392,16,6,52415,16,6,52611,16,6,52970,16,6,55030,7,23.25888921888938,-1.2584143,36.8048002,-1.225322,36.80855,448,2060,23,555
14154,19705,1363,3,Business,3,4,52171,3,4,53216,3,4,54391,3,4,54637,3,4,55532,7,26.1,-1.3004062,36.829741,-1.2650042,36.7903927,607,895,1045,1421
14155,12116,2851,1,Personal,16,4,53096,16,4,54210,16,4,54907,16,4,55436,16,4,59049,12,19.1,-1.2967404,36.7361755,-1.2615983,36.8083096,50,3613,1114,1226
14156,13174,2801,3,Business,11,1,49953,11,1,49977,11,1,50426,11,1,50926,11,1,52627,12,27.8,-1.2595422,36.7871178,-1.3288576,36.8465936,622,1701,24,949
14157,11838,1133,3,Business,5,2,26738,5,2,28016,5,2,28353,5,2,28881,5,2,29420,3,17.8,-1.2579304,36.8019667,-1.2736095,36.8011282,116,539,1278,865
14158,17379,1329,3,Business,18,1,55347,18,1,55378,18,1,55444,18,1,55803,18,1,55853,2,31.0,-1.273056,36.811298,-1.2673838,36.8069481,19,50,31,425
14159,23869,1148,3,Business,5,2,51858,5,2,53382,5,2,54389,5,2,55820,5,2,56945,9,23.25888921888938,-1.3100586,36.8500329,-1.2658335,36.8042867,61,1125,1524,2438
14160,14818,2106,1,Personal,20,3,30162,20,3,34549,20,3,35209,20,3,36519,20,3,37722,9,16.3,-1.2266581,36.844552,-1.2874648,36.8271985,661,1203,4387,1970
14161,19986,893,3,Business,7,2,50900,7,2,51047,7,2,52246,7,2,52366,7,2,55204,5,24.8,-1.2663194,36.809901,-1.2854193,36.8296162,519,2838,147,1319
14162,10840,3032,3,Business,12,1,41143,12,1,41228,12,1,42750,12,1,43166,12,1,46091,17,23.7,-1.2571472,36.7950633,-1.228394,36.9112672,108,2925,85,1938
14163,4117,3222,3,Business,28,4,52622,28,4,52662,28,4,53322,28,4,53440,28,4,54841,6,27.2,-1.2551895,36.7822034,-1.2833713,36.8233228,953,1401,40,778
14164,19146,1329,3,Business,14,5,60661,14,5,60979,14,5,61343,14,5,61480,14,5,64456,19,22.9,-1.273056,36.811298,-1.3677142,36.9136314,573,2976,318,501
14165,18297,1500,3,Business,7,2,40701,7,2,40977,7,2,41861,7,2,41954,7,2,43016,9,23.25888921888938,-1.2638185,36.7930057,-1.3004062,36.829741,161,1062,276,977
14166,6974,478,3,Business,4,4,53014,4,4,53058,4,4,53230,4,4,53383,4,4,55817,8,24.8,-1.2551895,36.7822034,-1.2864733,36.8239937,31,2434,44,325
14167,20449,635,3,Business,2,5,33346,2,5,34668,2,5,38269,2,5,38593,2,5,41834,17,23.6,-1.177202,36.8351183,-1.2599563,36.7993439,802,3241,1322,3925
14168,3441,12,3,Business,5,3,34759,5,3,36219,5,3,38881,5,3,39225,5,3,40295,9,22.1,-1.240021,36.84999,-1.2864963,36.8252086,320,1070,1460,3006
14169,5288,393,3,Business,26,2,36876,26,2,36887,26,2,36892,26,2,37186,26,2,37824,4,23.25888921888938,-1.3167113,36.8301563,-1.3004062,36.829741,15,638,11,299
14170,25837,1329,3,Business,29,2,55683,29,2,58090,29,2,58330,29,2,58739,29,2,60515,10,27.2,-1.273056,36.811298,-1.2835228,36.7437619,607,1776,2407,649
14171,9940,346,3,Business,13,3,50851,13,3,51692,13,3,52127,13,3,53930,13,3,54728,6,23.7,-1.2551895,36.7822034,-1.2885529,36.8160141,268,798,841,2238
14172,17312,2801,3,Business,31,4,57659,31,4,57683,31,4,58185,31,4,58577,31,4,58589,2,28.6,-1.2595422,36.7871178,-1.2635744,36.781677,598,12,24,894
14173,5670,2330,3,Business,27,1,60730,27,1,60767,27,1,61719,27,1,62600,27,1,63806,15,23.25888921888938,-1.2336843,36.8007259,-1.2687407,36.7373043,484,1206,37,1833
14174,14024,1473,3,Business,29,1,47176,29,1,47251,29,1,49227,29,1,49301,29,1,51740,17,23.25888921888938,-1.2845683,36.8128703,-1.3700383,36.9190174,106,2439,75,2050
14175,3449,1568,3,Business,26,2,57520,26,2,57643,26,2,58526,26,2,59045,26,2,60758,9,29.5,-1.2346044,36.8461804,-1.2421591,36.8939721,8,1713,123,1402
14176,16355,2183,3,Business,28,2,38087,28,2,38151,28,2,38730,28,2,39093,28,2,41469,12,17.8,-1.2551895,36.7822034,-1.3135294,36.8531378,50,2376,64,942
14177,15351,640,3,Business,16,2,58404,16,2,58545,16,2,59267,16,2,59527,16,2,60470,2,23.25888921888938,-1.289809,36.7938311,-1.2969741,36.7856612,245,943,141,982
14178,8800,1133,3,Business,20,3,39241,20,3,39284,20,3,39685,20,3,39938,20,3,41194,9,26.2,-1.2975066,36.7689423,-1.2571472,36.7950633,761,1256,43,654
14179,4488,2956,3,Business,11,4,59314,11,4,59390,11,4,59617,11,4,60452,11,4,61651,5,26.7,-1.279395,36.825364,-1.2584143,36.8048002,576,1199,76,1062
14180,7624,2523,3,Business,30,4,44389,30,4,44411,30,4,45084,30,4,46039,30,4,47585,13,23.25888921888938,-1.2551895,36.7822034,-1.3083777,36.8590077,448,1546,22,1628
14181,1909,391,3,Business,5,1,45553,5,1,47024,5,1,48912,5,1,49014,5,1,49799,5,25.9,-1.2777924,36.8231577,-1.3016417,36.8271679,237,785,1471,1990
14182,12141,393,3,Business,10,1,35123,10,1,35139,10,1,35297,10,1,36118,10,1,37579,11,16.4,-1.3228003,36.8306435,-1.2638185,36.7930057,36,1461,16,979
14183,1466,1838,3,Business,14,2,50028,14,2,50063,14,2,50543,14,2,50838,14,2,52061,4,23.25888921888938,-1.2649605,36.7981777,-1.2899256,36.815551,341,1223,35,775
14184,28227,71,3,Business,12,1,55207,12,1,56353,12,1,56356,12,1,58133,12,1,59513,11,27.0,-1.2283403,36.8822756,-1.2891922,36.825189,403,1380,1146,1780
14185,13264,635,3,Business,13,3,54781,13,3,54806,13,3,55374,13,3,57682,13,3,59038,10,27.1,-1.3081376,36.8329772,-1.2602337,36.7990548,283,1356,25,2876
14186,14263,867,3,Business,3,1,47214,3,1,57014,3,1,57348,3,1,57923,3,1,59448,10,23.4,-1.2996533,36.8292629,-1.306378,36.7519845,762,1525,9800,909
14187,11250,3393,1,Personal,22,3,55256,22,3,55581,22,3,55975,22,3,57403,22,3,57979,5,25.8,-1.278612,36.8195876,-1.2682179,36.8009289,956,576,325,1822
14188,13114,2931,3,Business,5,2,43270,5,2,43303,5,2,43961,5,2,44144,5,2,46969,22,25.4,-1.2452664,36.8028541,-1.3433181,36.9138018,318,2825,33,841
14189,21289,3291,3,Business,17,1,36288,17,1,36298,17,1,36357,17,1,37276,17,1,41075,12,19.1,-1.228911,36.881876,-1.2600926,36.8088685,669,3799,10,978
14190,19360,2436,3,Business,8,5,51693,8,5,51716,8,5,52802,8,5,53079,8,5,54878,15,30.4,-1.2551895,36.7822034,-1.3194911,36.7200853,770,1799,23,1363
14191,8231,631,1,Personal,23,3,33919,23,3,34598,23,3,35766,23,3,36386,23,3,37939,14,16.8,-1.2750282,36.8532236,-1.2124619,36.8739332,103,1553,679,1788
14192,2296,136,3,Business,25,2,47837,25,2,47869,25,2,48389,25,2,49385,25,2,50951,9,27.3,-1.2950413,36.7651697,-1.2773427,36.8266035,846,1566,32,1516
14193,13703,265,3,Business,28,4,40788,28,4,40808,28,4,41166,28,4,42836,28,4,45293,16,28.1,-1.300921,36.828195,-1.3882008,36.7699445,519,2457,20,2028
14194,16917,391,3,Business,3,4,26940,3,4,27960,3,4,28746,3,4,29416,3,4,30062,5,17.1,-1.2777924,36.8231577,-1.3007481,36.8341778,644,646,1020,1456
14195,10727,1085,3,Business,5,1,38308,5,1,38314,5,1,38600,5,1,38871,5,1,41199,18,24.6,-1.2628638,36.8070399,-1.3169591,36.7000029,902,2328,6,557
14196,25007,3689,3,Business,5,2,61399,5,2,64579,5,2,65618,5,2,66558,5,2,67767,6,21.4,-1.2793686,36.8259233,-1.2601709,36.8002238,742,1209,3180,1979
14197,22007,3291,3,Business,16,2,40722,16,2,43798,16,2,44497,16,2,46284,16,2,47371,12,23.25888921888938,-1.331619,36.847976,-1.2600926,36.8088685,119,1087,3076,2486
14198,8463,2763,3,Business,13,3,47723,13,3,47803,13,3,48786,13,3,49686,13,3,51418,13,27.0,-1.2551895,36.7822034,-1.326825,36.864345,931,1732,80,1883
14199,19364,3487,3,Business,26,5,34938,26,5,35025,26,5,35980,26,5,36301,26,5,39658,12,23.25888921888938,-1.3472066,36.7692638,-1.279395,36.825364,506,3357,87,1276
14200,9481,3491,3,Business,23,3,50584,23,3,50696,23,3,52143,23,3,52294,23,3,54300,16,22.0,-1.214328,36.7911903,-1.2297202,36.8745508,581,2006,112,1598
14201,19319,2474,1,Personal,7,6,57067,7,6,57100,7,6,58561,7,6,59531,7,6,61894,16,20.9,-1.2780878,36.8469436,-1.2643343,36.7447423,6,2363,33,2431
14202,3278,2464,3,Business,31,5,56666,31,5,57482,31,5,59022,31,5,59453,31,5,61497,4,24.9,-1.2658424,36.8101804,-1.279395,36.825364,79,2044,816,1971
14203,26352,2132,3,Business,11,4,46335,11,4,47015,11,4,48963,11,4,49201,11,4,53494,14,26.8,-1.2384056,36.8718698,-1.2981102,36.8293513,279,4293,680,2186
14204,11861,3108,3,Business,9,4,35000,9,4,35174,9,4,37965,9,4,38682,9,4,41098,10,23.6,-1.2551895,36.7822034,-1.314309,36.8392657,770,2416,174,3508
14205,18953,1720,3,Personal,2,1,54986,2,1,55340,2,1,57213,2,1,57437,2,1,60159,15,19.9,-1.2866269,36.8246368,-1.320321,36.7195522,905,2722,354,2097
14206,171,3295,3,Business,29,1,28753,29,1,31890,29,1,33155,29,1,33563,29,1,34591,7,18.9,-1.2814233,36.8251177,-1.2571472,36.7950633,795,1028,3137,1673
14207,14147,1280,3,Business,3,1,52670,3,1,53359,3,1,54109,3,1,54417,3,1,55337,4,23.2,-1.2551895,36.7822034,-1.269534,36.80697,228,920,689,1058
14208,2380,1850,3,Business,25,4,56398,25,4,56725,25,4,57432,25,4,57853,25,4,58920,8,23.25888921888938,-1.2551895,36.7822034,-1.3047132,36.8089553,710,1067,327,1128
14209,20655,704,3,Business,8,5,57437,8,5,58838,8,5,58849,8,5,59193,8,5,61491,13,21.7,-1.2860183,36.8975338,-1.3700383,36.9190174,852,2298,1401,355
14210,21093,111,3,Business,6,1,54405,6,1,54464,6,1,54819,6,1,55068,6,1,55577,4,23.25888921888938,-1.2551895,36.7822034,-1.2675613,36.8133001,598,509,59,604
14211,24639,2412,3,Business,16,5,62184,16,5,63368,16,5,63507,16,5,64009,16,5,66945,11,26.3,-1.2297202,36.8819507,-1.2836183,36.8297208,19,2936,1184,641
14212,4176,3618,3,Personal,7,1,33712,7,1,33818,7,1,35462,7,1,35760,7,1,36506,2,18.3,-1.279285,36.8260574,-1.2842286,36.8150609,742,746,106,1942
14213,24701,3470,3,Business,16,6,55060,16,6,55136,16,6,56038,16,6,56754,16,6,57864,4,23.25888921888938,-1.2659914,36.8283655,-1.28878,36.8168312,795,1110,76,1618
14214,28066,432,3,Business,27,3,55209,27,3,55271,27,3,56029,27,3,56149,27,3,58457,9,29.6,-1.3165542,36.700067,-1.3012008,36.764868,226,2308,62,878
14215,5509,2532,3,Business,23,3,49485,23,3,49979,23,3,52341,23,3,53600,23,3,56299,6,22.0,-1.2579304,36.8019667,-1.2824911,36.8218042,116,2699,494,3621
14216,15511,3154,1,Business,9,2,38580,9,2,38639,9,2,40140,9,2,40300,9,2,42584,17,21.8,-1.3326173,36.7146233,-1.2697141,36.7981777,565,2284,59,1661
14217,12258,1882,3,Business,21,4,67111,21,4,68449,21,4,69768,21,4,70135,21,4,71276,7,28.4,-1.2958783,36.7928125,-1.2588775,36.8079744,269,1141,1338,1686
14218,22135,1739,1,Personal,8,3,45458,8,3,45488,8,3,46524,8,3,47294,8,3,48538,12,22.0,-1.3232881,36.8537357,-1.2855153,36.7834515,101,1244,30,1806
14219,20118,198,3,Business,14,1,41345,14,1,41376,14,1,42116,14,1,43726,14,1,44761,8,23.5,-1.3396256,36.8863135,-1.318729,36.8401589,31,1035,31,2350
14220,22848,1346,3,Business,19,2,53567,19,2,53584,19,2,53856,19,2,54085,19,2,54118,2,30.1,-1.2917868,36.7872675,-1.2985749,36.8088,634,33,17,501
14221,15811,3688,3,Business,12,2,38765,12,2,38777,12,2,38783,12,2,39638,12,2,40774,4,24.7,-1.2551895,36.7822034,-1.2668454,36.7940642,952,1136,12,861
14222,15269,2685,1,Personal,31,2,49152,31,2,49338,31,2,51165,31,2,52978,31,2,55302,22,22.0,-1.3433181,36.9138018,-1.2899,36.7794355,456,2324,186,3640
14223,27879,830,3,Business,15,1,60650,15,1,60682,15,1,61236,15,1,61854,15,1,63937,21,23.25888921888938,-1.2551895,36.7822034,-1.3632162,36.9108253,812,2083,32,1172
14224,25728,929,2,Personal,19,4,42624,19,4,42642,19,4,44305,19,4,44750,19,4,48664,16,20.3,-1.3616128,36.7393753,-1.2911739,36.7614223,939,3914,18,2108
14225,3179,3676,3,Personal,30,4,33715,30,4,33831,30,4,36797,30,4,37381,30,4,40241,22,19.2,-1.353656,36.75865,-1.2263155,36.7994199,538,2860,116,3550
14226,18645,1522,3,Business,12,3,38789,12,3,39050,12,3,39088,12,3,39994,12,3,40303,1,19.4,-1.2571472,36.7950633,-1.2584143,36.8048002,427,309,261,944
14227,2379,1797,1,Personal,26,4,56344,26,4,56409,26,4,57173,26,4,57290,26,4,57881,5,22.2,-1.2902633,36.782965,-1.301796,36.8012024,312,591,65,881
14228,19246,2271,3,Business,7,6,45067,7,6,47539,7,6,47744,7,6,49964,7,6,51222,12,21.2,-1.228911,36.881876,-1.293515,36.897607,192,1258,2472,2425
14229,17496,1568,3,Business,19,1,47628,19,1,48700,19,1,48831,19,1,49481,19,1,50869,5,25.0,-1.2897368,36.8226783,-1.2666695,36.8328283,477,1388,1072,781
14230,14651,2138,2,Personal,13,4,52387,13,4,52404,13,4,52652,13,4,53114,13,4,55059,17,26.6,-1.29702,36.788216,-1.2016352,36.8200903,465,1945,17,710
14231,6963,2112,3,Business,13,3,52792,13,3,53022,13,3,53138,13,3,53880,13,3,55223,12,29.1,-1.279395,36.825364,-1.2156006,36.8916865,845,1343,230,858
14232,21663,3079,1,Personal,3,4,29459,3,4,30030,3,4,31080,3,4,31372,3,4,32613,5,17.5,-1.273056,36.811298,-1.2969293,36.8027733,241,1241,571,1342
14233,18305,3201,3,Business,7,4,40944,7,4,41029,7,4,41965,7,4,42413,7,4,45475,9,27.4,-1.2765736,36.8513646,-1.2584143,36.8048002,79,3062,85,1384
14234,187,3414,1,Personal,10,1,32156,10,1,32200,10,1,33588,10,1,34669,10,1,36337,8,18.0,-1.3173869,36.8112044,-1.2993094,36.7772069,328,1668,44,2469
14235,21871,635,3,Business,29,5,54406,29,5,54470,29,5,54817,29,5,55095,29,5,56653,16,29.1,-1.2602337,36.7990548,-1.2434951,36.6760986,279,1558,64,625
14236,5228,3491,3,Business,26,2,42619,26,2,42685,26,2,43042,26,2,45548,26,2,47462,11,27.5,-1.290894,36.822971,-1.2283403,36.8822756,329,1914,66,2863
14237,16957,2589,3,Personal,9,2,44702,9,2,44862,9,2,46520,9,2,46636,9,2,47575,4,22.0,-1.2825816,36.8092346,-1.289795,36.7957132,749,939,160,1774
14238,24783,1443,1,Personal,12,4,53127,12,4,53682,12,4,54714,12,4,55442,12,4,55966,6,21.5,-1.3154433,36.806386,-1.2962832,36.7849683,445,524,555,1760
14239,2284,2987,3,Business,3,1,43049,3,1,43072,3,1,44687,3,1,44938,3,1,46417,13,20.7,-1.270212,36.8210877,-1.2927792,36.9053492,4,1479,23,1866
14240,18604,237,3,Business,30,5,38523,30,5,38631,30,5,38989,30,5,39646,30,5,40593,10,23.7,-1.2597436,36.8282526,-1.2551895,36.7822034,453,947,108,1015
14241,15702,1500,3,Business,7,2,33570,7,2,33651,7,2,34313,7,2,35761,7,2,35870,8,23.25888921888938,-1.3004062,36.829741,-1.2638185,36.7930057,403,109,81,2110
14242,25679,2412,3,Business,27,4,32004,27,4,32680,27,4,33796,27,4,34668,27,4,35403,5,18.7,-1.2156006,36.8916865,-1.2297202,36.8819507,704,735,676,1988
14243,1558,778,3,Business,8,5,33355,8,5,33424,8,5,33952,8,5,34169,8,5,35277,8,23.0,-1.2535486,36.7933541,-1.2490885,36.8313166,885,1108,69,745
14244,22992,1646,3,Business,23,4,48076,23,4,48132,23,4,48698,23,4,49501,23,4,49905,3,24.5,-1.2611987,36.8060913,-1.2517448,36.7924971,344,404,56,1369
14245,25443,2634,3,Business,30,4,41955,30,4,41955,30,4,42192,30,4,42262,30,4,44076,15,23.25888921888938,-1.215326,36.8919938,-1.3094235,36.87,71,1814,0,307
14246,9882,1402,3,Business,13,4,44388,13,4,44586,13,4,44592,13,4,45308,13,4,48290,16,22.1,-1.288924,36.831527,-1.3297531,36.7063699,338,2982,198,722
14247,23872,136,3,Business,28,1,49392,28,1,50679,28,1,52055,28,1,52196,28,1,55098,16,26.2,-1.3254522,36.7216584,-1.281614,36.8275424,332,2902,1287,1517
14248,10055,1402,3,Business,3,5,34737,3,5,34859,3,5,36680,3,5,36745,3,5,38412,8,23.25888921888938,-1.2813012,36.8323962,-1.2551895,36.7822034,624,1667,122,1886
14249,1789,1874,3,Business,21,4,52288,21,4,52464,21,4,53305,21,4,53626,21,4,55742,5,26.5,-1.2571472,36.7950633,-1.2765676,36.8191974,411,2116,176,1162
14250,17877,1964,3,Personal,17,5,47600,17,5,47682,17,5,47925,17,5,48402,17,5,49335,11,23.25888921888938,-1.2977387,36.8031447,-1.32671,36.8600138,564,933,82,720
14251,27595,784,1,Personal,4,1,42640,4,1,42663,4,1,42682,4,1,43420,4,1,45288,19,21.2,-1.2770071,36.832167,-1.3565067,36.9062082,397,1868,23,757
14252,2945,2454,3,Business,14,5,43961,14,5,44984,14,5,45817,14,5,46137,14,5,46873,3,21.5,-1.2941792,36.7633637,-1.2993231,36.7753372,383,736,1023,1153
14253,8181,302,3,Business,27,6,57443,27,6,58032,27,6,58451,27,6,58882,27,6,60086,2,23.25888921888938,-1.2649605,36.7981777,-1.2661981,36.8154712,949,1204,589,850
14254,18091,3515,1,Personal,3,7,60041,3,7,60065,3,7,60541,3,7,60640,3,7,61879,6,20.8,-1.3054651,36.8845286,-1.2871568,36.8638193,890,1239,24,575
14255,24009,3474,3,Personal,3,3,55616,3,3,56186,3,3,57233,3,3,58012,3,3,58941,8,27.0,-1.2942764,36.7969749,-1.2653185,36.8358841,427,929,570,1826
14256,23017,944,1,Personal,2,4,41159,2,4,45941,2,4,46447,2,4,46884,2,4,47930,10,22.3,-1.255597,36.830024,-1.235348,36.760016,409,1046,4782,943
14257,8250,3525,3,Business,20,3,40731,20,3,40754,20,3,41465,20,3,41646,20,3,43004,13,27.3,-1.3700383,36.9190174,-1.3239488,36.8316835,584,1358,23,892
14258,12814,1964,3,Personal,5,2,39425,5,2,39463,5,2,39690,5,2,39973,5,2,40894,9,25.3,-1.32671,36.8600138,-1.29658,36.823699,425,921,38,510
14259,11839,2216,3,Business,1,4,51909,1,4,51954,1,4,52250,1,4,52710,1,4,54337,14,23.25888921888938,-1.2551895,36.7822034,-1.329568,36.8520825,450,1627,45,756
14260,14038,2956,3,Business,17,5,44335,17,5,44358,17,5,44920,17,5,46009,17,5,47902,17,23.25888921888938,-1.3165542,36.700067,-1.2584143,36.8048002,205,1893,23,1651
14261,14496,3673,1,Personal,12,5,38292,12,5,38298,12,5,38690,12,5,38997,12,5,39792,8,24.5,-1.32571,36.805533,-1.3196809,36.8410572,785,795,6,699
14262,12252,3450,3,Business,7,2,47934,7,2,47997,7,2,50938,7,2,51385,7,2,53728,14,23.25888921888938,-1.3352545,36.8659639,-1.2657464,36.7801144,911,2343,63,3388
14263,3811,1207,3,Business,8,6,40393,8,6,40539,8,6,41672,8,6,43404,8,6,46124,14,18.2,-1.2628638,36.8070399,-1.2156719,36.7990906,523,2720,146,2865
14264,2537,3091,3,Business,11,4,50335,11,4,53552,11,4,56206,11,4,57418,11,4,58396,6,27.0,-1.3147074,36.811722,-1.290894,36.822971,907,978,3217,3866
14265,2583,1850,3,Business,13,2,57687,13,2,58640,13,2,59251,13,2,59334,13,2,61586,9,26.3,-1.290894,36.822971,-1.2859912,36.8756811,622,2252,953,694
14266,2331,3295,3,Business,28,2,33967,28,2,33977,28,2,34013,28,2,34893,28,2,36799,14,18.6,-1.2571472,36.7950633,-1.3312396,36.8575323,177,1906,10,916
14267,26838,2330,3,Business,7,2,55303,7,2,55414,7,2,55438,7,2,55542,7,2,57160,7,23.25888921888938,-1.2890715,36.8157588,-1.294597,36.7742999,796,1618,111,128
14268,23935,2528,3,Business,4,4,30820,4,4,30839,4,4,31575,4,4,34029,4,4,34790,3,22.0,-1.2584143,36.8048002,-1.2551895,36.7822034,953,761,19,3190
14269,20116,145,1,Personal,6,3,47317,6,3,49063,6,3,50024,6,3,50537,6,3,52211,9,21.8,-1.2871938,36.8195031,-1.3271931,36.8452457,360,1674,1746,1474
14270,5671,2330,3,Business,19,2,36865,19,2,36881,19,2,37041,19,2,37533,19,2,38289,6,21.1,-1.2915247,36.8055757,-1.3015197,36.7658456,327,756,16,652
14271,19612,268,3,Business,28,4,31948,28,4,31969,28,4,33214,28,4,33287,28,4,34235,13,22.7,-1.3211235,36.7765164,-1.3263105,36.8622904,328,948,21,1318
14272,21437,1245,3,Business,23,2,54393,23,2,55020,23,2,56036,23,2,57528,23,2,60146,19,23.25888921888938,-1.300921,36.828195,-1.3198615,36.7110323,506,2618,627,2508
14273,23699,496,3,Business,31,3,43897,31,3,43905,31,3,44255,31,3,45322,31,3,47882,22,24.9,-1.2571472,36.7950633,-1.374163,36.913444,647,2560,8,1417
14274,2536,1705,3,Business,7,5,43628,7,5,44304,7,5,44329,7,5,44829,7,5,47221,12,24.9,-1.2551895,36.7822034,-1.3078018,36.849149,848,2392,676,525
14275,7672,1342,3,Business,25,3,47000,25,3,47021,25,3,47280,25,3,47668,25,3,50138,9,23.25888921888938,-1.3025826,36.7670807,-1.2620912,36.8013562,140,2470,21,647
14276,26163,1271,3,Business,18,2,35855,18,2,35861,18,2,35865,18,2,36272,18,2,38033,18,16.4,-1.3244885,36.897792,-1.254191,36.8099132,874,1761,6,411
14277,18371,54,2,Personal,2,2,64411,2,2,64452,2,2,65681,2,2,66145,2,2,66868,2,23.6,-1.2870045,36.7737096,-1.2991247,36.7642354,328,723,41,1693
14278,22186,393,3,Business,16,3,40720,16,3,40737,16,3,40741,16,3,41556,16,3,41973,4,22.6,-1.3167113,36.8301563,-1.3004062,36.829741,555,417,17,819
14279,5048,510,3,Business,11,4,61130,11,4,61435,11,4,62468,11,4,62946,11,4,65428,12,26.3,-1.279395,36.825364,-1.2860183,36.8975338,404,2482,305,1511
14280,5737,1490,1,Personal,25,3,60871,25,3,60903,25,3,61483,25,3,62002,25,3,63158,7,17.6,-1.2975039,36.8110959,-1.2681004,36.7952081,229,1156,32,1099
14281,6704,3602,3,Business,19,2,55258,19,2,56177,19,2,58188,19,2,58300,19,2,60859,20,29.9,-1.3929354,36.7640148,-1.2895725,36.775179,468,2559,919,2123
14282,15821,329,3,Personal,13,5,52021,13,5,52130,13,5,54281,13,5,54726,13,5,57815,17,19.1,-1.2866269,36.8246368,-1.3610501,36.7520889,844,3089,109,2596
14283,9821,970,3,Business,27,3,51011,27,3,51022,27,3,51156,27,3,51506,27,3,52110,3,29.7,-1.2551895,36.7822034,-1.2629594,36.8077626,708,604,11,484
14284,25294,685,3,Business,7,2,53293,7,2,53332,7,2,54434,7,2,54685,7,2,59222,24,23.25888921888938,-1.2726506,36.7960153,-1.34364,36.8925345,161,4537,39,1353
14285,12024,246,3,Business,12,6,45753,12,6,45858,12,6,46472,12,6,46585,12,6,47867,5,23.25888921888938,-1.2584143,36.8048002,-1.2857548,36.819062,575,1282,105,727
14286,18593,2990,1,Personal,16,4,42478,16,4,42510,16,4,42914,16,4,44549,16,4,45150,4,14.9,-1.2814031,36.8201647,-1.3047026,36.8172033,906,601,32,2039
14287,6456,839,1,Personal,24,1,55815,24,1,55825,24,1,55993,24,1,56176,24,1,57149,6,23.25888921888938,-1.2682179,36.8009289,-1.3038156,36.8122733,795,973,10,351
14288,4642,49,3,Business,28,3,33719,28,3,34060,28,3,35924,28,3,37007,28,3,37593,5,20.5,-1.329449,36.890451,-1.3508657,36.9019028,113,586,341,2947
14289,11191,1035,1,Personal,3,3,45968,3,3,46029,3,3,46171,3,3,47198,3,3,48695,8,24.2,-1.2626765,36.795599,-1.2991116,36.7960658,215,1497,61,1169
14290,6095,517,3,Business,28,5,38564,28,5,38570,28,5,38692,28,5,39047,28,5,39665,4,23.6,-1.3167113,36.8301563,-1.3004062,36.829741,523,618,6,477
14291,5998,111,3,Business,15,4,53184,15,4,53222,15,4,53767,15,4,53859,15,4,54675,4,27.4,-1.2551895,36.7822034,-1.2707177,36.8009828,259,816,38,637
14292,25739,2216,3,Business,3,1,52347,3,1,59372,3,1,59512,3,1,60359,3,1,62114,9,22.6,-1.2867627,36.883446,-1.3265961,36.8718676,19,1755,7025,987
14293,3527,3449,1,Personal,19,2,31622,19,2,31816,19,2,33155,19,2,34442,19,2,35483,10,15.4,-1.2689559,36.8097614,-1.266748,36.741316,101,1041,194,2626
14294,17135,1075,3,Business,7,4,51079,7,4,51128,7,4,51155,7,4,52081,7,4,52083,2,31.0,-1.2527958,36.8003131,-1.2685707,36.8064961,807,2,49,953
14295,24461,1687,3,Business,20,1,53984,20,1,54015,20,1,54917,20,1,55896,20,1,56891,7,23.25888921888938,-1.2626574,36.8014034,-1.2726755,36.7754049,956,995,31,1881
14296,14843,1075,3,Business,21,1,48176,21,1,50868,21,1,51993,21,1,52843,21,1,56089,17,27.8,-1.2852569,36.8976121,-1.2527958,36.8003131,19,3246,2692,1975
14297,23081,1389,3,Business,6,4,61873,6,4,62253,6,4,62305,6,4,63316,6,4,64968,14,22.6,-1.2232123,36.8932547,-1.207546,36.7913976,79,1652,380,1063
14298,28165,391,3,Business,11,2,52211,11,2,52533,11,2,52535,11,2,53812,11,2,53921,4,21.2,-1.2867454,36.8259017,-1.300921,36.828195,41,109,322,1279
14299,405,1287,3,Business,20,3,53162,20,3,53172,20,3,55022,20,3,55415,20,3,58421,29,29.5,-1.2551895,36.7822034,-1.417211,36.9594104,770,3006,10,2243
14300,6810,3127,3,Business,17,1,44339,17,1,44596,17,1,46471,17,1,46625,17,1,48187,5,23.8,-1.2918246,36.801585,-1.298744,36.8178237,436,1562,257,2029
14301,6557,1864,2,Personal,19,5,39173,19,5,39184,19,5,39636,19,5,40316,19,5,42542,16,24.9,-1.2626765,36.795599,-1.3189979,36.7104076,731,2226,11,1132
14302,12544,3517,3,Business,31,4,45723,31,4,45835,31,4,46542,31,4,49039,31,4,50546,15,22.9,-1.300921,36.828195,-1.3882008,36.7699445,808,1507,112,3204
14303,8109,510,3,Business,19,1,52202,19,1,52239,19,1,52245,19,1,54543,19,1,56977,13,25.4,-1.2860183,36.8975338,-1.3189252,36.8617269,402,2434,37,2304
14304,2847,2763,3,Business,16,4,40276,16,4,40373,16,4,40782,16,4,41274,16,4,42378,8,14.8,-1.2551895,36.7822034,-1.29387,36.7907813,229,1104,97,901
14305,8077,1724,3,Business,2,3,35865,2,3,35874,2,3,35915,2,3,36444,2,3,36446,2,19.8,-1.2551895,36.7822034,-1.2571472,36.7950633,647,2,9,570
14306,22481,2803,3,Business,30,2,39887,30,2,39919,30,2,41858,30,2,42782,30,2,44704,17,22.1,-1.269767,36.7351068,-1.2765736,36.8513646,336,1922,32,2863
14307,316,393,3,Business,31,3,31302,31,3,31678,31,3,31706,31,3,32596,31,3,35193,14,19.1,-1.3177547,36.8303703,-1.306378,36.7519845,97,2597,376,918
14308,16204,1075,3,Business,4,5,42402,4,5,42509,4,5,44348,4,5,45236,4,5,46477,8,17.5,-1.2765736,36.8513646,-1.2527958,36.8003131,101,1241,107,2727
14309,26231,633,3,Business,22,4,41009,22,4,42409,22,4,43095,22,4,43214,22,4,43919,4,22.4,-1.3077869,36.8443207,-1.3004062,36.829741,581,705,1400,805
14310,2900,2982,3,Business,30,4,37547,30,4,40323,30,4,41520,30,4,43201,30,4,45683,18,23.25888921888938,-1.300921,36.828195,-1.177202,36.8351183,416,2482,2776,2878
14311,27692,1500,3,Business,15,3,59010,15,3,59032,15,3,59323,15,3,59511,15,3,61913,9,25.8,-1.2638185,36.7930057,-1.3004062,36.829741,690,2402,22,479
14312,18654,2998,1,Personal,13,5,39262,13,5,41855,13,5,42331,13,5,42463,13,5,43405,6,23.25888921888938,-1.2617342,36.7927233,-1.2858323,36.8299948,786,942,2593,608
14313,4993,1205,3,Business,21,4,45532,21,4,45575,21,4,46010,21,4,46208,21,4,47209,4,25.0,-1.2495931,36.8065087,-1.2575407,36.7868197,428,1001,43,633
14314,24486,53,3,Business,28,4,49745,28,4,49774,28,4,49780,28,4,51317,28,4,52385,5,27.2,-1.3004062,36.829741,-1.2770708,36.8231093,809,1068,29,1543
14315,23253,635,3,Business,27,4,56238,27,4,56255,27,4,57075,27,4,57821,27,4,58896,9,25.3,-1.2365703,36.8054368,-1.2602337,36.7990548,882,1075,17,1566
14316,20007,134,3,Business,28,4,44200,28,4,44267,28,4,44836,28,4,45167,28,4,46862,16,27.9,-1.2609745,36.7886626,-1.207546,36.7913976,523,1695,67,900
14317,26946,2423,3,Business,27,5,44870,27,5,44875,27,5,45331,27,5,45666,27,5,47309,6,22.3,-1.2571472,36.7950633,-1.300722,36.816865,933,1643,5,791
14318,7541,914,3,Business,8,4,51687,8,4,51788,8,4,52569,8,4,53590,8,4,56972,21,27.1,-1.400779,36.763071,-1.2670213,36.7994482,845,3382,101,1802
14319,3073,868,3,Business,30,3,47996,30,3,48132,30,3,48648,30,3,49156,30,3,50071,5,25.3,-1.2600926,36.8088685,-1.265715,36.823815,742,915,136,1024
14320,28225,138,3,Business,27,1,42148,27,1,42223,27,1,42919,27,1,43128,27,1,44174,6,21.0,-1.2883,36.8167842,-1.2615888,36.7928732,341,1046,75,905
14321,9395,3078,1,Personal,3,5,57095,3,5,57289,3,5,58505,3,5,59358,3,5,60635,6,25.1,-1.255597,36.830024,-1.2906502,36.814118,263,1277,194,2069
14322,15987,2216,3,Business,16,1,46993,16,1,47006,16,1,47256,16,1,48018,16,1,49442,10,19.2,-1.2551895,36.7822034,-1.2287282,36.8115304,951,1424,13,1012
14323,11343,2987,3,Business,5,2,63835,5,2,64477,5,2,65114,5,2,66036,5,2,66544,4,21.4,-1.3014461,36.7661381,-1.3043821,36.7840586,116,508,642,1559
14324,8797,1280,3,Business,6,4,59050,6,4,59081,6,4,59101,6,4,59663,6,4,62095,5,22.3,-1.2551895,36.7822034,-1.2708788,36.7661155,875,2432,31,582
14325,350,2801,3,Business,14,3,32733,14,3,32783,14,3,33131,14,3,33747,14,3,34320,4,18.4,-1.2595422,36.7871178,-1.2664428,36.809453,125,573,50,964
14326,7588,1179,3,Business,21,1,46307,21,1,46316,21,1,48258,21,1,48434,21,1,50132,21,25.6,-1.3700383,36.9190174,-1.2917868,36.7872675,456,1698,9,2118
14327,23737,136,3,Business,12,5,42392,12,5,42424,12,5,43511,12,5,44448,12,5,48312,28,24.3,-1.3094447,36.9107706,-1.3326173,36.7146233,328,3864,32,2024
14328,5004,867,3,Business,13,3,46643,13,3,46690,13,3,46752,13,3,49497,13,3,50959,10,29.2,-1.2996533,36.8292629,-1.2991441,36.7528804,206,1462,47,2807
14329,15874,3283,3,Business,30,3,33708,30,3,33729,30,3,34694,30,3,36727,30,3,37953,14,19.6,-1.228911,36.881876,-1.2628473,36.781805,691,1226,21,2998
14330,6889,391,3,Business,19,3,45021,19,3,46850,19,3,47272,19,3,48302,19,3,50328,5,22.0,-1.300921,36.828195,-1.2867454,36.8259017,276,2026,1829,1452
14331,21372,816,3,Business,22,5,48956,22,5,49170,22,5,49663,22,5,49915,22,5,52361,6,27.3,-1.2649605,36.7981777,-1.290894,36.822971,260,2446,214,745
14332,4398,1746,3,Business,20,1,45509,20,1,45526,20,1,47275,20,1,47444,20,1,49317,12,20.1,-1.3069686,36.8596454,-1.296797,36.7764525,402,1873,17,1918
14333,24359,718,3,Business,5,2,55339,5,2,56134,5,2,57335,5,2,58014,5,2,59595,8,27.3,-1.2551895,36.7822034,-1.2996363,36.8186864,513,1581,795,1880
14334,16920,3201,3,Business,21,5,60752,21,5,60901,21,5,61084,21,5,61773,21,5,62174,2,23.2,-1.2527958,36.8003131,-1.2584143,36.8048002,65,401,149,872
14335,7518,2627,3,Business,11,2,44942,11,2,45651,11,2,46364,11,2,48239,11,2,52712,21,19.2,-1.3562374,36.9042954,-1.2571472,36.7950633,202,4473,709,2588
14336,9407,1927,3,Business,4,2,52073,4,2,52139,4,2,52922,4,2,53238,4,2,55427,17,22.5,-1.3472066,36.7692638,-1.2551895,36.7822034,675,2189,66,1099
14337,888,1231,3,Business,7,3,51370,7,3,52417,7,3,52424,7,3,52910,7,3,52916,2,28.1,-1.2821422,36.8161565,-1.290894,36.822971,351,6,1047,493
14338,27277,1927,3,Business,8,6,40194,8,6,40898,8,6,41442,8,6,41515,8,6,42966,10,18.2,-1.3052491,36.8223899,-1.3472066,36.7692638,477,1451,704,617
14339,6303,1304,3,Business,21,3,58041,21,3,58374,21,3,61396,21,3,61630,21,3,66028,14,23.25888921888938,-1.2551895,36.7822034,-1.2998685,36.8643907,547,4398,333,3256
14340,9433,271,1,Personal,6,6,57871,6,6,57918,6,6,58948,6,6,59950,6,6,61931,22,25.1,-1.2857764,36.8236622,-1.2491258,36.6894253,933,1981,47,2032
14341,15743,3108,3,Business,13,3,47081,13,3,47568,13,3,47589,13,3,49070,13,3,51439,9,27.3,-1.2551895,36.7822034,-1.3069127,36.8351372,406,2369,487,1502
14342,24207,2200,3,Business,7,5,34123,7,5,35152,7,5,36302,7,5,36714,7,5,38385,9,20.4,-1.2859912,36.8756811,-1.290894,36.822971,404,1671,1029,1562
14343,22450,3372,3,Business,10,5,38490,10,5,38507,10,5,38896,10,5,39097,10,5,40628,12,19.3,-1.2297202,36.8819507,-1.2143387,36.7914548,648,1531,17,590
14344,9579,1271,3,Business,6,4,54068,6,4,56792,6,4,58128,6,4,58715,6,4,59304,5,23.6,-1.3244885,36.897792,-1.3123977,36.902807,890,589,2724,1923
14345,8615,2200,3,Business,12,1,42856,12,1,44019,12,1,44129,12,1,44247,12,1,44261,2,24.0,-1.28878,36.8168312,-1.290894,36.822971,436,14,1163,228
14346,18929,3688,3,Business,2,2,38501,2,2,38622,2,2,39040,2,2,39452,2,2,40374,9,26.1,-1.3004846,36.7901591,-1.2571472,36.7950633,315,922,121,830
14347,4525,2801,3,Business,13,3,33747,13,3,33757,13,3,33840,13,3,34045,13,3,35324,9,20.0,-1.2674274,36.7870827,-1.2945074,36.8083195,576,1279,10,288
14348,13229,2904,3,Personal,11,1,44012,11,1,44339,11,1,45357,11,1,45443,11,1,49148,13,17.9,-1.3565822,36.7437878,-1.2970896,36.7771786,890,3705,327,1104
14349,23410,2178,1,Personal,13,4,42779,13,4,43059,13,4,44662,13,4,45294,13,4,45805,4,23.4,-1.2998552,36.8187077,-1.2815172,36.8336326,179,511,280,2235
14350,8289,1926,3,Business,21,4,40154,21,4,40177,21,4,41148,21,4,41694,21,4,43841,16,28.2,-1.3263105,36.8622904,-1.2843046,36.7746132,516,2147,23,1517
14351,2937,272,3,Personal,7,5,66102,7,5,66190,7,5,67070,7,5,67185,7,5,69663,11,21.3,-1.2979634,36.7719936,-1.3428522,36.7087888,643,2478,88,995
14352,938,301,3,Personal,26,2,39374,26,2,41328,26,2,42395,26,2,42876,26,2,44092,8,23.25888921888938,-1.3711733,36.7319722,-1.31754,36.70131,549,1216,1954,1548
14353,23009,2801,3,Business,3,1,39724,3,1,39749,3,1,40575,3,1,41435,3,1,41853,3,22.1,-1.2529635,36.7885404,-1.2595422,36.7871178,717,418,25,1686
14354,10784,2330,3,Business,24,4,39970,24,4,39987,24,4,40510,24,4,40657,24,4,41573,4,24.7,-1.2326041,36.8009029,-1.2533885,36.8165128,882,916,17,670
14355,14516,2112,3,Business,29,4,57003,29,4,57046,29,4,58119,29,4,58544,29,4,60227,15,24.8,-1.3277669,36.8975169,-1.2156006,36.8916865,675,1683,43,1498
14356,17801,439,3,Business,3,4,35228,3,4,35251,3,4,35368,3,4,36136,3,4,38708,11,20.3,-1.2884799,36.8217918,-1.3323107,36.8692616,88,2572,23,885
14357,26929,1329,3,Business,12,5,42598,12,5,42648,12,5,43140,12,5,43219,12,5,45529,15,26.5,-1.273056,36.811298,-1.2272149,36.7119796,660,2310,50,571
14358,18631,3222,3,Business,27,2,54017,27,2,54296,27,2,55367,27,2,55471,27,2,56114,4,25.5,-1.2551895,36.7822034,-1.2753109,36.8130185,547,643,279,1175
14359,1953,1410,3,Business,1,5,46610,1,5,48205,1,5,49904,1,5,50421,1,5,52393,21,31.7,-1.2847613,36.967084,-1.300921,36.828195,933,1972,1595,2216
14360,10445,3701,3,Business,12,3,43494,12,3,43505,12,3,44652,12,3,45632,12,3,46811,7,23.2,-1.261143,36.826916,-1.2684239,36.7952462,674,1179,11,2127
14361,8452,633,3,Business,4,1,35958,4,1,35977,4,1,36147,4,1,36461,4,1,38223,9,21.8,-1.2638185,36.7930057,-1.3004062,36.829741,245,1762,19,484
14362,1630,1014,1,Business,8,1,45317,8,1,45522,8,1,45708,8,1,46369,8,1,47603,6,24.7,-1.2590031,36.8078168,-1.2733546,36.7696069,848,1234,205,847
14363,16491,635,3,Business,5,2,30297,5,2,31290,5,2,33640,5,2,34461,5,2,36856,10,17.5,-1.3016417,36.8271679,-1.2599563,36.7993439,100,2395,993,3171
14364,3274,2982,3,Business,14,1,40517,14,1,41507,14,1,43848,14,1,45214,14,1,49351,24,23.7,-1.177202,36.8351183,-1.325469,36.862403,75,4137,990,3707
14365,15124,3599,3,Business,2,4,42625,2,4,42958,2,4,45843,2,4,46076,2,4,48448,12,23.25888921888938,-1.3302996,36.8707935,-1.3209614,36.7808827,864,2372,333,3118
14366,22062,2423,3,Business,29,5,51713,29,5,52165,29,5,52953,29,5,53103,29,5,55878,8,21.0,-1.2551895,36.7822034,-1.2945074,36.8083195,875,2775,452,938
14367,15676,2069,3,Business,25,2,42411,25,2,42449,25,2,43284,25,2,44550,25,2,47062,13,24.0,-1.307143,36.825009,-1.228911,36.881876,882,2512,38,2101
14368,18055,346,3,Business,30,3,47780,30,3,47864,30,3,48887,30,3,49507,30,3,50907,5,29.0,-1.2584143,36.8048002,-1.28878,36.8168312,404,1400,84,1643
14369,8203,2587,3,Business,30,1,43916,30,1,43925,30,1,45221,30,1,46139,30,1,49619,14,22.7,-1.3065979,36.7186349,-1.2885529,36.8160141,846,3480,9,2214
14370,5741,3291,3,Business,14,5,49465,14,5,49520,14,5,50376,14,5,50981,14,5,52416,12,22.9,-1.318062,36.849326,-1.2600926,36.8088685,270,1435,55,1461
14371,23996,1363,3,Business,13,6,43008,13,6,43022,13,6,43687,13,6,44069,13,6,44400,4,26.0,-1.3004062,36.829741,-1.2907474,36.8453439,291,331,14,1047
14372,12776,3283,3,Business,25,1,49019,25,1,49042,25,1,49088,25,1,49815,25,1,50958,4,28.0,-1.266837,36.799249,-1.2628473,36.781805,574,1143,23,773
14373,27494,3686,3,Business,28,1,52580,28,1,53003,28,1,53812,28,1,53900,28,1,55449,10,26.2,-1.2551895,36.7822034,-1.312469,36.815177,931,1549,423,897
14374,24859,3300,3,Business,16,4,54856,16,4,54975,16,4,54991,16,4,60140,16,4,60151,8,23.25888921888938,-1.307143,36.825009,-1.303596,36.778378,864,11,119,5165
14375,15241,496,3,Business,17,3,34358,17,3,34370,17,3,34482,17,3,34828,17,3,35206,2,23.25888921888938,-1.2551895,36.7822034,-1.2566078,36.7832089,535,378,12,458
14376,11569,1118,1,Personal,11,3,43341,11,3,45512,11,3,46621,11,3,47064,11,3,49639,7,19.0,-1.2857902,36.8316231,-1.3226567,36.8221416,281,2575,2171,1552
14377,2625,3758,1,Personal,26,2,56961,26,2,58388,26,2,59059,26,2,59295,26,2,61397,4,23.25888921888938,-1.279343,36.824395,-1.2771886,36.8419032,698,2102,1427,907
14378,26004,1809,3,Business,17,1,46370,17,1,46389,17,1,46656,17,1,47119,17,1,47121,2,23.8,-1.2584143,36.8048002,-1.2571472,36.7950633,647,2,19,730
14379,6379,2069,3,Business,30,6,50901,30,6,50944,30,6,51342,30,6,52018,30,6,53187,9,28.6,-1.265715,36.823815,-1.228911,36.881876,855,1169,43,1074
14380,18983,20,3,Business,5,2,56980,5,2,56994,5,2,58048,5,2,58568,5,2,60572,14,22.6,-1.2745321,36.765088,-1.3129873,36.8420022,852,2004,14,1574
14381,3088,2523,3,Business,15,5,41876,15,5,42085,15,5,43409,15,5,43610,15,5,46454,8,26.6,-1.2803414,36.8265456,-1.313063,36.8726225,686,2844,209,1525
14382,12352,2781,3,Personal,22,2,41924,22,2,41944,22,2,42549,22,2,43120,22,2,45377,16,19.5,-1.3043649,36.7816132,-1.3484124,36.6711807,755,2257,20,1176
14383,27318,3091,3,Business,28,5,46758,28,5,46815,28,5,47501,28,5,48472,28,5,49708,8,25.3,-1.2615888,36.7928732,-1.3012008,36.764868,770,1236,57,1657
14384,8610,2066,3,Business,15,4,43768,15,4,43787,15,4,43905,15,4,45881,15,4,50034,11,24.2,-1.3270716,36.8406371,-1.307764,36.895431,519,4153,19,2094
14385,18463,3560,3,Business,7,2,39324,7,2,40063,7,2,40497,7,2,41483,7,2,41959,1,23.1,-1.290894,36.822971,-1.279395,36.825364,670,476,739,1420
14386,22696,868,3,Business,5,2,46154,5,2,46318,5,2,47231,5,2,48141,5,2,49717,9,21.6,-1.318062,36.849326,-1.265715,36.823815,852,1576,164,1823
14387,6328,1116,2,Personal,10,5,48559,10,5,48604,10,5,48993,10,5,49858,10,5,49869,3,21.8,-1.26017,36.8097563,-1.2732317,36.7995587,832,11,45,1254
14388,4501,2112,3,Business,18,6,56445,18,6,56466,18,6,57698,18,6,58263,18,6,58921,4,20.6,-1.2297202,36.8819507,-1.2156006,36.8916865,384,658,21,1797
14389,14052,503,3,Business,18,5,46881,18,5,46891,18,5,46990,18,5,49818,18,5,50577,9,24.2,-1.2859912,36.8756811,-1.2860649,36.8306325,408,759,10,2927
14390,2455,2804,3,Business,29,2,32135,29,2,32155,29,2,32494,29,2,32790,29,2,33349,4,18.4,-1.2551895,36.7822034,-1.25681,36.7730826,50,559,20,635
14391,27196,2587,3,Business,10,4,58150,10,4,58250,10,4,58695,10,4,58923,10,4,59879,5,25.0,-1.2584143,36.8048002,-1.28878,36.8168312,467,956,100,673
14392,23601,1716,1,Personal,25,5,62871,25,5,62923,25,5,63371,25,5,64103,25,5,65794,9,21.1,-1.3276043,36.836922,-1.273009,36.802807,345,1691,52,1180
14393,3426,868,3,Business,16,1,48660,16,1,49778,16,1,50408,16,1,51731,16,1,53264,8,22.3,-1.303596,36.778378,-1.265715,36.823815,234,1533,1118,1953
14394,22995,2812,3,Personal,10,7,43010,10,7,43165,10,7,44139,10,7,44637,10,7,45750,9,17.7,-1.2577289,36.7410772,-1.2905046,36.7828277,334,1113,155,1472
14395,8590,3647,3,Business,6,4,44114,6,4,44147,6,4,44972,6,4,45314,6,4,46217,3,19.7,-1.272639,36.794723,-1.2667386,36.7937745,155,903,33,1167
14396,27303,2008,3,Business,26,2,53598,26,2,53672,26,2,54208,26,2,54665,26,2,55734,6,29.8,-1.2508229,36.7895263,-1.2596241,36.762407,958,1069,74,993
14397,26727,2182,1,Personal,31,2,43592,31,2,44509,31,2,45678,31,2,46229,31,2,49034,26,18.3,-1.4003836,36.7585447,-1.2355548,36.8474194,95,2805,917,1720
14398,18501,3149,3,Business,8,1,35874,8,1,35895,8,1,36055,8,1,36887,8,1,37542,5,22.0,-1.3004062,36.829741,-1.3167113,36.8301563,728,655,21,992
14399,863,3201,3,Business,29,4,38826,29,4,39271,29,4,39784,29,4,40080,29,4,41730,3,21.5,-1.2584143,36.8048002,-1.2551895,36.7822034,345,1650,445,809
14400,22576,3326,3,Business,26,2,41592,26,2,41602,26,2,41803,26,2,42096,26,2,42761,4,27.6,-1.2551895,36.7822034,-1.2585521,36.7945765,709,665,10,494
14401,9080,20,3,Business,6,6,55331,6,6,55352,6,6,55822,6,6,56266,6,6,58208,13,28.0,-1.2628638,36.8070399,-1.2264344,36.7071361,131,1942,21,914
14402,9100,3691,1,Business,11,5,55725,11,5,55781,11,5,56681,11,5,57582,11,5,58734,6,22.5,-1.255956,36.789867,-1.2651218,36.8228765,100,1152,56,1801
14403,6788,1674,1,Personal,31,4,57636,31,4,57686,31,4,58434,31,4,59954,31,4,61473,12,22.4,-1.2902869,36.8085396,-1.2343236,36.8861,379,1519,50,2268
14404,899,3689,3,Business,27,5,55183,27,5,55205,27,5,55215,27,5,55858,27,5,56660,3,24.2,-1.260232,36.807334,-1.2551895,36.7822034,74,802,22,653
14405,14069,540,3,Business,25,5,40389,25,5,40478,25,5,40898,25,5,41251,25,5,42329,8,26.5,-1.2551895,36.7822034,-1.2940713,36.7890758,663,1078,89,773
14406,9808,1500,3,Business,22,3,55200,22,3,56452,22,3,56851,22,3,57088,22,3,58507,9,24.4,-1.2638185,36.7930057,-1.2991441,36.7528804,263,1419,1252,636
14407,6732,1500,3,Business,27,3,34913,27,3,34957,27,3,34968,27,3,37228,27,3,37231,8,21.2,-1.3004062,36.829741,-1.2638185,36.7930057,613,3,44,2271
14408,27154,2277,3,Business,29,1,60507,29,1,60515,29,1,61119,29,1,61211,29,1,63061,14,23.3,-1.303637,36.8161168,-1.3204931,36.7043102,257,1850,8,696
14409,10462,1020,1,Personal,2,4,53237,2,4,53449,2,4,54901,2,4,55079,2,4,56222,7,26.2,-1.2764786,36.8194788,-1.312942,36.8152651,754,1143,212,1630
14410,7330,3496,3,Business,5,2,42569,5,2,42622,5,2,43181,5,2,43614,5,2,44115,5,21.6,-1.300921,36.828195,-1.332243,36.8068914,852,501,53,992
14411,167,2523,3,Business,31,4,45946,31,4,46323,31,4,47162,31,4,47435,31,4,50288,11,26.5,-1.2551895,36.7822034,-1.3233496,36.8139159,862,2853,377,1112
14412,26128,3115,1,Business,28,1,51090,28,1,52511,28,1,53631,28,1,53918,28,1,56300,23,24.5,-1.3160977,36.9131642,-1.2963097,36.7688221,543,2382,1421,1407
14413,21682,3486,3,Business,18,4,32158,18,4,33232,18,4,33644,18,4,33845,18,4,36620,7,20.8,-1.2551895,36.7822034,-1.2915969,36.8237639,208,2775,1074,613
14414,19126,2436,3,Business,26,2,54694,26,2,54724,26,2,55199,26,2,55345,26,2,58726,10,30.9,-1.2551895,36.7822034,-1.2300008,36.8043647,553,3381,30,621
14415,22292,2100,3,Business,22,1,43253,22,1,43266,22,1,43713,22,1,43942,22,1,45855,8,24.7,-1.2765736,36.8513646,-1.2597529,36.806629,328,1913,13,676
14416,6300,660,3,Personal,1,3,40575,1,3,40583,1,3,41321,1,3,42345,1,3,43387,7,20.0,-1.284282,36.8225455,-1.323971,36.8512242,414,1042,8,1762
14417,6940,3339,3,Business,17,1,36249,17,1,36425,17,1,37118,17,1,37412,17,1,38644,9,19.2,-1.2551895,36.7822034,-1.3084469,36.8263054,247,1232,176,987
14418,17593,186,3,Business,3,3,42813,3,3,42917,3,3,43809,3,3,44638,3,3,45299,4,27.4,-1.2571472,36.7950633,-1.2825816,36.8092346,448,661,104,1721
14419,10186,1927,3,Business,27,3,59367,27,3,59422,27,3,59979,27,3,63059,27,3,65542,19,27.6,-1.2927792,36.9053492,-1.3472066,36.7692638,883,2483,55,3637
14420,25591,2030,3,Business,26,1,34350,26,1,35234,26,1,36662,26,1,36746,26,1,37226,2,17.9,-1.270212,36.8210877,-1.2753109,36.8130185,259,480,884,1512
14421,8908,1245,3,Business,12,3,33404,12,3,33595,12,3,33824,12,3,34828,12,3,36827,17,16.5,-1.3198615,36.7110323,-1.2837255,36.8220797,726,1999,191,1233
14422,8163,1882,3,Business,22,4,61513,22,4,61593,22,4,62202,22,4,62777,22,4,64913,13,24.1,-1.2958783,36.7928125,-1.316704,36.699772,685,2136,80,1184
14423,3198,1724,3,Business,14,2,38798,14,2,38875,14,2,39457,14,2,39802,14,2,40450,4,23.25888921888938,-1.2551895,36.7822034,-1.2690013,36.8092872,247,648,77,927
14424,20236,1500,3,Business,14,2,57690,14,2,58006,14,2,58825,14,2,60302,14,2,62316,8,23.25888921888938,-1.3004062,36.829741,-1.2638185,36.7930057,709,2014,316,2296
14425,26330,3283,3,Business,21,4,50470,21,4,50480,21,4,50604,21,4,51721,21,4,52321,5,26.1,-1.2600926,36.8088685,-1.2628473,36.781805,383,600,10,1241
14426,8796,1340,3,Business,7,2,46048,7,2,46089,7,2,47310,7,2,48063,7,2,50028,13,23.1,-1.2707179,36.7979713,-1.2628424,36.8950641,937,1965,41,1974
14427,23061,659,3,Personal,18,4,48124,18,4,48188,18,4,48232,18,4,48768,18,4,48823,2,23.25888921888938,-1.2852584,36.8043641,-1.2945362,36.7928847,132,55,64,580
14428,16081,517,3,Business,16,6,29148,16,6,29167,16,6,30367,16,6,30724,16,6,31012,4,20.3,-1.3167113,36.8301563,-1.3004062,36.829741,127,288,19,1557
14429,25234,3647,3,Business,21,4,56515,21,4,56525,21,4,57189,21,4,57589,21,4,61347,19,26.2,-1.272639,36.794723,-1.3206433,36.9117533,523,3758,10,1064
14430,23134,893,3,Business,7,5,44780,7,5,44890,7,5,46602,7,5,46976,7,5,49052,21,25.1,-1.2663194,36.809901,-1.343439,36.912065,580,2076,110,2086
14431,3702,2918,3,Business,27,4,37138,27,4,37175,27,4,38045,27,4,38214,27,4,40584,16,22.6,-1.3339461,36.8219129,-1.2684443,36.7598788,16,2370,37,1039
14432,880,77,1,Personal,30,7,55106,30,7,56695,30,7,57923,30,7,58831,30,7,60721,8,27.0,-1.3064585,36.8119065,-1.288609,36.7829393,632,1890,1589,2136
14433,1133,1719,3,Business,29,3,43236,29,3,43240,29,3,43635,29,3,43785,29,3,45447,17,18.6,-1.3039411,36.7695316,-1.2330694,36.745451,425,1662,4,545
14434,19580,1687,3,Business,11,2,51616,11,2,51793,11,2,52961,11,2,53647,11,2,55053,12,22.4,-1.2626574,36.8014034,-1.2533046,36.886093,38,1406,177,1854
14435,11912,496,3,Business,5,3,53158,5,3,53179,5,3,53895,5,3,54624,5,3,56066,12,23.6,-1.3197099,36.8312312,-1.2551895,36.7822034,946,1442,21,1445
14436,26871,1271,3,Business,10,3,56504,10,3,56650,10,3,57292,10,3,57414,10,3,61612,23,30.7,-1.3244885,36.897792,-1.2784722,36.7556652,168,4198,146,764
14437,17468,2216,3,Business,29,1,38483,29,1,38514,29,1,38577,29,1,39429,29,1,40307,5,23.25888921888938,-1.2551895,36.7822034,-1.2745107,36.7974503,593,878,31,915
14438,11676,788,3,Business,9,5,48038,9,5,48142,9,5,48794,9,5,49921,9,5,51018,10,26.2,-1.225322,36.80855,-1.2653185,36.8358841,101,1097,104,1779
14439,10178,3082,1,Personal,26,6,37179,26,6,37206,26,6,37319,26,6,37531,26,6,38388,6,18.5,-1.2803499,36.8273403,-1.307774,36.8407541,100,857,27,325
14440,3731,2132,3,Business,14,4,51563,14,4,51617,14,4,52077,14,4,54335,14,4,55892,13,27.9,-1.2384056,36.8718698,-1.3160089,36.8551312,75,1557,54,2718
14441,600,3350,1,Personal,18,5,36788,18,5,39359,18,5,40315,18,5,40598,18,5,43245,6,21.3,-1.2626906,36.7827022,-1.2886385,36.8240195,742,2647,2571,1239
14442,2773,2271,3,Business,2,3,45049,2,3,45056,2,3,45062,2,3,45295,2,3,46229,12,21.8,-1.318062,36.849326,-1.293515,36.897607,408,934,7,239
14443,16468,3521,3,Business,4,4,32808,4,4,32824,4,4,33503,4,4,33763,4,4,35408,8,21.8,-1.3031971,36.7863146,-1.2696908,36.81519,548,1645,16,939
14444,11366,1482,3,Business,21,2,35641,21,2,35652,21,2,37708,21,2,37831,21,2,41079,15,23.25888921888938,-1.2649605,36.7981777,-1.338579,36.8963038,96,3248,11,2179
14445,4539,517,3,Business,9,5,45867,9,5,46424,9,5,46870,9,5,47266,9,5,48604,10,25.8,-1.3177547,36.8303703,-1.2574219,36.7927073,555,1338,557,842
14446,14075,84,3,Business,14,1,32804,14,1,32817,14,1,35059,14,1,35205,14,1,37984,23,20.4,-1.3632162,36.9108253,-1.2551895,36.7822034,346,2779,13,2388
14447,17420,136,3,Business,5,1,62694,5,1,63642,5,1,65061,5,1,65185,5,1,69011,18,24.4,-1.3326173,36.7146233,-1.256958,36.8144929,761,3826,948,1543
14448,21909,3194,3,Business,8,5,54195,8,5,54318,8,5,57416,8,5,57664,8,5,57711,8,30.4,-1.2551895,36.7822034,-1.2832259,36.7958373,425,47,123,3346
14449,15400,248,3,Business,3,3,37661,3,3,37696,3,3,42640,3,3,43196,3,3,43943,3,27.2,-1.2929747,36.7646358,-1.304735,36.7846054,362,747,35,5500
14450,21993,2956,3,Business,24,3,33685,24,3,34106,24,3,34864,24,3,37401,24,3,38662,6,23.25888921888938,-1.290894,36.822971,-1.2584143,36.8048002,263,1261,421,3295
14451,22844,972,3,Business,26,4,57763,26,4,57907,26,4,58453,26,4,58621,26,4,59927,11,21.9,-1.2862033,36.8152966,-1.3206958,36.8769553,857,1306,144,714
14452,7917,868,3,Business,23,4,54104,23,4,54487,23,4,56166,23,4,56745,23,4,57936,9,24.8,-1.318062,36.849326,-1.265715,36.823815,710,1191,383,2258
14453,1432,3727,3,Business,13,2,40014,13,2,40056,13,2,40561,13,2,40710,13,2,42281,8,22.4,-1.2963097,36.7688221,-1.2600616,36.7870182,57,1571,42,654
14454,17197,516,3,Business,30,2,44820,30,2,46718,30,2,47024,30,2,48082,30,2,50179,17,23.25888921888938,-1.2551895,36.7822034,-1.3339943,36.7263409,427,2097,1898,1364
14455,21330,1724,3,Business,9,4,37792,9,4,37810,9,4,38688,9,4,38926,9,4,40395,5,23.25888921888938,-1.2633393,36.7853172,-1.2571472,36.7950633,341,1469,18,1116
14456,9485,2069,3,Business,15,5,54556,15,5,54701,15,5,56388,15,5,59171,15,5,61113,12,27.9,-1.2600926,36.8088685,-1.228911,36.881876,210,1942,145,4470
14457,16798,1341,3,Business,23,6,39157,23,6,39253,23,6,39892,23,6,40244,23,6,41676,11,23.25888921888938,-1.272828,36.816608,-1.331619,36.847976,329,1432,96,991
14458,6016,1271,3,Business,14,3,44734,14,3,50206,14,3,50212,14,3,51238,14,3,52427,9,25.6,-1.3244885,36.897792,-1.2812821,36.8891847,179,1189,5472,1032
14459,12798,2840,1,Personal,13,5,43451,13,5,43458,13,5,43581,13,5,44339,13,5,45767,14,23.25888921888938,-1.289788,36.824911,-1.1994789,36.8167332,629,1428,7,881
14460,25952,393,3,Business,26,5,29967,26,5,33136,26,5,33514,26,5,34501,26,5,36923,14,23.25888921888938,-1.3177547,36.8303703,-1.306378,36.7519845,731,2422,3169,1365
14461,4576,3686,3,Business,20,3,47382,20,3,47410,20,3,47552,20,3,48032,20,3,49917,11,27.3,-1.2551895,36.7822034,-1.2381,36.732826,709,1885,28,622
14462,9604,20,3,Business,22,4,40948,22,4,41411,22,4,41849,22,4,42597,22,4,43905,9,22.4,-1.2648363,36.8023754,-1.3125593,36.8430941,878,1308,463,1186
14463,2357,2987,3,Business,18,1,55330,18,1,55334,18,1,55338,18,1,55921,18,1,56755,12,17.4,-1.270212,36.8210877,-1.2156006,36.8916865,886,834,4,587
14464,10744,3647,3,Business,21,4,60291,21,4,60330,21,4,60968,21,4,61703,21,4,62372,3,28.6,-1.272639,36.794723,-1.263453,36.7955612,177,669,39,1373
14465,3171,3432,3,Business,9,5,40155,9,5,40198,9,5,40608,9,5,43016,9,5,46555,3,25.7,-1.3139898,36.8676986,-1.3270347,36.8667362,56,3539,43,2818
14466,13211,2521,3,Business,10,5,49530,10,5,49541,10,5,49560,10,5,50648,10,5,51106,4,23.25888921888938,-1.3167113,36.8301563,-1.3004062,36.829741,349,458,11,1107
14467,20838,2066,3,Business,6,4,43016,6,4,43043,6,4,43194,6,4,43432,6,4,45304,10,22.0,-1.316961,36.820337,-1.2970279,36.761356,676,1872,27,389
14468,14870,1346,3,Business,8,2,56020,8,2,56217,8,2,57291,8,2,57379,8,2,58254,2,25.4,-1.2917868,36.7872675,-1.2985749,36.8088,38,875,197,1162
14469,10961,3291,3,Business,6,6,45855,6,6,45880,6,6,46951,6,6,48377,6,6,49870,11,26.5,-1.303596,36.778378,-1.2600926,36.8088685,855,1493,25,2497
14470,20698,2227,3,Personal,14,4,43640,14,4,44393,14,4,46412,14,4,46756,14,4,47826,10,19.1,-1.2541275,36.8263055,-1.2470959,36.8729823,820,1070,753,2363
14471,3050,467,3,Business,8,3,57505,8,3,57657,8,3,58890,8,3,59144,8,3,60553,12,23.25888921888938,-1.304735,36.7846054,-1.313266,36.6935289,161,1409,152,1487
14472,96,2330,3,Business,31,4,58226,31,4,58243,31,4,58794,31,4,59164,31,4,60565,8,28.8,-1.3270197,36.7037303,-1.3015197,36.7658456,831,1401,17,921
14473,24454,1920,3,Business,1,4,46895,1,4,46953,1,4,48132,1,4,48895,1,4,50091,9,23.25888921888938,-1.2551895,36.7822034,-1.2981352,36.8213822,932,1196,58,1942
14474,26256,186,3,Business,11,1,37559,11,1,37595,11,1,37811,11,1,38442,11,1,40158,20,26.6,-1.2571472,36.7950633,-1.3700383,36.9190174,786,1716,36,847
14475,13416,2869,3,Business,20,1,47776,20,1,47969,20,1,48063,20,1,48556,20,1,49608,9,23.25888921888938,-1.3025826,36.7670807,-1.290894,36.822971,855,1052,193,587
14476,1051,3091,3,Business,28,1,48127,28,1,48993,28,1,49883,28,1,50681,28,1,52839,19,24.7,-1.2927792,36.9053492,-1.3018758,36.7590863,888,2158,866,1688
14477,9146,3213,1,Personal,18,4,54669,18,4,54677,18,4,55188,18,4,55354,18,4,57159,20,26.7,-1.2270655,36.8809785,-1.3007534,36.7964576,281,1805,8,677
14478,9190,41,2,Personal,20,4,64119,20,4,64150,20,4,65213,20,4,65908,20,4,67515,10,25.0,-1.3171237,36.8393643,-1.2894031,36.7745653,848,1607,31,1758
14479,27097,1882,3,Business,8,2,45729,8,2,45898,8,2,47298,8,2,47842,8,2,48600,8,23.5,-1.2958783,36.7928125,-1.2588775,36.8079744,205,758,169,1944
14480,26197,1245,3,Business,26,2,45889,26,2,45902,26,2,45905,26,2,48433,26,2,50842,19,26.3,-1.300921,36.828195,-1.3198615,36.7110323,450,2409,13,2531
14481,15256,968,2,Personal,22,5,66965,22,5,66977,22,5,67226,22,5,67604,22,5,68050,3,23.25888921888938,-1.2584143,36.8048002,-1.2615888,36.7928732,103,446,12,627
14482,6921,2174,3,Business,17,5,42513,17,5,42518,17,5,42713,17,5,47228,17,5,49028,14,17.7,-1.2482781,36.884092,-1.25537,36.7756,946,1800,5,4710
14483,16231,3285,2,Personal,3,2,33395,3,2,34356,3,2,36278,3,2,36504,3,2,37353,4,15.5,-1.2817084,36.8143646,-1.2635425,36.8021963,752,849,961,2148
14484,6332,3204,1,Personal,18,3,50634,18,3,50648,18,3,51280,18,3,51706,18,3,55381,26,20.7,-1.2585705,36.7853303,-1.3002993,36.9153417,519,3675,14,1058
14485,25689,1367,3,Business,29,1,49260,29,1,49536,29,1,50575,29,1,53995,29,1,55953,23,24.2,-1.3285517,36.9018,-1.275442,36.7660207,164,1958,276,4459
14486,17238,1482,3,Business,6,2,52188,6,2,52324,6,2,52371,6,2,52944,6,2,54485,13,27.5,-1.338579,36.8963038,-1.2819448,36.8243884,648,1541,136,620
14487,16464,3661,3,Business,15,5,34802,15,5,34847,15,5,37170,15,5,37340,15,5,38138,6,19.4,-1.2132866,36.8678274,-1.2413316,36.8785525,812,798,45,2493
14488,16193,1384,3,Business,15,5,28053,15,5,28125,15,5,28627,15,5,28887,15,5,32378,12,19.1,-1.2517448,36.7924971,-1.3192764,36.8028521,108,3491,72,762
14489,12707,2330,3,Business,2,4,62007,2,4,62050,2,4,62733,2,4,63001,2,4,63617,3,23.25888921888938,-1.2921463,36.8029626,-1.3040812,36.7924217,76,616,43,951
14490,10025,3647,3,Business,13,4,55001,13,4,55051,13,4,55085,13,4,55781,13,4,55889,3,26.4,-1.272639,36.794723,-1.2615983,36.8083096,353,108,50,730
14491,6839,3017,1,Business,9,3,60688,9,3,60710,9,3,61241,9,3,61334,9,3,63042,7,21.9,-1.2991543,36.7827912,-1.2753109,36.8130185,761,1708,22,624
14492,1243,2735,3,Personal,30,3,38859,30,3,41176,30,3,41397,30,3,42279,30,3,43318,6,22.5,-1.2523599,36.8017648,-1.2966453,36.8191342,379,1039,2317,1103
14493,15287,3201,3,Business,19,3,48338,19,3,48348,19,3,48932,19,3,49526,19,3,49972,2,24.5,-1.2527958,36.8003131,-1.2584143,36.8048002,875,446,10,1178
14494,27811,1094,1,Business,28,4,49457,28,4,50980,28,4,51805,28,4,51886,28,4,53036,2,23.25888921888938,-1.2897368,36.8226783,-1.2795299,36.8223098,320,1150,1523,906
14495,8778,3017,3,Business,11,3,54633,11,3,55005,11,3,55432,11,3,55752,11,3,56283,4,20.4,-1.299313,36.7831488,-1.2940769,36.7491574,806,531,372,747
14496,18644,867,3,Business,5,3,32847,5,3,35850,5,3,36603,5,3,36984,5,3,38901,9,18.0,-1.2574219,36.7927073,-1.306378,36.7519845,631,1917,3003,1134
14497,12828,1280,3,Business,17,4,37859,17,4,37878,17,4,37890,17,4,38122,17,4,40018,15,25.5,-1.2551895,36.7822034,-1.3288106,36.8697344,630,1896,19,244
14498,11192,1408,1,Personal,9,2,37276,9,2,37288,9,2,37509,9,2,38691,9,2,39877,8,22.2,-1.2862659,36.8264616,-1.293886,36.7596951,88,1186,12,1403
14499,11069,1363,3,Business,4,5,34100,4,5,34970,4,5,35334,4,5,35396,4,5,36737,4,19.6,-1.3004062,36.829741,-1.3177547,36.8303703,753,1341,870,426
14500,8892,2583,3,Personal,26,5,53049,26,5,53204,26,5,54767,26,5,54945,26,5,55802,6,23.25888921888938,-1.2607569,36.7747575,-1.2744463,36.8132178,709,857,155,1741
14501,10279,2523,3,Business,13,1,33587,13,1,34109,13,1,34192,13,1,34701,13,1,36513,6,23.25888921888938,-1.2551895,36.7822034,-1.2904753,36.8144721,692,1812,522,592
14502,24891,478,1,Business,6,1,56143,6,1,56454,6,1,57147,6,1,57535,6,1,58103,2,24.7,-1.2621261,36.8079755,-1.263194,36.797624,520,568,311,1081
14503,10069,1108,3,Personal,10,3,64903,10,3,64911,10,3,65026,10,3,66447,10,3,66659,2,27.2,-1.2969741,36.7856612,-1.2963097,36.7688221,613,212,8,1536
14504,24344,2286,3,Personal,31,7,49766,31,7,50073,31,7,52846,31,7,53702,31,7,54703,10,30.3,-1.2073966,36.7917836,-1.2261247,36.7933019,870,1001,307,3629
14505,19875,3291,3,Business,22,3,40879,22,3,40953,22,3,41524,22,3,42003,22,3,42593,5,22.9,-1.2628473,36.781805,-1.2600926,36.8088685,651,590,74,1050
14506,13112,2829,3,Business,2,5,60077,2,5,61241,2,5,61315,2,5,61430,2,5,63077,6,24.0,-1.2571472,36.7950633,-1.2925919,36.8170577,761,1647,1164,189
14507,21782,2436,3,Business,2,5,55992,2,5,56237,2,5,56248,2,5,57225,2,5,58410,8,25.1,-1.2551895,36.7822034,-1.2925919,36.8170577,596,1185,245,988
14508,19877,3283,3,Business,11,4,42918,11,4,42939,11,4,43133,11,4,43719,11,4,44044,4,25.6,-1.266837,36.799249,-1.2628473,36.781805,147,325,21,780
14509,4517,3689,3,Business,20,3,49931,20,3,50043,20,3,51547,20,3,51773,20,3,52972,10,23.3,-1.3014461,36.7661381,-1.2601709,36.8002238,4,1199,112,1730
14510,11996,2523,3,Business,22,5,56221,22,5,56303,22,5,56961,22,5,57498,22,5,61229,8,27.5,-1.2551895,36.7822034,-1.2985749,36.8088,831,3731,82,1195
14511,26786,53,3,Business,1,5,36661,1,5,42862,1,5,43500,1,5,43751,1,5,45010,5,28.7,-1.2770708,36.8231093,-1.3004062,36.829741,674,1259,6201,889
14512,2543,2660,2,Personal,7,1,63074,7,1,63139,7,1,63775,7,1,64052,7,1,66480,15,19.8,-1.2596351,36.8063205,-1.326825,36.864345,789,2428,65,913
14513,18646,2812,3,Personal,20,3,35997,20,3,37927,20,3,38853,20,3,39147,20,3,40162,4,20.1,-1.264917,36.8150651,-1.2897399,36.8270975,338,1015,1930,1220
14514,8649,1535,1,Business,21,1,58251,21,1,58424,21,1,60263,21,1,60556,21,1,61937,7,23.25888921888938,-1.2897368,36.8226783,-1.2579304,36.8019667,844,1381,173,2132
14515,14311,2828,1,Business,18,6,61145,18,6,61154,18,6,61921,18,6,64003,18,6,66754,25,19.2,-1.264272,36.7978791,-1.3592118,36.6717545,427,2751,9,2849
14516,6076,3534,1,Personal,31,4,56145,31,4,56760,31,4,59269,31,4,59367,31,4,60266,8,23.1,-1.242265,36.8808728,-1.2021922,36.8904146,742,899,615,2607
14517,19674,533,3,Business,23,2,57178,23,2,57404,23,2,57453,23,2,58106,23,2,58924,6,19.0,-1.2551895,36.7822034,-1.2765492,36.7669809,107,818,226,702
14518,8319,830,3,Business,16,1,43905,16,1,44331,16,1,45083,16,1,45514,16,1,46567,8,19.3,-1.2551895,36.7822034,-1.2812845,36.8327127,726,1053,426,1183
14519,2568,2423,3,Business,14,4,55903,14,4,56043,14,4,56392,14,4,56749,14,4,57224,3,27.8,-1.2551895,36.7822034,-1.259919,36.808244,446,475,140,706
14520,12784,1616,1,Personal,31,5,57975,31,5,57989,31,5,58366,31,5,58587,31,5,60787,6,19.8,-1.2798072,36.8290023,-1.311706,36.802841,447,2200,14,598
14521,6907,1568,3,Business,28,1,52240,28,1,53485,28,1,54559,28,1,54770,28,1,56382,9,26.5,-1.2897368,36.8226783,-1.293049,36.87902,276,1612,1245,1285
14522,6500,1502,3,Business,12,2,42797,12,2,42950,12,2,43683,12,2,44398,12,2,45986,5,24.4,-1.2283403,36.8822756,-1.2232123,36.8932547,206,1588,153,1448
14523,25166,71,3,Business,21,1,35006,21,1,35801,21,1,36186,21,1,36670,21,1,40053,7,17.0,-1.2821108,36.8250555,-1.32751,36.828812,742,3383,795,869
14524,14800,2145,3,Personal,12,3,40030,12,3,40993,12,3,42873,12,3,43467,12,3,44580,6,19.6,-1.2752846,36.8027022,-1.2926564,36.7873181,547,1113,963,2474
14525,6536,478,3,Business,22,3,40742,22,3,43941,22,3,44718,22,3,45035,22,3,47654,6,23.3,-1.2551895,36.7822034,-1.2857095,36.8188266,155,2619,3199,1094
14526,21404,3283,3,Business,24,6,41538,24,6,41555,24,6,42774,24,6,43099,24,6,44107,13,24.2,-1.2296618,36.8438272,-1.2628473,36.781805,453,1008,17,1544
14527,3975,3300,3,Business,6,4,56511,6,4,56638,6,4,57264,6,4,58210,6,4,59804,7,21.5,-1.2628473,36.781805,-1.303596,36.778378,427,1594,127,1572
14528,6821,3221,3,Business,21,4,52590,21,4,52629,21,4,53470,21,4,53540,21,4,54753,5,30.8,-1.2737206,36.8072379,-1.2611818,36.8271669,434,1213,39,911
14529,23556,3201,3,Business,7,3,48742,7,3,48919,7,3,49894,7,3,52578,7,3,54416,5,28.3,-1.2857548,36.819062,-1.2584143,36.8048002,812,1838,177,3659
14530,27121,2532,3,Business,16,4,40642,16,4,40943,16,4,41289,16,4,43734,16,4,45210,8,23.25888921888938,-1.2551895,36.7822034,-1.2824911,36.8218042,868,1476,301,2791
14531,24881,136,3,Business,4,2,53185,4,2,53202,4,2,54297,4,2,54381,4,2,55758,16,23.7,-1.3233496,36.8139159,-1.3326173,36.7146233,263,1377,17,1179
14532,22759,1578,3,Business,28,1,48901,28,1,50469,28,1,50825,28,1,52115,28,1,53143,17,26.1,-1.3632162,36.9108253,-1.2859912,36.8756811,295,1028,1568,1646
14533,2866,3547,3,Business,14,5,35851,14,5,35860,14,5,38253,14,5,40093,14,5,43078,16,21.9,-1.3189252,36.8617269,-1.2856319,36.7672998,25,2985,9,4233
14534,18482,3149,3,Business,7,4,52255,7,4,52534,7,4,53166,7,4,55393,7,4,56053,5,27.9,-1.3004062,36.829741,-1.3167113,36.8301563,576,660,279,2859
14535,27046,3200,1,Personal,22,3,49977,22,3,50883,22,3,52315,22,3,52784,22,3,56080,36,25.6,-1.15393,36.936186,-1.274381,36.7272265,400,3296,906,1901
14536,3634,985,1,Personal,11,5,47901,11,5,47918,11,5,49869,11,5,50575,11,5,54763,14,22.5,-1.226218,36.849712,-1.3108368,36.8226308,100,4188,17,2657
14537,836,1342,3,Business,14,6,55040,14,6,55070,14,6,55245,14,6,55866,14,6,56809,10,19.3,-1.2584143,36.8048002,-1.3025826,36.7670807,116,943,30,796
14538,22164,136,3,Business,7,3,53470,7,3,53566,7,3,53568,7,3,54691,7,3,56509,16,28.3,-1.3254522,36.7216584,-1.2531983,36.8069669,813,1818,96,1125
14539,9589,2412,3,Business,17,3,57147,17,3,57289,17,3,58652,17,3,59179,17,3,59771,3,23.25888921888938,-1.2232123,36.8932547,-1.2283403,36.8822756,669,592,142,1890
14540,14550,970,3,Business,26,5,40851,26,5,40898,26,5,41378,26,5,41525,26,5,43132,9,23.25888921888938,-1.2551895,36.7822034,-1.3040651,36.7981254,161,1607,47,627
14541,10594,3677,3,Personal,1,1,58869,1,1,58994,1,1,59594,1,1,60642,1,1,61011,6,27.6,-1.2921983,36.7965431,-1.2728069,36.7962362,362,369,125,1648
14542,9811,795,3,Personal,15,2,42408,15,2,42465,15,2,43329,15,2,43401,15,2,45017,12,24.5,-1.3322618,36.8045412,-1.3104734,36.7363698,15,1616,57,936
14543,387,3647,3,Business,12,5,62915,12,5,62967,12,5,63533,12,5,63826,12,5,65614,15,26.7,-1.272639,36.794723,-1.2156006,36.8916865,576,1788,52,859
14544,16068,1075,3,Business,2,2,45536,2,2,45733,2,2,46767,2,2,47886,2,2,50199,6,26.3,-1.2904016,36.8226303,-1.2527958,36.8003131,740,2313,197,2153
14545,13775,391,3,Business,15,1,51444,15,1,51798,15,1,51824,15,1,53753,15,1,55076,5,23.25888921888938,-1.2784063,36.8222933,-1.3081376,36.8329772,613,1323,354,1955
14546,14269,393,3,Business,10,4,41989,10,4,42638,10,4,42667,10,4,42844,10,4,44733,4,24.6,-1.3167113,36.8301563,-1.3004062,36.829741,518,1889,649,206
14547,2895,1927,3,Business,7,5,53719,7,5,54162,7,5,54482,7,5,55154,7,5,56845,18,26.9,-1.2859912,36.8756811,-1.3472066,36.7692638,622,1691,443,992
14548,20177,868,3,Business,16,2,59787,16,2,59867,16,2,59922,16,2,60540,16,2,61459,7,23.25888921888938,-1.2628473,36.781805,-1.265715,36.823815,349,919,80,673
14549,26171,3426,3,Business,31,1,63030,31,1,63073,31,1,63471,31,1,63863,31,1,64575,2,22.5,-1.3012008,36.764868,-1.2881542,36.7616794,952,712,43,790
14550,2112,778,3,Business,31,3,50433,31,3,50660,31,3,51174,31,3,51345,31,3,52374,7,27.2,-1.2535486,36.7933541,-1.2717174,36.7753883,237,1029,227,685
14551,5719,2480,3,Personal,17,4,47702,17,4,47725,17,4,48313,17,4,48649,17,4,49670,9,22.4,-1.3024794,36.8228284,-1.3330427,36.8635157,676,1021,23,924
14552,7640,2506,3,Personal,13,3,34522,13,3,34597,13,3,34914,13,3,36851,13,3,38171,9,20.0,-1.289498,36.818878,-1.3263105,36.8622904,768,1320,75,2254
14553,3598,2457,3,Business,7,3,49536,7,3,49565,7,3,49776,7,3,49842,7,3,52610,14,28.2,-1.2551895,36.7822034,-1.329568,36.8520825,555,2768,29,277
14554,6523,265,3,Business,13,2,51974,13,2,52937,13,2,53714,13,2,54059,13,2,55122,7,26.4,-1.2599563,36.7993439,-1.300921,36.828195,744,1063,963,1122
14555,833,3016,1,Personal,9,3,36045,9,3,37088,9,3,37414,9,3,37576,9,3,38835,4,17.6,-1.269199,36.8236418,-1.273333,36.8122251,421,1259,1043,488
14556,17010,3621,3,Business,1,6,36231,1,6,36247,1,6,37554,1,6,37869,1,6,41072,26,18.6,-1.2836583,36.7886014,-1.1567082,36.9618034,227,3203,16,1622
14557,14268,1927,3,Business,4,2,51331,4,2,54405,4,2,55357,4,2,56352,4,2,59992,20,23.7,-1.3472066,36.7692638,-1.2413316,36.8785525,937,3640,3074,1947
14558,7222,2828,3,Business,6,2,66365,6,2,66404,6,2,66971,6,2,67564,6,2,73284,31,23.25888921888938,-1.2615888,36.7928732,-1.4196538,36.69308,38,5720,39,1160
14559,8479,1880,3,Business,24,4,40951,24,4,40963,24,4,40987,24,4,41500,24,4,43316,7,24.5,-1.2571472,36.7950633,-1.2948835,36.7830474,586,1816,12,537
14560,16442,2397,3,Personal,14,5,41497,14,5,41530,14,5,42017,14,5,42190,14,5,43167,4,24.4,-1.2788182,36.8206683,-1.2659573,36.8092527,434,977,33,660
14561,25029,393,3,Business,29,1,41333,29,1,41352,29,1,41478,29,1,42118,29,1,42683,4,23.25888921888938,-1.3167113,36.8301563,-1.3004062,36.829741,211,565,19,766
14562,25595,733,3,Business,18,2,38334,18,2,38397,18,2,40770,18,2,40940,18,2,43177,16,22.5,-1.2604833,36.7352777,-1.323682,36.708787,268,2237,63,2543
14563,24883,265,3,Business,25,4,42300,25,4,42357,25,4,42444,25,4,43612,25,4,44055,4,20.1,-1.300921,36.828195,-1.308231,36.857306,848,443,57,1255
14564,254,1713,2,Personal,23,3,46719,23,3,46840,23,3,48510,23,3,48701,23,3,50349,7,21.7,-1.3025643,36.8276716,-1.2741662,36.7969144,116,1648,121,1861
14565,14297,647,3,Business,3,3,43497,3,3,43547,3,3,43840,3,3,44130,3,3,45649,12,27.6,-1.2991441,36.7528804,-1.3004062,36.829741,545,1519,50,583
14566,22742,3149,3,Business,25,4,54215,25,4,54250,25,4,54334,25,4,56587,25,4,57071,5,23.25888921888938,-1.3004062,36.829741,-1.3167113,36.8301563,206,484,35,2337
14567,10455,276,2,Personal,18,1,48055,18,1,49153,18,1,49531,18,1,49846,18,1,52207,5,17.1,-1.2854453,36.8188363,-1.2509176,36.8246646,444,2361,1098,693
14568,13610,1075,3,Business,14,4,41691,14,4,42947,14,4,43373,14,4,43648,14,4,45976,18,23.9,-1.2527958,36.8003131,-1.2422942,36.6669445,351,2328,1256,701
14569,24420,1687,3,Business,12,2,35489,12,2,35964,12,2,36062,12,2,37221,12,2,37226,1,15.9,-1.2962832,36.7849683,-1.3025299,36.7901963,354,5,475,1257
14570,26847,3599,3,Business,6,1,51738,6,1,54084,6,1,54433,6,1,55308,6,1,57715,12,23.25888921888938,-1.3302996,36.8707935,-1.2922992,36.7983035,675,2407,2346,1224
14571,25903,3283,3,Business,21,4,51423,21,4,51438,21,4,51532,21,4,52136,21,4,52938,5,31.0,-1.2600926,36.8088685,-1.2628473,36.781805,575,802,15,698
14572,20544,478,3,Business,21,4,44222,21,4,44269,21,4,44906,21,4,46887,21,4,47951,2,28.2,-1.2715686,36.8023526,-1.2571472,36.7950633,462,1064,47,2618
14573,23277,393,3,Business,6,2,28195,6,2,30299,6,2,30312,6,2,33790,6,2,33801,4,19.9,-1.3177547,36.8303703,-1.3004062,36.829741,684,11,2104,3491
14574,26634,2112,3,Business,8,6,47161,8,6,47182,8,6,48189,8,6,48392,8,6,49454,5,19.9,-1.2285835,36.8826468,-1.2156006,36.8916865,152,1062,21,1210
14575,16805,3647,3,Business,18,4,35175,18,4,35198,18,4,35598,18,4,35711,18,4,36762,6,20.5,-1.272639,36.794723,-1.3004846,36.7901591,674,1051,23,513
14576,11348,2423,3,Business,27,3,54749,27,3,54794,27,3,55012,27,3,56200,27,3,57297,8,29.5,-1.2551895,36.7822034,-1.2967702,36.8040381,85,1097,45,1406
14577,10738,2200,3,Business,18,4,29336,18,4,31607,18,4,32291,18,4,33334,18,4,33485,2,20.8,-1.28878,36.8168312,-1.290894,36.822971,266,151,2271,1727
14578,9334,2330,3,Business,28,4,33376,28,4,33517,28,4,34007,28,4,34200,28,4,35581,6,22.7,-1.2990401,36.8116114,-1.2642903,36.8002137,803,1381,141,683
14579,14774,3222,3,Business,21,4,50394,21,4,50430,21,4,50928,21,4,51026,21,4,53078,8,26.3,-1.2551895,36.7822034,-1.3012619,36.8213697,761,2052,36,596
14580,11516,352,3,Personal,29,2,31922,29,2,33304,29,2,34455,29,2,34682,29,2,38576,7,16.7,-1.2866269,36.8246368,-1.3202277,36.8223638,906,3894,1382,1378
14581,10829,540,3,Business,7,1,46798,7,1,47299,7,1,47766,7,1,47926,7,1,49598,8,24.8,-1.2551895,36.7822034,-1.3027475,36.8178196,512,1672,501,627
14582,19930,1162,3,Business,20,3,34140,20,3,34194,20,3,35713,20,3,36211,20,3,37664,9,16.6,-1.312261,36.794658,-1.2663132,36.7955271,465,1453,54,2017
14583,24032,570,3,Business,18,2,40180,18,2,40205,18,2,40563,18,2,41350,18,2,45221,6,23.25888921888938,-1.2551895,36.7822034,-1.284382,36.7746045,720,3871,25,1145
14584,4042,1500,3,Business,18,1,43963,18,1,43990,18,1,44792,18,1,46251,18,1,47081,8,27.8,-1.3004062,36.829741,-1.2638185,36.7930057,61,830,27,2261
14585,9902,3688,3,Business,29,5,40366,29,5,40445,29,5,40785,29,5,40938,29,5,43528,21,26.9,-1.2551895,36.7822034,-1.2123576,36.6426562,763,2590,79,493
14586,19096,1131,3,Business,26,5,38273,26,5,38339,26,5,38716,26,5,39235,26,5,40953,15,23.25888921888938,-1.2869041,36.8240057,-1.207546,36.7913976,456,1718,66,896
14587,357,1882,3,Business,10,5,47267,10,5,47646,10,5,48763,10,5,49110,10,5,50442,9,23.25888921888938,-1.323615,36.700475,-1.3014461,36.7661381,572,1332,379,1464
14588,20163,269,3,Business,30,3,55485,30,3,55767,30,3,56007,30,3,56415,30,3,60751,22,25.0,-1.3332749,36.8708147,-1.3169591,36.7000029,890,4336,282,648
14589,27591,811,3,Personal,3,3,38480,3,3,38499,3,3,39489,3,3,39774,3,3,41207,11,23.9,-1.3295831,36.7388987,-1.2963097,36.7688221,844,1433,19,1275
14590,4561,190,3,Business,7,2,48049,7,2,48068,7,2,48145,7,2,49835,7,2,51221,9,23.25888921888938,-1.2820997,36.8163378,-1.3270347,36.8667362,564,1386,19,1767
14591,10523,265,3,Business,14,1,43911,14,1,43957,14,1,44276,14,1,44984,14,1,45975,8,23.3,-1.2633494,36.7959696,-1.300921,36.828195,882,991,46,1027
14592,9929,1500,3,Business,13,3,54710,13,3,54741,13,3,55251,13,3,58156,13,3,59631,8,29.1,-1.3004062,36.829741,-1.2638185,36.7930057,349,1475,31,3415
14593,10259,116,3,Personal,10,1,54945,10,1,55142,10,1,56100,10,1,56338,10,1,58257,14,18.1,-1.2201257,36.8115035,-1.2929587,36.783318,856,1919,197,1196
14594,13177,3613,3,Business,4,1,42125,4,1,42258,4,1,42928,4,1,43373,4,1,44981,9,26.4,-1.2733622,36.7704045,-1.3044313,36.818504,496,1608,133,1115
14595,18967,186,3,Business,10,2,44958,10,2,45039,10,2,46698,10,2,47141,10,2,48102,6,20.2,-1.2890399,36.8164942,-1.2571191,36.8019652,268,961,81,2102
14596,6350,53,3,Business,11,5,48023,11,5,48102,11,5,48576,11,5,50322,11,5,51026,6,26.6,-1.3077869,36.8443207,-1.2770708,36.8231093,576,704,79,2220
14597,8711,635,3,Business,20,1,50441,20,1,50470,20,1,51011,20,1,55513,20,1,55517,10,23.25888921888938,-1.3081376,36.8329772,-1.2602337,36.7990548,863,4,29,5043
14598,7061,1792,3,Business,22,2,52153,22,2,52161,22,2,53080,22,2,53241,22,2,55417,19,25.5,-1.2809121,36.7852524,-1.3094447,36.9107706,449,2176,8,1080
14599,23895,2174,3,Business,23,6,32208,23,6,32922,23,6,34767,23,6,37075,23,6,39152,6,18.9,-1.2482781,36.884092,-1.2241625,36.8851115,489,2077,714,4153
14600,21883,2200,3,Business,30,4,35948,30,4,36036,30,4,37924,30,4,39120,30,4,40383,9,23.25888921888938,-1.2859912,36.8756811,-1.290894,36.822971,183,1263,88,3084
14601,19069,2132,3,Business,1,5,30097,1,5,30151,1,5,30280,1,5,30961,1,5,34242,27,23.0,-1.2384056,36.8718698,-1.3858142,36.7641498,75,3281,54,810
14602,25551,3295,3,Business,22,3,41237,22,3,41360,22,3,43624,22,3,43815,22,3,46268,7,23.3,-1.2571472,36.7950633,-1.2965924,36.8179314,139,2453,123,2455
14603,10356,246,3,Business,2,2,45458,2,2,45511,2,2,45713,2,2,46074,2,2,46772,2,20.8,-1.2551895,36.7822034,-1.2584143,36.8048002,848,698,53,563
14604,27990,2532,3,Business,10,5,31490,10,5,31588,10,5,32585,10,5,33491,10,5,34763,6,23.25888921888938,-1.2571472,36.7950633,-1.2824911,36.8218042,491,1272,98,1903
14605,14287,1500,3,Business,16,6,32395,16,6,32417,16,6,32874,16,6,33769,16,6,34171,8,20.4,-1.3004062,36.829741,-1.2638185,36.7930057,119,402,22,1352
14606,8173,3517,3,Business,11,1,43194,11,1,43215,11,1,43686,11,1,46968,11,1,48894,16,18.0,-1.300921,36.828195,-1.3882008,36.7699445,340,1926,21,3753
14607,24238,391,3,Business,14,4,38116,14,4,39298,14,4,40451,14,4,40664,14,4,44390,18,23.9,-1.2867454,36.8259017,-1.3878505,36.7692885,365,3726,1182,1366
14608,9784,3222,3,Business,29,2,54615,29,2,54636,29,2,54658,29,2,55146,29,2,56760,11,27.2,-1.2551895,36.7822034,-1.2217967,36.81099,579,1614,21,510
14609,11579,3647,3,Business,12,3,60613,12,3,60711,12,3,61343,12,3,61543,12,3,63891,18,20.4,-1.272639,36.794723,-1.344748,36.745184,158,2348,98,832
14610,1720,2605,3,Business,30,3,52317,30,3,52351,30,3,52807,30,3,53102,30,3,54353,10,29.1,-1.3066143,36.8161046,-1.2571472,36.7950633,933,1251,34,751
14611,19591,375,3,Business,6,3,63353,6,3,63361,6,3,63372,6,3,63600,6,3,64437,3,26.0,-1.2551895,36.7822034,-1.2597367,36.7848482,445,837,8,239
14612,13603,517,3,Business,6,5,46888,6,5,48254,6,5,50603,6,5,54647,6,5,54655,8,22.6,-1.3177547,36.8303703,-1.2770708,36.8231093,333,8,1366,6393
14613,4540,3404,3,Business,29,6,43824,29,6,43850,29,6,44024,29,6,44335,29,6,45265,5,24.0,-1.2584143,36.8048002,-1.279395,36.825364,275,930,26,485
14614,16537,1498,3,Business,13,4,46073,13,4,46144,13,4,48056,13,4,48315,13,4,48952,2,22.1,-1.2538731,36.7850223,-1.2648024,36.7966196,155,637,71,2171
14615,13354,3674,3,Business,24,5,53625,24,5,54713,24,5,55381,24,5,55509,24,5,57161,12,23.2,-1.2551895,36.7822034,-1.3200694,36.7931306,205,1652,1088,796
14616,12791,1955,3,Business,26,1,54071,26,1,54135,26,1,55626,26,1,55688,26,1,57168,11,22.4,-1.2859912,36.8756811,-1.2962731,36.8111863,85,1480,64,1553
14617,17587,2330,3,Business,31,4,63480,31,4,64240,31,4,65280,31,4,65797,31,4,67283,9,27.5,-1.3999741,36.7519812,-1.3443583,36.7571528,328,1486,760,1557
14618,18845,3557,3,Business,19,3,41802,19,3,41822,19,3,42343,19,3,43139,19,3,43910,3,23.25888921888938,-1.2740396,36.7993518,-1.2546732,36.8086796,882,771,20,1317
14619,26601,2987,3,Business,23,2,38980,23,2,41413,23,2,42715,23,2,44077,23,2,45733,7,17.8,-1.270212,36.8210877,-1.3043821,36.7840586,713,1656,2433,2664
14620,23002,2582,3,Business,27,3,33308,27,3,33316,27,3,33617,27,3,34376,27,3,36477,18,23.25888921888938,-1.3356493,36.8927662,-1.2551895,36.7822034,379,2101,8,1060
14621,19739,393,3,Business,27,1,41946,27,1,42075,27,1,42563,27,1,44120,27,1,44333,11,20.9,-1.3228003,36.8306435,-1.2638185,36.7930057,2,213,129,2045
14622,1553,3147,3,Business,18,5,42539,18,5,43180,18,5,44575,18,5,45021,18,5,47742,18,21.2,-1.3467389,36.7690312,-1.2626906,36.7827022,290,2721,641,1841
14623,9025,835,3,Business,26,1,43824,26,1,43911,26,1,44879,26,1,45433,26,1,48076,20,22.9,-1.2917868,36.7872675,-1.3700383,36.9190174,647,2643,87,1522
14624,3500,752,3,Personal,24,4,34201,24,4,34832,24,4,35789,24,4,36135,24,4,37780,13,16.8,-1.2872996,36.8310969,-1.3191788,36.8895401,88,1645,631,1303
14625,25889,2412,3,Business,21,2,34145,21,2,34174,21,2,35399,21,2,36283,21,2,39435,11,23.25888921888938,-1.2283403,36.8822756,-1.290894,36.822971,686,3152,29,2109
14626,14784,2383,3,Business,17,3,41668,17,3,41768,17,3,42055,17,3,42390,17,3,42819,1,25.4,-1.2666153,36.8015124,-1.2608993,36.799246,726,429,100,622
14627,4769,246,3,Business,1,5,49497,1,5,50099,1,5,51779,1,5,52417,1,5,54087,15,28.6,-1.2156006,36.8916865,-1.2584143,36.8048002,237,1670,602,2318
14628,26075,2987,3,Business,7,1,45238,7,1,45276,7,1,45622,7,1,45856,7,1,47363,11,21.6,-1.270212,36.8210877,-1.3018758,36.7590863,923,1507,38,580
14629,4405,1342,3,Business,23,3,48367,23,3,48967,23,3,50015,23,3,50669,23,3,51759,4,22.0,-1.3025826,36.7670807,-1.2962832,36.7849683,890,1090,600,1702
14630,81,3339,3,Business,2,2,55098,2,2,55110,2,2,55648,2,2,55749,2,2,55751,2,29.2,-1.2551895,36.7822034,-1.2566586,36.7929682,405,2,12,639
14631,18773,2987,3,Business,18,3,41225,18,3,41300,18,3,41548,18,3,41841,18,3,42425,4,19.9,-1.270212,36.8210877,-1.260232,36.807334,100,584,75,541
14632,4049,2528,3,Business,8,5,52897,8,5,53278,8,5,53398,8,5,53490,8,5,53866,3,30.6,-1.2584143,36.8048002,-1.2551895,36.7822034,520,376,381,212
14633,12306,284,1,Personal,22,5,44579,22,5,44592,22,5,45880,22,5,46393,22,5,47903,10,21.6,-1.2602386,36.7503491,-1.2796316,36.8250415,844,1510,13,1801
14634,15807,3473,1,Personal,23,3,50164,23,3,50554,23,3,51123,23,3,51450,23,3,53750,9,22.4,-1.3312306,36.8563683,-1.2901786,36.824294,888,2300,390,896
14635,11029,2587,3,Business,3,3,50067,3,3,50547,3,3,51331,3,3,54312,3,3,55267,8,28.3,-1.3025826,36.7670807,-1.28878,36.8168312,291,955,480,3765
14636,18386,475,3,Business,5,1,53657,5,1,53674,5,1,53881,5,1,55981,5,1,58147,19,26.0,-1.2571472,36.7950633,-1.3339943,36.7263409,45,2166,17,2307
14637,25869,2174,3,Business,4,5,44178,4,5,44182,4,5,44309,4,5,46484,4,5,48489,17,17.1,-1.2482781,36.884092,-1.1689085,36.8212897,946,2005,4,2302
14638,9478,1721,3,Business,10,3,49552,10,3,49583,10,3,49713,10,3,49982,10,3,51712,10,30.7,-1.2551895,36.7822034,-1.2363748,36.8177502,709,1730,31,399
14639,19187,3669,3,Business,10,5,49671,10,5,51505,10,5,52177,10,5,53343,10,5,54534,4,23.25888921888938,-1.2615888,36.7928732,-1.2651643,36.8072214,675,1191,1834,1838
14640,7797,111,3,Business,22,5,45617,22,5,45641,22,5,45680,22,5,46002,22,5,46503,4,23.25888921888938,-1.2551895,36.7822034,-1.2747247,36.8150014,793,501,24,361
14641,25718,1085,3,Business,29,1,42690,29,1,43669,29,1,47033,29,1,47832,29,1,50811,25,23.25888921888938,-1.3869643,36.7387957,-1.2628638,36.8070399,817,2979,979,4163
14642,1871,186,3,Business,21,3,56945,21,3,57011,21,3,57025,21,3,58636,21,3,59297,4,23.1,-1.2571472,36.7950633,-1.2890399,36.8164942,848,661,66,1625
14643,20859,393,3,Business,18,4,59510,18,4,59533,18,4,60199,18,4,60984,18,4,60992,4,23.25888921888938,-1.3167113,36.8301563,-1.3004062,36.829741,710,8,23,1451
14644,9419,941,1,Personal,6,6,62861,6,6,62871,6,6,64310,6,6,64672,6,6,66682,19,25.2,-1.2807298,36.8299116,-1.282399,36.957033,208,2010,10,1801
14645,9661,3432,3,Business,5,6,40306,5,6,40333,5,6,40755,5,6,41069,5,6,42944,14,22.5,-1.2672588,36.8000252,-1.3291155,36.8861,103,1875,27,736
14646,11301,2260,1,Personal,21,5,42990,21,5,43013,21,5,43635,21,5,44095,21,5,46032,6,20.2,-1.2978908,36.7963215,-1.315756,36.813058,612,1937,23,1082
14647,24449,432,3,Business,16,2,60768,16,2,60793,16,2,61147,16,2,62094,16,2,64890,9,23.25888921888938,-1.3012008,36.764868,-1.2584143,36.8048002,507,2796,25,1301
14648,7278,136,3,Business,4,2,56594,4,2,56632,4,2,56886,4,2,57186,4,2,58313,8,23.9,-1.2962832,36.7849683,-1.2649605,36.7981777,454,1127,38,554
14649,9385,1927,3,Business,6,3,52617,6,3,52977,6,3,54201,6,3,54737,6,3,56619,12,23.25888921888938,-1.3472066,36.7692638,-1.2880129,36.8308097,278,1882,360,1760
14650,22071,2216,3,Business,22,2,53258,22,2,53482,22,2,54540,22,2,54937,22,2,56852,9,21.3,-1.2626906,36.7827022,-1.3038912,36.7961524,301,1915,224,1455
14651,21710,190,3,Business,14,5,53300,14,5,53339,14,5,53684,14,5,54065,14,5,55279,11,23.2,-1.2919479,36.7996653,-1.3270347,36.8667362,538,1214,39,726
14652,26856,265,3,Business,19,2,54267,19,2,54301,19,2,55278,19,2,55666,19,2,59128,16,29.4,-1.300921,36.828195,-1.2051859,36.836315,863,3462,34,1365
14653,27982,1990,3,Business,27,3,45166,27,3,45380,27,3,46165,27,3,47262,27,3,50629,10,26.1,-1.2767064,36.8227148,-1.275442,36.7660207,564,3367,214,1882
14654,11140,1075,3,Business,16,3,66208,16,3,66221,16,3,66448,16,3,66989,16,3,67441,3,23.5,-1.2527958,36.8003131,-1.2551895,36.7822034,72,452,13,768
14655,14218,1367,3,Business,6,4,45011,6,4,45031,6,4,46073,6,4,46838,6,4,49338,26,24.2,-1.275442,36.7660207,-1.3732935,36.9199406,222,2500,20,1807
14656,9342,480,1,Personal,8,1,57804,8,1,58772,8,1,59529,8,1,60066,8,1,60948,5,18.6,-1.3321944,36.8892329,-1.3278522,36.8711134,932,882,968,1294
14657,4599,1340,3,Business,13,4,36321,13,4,37120,13,4,38006,13,4,38197,13,4,39197,6,21.8,-1.2945798,36.7737755,-1.2707179,36.7979713,205,1000,799,1077
14658,3271,2271,3,Business,30,6,56107,30,6,57449,30,6,57455,30,6,58661,30,6,60961,14,23.8,-1.272828,36.816608,-1.293515,36.897607,886,2300,1342,1212
14659,22825,324,3,Personal,18,2,43575,18,2,43603,18,2,43840,18,2,44052,18,2,47405,15,23.25888921888938,-1.2653676,36.7911012,-1.332942,36.714065,167,3353,28,449
14660,19942,2521,3,Business,15,5,50339,15,5,53095,15,5,53099,15,5,56608,15,5,56611,8,28.0,-1.3167113,36.8301563,-1.2770708,36.8231093,39,3,2756,3513
14661,22139,2154,3,Business,18,5,51915,18,5,52902,18,5,54259,18,5,54427,18,5,55905,7,24.3,-1.2885529,36.8160141,-1.2626906,36.7827022,742,1478,987,1525
14662,24480,2154,3,Business,4,4,37430,4,4,37450,4,4,37934,4,4,39531,4,4,42221,15,25.4,-1.3472066,36.7692638,-1.2765736,36.8513646,693,2690,20,2081
14663,3159,2411,3,Business,10,4,60272,10,4,60303,10,4,60370,10,4,61441,10,4,63300,5,23.6,-1.2615888,36.7928732,-1.2763916,36.8246826,258,1859,31,1138
14664,4435,909,3,Business,2,3,55246,2,3,55421,2,3,57680,2,3,58294,2,3,58979,7,25.9,-1.207546,36.7913976,-1.225322,36.80855,870,685,175,2873
14665,21598,1920,3,Business,13,2,48670,13,2,49706,13,2,49890,13,2,50369,13,2,51912,10,26.3,-1.2551895,36.7822034,-1.2982578,36.8443952,518,1543,1036,663
14666,14630,2468,3,Business,17,3,33049,17,3,33066,17,3,33470,17,3,34123,17,3,35108,7,23.25888921888938,-1.2884231,36.7794566,-1.3127304,36.8189817,161,985,17,1057
14667,16844,3149,3,Business,30,2,42056,30,2,42199,30,2,42210,30,2,44178,30,2,44188,12,23.25888921888938,-1.3167113,36.8301563,-1.276954,36.765926,515,10,143,1979
14668,8143,246,3,Business,5,1,52732,5,1,52768,5,1,52940,5,1,54739,5,1,55028,1,26.2,-1.2571472,36.7950633,-1.2584143,36.8048002,846,289,36,1971
14669,5250,393,3,Business,18,4,51441,18,4,52447,18,4,53309,18,4,54048,18,4,55095,5,23.25888921888938,-1.3167113,36.8301563,-1.3077869,36.8443207,461,1047,1006,1601
14670,21946,1085,3,Business,11,5,42253,11,5,42323,11,5,42737,11,5,43028,11,5,44305,7,20.9,-1.2628638,36.8070399,-1.232864,36.8084708,279,1277,70,705
14671,446,393,3,Business,9,4,34838,9,4,34854,9,4,35044,9,4,36488,9,4,37381,4,23.25888921888938,-1.3167113,36.8301563,-1.3004062,36.829741,343,893,16,1634
14672,10612,868,3,Business,16,2,59755,16,2,59766,16,2,62114,16,2,62426,16,2,62984,4,23.25888921888938,-1.2600926,36.8088685,-1.265715,36.823815,547,558,11,2660
14673,26065,2330,3,Business,12,3,63561,12,3,63806,12,3,65896,12,3,66017,12,3,69521,6,20.7,-1.2921463,36.8029626,-1.3015197,36.7658456,233,3504,245,2211
14674,7869,1637,3,Business,26,5,44139,26,5,44882,26,5,44883,26,5,46676,26,5,48305,3,23.25888921888938,-1.2649605,36.7981777,-1.2615888,36.7928732,755,1629,743,1794
14675,22617,2377,3,Business,31,4,53340,31,4,53402,31,4,53824,31,4,54174,31,4,56748,16,28.7,-1.2963097,36.7688221,-1.2954158,36.8934011,276,2574,62,772
14676,26366,1724,3,Business,28,4,39179,28,4,39199,28,4,39397,28,4,40204,28,4,40871,7,28.2,-1.2626488,36.8239773,-1.2551895,36.7822034,62,667,20,1005
14677,20040,704,1,Business,5,5,47168,5,5,47173,5,5,47190,5,5,47301,5,5,49735,18,23.6,-1.2860183,36.8975338,-1.288501,36.784742,284,2434,5,128
14678,21059,2789,3,Business,15,2,63425,15,2,63453,15,2,63902,15,2,64253,15,2,65703,11,23.0,-1.304735,36.7846054,-1.3373345,36.7118861,246,1450,28,800
14679,4957,3517,3,Business,21,3,39826,21,3,40043,21,3,40646,21,3,43032,21,3,44537,15,21.9,-1.300921,36.828195,-1.3882008,36.7699445,715,1505,217,2989
14680,7972,3264,3,Business,13,3,52016,13,3,52048,13,3,52089,13,3,52582,13,3,53589,8,29.2,-1.2551895,36.7822034,-1.293679,36.767255,576,1007,32,534
14681,27771,2727,3,Personal,30,3,45094,30,3,45164,30,3,46008,30,3,48688,30,3,51333,12,24.9,-1.3155247,36.8484927,-1.2925556,36.7903149,519,2645,70,3524
14682,16456,645,1,Personal,10,1,58751,10,1,58807,10,1,59532,10,1,60278,10,1,61831,11,18.8,-1.2655306,36.828148,-1.3269776,36.8055554,427,1553,56,1471
14683,5416,2801,3,Business,15,1,43371,15,1,43418,15,1,44928,15,1,45062,15,1,46611,9,23.25888921888938,-1.307726,36.839117,-1.2595422,36.7871178,363,1549,47,1644
14684,17330,867,3,Business,15,6,41344,15,6,41353,15,6,41436,15,6,41861,15,6,43316,9,19.1,-1.2574219,36.7927073,-1.2991441,36.7528804,155,1455,9,508
14685,4779,2701,3,Business,5,3,38025,5,3,38305,5,3,39167,5,3,39282,5,3,41461,4,22.4,-1.2765736,36.8513646,-1.2857548,36.819062,660,2179,280,977
14686,16013,1453,3,Business,14,4,42848,14,4,46135,14,4,46870,14,4,46963,14,4,48172,9,19.2,-1.3169591,36.7000029,-1.3014461,36.7661381,636,1209,3287,828
14687,19296,1544,3,Business,6,3,39449,6,3,39574,6,3,40042,6,3,40213,6,3,41544,7,23.25888921888938,-1.2885029,36.825605,-1.2529072,36.8525066,953,1331,125,639
14688,871,186,3,Business,14,2,41741,14,2,43221,14,2,43710,14,2,44093,14,2,46727,23,23.25888921888938,-1.3700383,36.9190174,-1.2571472,36.7950633,690,2634,1480,872
14689,13629,3326,3,Business,22,5,44110,22,5,44300,22,5,44598,22,5,45287,22,5,46541,7,28.5,-1.2897368,36.8226783,-1.2551895,36.7822034,583,1254,190,987
14690,18633,1502,3,Business,7,7,41692,7,7,43158,7,7,43537,7,7,45178,7,7,46190,12,25.7,-1.290894,36.822971,-1.2232123,36.8932547,438,1012,1466,2020
14691,7750,2935,3,Business,29,5,42802,29,5,42904,29,5,43367,29,5,43903,29,5,45350,17,19.7,-1.3657874,36.7346043,-1.2961922,36.791994,636,1447,102,999
14692,17527,970,3,Business,23,2,55323,23,2,55419,23,2,56870,23,2,57150,23,2,58928,10,23.25888921888938,-1.2551895,36.7822034,-1.3089235,36.8372446,96,1778,96,1731
14693,24458,2804,3,Business,17,3,47084,17,3,47320,17,3,47747,17,3,48072,17,3,48889,7,25.3,-1.2551895,36.7822034,-1.279767,36.7695313,208,817,236,752
14694,16575,412,3,Business,13,4,53289,13,4,53583,13,4,54251,13,4,55278,13,4,55453,2,23.3,-1.2600926,36.8088685,-1.266837,36.799249,310,175,294,1695
14695,27775,2305,1,Personal,17,5,48752,17,5,48826,17,5,49697,17,5,50396,17,5,52800,17,20.4,-1.2486621,36.8874559,-1.3007592,36.7754197,851,2404,74,1570
14696,3586,1557,3,Business,29,2,40359,29,2,41697,29,2,42037,29,2,42865,29,2,44193,8,21.6,-1.3147074,36.811722,-1.268027,36.8037005,101,1328,1338,1168
14697,23032,393,3,Business,26,3,49028,26,3,49053,26,3,49217,26,3,49903,26,3,52388,14,27.3,-1.3177547,36.8303703,-1.306378,36.7519845,731,2485,25,850
14698,9059,3686,3,Business,11,2,51291,11,2,58435,11,2,59007,11,2,59455,11,2,61599,12,22.5,-1.2551895,36.7822034,-1.318497,36.8296133,362,2144,7144,1020
14699,3242,3686,3,Business,8,5,42152,8,5,42253,8,5,42912,8,5,44336,8,5,45890,8,28.4,-1.2551895,36.7822034,-1.3012619,36.8213697,322,1554,101,2083
14700,12742,2150,3,Business,14,4,33521,14,4,34063,14,4,36274,14,4,36898,14,4,38086,13,18.9,-1.3033561,36.8163631,-1.344446,36.756597,332,1188,542,2835
14701,20440,2580,1,Personal,4,1,55466,4,1,57291,4,1,57300,4,1,57900,4,1,62281,6,22.6,-1.289498,36.818878,-1.3028861,36.7943829,672,4381,1825,609
14702,20930,90,1,Personal,15,1,48570,15,1,50178,15,1,50808,15,1,51148,15,1,52267,7,23.25888921888938,-1.256958,36.8144929,-1.294624,36.814874,72,1119,1608,970
14703,106,1363,3,Business,11,4,33015,11,4,33070,11,4,33764,11,4,33881,11,4,35593,10,22.1,-1.3004062,36.829741,-1.2529484,36.8651347,85,1712,55,811
14704,9996,3557,3,Business,24,2,53911,24,2,54017,24,2,54610,24,2,55019,24,2,56145,5,18.2,-1.2844084,36.8106592,-1.2546732,36.8086796,88,1126,106,1002
14705,8382,3283,3,Business,30,4,53498,30,4,53524,30,4,53858,30,4,54234,30,4,55647,13,23.25888921888938,-1.318062,36.849326,-1.2628473,36.781805,178,1413,26,710
14706,5542,2330,3,Business,22,1,49592,22,1,49655,22,1,49857,22,1,54151,22,1,54171,5,26.4,-1.2891975,36.8225285,-1.2614329,36.8094365,521,20,63,4496
14707,5778,391,3,Business,28,4,29225,28,4,31689,28,4,32236,28,4,32653,28,4,33654,5,23.25888921888938,-1.2599563,36.7993439,-1.2857574,36.8295667,752,1001,2464,964
14708,20514,1341,3,Business,27,1,37896,27,1,37949,27,1,38484,27,1,38990,27,1,39609,9,20.8,-1.3033561,36.8163631,-1.331619,36.847976,591,619,53,1041
14709,9015,496,3,Business,14,2,39457,14,2,39516,14,2,39937,14,2,41086,14,2,44411,9,23.25888921888938,-1.2551895,36.7822034,-1.2980229,36.78865,617,3325,59,1570
14710,24686,547,1,Personal,13,4,48116,13,4,48142,13,4,48769,13,4,48923,13,4,50787,19,26.3,-1.320871,36.826126,-1.3713927,36.7213028,543,1864,26,781
14711,16758,63,2,Personal,5,5,31215,5,5,31381,5,5,31888,5,5,33976,5,5,35512,13,18.0,-1.2737091,36.8131533,-1.2846933,36.9059033,403,1536,166,2595
14712,26350,3560,3,Business,22,3,50734,22,3,52030,22,3,54190,22,3,57121,22,3,58419,5,24.2,-1.2571472,36.7950633,-1.279395,36.825364,139,1298,1296,5091
14713,3617,3647,3,Business,5,3,35128,5,3,35167,5,3,35961,5,3,36168,5,3,36578,2,18.2,-1.272639,36.794723,-1.2746436,36.803682,50,410,39,1001
14714,3983,3640,2,Personal,3,2,71813,3,2,71855,3,2,72973,3,2,73441,3,2,75449,14,17.1,-1.286411,36.7925973,-1.3089969,36.7064138,95,2008,42,1586
14715,7409,1340,3,Business,17,2,50203,17,2,50215,17,2,51397,17,2,51622,17,2,53268,16,24.4,-1.2602386,36.7503491,-1.2644776,36.870655,74,1646,12,1407
14716,22271,121,1,Personal,15,3,30180,15,3,30200,15,3,30536,15,3,30705,15,3,31950,10,16.2,-1.2367559,36.8082168,-1.273308,36.802847,208,1245,20,505
14717,12083,1850,3,Business,25,1,54991,25,1,55035,25,1,56447,25,1,56540,25,1,60099,9,27.9,-1.2551895,36.7822034,-1.3074264,36.8226123,817,3559,44,1505
14718,11330,1724,3,Business,30,4,40134,30,4,40157,30,4,42436,30,4,42538,30,4,44321,15,23.25888921888938,-1.2551895,36.7822034,-1.3267689,36.8756255,57,1783,23,2381
14719,3622,635,3,Business,12,2,57126,12,2,57982,12,2,58184,12,2,58559,12,2,59592,9,27.1,-1.2599563,36.7993439,-1.2293244,36.7839539,510,1033,856,577
14720,17013,3698,3,Business,31,5,45155,31,5,45467,31,5,45476,31,5,46316,31,5,47351,7,21.7,-1.3244885,36.897792,-1.34364,36.8925345,692,1035,312,849
14721,3330,1850,3,Business,25,4,46716,25,4,48250,25,4,48257,25,4,48621,25,4,48988,2,23.25888921888938,-1.2551895,36.7822034,-1.2566586,36.7929682,709,367,1534,371
14722,15004,1961,3,Business,3,5,30999,3,5,31024,3,5,31636,3,5,32837,3,5,35344,20,23.25888921888938,-1.331619,36.847976,-1.3181159,36.7101559,519,2507,25,1813
14723,10320,517,3,Business,27,4,53506,27,4,53521,27,4,53660,27,4,54002,27,4,54929,11,23.9,-1.3167113,36.8301563,-1.2574219,36.7927073,523,927,15,481
14724,3738,868,3,Business,17,6,53475,17,6,53632,17,6,55625,17,6,58357,17,6,59288,5,23.8,-1.2600926,36.8088685,-1.265715,36.823815,6,931,157,4725
14725,23214,1207,3,Business,5,6,38021,5,6,38042,5,6,38660,5,6,40472,5,6,41055,8,22.3,-1.2628638,36.8070399,-1.2745321,36.765088,427,583,21,2430
14726,6830,1630,1,Personal,28,2,34125,28,2,34183,28,2,35136,28,2,35584,28,2,38203,20,15.9,-1.290059,36.7703475,-1.2902161,36.8936181,548,2619,58,1401
14727,21984,1397,3,Business,14,4,48637,14,4,49553,14,4,49985,14,4,50307,14,4,52870,6,27.8,-1.2616841,36.801999,-1.287079,36.7811277,411,2563,916,754
14728,27760,1469,3,Business,20,4,53533,20,4,54795,20,4,55472,20,4,55585,20,4,58311,5,25.1,-1.2551895,36.7822034,-1.2764851,36.8007126,259,2726,1262,790
14729,2130,393,3,Business,11,5,36058,11,5,36087,11,5,36090,11,5,37590,11,5,39311,11,20.8,-1.3167113,36.8301563,-1.2574219,36.7927073,914,1721,29,1503
14730,25683,3647,3,Business,3,2,57477,3,2,57787,3,2,58931,3,2,59121,3,2,59870,6,20.2,-1.272639,36.794723,-1.2583976,36.7980465,103,749,310,1334
14731,21842,2188,2,Personal,19,4,44473,19,4,44504,19,4,45344,19,4,46060,19,4,47922,8,20.0,-1.2970279,36.761356,-1.269534,36.80697,140,1862,31,1556
14732,22018,2523,3,Business,12,2,58760,12,2,58919,12,2,59279,12,2,59393,12,2,60521,9,23.25888921888938,-1.2551895,36.7822034,-1.2955334,36.7742857,343,1128,159,474
14733,26172,2112,3,Business,12,3,38605,12,3,39456,12,3,39597,12,3,40367,12,3,41660,7,19.4,-1.2156006,36.8916865,-1.2475028,36.8774697,75,1293,851,911
14734,558,956,3,Personal,30,3,58152,30,3,58249,30,3,59818,30,3,60088,30,3,62948,17,27.5,-1.3136452,36.7974014,-1.218376,36.8821822,328,2860,97,1839
14735,5389,1771,1,Personal,8,2,65091,8,2,65951,8,2,66927,8,2,68303,8,2,70694,11,20.5,-1.2821474,36.8317731,-1.3104826,36.903499,347,2391,860,2352
14736,13574,3509,1,Personal,7,5,41761,7,5,42399,7,5,43291,7,5,43565,7,5,45838,8,25.5,-1.290499,36.784363,-1.282772,36.8259993,726,2273,638,1166
14737,3044,2344,3,Business,14,4,46649,14,4,51875,14,4,52003,14,4,52667,14,4,54123,6,27.9,-1.2551895,36.7822034,-1.2812704,36.8173538,863,1456,5226,792
14738,23273,2553,1,Personal,3,2,53837,3,2,53958,3,2,54734,3,2,54908,3,2,55564,6,20.3,-1.2765492,36.7669809,-1.2551895,36.7822034,103,656,121,950
14739,23602,439,3,Business,5,2,42769,5,2,43669,5,2,44326,5,2,44971,5,2,46057,8,23.5,-1.2910168,36.8369384,-1.3250048,36.8697188,72,1086,900,1302
14740,9859,1882,3,Business,3,7,32740,3,7,33716,3,7,34753,3,7,37021,3,7,38648,7,21.8,-1.2958783,36.7928125,-1.2588775,36.8079744,605,1627,976,3305
14741,24659,1880,3,Business,17,4,40469,17,4,40488,17,4,40653,17,4,41077,17,4,41666,7,25.2,-1.2571472,36.7950633,-1.2935403,36.7796304,881,589,19,589
14742,22078,111,3,Business,8,1,30520,8,1,30526,8,1,30585,8,1,31218,8,1,32876,20,21.7,-1.2551895,36.7822034,-1.3129275,36.9235657,291,1658,6,692
14743,16025,2476,3,Business,23,6,46790,23,6,46800,23,6,47950,23,6,49004,23,6,50701,12,28.3,-1.2795594,36.8472647,-1.264836,36.805373,206,1697,10,2204
14744,5948,2335,3,Business,3,3,38027,3,3,38034,3,3,38411,3,3,39185,3,3,43244,22,27.3,-1.2551895,36.7822034,-1.3562374,36.9042954,831,4059,7,1151
14745,18906,3470,3,Business,9,5,42241,9,5,42322,9,5,42699,9,5,45074,9,5,49702,15,25.7,-1.28878,36.8168312,-1.2265676,36.9068373,718,4628,81,2752
14746,25752,2718,3,Business,4,2,44749,4,2,45054,4,2,45779,4,2,46384,4,2,47187,4,19.7,-1.269534,36.80697,-1.2668815,36.8017244,671,803,305,1330
14747,19410,2009,2,Personal,15,1,40842,15,1,40860,15,1,40906,15,1,41773,15,1,42858,8,23.25888921888938,-1.307241,36.8302368,-1.2956882,36.7861845,449,1085,18,913
14748,5192,2587,3,Business,26,5,48232,26,5,48241,26,5,48287,26,5,49775,26,5,51318,8,23.25888921888938,-1.3014461,36.7661381,-1.28878,36.8168312,581,1543,9,1534
14749,12119,1363,3,Business,3,5,37848,3,5,37872,3,5,37918,3,5,38887,3,5,39272,5,23.25888921888938,-1.3004062,36.829741,-1.3228003,36.8306435,686,385,24,1015
14750,17169,2383,3,Business,3,3,33055,3,3,33331,3,3,33421,3,3,33633,3,3,34258,2,21.6,-1.2608993,36.799246,-1.2682478,36.8072852,205,625,276,302
14751,24175,3214,3,Business,9,5,39064,9,5,39343,9,5,41620,9,5,41847,9,5,45598,7,25.6,-1.289795,36.7957132,-1.2633274,36.8073226,322,3751,279,2504
14752,11313,3097,3,Personal,16,6,33410,16,6,39284,16,6,40952,16,6,41671,16,6,46154,28,25.9,-1.2866269,36.8246368,-1.4242042,36.717817,59,4483,5874,2387
14753,23196,1724,3,Business,18,1,37812,18,1,37912,18,1,38774,18,1,39484,18,1,42043,3,27.9,-1.2551895,36.7822034,-1.2595467,36.8113044,448,2559,100,1572
14754,9290,402,3,Business,22,3,48816,22,3,49356,22,3,49374,22,3,50456,22,3,50463,1,24.5,-1.2584143,36.8048002,-1.2527958,36.8003131,704,7,540,1100
14755,21163,393,3,Business,10,1,53344,10,1,53391,10,1,53412,10,1,55834,10,1,55840,13,18.1,-1.3228003,36.8306435,-1.2991441,36.7528804,97,6,47,2443
14756,5862,718,3,Business,14,2,38482,14,2,38685,14,2,39399,14,2,39912,14,2,42054,12,23.25888921888938,-1.2551895,36.7822034,-1.3114499,36.7425836,3,2142,203,1227
14757,3460,1363,3,Business,9,5,31472,9,5,31503,9,5,31505,9,5,31658,9,5,32183,5,20.4,-1.3004062,36.829741,-1.3083266,36.8494756,595,525,31,155
14758,23688,1577,1,Personal,4,2,29502,4,2,29549,4,2,29992,4,2,30268,4,2,31244,7,16.4,-1.2816234,36.8239846,-1.3006208,36.7727444,726,976,47,719
14759,12595,3091,3,Business,18,2,50021,18,2,51579,18,2,51803,18,2,51865,18,2,55394,16,25.5,-1.225322,36.80855,-1.3012008,36.764868,353,3529,1558,286
14760,24381,2344,3,Business,21,3,45305,21,3,45315,21,3,45730,21,3,46586,21,3,47239,7,21.8,-1.2571472,36.7950633,-1.2881596,36.789292,566,653,10,1271
14761,20952,2627,3,Business,22,5,29528,22,5,29627,22,5,29986,22,5,30924,22,5,31298,2,22.2,-1.2584143,36.8048002,-1.2571472,36.7950633,520,374,99,1297
14762,2998,2987,3,Business,5,4,55910,5,4,56279,5,4,56283,5,4,57003,5,4,59368,10,22.4,-1.270212,36.8210877,-1.3014461,36.7661381,406,2365,369,724
14763,18502,2685,1,Personal,22,6,36209,22,6,36225,22,6,37705,22,6,38642,22,6,41179,28,21.3,-1.3433181,36.9138018,-1.3329386,36.7087809,504,2537,16,2417
14764,11469,432,3,Business,27,1,53022,27,1,53170,27,1,53564,27,1,53841,27,1,55229,9,23.0,-1.2584143,36.8048002,-1.3012008,36.764868,96,1388,148,671
14765,417,2229,3,Business,14,5,51188,14,5,51222,14,5,51430,14,5,51870,14,5,54571,23,23.2,-1.3247683,36.85803,-1.2128205,36.8026175,4,2701,34,648
14766,18022,2457,3,Business,7,2,28663,7,2,28717,7,2,30112,7,2,30354,7,2,32473,19,23.25888921888938,-1.2551895,36.7822034,-1.324753,36.89748,865,2119,54,1637
14767,21923,336,1,Personal,11,5,39140,11,5,40176,11,5,41377,11,5,41790,11,5,43307,5,20.8,-1.2844941,36.8227621,-1.3061448,36.7978023,338,1517,1036,1614
14768,26336,475,3,Business,31,4,51281,31,4,51321,31,4,51867,31,4,54057,31,4,55359,6,22.7,-1.2579304,36.8019667,-1.3024794,36.8228284,555,1302,40,2736
14769,11294,2436,3,Business,8,5,55242,8,5,56407,8,5,56792,8,5,57099,8,5,58492,9,30.6,-1.2551895,36.7822034,-1.2945128,36.8396881,576,1393,1165,692
14770,5977,3283,3,Business,13,4,48735,13,4,48830,13,4,50096,13,4,53249,13,4,53938,7,23.3,-1.2783849,36.8163445,-1.2628473,36.781805,55,689,95,4419
14771,25668,3291,3,Business,4,1,42772,4,1,42929,4,1,43059,4,1,43504,4,1,44570,8,25.4,-1.303596,36.778378,-1.2600926,36.8088685,604,1066,157,575
14772,11147,2982,3,Business,9,3,41492,9,3,41502,9,3,41901,9,3,43333,9,3,45572,18,25.5,-1.300921,36.828195,-1.177202,36.8351183,148,2239,10,1831
14773,11212,2869,3,Business,3,1,41870,3,1,41957,3,1,42839,3,1,43377,3,1,44287,3,21.4,-1.3014461,36.7661381,-1.2763494,36.7671783,496,910,87,1420
14774,19170,517,3,Business,9,6,42214,9,6,42222,9,6,42386,9,6,42952,9,6,42956,4,24.6,-1.3167113,36.8301563,-1.3004062,36.829741,239,4,8,730
14775,17927,2763,3,Business,25,4,52770,25,4,52792,25,4,53321,25,4,53691,25,4,54990,7,20.9,-1.2551895,36.7822034,-1.2885417,36.8100523,337,1299,22,899
14776,24627,1500,3,Business,13,1,35827,13,1,35845,13,1,37589,13,1,38063,13,1,38676,6,23.25888921888938,-1.2770708,36.8231093,-1.2638185,36.7930057,448,613,18,2218
14777,24202,642,2,Personal,31,5,59337,31,5,59549,31,5,59595,31,5,60696,31,5,62271,15,19.7,-1.2854453,36.8188363,-1.3444745,36.7507427,813,1575,212,1147
14778,2870,3222,3,Business,8,1,43553,8,1,43582,8,1,44024,8,1,44172,8,1,44766,5,24.5,-1.2551895,36.7822034,-1.2731645,36.7900343,178,594,29,590
14779,11292,2195,1,Business,15,6,34161,15,6,34176,15,6,34287,15,6,35470,15,6,37508,8,17.5,-1.2783849,36.8163445,-1.3313643,36.8577422,338,2038,15,1294
14780,1825,1500,3,Business,8,1,44104,8,1,44435,8,1,45462,8,1,45735,8,1,46453,6,28.0,-1.2759989,36.820884,-1.2638185,36.7930057,448,718,331,1300
14781,12827,2200,3,Business,12,2,46459,12,2,46510,12,2,47675,12,2,49758,12,2,50583,1,22.8,-1.2840467,36.8222701,-1.290894,36.822971,431,825,51,3248
14782,17855,1500,3,Business,8,3,39109,8,3,39131,8,3,41218,8,3,42370,8,3,44919,11,23.25888921888938,-1.3077869,36.8443207,-1.2638185,36.7930057,668,2549,22,3239
14783,8275,302,3,Business,15,6,51014,15,6,53587,15,6,54351,15,6,54648,15,6,55813,14,26.0,-1.2649605,36.7981777,-1.3255287,36.7850772,179,1165,2573,1061
14784,17144,393,3,Business,9,4,46957,9,4,47033,9,4,47564,9,4,48632,9,4,49191,4,23.25888921888938,-1.3167113,36.8301563,-1.3004062,36.829741,411,559,76,1599
14785,15402,2030,3,Business,16,5,51894,16,5,52993,16,5,54257,16,5,54391,16,5,54760,7,23.25888921888938,-1.3302996,36.8707935,-1.3333725,36.8717613,839,369,1099,1398
14786,1591,3772,1,Personal,11,6,41066,11,6,41081,11,6,41415,11,6,41597,11,6,42287,6,20.9,-1.2971834,36.8295073,-1.276245,36.8363293,249,690,15,516
14787,15917,3201,3,Business,20,3,37078,20,3,37393,20,3,39976,20,3,40632,20,3,43063,17,26.4,-1.3463042,36.768164,-1.2584143,36.8048002,267,2431,315,3239
14788,2088,3091,3,Business,8,2,56108,8,2,56458,8,2,56926,8,2,57182,8,2,59450,8,25.4,-1.3012008,36.764868,-1.2551895,36.7822034,489,2268,350,724
14789,14589,3283,3,Business,26,2,37191,26,2,37220,26,2,38180,26,2,39344,26,2,39923,6,27.5,-1.272828,36.816608,-1.2628473,36.781805,268,579,29,2124
14790,23478,346,3,Business,8,5,46391,8,5,48176,8,5,48891,8,5,49205,8,5,49918,3,21.7,-1.2885529,36.8160141,-1.3040024,36.808297,217,713,1785,1029
14791,18498,540,3,Business,19,2,49627,19,2,49676,19,2,50440,19,2,50527,19,2,52434,8,29.5,-1.2551895,36.7822034,-1.3028118,36.8174764,948,1907,49,851
14792,14871,286,3,Business,11,2,32243,11,2,32270,11,2,33555,11,2,33783,11,2,36580,17,16.8,-1.2551895,36.7822034,-1.200709,36.8471472,865,2797,27,1513
14793,1149,868,3,Business,29,1,36991,29,1,37011,29,1,37078,29,1,37781,29,1,39015,6,23.25888921888938,-1.307143,36.825009,-1.265715,36.823815,155,1234,20,770
14794,6291,2150,3,Business,2,3,35778,2,3,35824,2,3,35826,2,3,37109,2,3,38286,15,20.2,-1.265715,36.823815,-1.344446,36.756597,886,1177,46,1285
14795,12,1934,2,Personal,16,3,39425,16,3,41273,16,3,42165,16,3,42563,16,3,44281,6,24.0,-1.2875013,36.8171787,-1.2502923,36.7887568,949,1718,1848,1290
14796,25307,2330,3,Business,8,3,35106,8,3,35127,8,3,35322,8,3,35407,8,3,35777,3,23.25888921888938,-1.3040812,36.7924217,-1.2921463,36.8029626,829,370,21,280
14797,15648,3688,3,Business,31,3,46317,31,3,48027,31,3,48825,31,3,48977,31,3,50356,12,27.1,-1.2551895,36.7822034,-1.3104734,36.7363698,147,1379,1710,950
14798,12496,478,3,Business,24,4,28150,24,4,28181,24,4,28371,24,4,29000,24,4,30879,15,19.5,-1.2551895,36.7822034,-1.3216456,36.7145156,427,1879,31,819
14799,10759,733,3,Business,4,2,46956,4,2,47550,4,2,47852,4,2,48455,4,2,50082,20,19.6,-1.2551895,36.7822034,-1.3251247,36.8995926,74,1627,594,905
14800,20238,2412,3,Business,23,4,42513,23,4,42528,23,4,42728,23,4,45057,23,4,47964,23,18.4,-1.3562374,36.9042954,-1.2297202,36.8819507,882,2907,15,2529
14801,27265,2084,1,Personal,1,1,49332,1,1,49523,1,1,49907,1,1,50421,1,1,51565,3,25.8,-1.265715,36.808525,-1.2793148,36.8148394,263,1144,191,898
14802,12232,1103,3,Business,4,1,54439,4,1,54805,4,1,55730,4,1,56426,4,1,59348,7,28.5,-1.290894,36.822971,-1.2551895,36.7822034,751,2922,366,1621
14803,5298,3111,3,Personal,21,5,42212,21,5,42235,21,5,44306,21,5,44819,21,5,46836,15,22.6,-1.2363092,36.8823617,-1.2966535,36.8123136,86,2017,23,2584
14804,27322,2355,3,Personal,8,2,39969,8,2,40020,8,2,40473,8,2,40549,8,2,42908,10,23.5,-1.2608932,36.8143218,-1.3083777,36.8590077,715,2359,51,529
14805,21128,3686,3,Business,16,3,57402,16,3,57409,16,3,57699,16,3,57834,16,3,58091,3,26.9,-1.2551895,36.7822034,-1.2560455,36.7800867,932,257,7,425
14806,16960,1402,3,Business,14,4,43900,14,4,43960,14,4,47306,14,4,47424,14,4,48453,3,25.0,-1.2813012,36.8323962,-1.2733311,36.820489,448,1029,60,3464
14807,25284,3222,3,Business,8,5,58914,8,5,61593,8,5,62137,8,5,62561,8,5,65146,7,27.8,-1.2551895,36.7822034,-1.2897399,36.8270975,76,2585,2679,968
14808,3320,1467,3,Personal,25,3,50023,25,3,50066,25,3,51002,25,3,51159,25,3,52150,6,17.5,-1.2984591,36.7855438,-1.2688224,36.7944062,415,991,43,1093
14809,11552,633,3,Business,25,5,57831,25,5,58573,25,5,58582,25,5,59366,25,5,60590,8,29.4,-1.3004062,36.829741,-1.2574219,36.7927073,555,1224,742,793
14810,27891,1329,3,Business,12,3,51335,12,3,51467,12,3,52715,12,3,52873,12,3,54936,19,21.1,-1.273056,36.811298,-1.3334681,36.7116093,622,2063,132,1406
14811,5807,3211,3,Personal,3,2,36344,3,2,36431,3,2,37657,3,2,37880,3,2,39761,11,15.4,-1.2846475,36.8275903,-1.2245407,36.7583778,208,1881,87,1449
14812,20529,3752,3,Business,17,5,54784,17,5,54820,17,5,54917,17,5,55426,17,5,56745,4,23.25888921888938,-1.265432,36.795034,-1.2753109,36.8130185,155,1319,36,606
14813,16255,1594,3,Business,10,5,44312,10,5,44336,10,5,45007,10,5,45149,10,5,51059,13,23.25888921888938,-1.225322,36.80855,-1.2876804,36.7802778,689,5910,24,813
14814,10585,53,3,Business,23,4,37599,23,4,37688,23,4,39289,23,4,39690,23,4,40739,5,23.5,-1.3004062,36.829741,-1.2770708,36.8231093,790,1049,89,2002
14815,22926,640,3,Business,9,4,40766,9,4,40816,9,4,41575,9,4,41734,9,4,44804,7,23.25888921888938,-1.2969741,36.7856612,-1.2641724,36.8014198,571,3070,50,918
14816,27817,739,1,Personal,20,1,56690,20,1,56760,20,1,57400,20,1,58241,20,1,61691,11,21.3,-1.2655699,36.8162505,-1.329312,36.787642,40,3450,70,1481
14817,2804,517,3,Business,31,5,40685,31,5,40723,31,5,40857,31,5,41640,31,5,42343,4,21.7,-1.3228003,36.8306435,-1.3004062,36.829741,349,703,38,917
14818,3945,3201,3,Business,4,1,52698,4,1,58459,4,1,60986,4,1,61946,4,1,63206,5,27.6,-1.2584143,36.8048002,-1.2857548,36.819062,448,1260,5761,3487
14819,20507,1013,1,Personal,21,5,37951,21,5,38091,21,5,39078,21,5,39440,21,5,40313,6,20.0,-1.2922888,36.7755707,-1.2731645,36.7900343,731,873,140,1349
14820,8105,2330,3,Business,8,3,35700,8,3,35730,8,3,35856,8,3,36876,8,3,38008,13,23.25888921888938,-1.2645318,36.7981775,-1.2284323,36.8757058,576,1132,30,1146
14821,6854,1389,3,Business,4,1,57725,4,1,57748,4,1,58553,4,1,59665,4,1,60609,5,21.0,-1.2584143,36.8048002,-1.2885529,36.8160141,742,944,23,1917
14822,21796,3686,3,Business,30,2,41844,30,2,41913,30,2,42455,30,2,42614,30,2,43427,5,22.5,-1.2551895,36.7822034,-1.2731645,36.7900343,770,813,69,701
14823,17006,2795,1,Personal,22,5,41479,22,5,41674,22,5,42316,22,5,42818,22,5,44553,12,21.8,-1.3108386,36.7555239,-1.263419,36.8060348,116,1735,195,1144
14824,14343,2330,3,Business,27,3,41063,27,3,41092,27,3,41761,27,3,42449,27,3,43006,8,26.1,-1.3015197,36.7658456,-1.3192789,36.7112991,119,557,29,1357
14825,25932,2436,3,Business,1,4,45948,1,4,48976,1,4,49937,1,4,51699,1,4,53191,7,23.25888921888938,-1.2854453,36.8188363,-1.26284,36.774046,131,1492,3028,2723
14826,1766,552,3,Business,26,2,46494,26,2,46539,26,2,47514,26,2,48628,26,2,50078,18,27.3,-1.290894,36.822971,-1.3562374,36.9042954,99,1450,45,2089
14827,2402,1196,3,Business,29,2,48483,29,2,49477,29,2,50589,29,2,50959,29,2,51925,7,24.0,-1.2553615,36.7895376,-1.293278,36.827789,752,966,994,1482
14828,21733,948,3,Business,4,4,46016,4,4,46046,4,4,49635,4,4,49838,4,4,50680,3,27.2,-1.2547101,36.8093272,-1.2696908,36.81519,547,842,30,3792
14829,11157,1095,1,Personal,25,5,47999,25,5,48108,25,5,48526,25,5,49064,25,5,50229,7,23.3,-1.2624838,36.83963,-1.2658315,36.809049,735,1165,109,956
14830,25441,496,3,Business,5,5,48077,5,5,48086,5,5,48422,5,5,48577,5,5,49876,5,24.4,-1.2551895,36.7822034,-1.2677588,36.8169359,76,1299,9,491
14831,4560,1244,3,Business,5,3,32677,5,3,32689,5,3,35110,5,3,35666,5,3,38910,18,18.4,-1.293515,36.897607,-1.303596,36.778378,753,3244,12,2977
14832,2597,2061,2,Personal,10,2,62309,10,2,62881,10,2,63539,10,2,63731,10,2,64674,9,20.7,-1.2902141,36.7714825,-1.2659149,36.8054322,312,943,572,850
14833,10625,3194,3,Business,24,4,56338,24,4,56408,24,4,57663,24,4,58131,24,4,60239,18,28.5,-1.2551895,36.7822034,-1.3441039,36.7177746,862,2108,70,1723
14834,14290,317,1,Personal,6,6,56164,6,6,56203,6,6,57032,6,6,57092,6,6,57832,4,27.8,-1.2849416,36.7729077,-1.2858786,36.7888062,674,740,39,889
14835,21951,155,3,Personal,14,1,45813,14,1,46018,14,1,46658,14,1,46882,14,1,48089,4,23.4,-1.271337,36.786712,-1.290701,36.782992,382,1207,205,864
14836,20807,677,3,Business,4,2,47192,4,2,47329,4,2,47976,4,2,48583,4,2,52302,9,20.6,-1.290894,36.822971,-1.3025826,36.7670807,787,3719,137,1254
14837,26733,2358,4,Business,18,4,34407,18,4,34883,18,4,36157,18,4,36631,18,4,37053,4,20.8,-1.286708,36.82319,-1.297503,36.817503,477,422,476,1748
14838,16793,2216,3,Business,9,3,53014,9,3,53071,9,3,54631,9,3,55625,9,3,58003,12,25.5,-1.2551895,36.7822034,-1.3202198,36.8026069,45,2378,57,2554
14839,23403,3621,3,Business,22,7,54305,22,7,54327,22,7,54555,22,7,55257,22,7,56667,14,19.2,-1.2836583,36.7886014,-1.328751,36.8818019,670,1410,22,930
14840,13795,1850,3,Business,13,1,59168,13,1,59227,13,1,59977,13,1,60496,13,1,61536,7,23.25888921888938,-1.290894,36.822971,-1.2566586,36.7929682,291,1040,59,1269
14841,9823,1796,3,Business,6,3,41024,6,3,41043,6,3,41147,6,3,43570,6,3,44247,5,22.4,-1.2600926,36.8088685,-1.2628473,36.781805,26,677,19,2527
14842,24183,1357,1,Personal,22,3,39882,22,3,39893,22,3,41465,22,3,41968,22,3,44591,20,23.0,-1.2897215,36.7945959,-1.2705293,36.6736142,50,2623,11,2075
14843,3767,2423,3,Business,25,5,56948,25,5,59751,25,5,60327,25,5,60570,25,5,61801,4,21.2,-1.2553615,36.7895376,-1.2707979,36.8065786,742,1231,2803,819
14844,21742,3743,3,Business,11,1,62386,11,1,63771,11,1,64999,11,1,66134,11,1,67651,14,21.0,-1.3223393,36.8867317,-1.320157,36.830887,543,1517,1385,2363
14845,18148,1961,3,Business,15,3,56266,15,3,56292,15,3,56762,15,3,57175,15,3,59263,19,25.8,-1.2600926,36.8088685,-1.3181159,36.7101559,484,2088,26,883
14846,13121,633,3,Business,7,4,57072,7,4,57082,7,4,57097,7,4,58447,7,4,58457,9,27.6,-1.2638185,36.7930057,-1.3004062,36.829741,10,10,10,1365
14847,5793,2789,3,Business,4,1,57018,4,1,57040,4,1,57555,4,1,57623,4,1,59104,4,28.6,-1.304735,36.7846054,-1.2804664,36.7701111,468,1481,22,583
14848,9968,633,3,Business,20,2,44666,20,2,45491,20,2,46320,20,2,46560,20,2,48215,9,19.9,-1.2574219,36.7927073,-1.3004062,36.829741,219,1655,825,1069
14849,16386,1244,3,Business,5,6,45507,5,6,45547,5,6,45770,5,6,46463,5,6,47519,9,22.3,-1.2600926,36.8088685,-1.303596,36.778378,72,1056,40,916
14850,5309,3560,3,Business,12,6,40879,12,6,41356,12,6,41726,12,6,43005,12,6,43579,2,23.2,-1.28871,36.8251253,-1.279395,36.825364,742,574,477,1649
14851,28142,12,3,Business,28,1,45955,28,1,46012,28,1,47730,28,1,48833,28,1,51350,18,26.1,-1.2492578,36.7348515,-1.240021,36.84999,240,2517,57,2821
14852,14824,965,1,Personal,17,5,35275,17,5,35285,17,5,35900,17,5,36483,17,5,38075,22,14.1,-1.2857095,36.8188266,-1.1682729,36.9536167,648,1592,10,1198
14853,2257,1469,3,Business,30,2,55565,30,2,57764,30,2,58899,30,2,59370,30,2,60815,4,23.25888921888938,-1.2551895,36.7822034,-1.2752846,36.8027022,269,1445,2199,1606
14854,9609,867,3,Business,5,2,47425,5,2,47452,5,2,47458,5,2,48066,5,2,49344,9,25.7,-1.2638185,36.7930057,-1.2991441,36.7528804,523,1278,27,614
14855,11508,2956,3,Business,3,1,57245,3,1,57730,3,1,58391,3,1,58680,3,1,60028,14,23.0,-1.207546,36.7913976,-1.2584143,36.8048002,959,1348,485,950
14856,28094,393,3,Business,1,1,38442,1,1,38491,1,1,39038,1,1,39937,1,1,40335,4,23.25888921888938,-1.3167113,36.8301563,-1.3004062,36.829741,901,398,49,1446
14857,18830,246,3,Business,22,2,42641,22,2,42658,22,2,42667,22,2,43460,22,2,45152,15,23.8,-1.2283403,36.8822756,-1.2584143,36.8048002,669,1692,17,802
14858,12151,545,3,Business,16,4,52469,16,4,52498,16,4,52517,16,4,52858,16,4,55188,19,23.25888921888938,-1.2963097,36.7688221,-1.2417321,36.8886277,831,2330,29,360
14859,12789,3164,2,Personal,2,3,41831,2,3,41854,2,3,42764,2,3,43333,2,3,44052,5,21.8,-1.2991543,36.7827912,-1.2735236,36.7992196,761,719,23,1479
14860,6894,2587,3,Business,2,3,42149,2,3,42882,2,3,43518,2,3,43765,2,3,45579,12,24.2,-1.2859912,36.8756811,-1.28878,36.8168312,31,1814,733,883
14861,6548,516,3,Business,25,1,44332,25,1,44385,25,1,45129,25,1,45331,25,1,46379,8,27.2,-1.2551895,36.7822034,-1.2985749,36.8088,937,1048,53,946
14862,9864,3251,3,Business,5,1,39124,5,1,39228,5,1,40169,5,1,40342,5,1,40945,4,24.6,-1.2833534,36.8165865,-1.3059713,36.8200566,920,603,104,1114
14863,19106,3264,3,Business,31,2,35573,31,2,35581,31,2,36470,31,2,36721,31,2,39715,12,17.1,-1.2551895,36.7822034,-1.2121659,36.8112437,452,2994,8,1140
14864,18060,3495,1,Personal,11,6,38490,11,6,38532,11,6,38959,11,6,39130,11,6,39679,7,21.1,-1.3047132,36.8089553,-1.2866305,36.7754914,207,549,42,598
14865,6774,1195,3,Business,14,4,33702,14,4,33721,14,4,35018,14,4,36288,14,4,38220,14,17.6,-1.3228003,36.8306435,-1.2991441,36.7528804,326,1932,19,2567
14866,365,2330,3,Business,26,5,58938,26,5,59808,26,5,60341,26,5,60428,26,5,61176,5,23.25888921888938,-1.293082,36.8278578,-1.3040812,36.7924217,843,748,870,620
14867,6791,3465,3,Business,5,5,44526,5,5,44541,5,5,44647,5,5,44949,5,5,46846,9,24.4,-1.2551895,36.7822034,-1.312406,36.827447,349,1897,15,408
14868,12779,2523,3,Business,10,3,35366,10,3,35415,10,3,35525,10,3,35801,10,3,36470,4,22.0,-1.2551895,36.7822034,-1.2693662,36.8085295,576,669,49,386
14869,12872,1219,1,Personal,20,4,44815,20,4,44851,20,4,45317,20,4,46852,20,4,47686,5,24.5,-1.2943686,36.8077475,-1.2707833,36.7993825,365,834,36,2001
14870,21712,2330,3,Business,9,3,45205,9,3,45220,9,3,46055,9,3,46332,9,3,49006,23,25.4,-1.3800951,36.9297274,-1.2642903,36.8002137,322,2674,15,1112
14871,2737,3291,3,Business,26,5,39070,26,5,39171,26,5,39726,26,5,40076,26,5,40647,5,23.25888921888938,-1.2628473,36.781805,-1.2600926,36.8088685,287,571,101,905
14872,17721,2066,3,Business,27,5,40024,27,5,40100,27,5,40726,27,5,40894,27,5,41895,5,22.3,-1.316961,36.820337,-1.3181843,36.8394827,844,1001,76,794
14873,27251,3560,3,Business,5,2,58310,5,2,58419,5,2,59422,5,2,59818,5,2,62096,8,23.25888921888938,-1.279395,36.825364,-1.2765492,36.7669809,831,2278,109,1399
14874,27207,3127,3,Business,1,1,53412,1,1,53501,1,1,54175,1,1,54311,1,1,55489,12,25.4,-1.2918246,36.801585,-1.3368903,36.767101,865,1178,89,810
14875,14547,2895,3,Business,30,2,46047,30,2,46347,30,2,46703,30,2,46888,30,2,48422,14,22.5,-1.3700383,36.9190174,-1.307182,36.850321,620,1534,300,541
14876,2026,893,3,Business,1,1,47513,1,1,47608,1,1,48187,1,1,48296,1,1,49660,9,24.0,-1.2664491,36.8102685,-1.2698168,36.7421898,72,1364,95,688
14877,9167,302,3,Business,5,5,68557,5,5,68862,5,5,69729,5,5,69798,5,5,70894,3,24.6,-1.2649605,36.7981777,-1.2513861,36.8174281,607,1096,305,936
14878,18940,346,3,Business,7,4,52712,7,4,52796,7,4,53280,7,4,54212,7,4,56111,4,31.3,-1.2646974,36.8051788,-1.28878,36.8168312,795,1899,84,1416
14879,15164,2066,3,Business,6,3,40447,6,3,40471,6,3,41415,6,3,41871,6,3,43776,19,22.3,-1.3210189,36.8410551,-1.3218455,36.7213009,523,1905,24,1400
14880,1696,176,1,Personal,18,4,40713,18,4,40839,18,4,41691,18,4,41839,18,4,42609,4,25.5,-1.278612,36.8195876,-1.2666695,36.8328283,477,770,126,1000
14881,6697,2828,2,Business,30,6,46196,30,6,46263,30,6,47321,30,6,47675,30,6,48392,3,21.9,-1.2584143,36.8048002,-1.2615888,36.7928732,795,717,67,1412
14882,8409,2423,3,Business,26,2,42369,26,2,42456,26,2,43103,26,2,44038,26,2,45231,6,27.4,-1.2571472,36.7950633,-1.300722,36.816865,245,1193,87,1582
14883,23574,633,3,Business,5,2,55354,5,2,55407,5,2,55666,5,2,55914,5,2,56480,4,27.7,-1.3077869,36.8443207,-1.3004062,36.829741,433,566,53,507
14884,27889,3641,3,Business,11,1,51721,11,1,51850,11,1,52094,11,1,52308,11,1,52523,4,28.7,-1.2551895,36.7822034,-1.254373,36.7760066,242,215,129,458
14885,12538,592,1,Personal,17,1,48025,17,1,48038,17,1,48147,17,1,50321,17,1,51363,10,28.2,-1.2728947,36.8079426,-1.2949439,36.7604214,895,1042,13,2283
14886,10165,1046,1,Personal,12,3,32057,12,3,32140,12,3,33571,12,3,33705,12,3,35156,4,16.5,-1.3054537,36.8284768,-1.3007415,36.8356523,328,1451,83,1565
14887,8210,3300,3,Business,11,4,37310,11,4,37324,11,4,38455,11,4,39215,11,4,41083,19,25.4,-1.293515,36.897607,-1.303596,36.778378,377,1868,14,1891
14888,8272,1191,1,Personal,3,1,47536,3,1,47645,3,1,48153,3,1,48568,3,1,49961,5,20.4,-1.297451,36.8210544,-1.2922258,36.7796871,932,1393,109,923
14889,11393,3196,2,Personal,24,2,40066,24,2,40225,24,2,41724,24,2,41874,24,2,43303,8,17.2,-1.3185531,36.7943715,-1.2835586,36.8157644,88,1429,159,1649
14890,17157,786,1,Personal,4,4,39229,4,4,39248,4,4,39839,4,4,40351,4,4,41626,9,23.25888921888938,-1.3123271,36.8147383,-1.2884404,36.7736747,726,1275,19,1103
14891,1873,3647,3,Business,5,5,38186,5,5,38233,5,5,39382,5,5,39727,5,5,42134,8,24.4,-1.272639,36.794723,-1.3041019,36.8105732,843,2407,47,1494
14892,21357,1100,2,Personal,12,2,26722,12,2,26746,12,2,27358,12,2,28007,12,2,29215,7,16.0,-1.2764851,36.8007126,-1.3025826,36.7670807,334,1208,24,1261
14893,23087,346,3,Business,18,3,47491,18,3,47528,18,3,48852,18,3,49034,18,3,51261,10,20.9,-1.2885529,36.8160141,-1.2390763,36.8691597,174,2227,37,1506
14894,6077,3239,1,Personal,5,5,34490,5,5,34562,5,5,35694,5,5,35954,5,5,37031,9,17.6,-1.2844072,36.8247296,-1.3194988,36.7966681,736,1077,72,1392
14895,17435,3214,3,Business,15,2,52622,15,2,52666,15,2,53446,15,2,53653,15,2,58121,12,24.6,-1.2315181,36.8140543,-1.289795,36.7957132,899,4468,44,987
14896,6603,1927,3,Business,5,2,61363,5,2,61645,5,2,64385,5,2,64825,5,2,66541,10,23.25888921888938,-1.3169591,36.7000029,-1.3472066,36.7692638,789,1716,282,3180
14897,21850,3723,1,Personal,10,4,45697,10,4,45742,10,4,46461,10,4,46701,10,4,47667,9,23.25888921888938,-1.300722,36.816865,-1.2562249,36.7868661,742,966,45,959
14898,1034,3647,3,Business,13,1,36429,13,1,36470,13,1,37154,13,1,37496,13,1,37896,3,23.25888921888938,-1.272639,36.794723,-1.263453,36.7955612,576,400,41,1026
14899,10094,3599,3,Business,23,5,39774,23,5,43681,23,5,44425,23,5,45463,23,5,48001,13,24.1,-1.3302996,36.8707935,-1.2662453,36.8219775,550,2538,3907,1782
14900,11034,1075,3,Business,15,5,39905,15,5,39931,15,5,40884,15,5,41388,15,5,43732,20,26.6,-1.3277669,36.8975169,-1.2527958,36.8003131,675,2344,26,1457
14901,16368,1014,3,Business,30,4,35623,30,4,35669,30,4,36470,30,4,37070,30,4,38116,12,16.0,-1.3234104,36.7989459,-1.2733546,36.7696069,249,1046,46,1401
14902,8490,3647,3,Business,28,1,61767,28,1,62016,28,1,62875,28,1,63098,28,1,64680,11,25.2,-1.272639,36.794723,-1.318411,36.8059305,343,1582,249,1082
14903,12386,265,3,Business,8,4,44386,8,4,44449,8,4,44927,8,4,45242,8,4,45629,3,26.1,-1.3108107,36.8244221,-1.300921,36.828195,634,387,63,793
14904,7449,3651,3,Business,7,3,57009,7,3,58646,7,3,60625,7,3,61164,7,3,62399,5,25.0,-1.2904119,36.7898312,-1.2895384,36.8276707,612,1235,1637,2518
14905,23975,2271,3,Business,28,5,38043,28,5,38054,28,5,38438,28,5,39371,28,5,41485,14,23.9,-1.272828,36.816608,-1.293515,36.897607,829,2114,11,1317
14906,8758,2676,3,Business,23,1,46457,23,1,46517,23,1,46591,23,1,47002,23,1,47556,4,18.5,-1.2963097,36.7688221,-1.2764692,36.7580111,100,554,60,485
14907,21539,1500,3,Business,4,5,40192,4,5,40665,4,5,41345,4,5,43006,4,5,43852,8,17.4,-1.3004062,36.829741,-1.2574219,36.7927073,555,846,473,2341
14908,28264,816,3,Business,21,1,39152,21,1,39259,21,1,39455,21,1,39752,21,1,43950,4,25.4,-1.2938807,36.8129504,-1.290894,36.822971,458,4198,107,493
14909,18937,2330,3,Business,26,5,62338,26,5,62408,26,5,62822,26,5,63055,26,5,64407,6,23.25888921888938,-1.2645318,36.7981775,-1.2915247,36.8055757,168,1352,70,647
14910,14835,1363,3,Business,10,1,53700,10,1,53837,10,1,54477,10,1,55274,10,1,55786,4,18.3,-1.3004062,36.829741,-1.2825816,36.8092346,106,512,137,1437
14911,6883,2330,3,Business,13,1,45628,13,1,45697,13,1,47265,13,1,47692,13,1,50447,11,23.25888921888938,-1.293082,36.8278578,-1.2925641,36.8976449,884,2755,69,1995
14912,15682,347,1,Personal,30,1,48973,30,1,48977,30,1,49017,30,1,50372,30,1,53191,14,20.6,-1.3223068,36.7929881,-1.276312,36.882742,229,2819,4,1395
14913,13155,3517,3,Business,7,5,36395,7,5,36431,7,5,36937,7,5,40859,7,5,42040,16,23.25888921888938,-1.300921,36.828195,-1.3882008,36.7699445,557,1181,36,4428
14914,19886,53,3,Business,12,5,56804,12,5,57197,12,5,57781,12,5,58420,12,5,59885,6,23.25888921888938,-1.3077869,36.8443207,-1.2770708,36.8231093,99,1465,393,1223
14915,2341,3238,3,Business,4,2,42696,4,2,44544,4,2,47104,4,2,47465,4,2,50483,24,19.4,-1.3976138,36.782966,-1.2883874,36.7756411,205,3018,1848,2921
14916,11536,1837,1,Personal,1,1,42978,1,1,42997,1,1,43482,1,1,43971,1,1,46551,15,24.1,-1.2772589,36.8190221,-1.3563742,36.7580286,31,2580,19,974
14917,5823,2190,3,Business,3,1,50636,3,1,50739,3,1,51652,3,1,52312,3,1,54938,18,23.5,-1.301953,36.788458,-1.260964,36.711857,519,2626,103,1573
14918,4081,2536,3,Personal,2,6,40515,2,6,40542,2,6,41866,2,6,42136,2,6,42950,6,24.0,-1.2765492,36.7669809,-1.2705336,36.7943509,215,814,27,1594
14919,6690,1299,3,Business,2,3,42833,2,3,42845,2,3,43135,2,3,43534,2,3,44746,7,21.9,-1.282543,36.824618,-1.25537,36.7756,742,1212,12,689
14920,24555,1245,3,Business,5,2,43801,5,2,43824,5,2,43826,5,2,48846,5,2,50667,17,27.6,-1.300921,36.828195,-1.3198615,36.7110323,595,1821,23,5022
14921,4806,478,3,Business,12,3,49523,12,3,49656,12,3,49711,12,3,50053,12,3,50362,2,20.8,-1.2551895,36.7822034,-1.2571341,36.7904501,709,309,133,397
14922,13555,1471,3,Business,30,2,40309,30,2,40537,30,2,43992,30,2,44561,30,2,47017,9,23.25888921888938,-1.2551895,36.7822034,-1.2983462,36.8139996,394,2456,228,4024
14923,23414,3647,3,Business,28,3,60633,28,3,60655,28,3,61345,28,3,61578,28,3,66385,17,23.2,-1.272639,36.794723,-1.207546,36.7913976,56,4807,22,923
14924,16358,869,3,Personal,10,4,41741,10,4,41784,10,4,42039,10,4,43046,10,4,43411,2,23.25888921888938,-1.2775276,36.8140021,-1.2895261,36.8164407,100,365,43,1262
14925,10141,3283,3,Business,30,6,39616,30,6,40519,30,6,41700,30,6,43103,30,6,43105,6,26.8,-1.272828,36.816608,-1.2628473,36.781805,309,2,903,2584
14926,14001,718,3,Business,18,1,50852,18,1,51025,18,1,51678,18,1,52121,18,1,53371,6,31.0,-1.2551895,36.7822034,-1.2881035,36.8142095,206,1250,173,1096
14927,25742,1280,3,Business,11,2,58768,11,2,59011,11,2,59547,11,2,59901,11,2,60418,3,20.4,-1.2551895,36.7822034,-1.2575407,36.7868197,690,517,243,890
14928,10271,3727,3,Business,6,4,35548,6,4,35690,6,4,36005,6,4,36424,6,4,37558,8,18.7,-1.2963097,36.7688221,-1.2600616,36.7870182,517,1134,142,734
14929,23543,1389,3,Business,5,2,48636,5,2,48669,5,2,49116,5,2,49573,5,2,50831,14,23.25888921888938,-1.2584143,36.8048002,-1.207546,36.7913976,205,1258,33,904
14930,3203,1402,3,Business,25,6,55968,25,6,56086,25,6,56768,25,6,59199,25,6,59390,1,23.25888921888938,-1.290894,36.822971,-1.2813012,36.8323962,106,191,118,3113
14931,21629,1809,3,Business,15,1,55680,15,1,55851,15,1,55864,15,1,56928,15,1,56943,2,23.25888921888938,-1.264272,36.7978791,-1.2646084,36.8028645,51,15,171,1077
14932,12613,142,3,Business,22,3,32238,22,3,32286,22,3,32433,22,3,33825,22,3,35000,8,18.8,-1.2601197,36.7985271,-1.2963097,36.7688221,131,1175,48,1539
14933,24282,911,3,Personal,11,6,62865,11,6,62938,11,6,64232,11,6,64451,11,6,69306,28,23.25888921888938,-1.2872974,36.8241743,-1.364732,36.658943,622,4855,73,1513
14934,290,2796,1,Personal,21,4,46417,21,4,47099,21,4,48728,21,4,49634,21,4,52185,10,22.6,-1.3052672,36.7538539,-1.268027,36.8037005,101,2551,682,2535
14935,11467,2271,3,Business,13,3,43457,13,3,43692,13,3,44243,13,3,45796,13,3,47377,12,24.9,-1.228911,36.881876,-1.293515,36.897607,267,1581,235,2104
14936,22263,640,3,Business,29,5,56119,29,5,56608,29,5,58451,29,5,58744,29,5,60099,7,21.0,-1.304033,36.7848695,-1.2641724,36.8014198,208,1355,489,2136
14937,7732,910,3,Personal,13,1,41903,13,1,42784,13,1,43149,13,1,43424,13,1,47554,5,17.3,-1.2506462,36.846258,-1.287588,36.820226,265,4130,881,640
14938,8353,1439,3,Business,3,3,35506,3,3,35578,3,3,36032,3,3,37242,3,3,39412,16,21.4,-1.2913642,36.8710819,-1.2962487,36.7772971,247,2170,72,1664
14939,6385,3300,3,Business,12,3,50662,12,3,50874,12,3,50927,12,3,52407,12,3,52769,5,20.8,-1.3040553,36.8092658,-1.303596,36.778378,564,362,212,1533
14940,7714,2066,3,Business,10,1,40120,10,1,40220,10,1,41022,10,1,41444,10,1,42642,10,23.25888921888938,-1.316961,36.820337,-1.2523489,36.8006091,88,1198,100,1224
14941,26535,142,3,Business,19,2,46493,19,2,46520,19,2,47432,19,2,47993,19,2,48605,4,26.4,-1.2795216,36.7706752,-1.2963097,36.7688221,778,612,27,1473
14942,15233,1594,3,Business,14,7,57384,14,7,58526,14,7,60213,14,7,60303,14,7,62119,10,27.6,-1.2285835,36.8826468,-1.1898857,36.9103054,679,1816,1142,1777
14943,22578,3496,3,Business,14,4,57401,14,4,58320,14,4,58860,14,4,59924,14,4,61391,13,25.8,-1.332175,36.8819641,-1.300921,36.828195,856,1467,919,1604
14944,15171,718,3,Business,15,1,58202,15,1,62585,15,1,63414,15,1,63535,15,1,66169,14,23.25888921888938,-1.2551895,36.7822034,-1.2515931,36.8754396,383,2634,4383,950
14945,22053,84,3,Business,27,4,37132,27,4,37517,27,4,38431,27,4,39170,27,4,41358,21,23.0,-1.3562374,36.9042954,-1.2551895,36.7822034,436,2188,385,1653
14946,22874,3688,3,Business,19,3,53552,19,3,55404,19,3,56257,19,3,56446,19,3,57718,8,24.5,-1.2551895,36.7822034,-1.2962731,36.8111863,899,1272,1852,1042
14947,12598,2956,3,Business,27,1,39236,27,1,39331,27,1,40769,27,1,41017,27,1,42710,13,20.8,-1.2584143,36.8048002,-1.2413316,36.8785525,541,1693,95,1686
14948,4181,798,3,Business,17,1,46365,17,1,46386,17,1,46585,17,1,46998,17,1,49365,15,24.8,-1.304033,36.7848695,-1.2898851,36.8791504,101,2367,21,612
14949,26549,393,3,Business,21,4,40570,21,4,40578,21,4,40593,21,4,41787,21,4,43211,14,25.0,-1.3167113,36.8301563,-1.306378,36.7519845,842,1424,8,1209
14950,11910,346,3,Business,24,4,53201,24,4,53274,24,4,53718,24,4,54140,24,4,54619,2,28.5,-1.28878,36.8168312,-1.2859116,36.8098035,819,479,73,866
14951,15829,3001,3,Business,31,5,59129,31,5,59324,31,5,60436,31,5,60848,31,5,62015,6,23.8,-1.2846195,36.7958316,-1.2637515,36.7885663,502,1167,195,1524
14952,18596,1368,3,Business,28,1,52351,28,1,52389,28,1,52978,28,1,53503,28,1,54877,7,26.1,-1.2664227,36.7453671,-1.2571472,36.7950633,337,1374,38,1114
14953,25153,3295,3,Business,21,5,31540,21,5,31559,21,5,31880,21,5,32567,21,5,35055,20,20.0,-1.2571472,36.7950633,-1.3700383,36.9190174,620,2488,19,1008
14954,14089,552,3,Business,13,3,40002,13,3,40026,13,3,43381,13,3,44092,13,3,46282,20,23.25888921888938,-1.3562374,36.9042954,-1.2569503,36.7834728,300,2190,24,4066
14955,12015,3214,3,Business,6,4,52741,6,4,52817,6,4,54834,6,4,55304,6,4,58950,21,21.2,-1.289795,36.7957132,-1.3190102,36.9230693,411,3646,76,2487
14956,28125,136,3,Business,20,4,49504,20,4,50422,20,4,51465,20,4,51567,20,4,53355,16,25.4,-1.3254522,36.7216584,-1.3233496,36.8139159,470,1788,918,1145
14957,6230,3355,3,Business,25,4,61070,25,4,61771,25,4,63094,25,4,63545,25,4,64915,8,23.25888921888938,-1.3226302,36.8719901,-1.305399,36.8221849,184,1370,701,1774
14958,5722,972,3,Business,13,3,49485,13,3,49960,13,3,51223,13,3,51377,13,3,52217,4,23.6,-1.2862033,36.8152966,-1.2610959,36.8281022,844,840,475,1417
14959,18918,393,3,Business,14,1,56429,14,1,56448,14,1,56454,14,1,59667,14,1,59669,14,24.6,-1.3167113,36.8301563,-1.2991441,36.7528804,515,2,19,3219
14960,8195,2987,3,Business,4,2,45902,4,2,46276,4,2,47104,4,2,47198,4,2,48014,4,19.7,-1.270212,36.8210877,-1.2513591,36.7947674,658,816,374,922
14961,26706,393,3,Business,24,5,54866,24,5,54935,24,5,55503,24,5,56250,24,5,57029,4,23.1,-1.3228003,36.8306435,-1.3004062,36.829741,2,779,69,1315
14962,4978,1271,3,Business,5,2,55335,5,2,55388,5,2,56461,5,2,56664,5,2,58848,10,27.5,-1.3108386,36.7555239,-1.2649605,36.7981777,198,2184,53,1276
14963,26550,633,3,Business,20,2,61196,20,2,61208,20,2,61234,20,2,61352,20,2,62196,5,23.8,-1.3004062,36.829741,-1.3083266,36.8494756,39,844,12,144
14964,1655,136,3,Business,17,5,40314,17,5,40329,17,5,40715,17,5,40940,17,5,41425,2,23.25888921888938,-1.2649605,36.7981777,-1.2657988,36.812624,96,485,15,611
14965,4832,137,3,Personal,12,4,46265,12,4,46477,12,4,46741,12,4,46846,12,4,49044,5,18.9,-1.2916556,36.8262516,-1.297171,36.783278,24,2198,212,369
14966,200,1594,3,Business,8,3,37948,8,3,37981,8,3,38682,8,3,40083,8,3,40932,8,23.25888921888938,-1.2571472,36.7950633,-1.225322,36.80855,819,849,33,2102
14967,18269,3291,3,Business,6,6,44028,6,6,44074,6,6,44131,6,6,48649,6,6,50262,12,26.5,-1.331619,36.847976,-1.2600926,36.8088685,459,1613,46,4575
14968,608,393,3,Business,4,1,40947,4,1,40987,4,1,41567,4,1,41794,4,1,43418,14,26.6,-1.3167113,36.8301563,-1.306378,36.7519845,523,1624,40,807
14969,3990,1874,3,Business,28,3,47044,28,3,47077,28,3,47787,28,3,47905,28,3,49294,9,23.25888921888938,-1.2993094,36.7772069,-1.2571472,36.7950633,353,1389,33,828
14970,25338,868,3,Business,28,2,56959,28,2,56979,28,2,57416,28,2,58195,28,2,59265,5,19.5,-1.2600926,36.8088685,-1.265715,36.823815,882,1070,20,1216
14971,17818,567,3,Business,23,2,51303,23,2,51595,23,2,52234,23,2,54277,23,2,55228,5,18.8,-1.273056,36.811298,-1.295908,36.791433,878,951,292,2682
14972,1695,1502,3,Business,14,5,55876,14,5,58811,14,5,59609,14,5,59715,14,5,63843,3,22.9,-1.2232123,36.8932547,-1.2198413,36.9054958,854,4128,2935,904
14973,11067,138,3,Business,27,3,47940,27,3,47977,27,3,48780,27,3,48844,27,3,53726,20,29.3,-1.3562374,36.9042954,-1.2615888,36.7928732,606,4882,37,867
14974,20111,2330,3,Business,15,5,56205,15,5,56351,15,5,56703,15,5,56836,15,5,57366,4,28.1,-1.3040812,36.7924217,-1.3015197,36.7658456,545,530,146,485
14975,22165,517,3,Business,29,4,36596,29,4,36608,29,4,36811,29,4,37185,29,4,39686,14,18.7,-1.3177547,36.8303703,-1.306378,36.7519845,523,2501,12,577
14976,3960,868,3,Business,28,2,31845,28,2,31894,28,2,32624,28,2,33643,28,2,34639,6,18.6,-1.307143,36.825009,-1.265715,36.823815,2,996,49,1749
14977,10117,3187,2,Personal,9,3,32287,9,3,32310,9,3,33217,9,3,33363,9,3,35290,13,17.7,-1.3206958,36.8769553,-1.306245,36.8192978,285,1927,23,1053
14978,15836,2150,3,Business,5,2,37099,5,2,37270,5,2,37886,5,2,37996,5,2,39283,9,25.3,-1.303596,36.778378,-1.344446,36.756597,801,1287,171,726
14979,21028,3578,3,Business,26,6,53057,26,6,53124,26,6,53779,26,6,54619,26,6,56557,13,28.2,-1.2527958,36.8003131,-1.2297488,36.8605832,880,1938,67,1495
14980,16781,346,3,Business,4,3,57752,4,3,57882,4,3,58323,4,3,59154,4,3,59622,1,18.2,-1.279395,36.825364,-1.2885529,36.8160141,531,468,130,1272
14981,8731,3291,3,Business,16,4,54010,16,4,54097,16,4,54198,16,4,56235,16,4,56876,4,23.25888921888938,-1.2663631,36.8163329,-1.2600926,36.8088685,686,641,87,2138
14982,22675,3621,3,Business,25,7,42419,25,7,42477,25,7,43343,25,7,43591,25,7,45547,9,23.2,-1.2836583,36.7886014,-1.254443,36.825857,805,1956,58,1114
14983,3259,1329,3,Business,26,5,53202,26,5,53394,26,5,55834,26,5,55965,26,5,56231,1,23.25888921888938,-1.273056,36.811298,-1.2753109,36.8130185,607,266,192,2571
14984,2995,3201,3,Business,30,3,42528,30,3,42564,30,3,43213,30,3,43701,30,3,47338,17,24.8,-1.3165542,36.700067,-1.2584143,36.8048002,70,3637,36,1137
14985,16420,1647,3,Business,4,4,59235,4,4,59483,4,4,60871,4,4,61286,4,4,64989,13,25.8,-1.2190317,36.8825092,-1.2849786,36.8322989,570,3703,248,1803
14986,13092,1346,3,Business,17,3,56485,17,3,57796,17,3,58984,17,3,59431,17,3,60359,5,23.25888921888938,-1.2917868,36.7872675,-1.2802618,36.8191684,855,928,1311,1635
14987,18552,2801,3,Business,27,3,43647,27,3,43883,27,3,45016,27,3,45562,27,3,47283,8,26.2,-1.289081,36.8300409,-1.2674274,36.7870827,61,1721,236,1679
14988,2223,1162,3,Business,18,6,48914,18,6,48998,18,6,50239,18,6,51449,18,6,53245,10,20.1,-1.2560222,36.7886679,-1.312261,36.794658,161,1796,84,2451
14989,26505,3589,1,Personal,10,2,27876,10,2,27887,10,2,28165,10,2,28889,10,2,29822,9,16.4,-1.2571191,36.8019652,-1.2248308,36.8012573,116,933,11,1002
14990,1600,478,3,Business,6,1,42186,6,1,42232,6,1,42239,6,1,42763,6,1,44008,11,23.25888921888938,-1.2551895,36.7822034,-1.3142701,36.8537693,576,1245,46,531
14991,22329,868,3,Business,13,3,53842,13,3,53864,13,3,54083,13,3,54552,13,3,54555,3,27.2,-1.2783849,36.8163445,-1.265715,36.823815,79,3,22,688
14992,16221,1736,3,Personal,14,5,53298,14,5,53365,14,5,54500,14,5,55853,14,5,57871,14,27.1,-1.296485,36.7931959,-1.3189252,36.8617269,890,2018,67,2488
14993,15280,2801,3,Business,14,3,57702,14,3,57746,14,3,58420,14,3,58792,14,3,59212,5,25.7,-1.2595422,36.7871178,-1.257773,36.795486,839,420,44,1046
14994,20918,201,3,Business,4,2,31132,4,2,31655,4,2,32295,4,2,32853,4,2,33706,6,16.3,-1.2551895,36.7822034,-1.2816948,36.8252304,407,853,523,1198
14995,6372,28,3,Business,3,4,36762,3,4,37384,3,4,38110,3,4,38459,3,4,39407,5,22.1,-1.2745107,36.7974503,-1.299846,36.7940155,580,948,622,1075
14996,303,2468,3,Business,4,1,40149,4,1,40191,4,1,40736,4,1,41146,4,1,42160,5,25.4,-1.2857671,36.7875614,-1.2996681,36.8068413,432,1014,42,955
14997,847,319,2,Personal,7,4,48186,7,4,48302,7,4,49152,7,4,49307,7,4,51235,8,20.0,-1.3043649,36.7816132,-1.280122,36.8309201,116,1928,116,1005
14998,729,3032,3,Business,11,5,55645,11,5,55651,11,5,56266,11,5,56335,11,5,58085,16,26.6,-1.2571472,36.7950633,-1.2117467,36.9002941,932,1750,6,684
14999,9869,346,3,Business,20,1,32465,20,1,32620,20,1,33979,20,1,34450,20,1,34604,1,19.3,-1.279395,36.825364,-1.28878,36.8168312,75,154,155,1830
15000,16736,2423,3,Business,10,3,56007,10,3,56045,10,3,56064,10,3,57258,10,3,57614,1,30.5,-1.2571472,36.7950633,-1.2655477,36.8001682,720,356,38,1213
15001,20640,3194,3,Business,14,4,35560,14,4,35573,14,4,35592,14,4,36981,14,4,38750,14,18.9,-1.2551895,36.7822034,-1.312745,36.875715,26,1769,13,1408
15002,18525,1075,3,Business,12,2,35182,12,2,35378,12,2,37177,12,2,37454,12,2,39350,6,20.7,-1.2813012,36.8323962,-1.2527958,36.8003131,590,1896,196,2076
15003,11946,1271,3,Business,21,4,48597,21,4,48634,21,4,49493,21,4,49982,21,4,51975,17,30.9,-1.2285995,36.9012372,-1.3244885,36.897792,691,1993,37,1348
15004,17685,3201,3,Business,29,6,56400,29,6,56939,29,6,58826,29,6,59204,29,6,60633,17,26.5,-1.3463042,36.768164,-1.2584143,36.8048002,237,1429,539,2265
15005,11403,909,3,Business,5,5,47628,5,5,47745,5,5,48854,5,5,49746,5,5,50218,7,26.7,-1.207546,36.7913976,-1.225322,36.80855,882,472,117,2001
15006,26907,1243,3,Business,30,1,43698,30,1,43716,30,1,43747,30,1,44293,30,1,46093,16,22.8,-1.2551895,36.7822034,-1.226855,36.8857626,539,1800,18,577
15007,25057,2987,3,Business,29,4,35330,29,4,35368,29,4,36200,29,4,36362,29,4,37130,4,18.5,-1.270212,36.8210877,-1.2534301,36.8000983,612,768,38,994
15008,25400,1874,3,Business,12,2,55361,12,2,55389,12,2,55400,12,2,56582,12,2,58637,12,27.0,-1.2571472,36.7950633,-1.3035721,36.7361169,279,2055,28,1193
15009,12586,3718,3,Business,14,5,54176,14,5,54592,14,5,55748,14,5,56076,14,5,56454,2,23.5,-1.2650027,36.8126242,-1.2640299,36.8134074,932,378,416,1484
15010,12937,393,3,Business,20,3,31353,20,3,31368,20,3,31388,20,3,31631,20,3,32330,5,21.0,-1.3167113,36.8301563,-1.3077869,36.8443207,111,699,15,263
15011,6121,3647,3,Business,27,4,35216,27,4,35312,27,4,35994,27,4,36362,27,4,37571,6,18.0,-1.272639,36.794723,-1.2884243,36.8207248,26,1209,96,1050
15012,19206,3487,3,Business,13,1,54463,13,1,54915,13,1,54936,13,1,55869,13,1,56887,5,23.25888921888938,-1.2527958,36.8003131,-1.279395,36.825364,89,1018,452,954
15013,17546,20,3,Business,11,4,53836,11,4,54041,11,4,55060,11,4,55380,11,4,58136,6,26.8,-1.2629666,36.8068369,-1.2937193,36.8236214,576,2756,205,1339
15014,10291,3203,3,Business,9,6,40084,9,6,40854,9,6,41919,9,6,44569,9,6,45380,9,17.3,-1.272828,36.816608,-1.228911,36.881876,379,811,770,3715
15015,9792,561,1,Personal,6,4,73688,6,4,73712,6,4,73769,6,4,76669,6,4,77352,7,17.8,-1.2546942,36.7832536,-1.238146,36.7649366,874,683,24,2957
15016,1861,60,3,Business,1,4,37334,1,4,37519,1,4,38828,1,4,39201,1,4,42189,9,23.25888921888938,-1.2783849,36.8163445,-1.2296618,36.8438272,6,2988,185,1682
15017,20063,1527,3,Business,10,3,40361,10,3,40583,10,3,42159,10,3,43166,10,3,43168,4,27.6,-1.2770708,36.8231093,-1.3004062,36.829741,61,2,222,2583
15018,3582,627,3,Business,1,1,50475,1,1,50535,1,1,50916,1,1,52530,1,1,54220,13,23.25888921888938,-1.2527958,36.8003131,-1.2998685,36.8643907,383,1690,60,1995
15019,25038,2588,3,Personal,16,3,44807,16,3,45149,16,3,47357,16,3,47472,16,3,48680,7,24.0,-1.2530951,36.8141675,-1.2983124,36.8104456,749,1208,342,2323
15020,10734,1724,3,Business,1,4,41753,1,4,42224,1,4,43644,1,4,44041,1,4,45808,8,23.25888921888938,-1.2793172,36.8276567,-1.2551895,36.7822034,268,1767,471,1817
15021,8505,1926,3,Business,13,3,39011,13,3,39043,13,3,39531,13,3,39744,13,3,41751,16,23.25888921888938,-1.3263105,36.8622904,-1.2571472,36.7950633,145,2007,32,701
15022,3650,3149,3,Business,3,3,39981,3,3,40025,3,3,40051,3,3,41323,3,3,41901,6,24.2,-1.3004062,36.829741,-1.3177547,36.8303703,848,578,44,1298
15023,13815,333,1,Personal,11,2,50286,11,2,50529,11,2,51381,11,2,51763,11,2,52663,5,25.4,-1.3024794,36.8228284,-1.2854174,36.7951152,148,900,243,1234
15024,12591,2174,3,Business,6,4,38686,6,4,38694,6,4,39070,6,4,40175,6,4,40836,5,22.2,-1.2482781,36.884092,-1.2297202,36.8819507,946,661,8,1481
15025,18626,237,3,Business,21,4,36296,21,4,36457,21,4,37277,21,4,37681,21,4,38745,5,21.6,-1.2551895,36.7822034,-1.2764099,36.8208451,682,1064,161,1224
15026,5451,1646,3,Business,20,6,51945,20,6,52024,20,6,52679,20,6,53104,20,6,55018,7,23.25888921888938,-1.2517448,36.7924971,-1.2547586,36.7628357,576,1914,79,1080
15027,7964,2030,3,Business,14,5,41300,14,5,45037,14,5,45803,14,5,46166,14,5,48259,6,24.6,-1.3396256,36.8863135,-1.3333725,36.8717613,516,2093,3737,1129
15028,884,3291,3,Business,2,6,47613,2,6,48454,2,6,48676,2,6,49082,2,6,49660,5,31.1,-1.2628473,36.781805,-1.2600926,36.8088685,291,578,841,628
15029,28123,265,3,Business,7,3,54679,7,3,54750,7,3,56621,7,3,57236,7,3,58443,12,28.2,-1.2427291,36.7821206,-1.300921,36.828195,257,1207,71,2486
15030,7390,302,3,Business,6,3,47185,6,3,47274,6,3,48461,6,3,49867,6,3,51378,9,23.25888921888938,-1.3039695,36.7838267,-1.2649605,36.7981777,118,1511,89,2593
15031,10539,1342,3,Business,6,2,40786,6,2,40916,6,2,41572,6,2,42068,6,2,43062,9,24.9,-1.2977705,36.8134139,-1.3025826,36.7670807,726,994,130,1152
15032,17631,2200,3,Business,27,3,57820,27,3,58103,27,3,59266,27,3,59996,27,3,63637,4,27.4,-1.290894,36.822971,-1.3041129,36.8104939,448,3641,283,1893
15033,1701,970,3,Business,5,4,42336,5,4,43757,5,4,44287,5,4,44571,5,4,45694,6,23.25888921888938,-1.2551895,36.7822034,-1.2834774,36.8218085,726,1123,1421,814
15034,26044,393,3,Business,9,3,42942,9,3,43018,9,3,44516,9,3,45602,9,3,47068,11,25.2,-1.3167113,36.8301563,-1.2574219,36.7927073,725,1466,76,2584
15035,10740,2521,3,Business,25,5,44139,25,5,44198,25,5,44204,25,5,44815,25,5,45886,4,26.5,-1.3167113,36.8301563,-1.3004062,36.829741,518,1071,59,617
15036,27984,2982,3,Business,8,5,60140,8,5,60302,8,5,60324,8,5,62114,8,5,62642,12,27.9,-1.300921,36.828195,-1.2658003,36.8983864,70,528,162,1812
15037,20500,797,3,Business,29,3,41558,29,3,41668,29,3,42111,29,3,42340,29,3,43334,7,18.4,-1.2551895,36.7822034,-1.2949474,36.8270407,79,994,110,672
15038,13307,1402,3,Business,16,1,46837,16,1,46907,16,1,48035,16,1,48547,16,1,49441,9,19.4,-1.2891922,36.825189,-1.2584143,36.8048002,358,894,70,1640
15039,15068,496,3,Business,15,5,42890,15,5,42952,15,5,46299,15,5,46648,15,5,50267,11,26.1,-1.3217077,36.8170671,-1.2571472,36.7950633,304,3619,62,3696
15040,7843,552,3,Business,25,2,47028,25,2,47124,25,2,48768,25,2,49667,25,2,50377,8,27.0,-1.3332749,36.8708147,-1.3632162,36.9108253,38,710,96,2543
15041,20614,2825,2,Personal,18,6,48378,18,6,48385,18,6,49003,18,6,49676,18,6,51218,14,20.5,-1.2156006,36.8916865,-1.2695713,36.8053074,384,1542,7,1291
15042,13057,1402,3,Business,14,4,43725,14,4,43748,14,4,44151,14,4,44389,14,4,45470,11,25.1,-1.2283403,36.8822756,-1.2813012,36.8323962,456,1081,23,641
15043,14841,1351,1,Personal,19,5,47820,19,5,47876,19,5,47967,19,5,48755,19,5,50644,16,27.5,-1.2854453,36.8188363,-1.323682,36.708787,456,1889,56,879
15044,10303,2310,1,Business,30,6,35319,30,6,35418,30,6,37017,30,6,37379,30,6,38735,7,17.8,-1.285382,36.8162878,-1.29928,36.85631,752,1356,99,1961
15045,20587,1500,3,Business,5,1,30814,5,1,45294,5,1,45314,5,1,45756,5,1,47136,8,24.7,-1.3004062,36.829741,-1.2574219,36.7927073,208,1380,14480,462
15046,2936,2112,3,Business,27,2,54517,27,2,54707,27,2,57483,27,2,57671,27,2,58754,12,25.5,-1.290894,36.822971,-1.2156006,36.8916865,622,1083,190,2964
15047,5294,2216,3,Business,4,5,38558,4,5,38572,4,5,38604,4,5,41103,4,5,43710,23,17.1,-1.2867627,36.883446,-1.1612808,36.9563278,31,2607,14,2531
15048,13978,3426,3,Business,9,6,39268,9,6,39300,9,6,39647,9,6,39971,9,6,40785,4,27.5,-1.3012008,36.764868,-1.2985559,36.783791,132,814,32,671
15049,11663,1637,3,Business,13,4,52523,13,4,52550,13,4,53187,13,4,53454,13,4,55011,15,22.5,-1.2615888,36.7928732,-1.207546,36.7913976,259,1557,27,904
15050,8470,893,3,Business,28,3,56793,28,3,62350,28,3,62994,28,3,63230,28,3,64080,5,23.0,-1.2747111,36.8083983,-1.258348,36.8449018,685,850,5557,880
15051,1267,3599,3,Business,30,2,37667,30,2,40571,30,2,42032,30,2,42297,30,2,44484,12,23.25888921888938,-1.3302996,36.8707935,-1.2829828,36.7972062,853,2187,2904,1726
15052,657,3222,3,Business,1,1,54805,1,1,54854,1,1,54959,1,1,55043,1,1,57524,8,25.6,-1.2551895,36.7822034,-1.2824911,36.8218042,447,2481,49,189
15053,12380,1329,3,Business,31,4,35526,31,4,36470,31,4,36954,31,4,37056,31,4,37795,2,20.7,-1.273056,36.811298,-1.2641662,36.8136393,228,739,944,586
15054,23048,718,3,Business,2,2,42069,2,2,42108,2,2,42651,2,2,42766,2,2,43702,4,21.2,-1.2551895,36.7822034,-1.265981,36.7936121,937,936,39,658
15055,4381,3330,3,Business,20,3,46123,20,3,46136,20,3,46140,20,3,46977,20,3,47757,3,20.2,-1.2652108,36.8056075,-1.2825816,36.8092346,813,780,13,841
15056,20075,2285,3,Personal,13,1,40133,13,1,40150,13,1,40578,13,1,40656,13,1,44359,16,23.25888921888938,-1.351453,36.899315,-1.2950041,36.8143583,504,3703,17,506
15057,15050,2330,3,Business,8,1,35688,8,1,35697,8,1,35768,8,1,36707,8,1,38397,17,21.8,-1.2642903,36.8002137,-1.3272343,36.7110502,96,1690,9,1010
15058,13806,3532,2,Personal,12,5,47276,12,5,47332,12,5,47596,12,5,48219,12,5,50536,5,24.4,-1.2795195,36.8230726,-1.2885364,36.7995016,698,2317,56,887
15059,25599,1340,3,Business,28,4,52960,28,4,52984,28,4,53148,28,4,53928,28,4,56866,19,27.2,-1.2707179,36.7979713,-1.166938,36.824351,755,2938,24,944
15060,27334,242,3,Business,30,3,35840,30,3,35846,30,3,36166,30,3,36490,30,3,38412,18,17.4,-1.2553615,36.7895376,-1.338579,36.8963038,103,1922,6,644
15061,8844,2100,3,Business,29,3,60272,29,3,60320,29,3,60778,29,3,61688,29,3,62469,6,19.0,-1.2765736,36.8513646,-1.28593,36.8151111,629,781,48,1368
15062,13475,1500,3,Business,5,1,57697,5,1,59053,5,1,59080,5,1,60733,5,1,62075,10,24.3,-1.3177547,36.8303703,-1.2574219,36.7927073,10,1342,1356,1680
15063,20124,238,3,Business,22,5,43586,22,5,43690,22,5,43766,22,5,45996,22,5,46378,4,28.4,-1.3004062,36.829741,-1.3077869,36.8443207,576,382,104,2306
15064,21449,1874,3,Business,9,1,54495,9,1,54637,9,1,56216,9,1,56415,9,1,57924,7,21.2,-1.2907672,36.8252167,-1.2571191,36.8019652,858,1509,142,1778
15065,4026,3426,3,Business,26,5,37259,26,5,38817,26,5,39499,26,5,40764,26,5,41906,11,23.25888921888938,-1.3014461,36.7661381,-1.295324,36.839629,726,1142,1558,1947
15066,9722,2523,3,Business,27,1,41061,27,1,41356,27,1,41775,27,1,41898,27,1,43553,19,20.9,-1.2551895,36.7822034,-1.1708105,36.8336102,564,1655,295,542
15067,19176,53,3,Business,2,4,47897,2,4,48910,2,4,50284,2,4,50576,2,4,51598,6,23.25888921888938,-1.3077869,36.8443207,-1.2770708,36.8231093,92,1022,1013,1666
15068,69,3517,3,Business,17,1,36315,17,1,36334,17,1,36341,17,1,37548,17,1,38940,15,18.3,-1.300921,36.828195,-1.3882008,36.7699445,450,1392,19,1214
15069,11949,2523,3,Business,4,1,53692,4,1,54933,4,1,56234,4,1,56396,4,1,57820,9,28.6,-1.2551895,36.7822034,-1.3074264,36.8226123,328,1424,1241,1463
15070,25590,3262,3,Personal,19,2,57698,19,2,57754,19,2,58768,19,2,59044,19,2,64275,34,29.2,-1.2876008,36.8387246,-1.0921599,37.005025,697,5231,56,1290
15071,7866,3486,3,Business,19,3,43682,19,3,46160,19,3,46494,19,3,46734,19,3,50310,7,22.1,-1.2551895,36.7822034,-1.2836183,36.8297208,906,3576,2478,574
15072,23402,1329,3,Business,29,1,55500,29,1,55548,29,1,55918,29,1,56235,29,1,56782,3,23.25888921888938,-1.273056,36.811298,-1.2672461,36.7996289,96,547,48,687
15073,18951,2174,3,Business,20,3,30964,20,3,33468,20,3,35076,20,3,36538,20,3,37563,10,23.25888921888938,-1.2482781,36.884092,-1.270528,36.8153,812,1025,2504,3070
15074,20760,2574,3,Personal,13,7,57462,13,7,58138,13,7,59023,13,7,59122,13,7,59795,4,26.2,-1.2780823,36.7960191,-1.2819131,36.7813526,749,673,676,984
15075,10730,3299,3,Personal,30,4,44011,30,4,44723,30,4,45537,30,4,46279,30,4,48674,16,23.25888921888938,-1.3339943,36.7263409,-1.2669736,36.8040985,538,2395,712,1556
15076,10889,238,3,Business,14,2,42749,14,2,42764,14,2,42797,14,2,43514,14,2,43532,3,23.25888921888938,-1.3077869,36.8443207,-1.308366,36.823613,349,18,15,750
15077,4338,1329,3,Business,6,4,37465,6,4,41131,6,4,42796,6,4,43012,6,4,47070,6,24.3,-1.273056,36.811298,-1.3085436,36.7914147,669,4058,3666,1881
15078,7270,3647,3,Business,13,4,52456,13,4,52671,13,4,52895,13,4,53779,13,4,54948,4,23.1,-1.2762743,36.8152789,-1.272639,36.794723,75,1169,215,1108
15079,1628,867,3,Business,22,5,51588,22,5,51626,22,5,51962,22,5,52252,22,5,53839,9,31.0,-1.2638185,36.7930057,-1.2991441,36.7528804,177,1587,38,626
15080,3098,136,3,Business,6,1,60931,6,1,61031,6,1,62219,6,1,63534,6,1,65267,7,22.3,-1.2248308,36.8012573,-1.2536042,36.8064895,882,1733,100,2503
15081,10782,322,3,Business,28,3,57361,28,3,57406,28,3,58041,28,3,58915,28,3,61668,22,23.25888921888938,-1.174484,36.914608,-1.2452664,36.8028541,627,2753,45,1509
15082,23706,113,1,Business,7,1,45974,7,1,45992,7,1,45998,7,1,46603,7,1,46612,2,21.6,-1.3018758,36.7590863,-1.2963097,36.7688221,900,9,18,611
15083,22191,3533,3,Business,16,5,48556,16,5,49180,16,5,49901,16,5,50372,16,5,52118,9,23.25888921888938,-1.2615888,36.7928732,-1.29515,36.844874,660,1746,624,1192
15084,10796,1874,3,Business,23,5,36358,23,5,36931,23,5,37462,23,5,38013,23,5,39402,16,24.0,-1.2571472,36.7950633,-1.2434951,36.6760986,595,1389,573,1082
15085,23712,2174,3,Business,9,4,37431,9,4,37436,9,4,37518,9,4,38356,9,4,41100,15,23.9,-1.2482781,36.884092,-1.2979242,36.7902416,82,2744,5,920
15086,24472,3201,3,Business,21,4,50392,21,4,50472,21,4,51431,21,4,51842,21,4,52848,11,30.8,-1.2765736,36.8513646,-1.2584143,36.8048002,276,1006,80,1370
15087,22997,1389,3,Business,15,1,48914,15,1,51495,15,1,52083,15,1,53606,15,1,55860,18,23.25888921888938,-1.2859912,36.8756811,-1.207546,36.7913976,482,2254,2581,2111
15088,16357,1402,3,Business,4,4,28879,4,4,29772,4,4,32067,4,4,32623,4,4,34193,16,21.6,-1.3374394,36.7339115,-1.2813012,36.8323962,855,1570,893,2851
15089,22441,265,3,Business,19,3,37813,19,3,38230,19,3,39093,19,3,39585,19,3,40770,9,22.4,-1.2580565,36.8084825,-1.300921,36.828195,72,1185,417,1355
15090,9635,238,3,Business,12,2,30057,12,2,30081,12,2,30330,12,2,30647,12,2,32158,15,21.1,-1.3077869,36.8443207,-1.362953,36.904214,281,1511,24,566
15091,16637,635,3,Business,28,2,52040,28,2,52223,28,2,52532,28,2,56170,28,2,56850,10,23.7,-1.3081376,36.8329772,-1.2602337,36.7990548,68,680,183,3947
15092,23412,1280,3,Business,26,5,48031,26,5,48323,26,5,48412,26,5,48613,26,5,49709,3,23.25888921888938,-1.2551895,36.7822034,-1.2654348,36.8022464,578,1096,292,290
15093,15359,2523,3,Business,2,3,44636,2,3,45154,2,3,46359,2,3,46519,2,3,48424,14,21.9,-1.255956,36.789867,-1.320321,36.7195522,131,1905,518,1365
15094,9641,53,3,Business,30,4,51259,30,4,51331,30,4,51555,30,4,51994,30,4,53566,8,23.25888921888938,-1.3167113,36.8301563,-1.2770708,36.8231093,330,1572,72,663
15095,396,3686,3,Business,18,3,59044,18,3,59055,18,3,59288,18,3,59706,18,3,61827,19,20.3,-1.2551895,36.7822034,-1.3285517,36.9018,726,2121,11,651
15096,23656,2956,3,Business,18,7,41730,18,7,45209,18,7,45667,18,7,45848,18,7,47101,9,24.1,-1.3014461,36.7661381,-1.2584143,36.8048002,532,1253,3479,639
15097,313,3020,1,Personal,24,4,45696,24,4,45709,24,4,47591,24,4,47761,24,4,51318,5,21.4,-1.3090115,36.8078826,-1.292044,36.821938,338,3557,13,2052
15098,12354,2956,3,Business,28,2,59334,28,2,59408,28,2,61059,28,2,61151,28,2,63750,14,21.5,-1.207546,36.7913976,-1.2584143,36.8048002,58,2599,74,1743
15099,2913,3560,3,Business,28,4,54853,28,4,54873,28,4,55875,28,4,61061,28,4,63659,5,27.8,-1.2571472,36.7950633,-1.279395,36.825364,223,2598,20,6188
15100,1308,2801,3,Business,16,4,46261,16,4,46330,16,4,46418,16,4,47149,16,4,47861,4,23.25888921888938,-1.273488,36.804158,-1.2674274,36.7870827,622,712,69,819
15101,25881,1341,3,Business,15,1,43398,15,1,43887,15,1,45035,15,1,45780,15,1,46829,15,23.25888921888938,-1.344446,36.756597,-1.331619,36.847976,628,1049,489,1893
15102,25087,540,3,Business,18,4,45888,18,4,49339,18,4,49362,18,4,49772,18,4,51246,4,23.25888921888938,-1.2551895,36.7822034,-1.2753109,36.8130185,576,1474,3451,433
15103,12961,3326,3,Business,28,2,54461,28,2,54514,28,2,55711,28,2,57273,28,2,58663,7,23.7,-1.2571472,36.7950633,-1.3038156,36.8122733,524,1390,53,2759
15104,17948,59,3,Business,14,4,47026,14,4,47118,14,4,47567,14,4,48270,14,4,50671,16,24.8,-1.290894,36.822971,-1.3124537,36.925365,548,2401,92,1152
15105,24937,1146,3,Business,8,5,40506,8,5,40551,8,5,40669,8,5,42953,8,5,44046,5,28.4,-1.3004062,36.829741,-1.3083266,36.8494756,686,1093,45,2402
15106,25886,1502,3,Business,22,5,57535,22,5,57546,22,5,58112,22,5,58222,22,5,59663,13,27.1,-1.2860183,36.8975338,-1.2232123,36.8932547,456,1441,11,676
15107,26058,1927,3,Business,14,4,53050,14,4,53219,14,4,54014,14,4,54329,14,4,56059,13,27.4,-1.2765736,36.8513646,-1.3472066,36.7692638,953,1730,169,1110
15108,16867,824,3,Business,14,3,59723,14,3,59847,14,3,61092,14,3,61500,14,3,64076,14,23.3,-1.264272,36.7978791,-1.207546,36.7913976,793,2576,124,1653
15109,20321,3686,3,Business,19,3,35851,19,3,36849,19,3,37228,19,3,37453,19,3,39616,15,19.7,-1.2551895,36.7822034,-1.2186206,36.8563363,453,2163,998,604
15110,8284,2164,3,Business,22,5,53139,22,5,53251,22,5,53738,22,5,54389,22,5,55855,6,27.1,-1.2551895,36.7822034,-1.281223,36.8239,953,1466,112,1138
15111,433,1909,3,Business,12,5,33258,12,5,33399,12,5,33831,12,5,34082,12,5,37115,8,18.4,-1.2653185,36.8358841,-1.3054597,36.8119025,726,3033,141,683
15112,943,2423,3,Business,18,2,36847,18,2,38707,18,2,39536,18,2,40899,18,2,42657,8,23.25888921888938,-1.2551895,36.7822034,-1.294869,36.815327,925,1758,1860,2192
15113,17829,2625,1,Personal,22,5,48165,22,5,48296,22,5,49375,22,5,49681,22,5,50578,5,23.25888921888938,-1.2739208,36.8310153,-1.2655306,36.828148,579,897,131,1385
15114,21464,868,3,Business,24,4,43125,24,4,48383,24,4,49504,24,4,50166,24,4,51853,9,22.8,-1.331619,36.847976,-1.265715,36.823815,808,1687,5258,1783
15115,27536,1262,1,Personal,5,5,60049,5,5,60726,5,5,62902,5,5,63164,5,5,65615,11,24.6,-1.2870003,36.8312206,-1.2778523,36.9094543,933,2451,677,2438
15116,23576,1364,1,Personal,9,4,34812,9,4,34869,9,4,36343,9,4,37282,9,4,38696,5,17.2,-1.2915969,36.8237639,-1.2745107,36.7974503,532,1414,57,2413
15117,1052,733,3,Business,16,3,42016,16,3,44605,16,3,45603,16,3,46634,16,3,49939,19,24.1,-1.2579304,36.8019667,-1.3160977,36.9131642,499,3305,2589,2029
15118,25777,136,3,Business,22,5,61230,22,5,61252,22,5,61506,22,5,62173,22,5,62820,4,25.7,-1.2654716,36.7983635,-1.2902869,36.8085396,156,647,22,921
15119,16303,374,2,Personal,18,3,29652,18,3,29720,18,3,29958,18,3,30031,18,3,30657,6,14.4,-1.2580979,36.7959844,-1.2900727,36.7890059,379,626,68,311
15120,15615,1329,3,Business,16,2,69136,16,2,69303,16,2,69775,16,2,69904,16,2,71018,6,23.25888921888938,-1.273056,36.811298,-1.2832105,36.7777664,461,1114,167,601
15121,24108,2200,3,Business,26,1,38675,26,1,41895,26,1,42823,26,1,43243,26,1,43560,1,22.9,-1.290894,36.822971,-1.279395,36.825364,88,317,3220,1348
15122,4037,391,3,Business,25,3,44358,25,3,44736,25,3,46200,25,3,46640,25,3,47970,8,23.25888921888938,-1.2857574,36.8295667,-1.238874,36.807889,144,1330,378,1904
15123,9872,3557,3,Business,24,3,58396,24,3,58420,24,3,58805,24,3,59847,24,3,59878,3,18.4,-1.2659914,36.8283655,-1.2546732,36.8086796,579,31,24,1427
15124,22162,2379,2,Personal,13,5,62718,13,5,63078,13,5,64503,13,5,65308,13,5,68030,18,19.3,-1.3632233,36.7339157,-1.2925236,36.7795556,629,2722,360,2230
15125,2163,136,3,Business,13,5,40024,13,5,40034,13,5,42414,13,5,46037,13,5,48466,19,23.25888921888938,-1.2407216,36.7888553,-1.3326173,36.7146233,101,2429,10,6003
15126,937,3295,3,Business,28,2,54263,28,2,54360,28,2,56509,28,2,56626,28,2,57982,10,23.4,-1.2571472,36.7950633,-1.2998093,36.8595226,260,1356,97,2266
15127,28020,3283,3,Business,5,5,51235,5,5,51259,5,5,51664,5,5,52481,5,5,53734,14,27.7,-1.228911,36.881876,-1.2628473,36.781805,8,1253,24,1222
15128,22451,867,3,Business,13,2,54109,13,2,54134,13,2,54204,13,2,55887,13,2,57651,14,26.2,-1.3177547,36.8303703,-1.306378,36.7519845,619,1764,25,1753
15129,27003,3147,3,Business,19,3,44015,19,3,45467,19,3,45557,19,3,46459,19,3,49219,5,22.3,-1.3472066,36.7692638,-1.3678944,36.7513257,12,2760,1452,992
15130,6820,868,3,Business,15,5,54024,15,5,54073,15,5,54505,15,5,54785,15,5,55377,4,17.7,-1.266837,36.799249,-1.265715,36.823815,205,592,49,712
15131,13142,1927,3,Business,22,5,57367,22,5,58986,22,5,60450,22,5,60710,22,5,62939,23,28.4,-1.3472066,36.7692638,-1.3562374,36.9042954,343,2229,1619,1724
15132,12559,3355,3,Business,29,4,58157,29,4,60914,29,4,61405,29,4,61733,29,4,62883,8,20.8,-1.3226302,36.8719901,-1.3052491,36.8223899,932,1150,2757,819
15133,4792,2876,1,Personal,2,2,42081,2,2,42188,2,2,42484,2,2,42960,2,2,43809,6,21.2,-1.2684239,36.7952462,-1.2944292,36.7793569,12,849,107,772
15134,10661,1724,3,Business,13,2,45212,13,2,45471,13,2,46754,13,2,47108,13,2,48491,9,22.2,-1.2941648,36.7977315,-1.2551895,36.7822034,276,1383,259,1637
15135,8608,391,3,Business,18,1,45716,18,1,46017,18,1,46794,18,1,48261,18,1,51630,13,26.7,-1.300921,36.828195,-1.2449522,36.7580025,262,3369,301,2244
15136,13739,1271,3,Business,24,1,57083,24,1,60288,24,1,61389,24,1,61884,24,1,63106,7,24.3,-1.2927792,36.9053492,-1.3244885,36.897792,890,1222,3205,1596
15137,27194,1792,3,Business,23,3,46314,23,3,46503,23,3,47323,23,3,47508,23,3,49254,12,23.25888921888938,-1.2809121,36.7852524,-1.3104506,36.8687235,124,1746,189,1005
15138,2865,868,3,Business,4,6,49361,4,6,49376,4,6,49895,4,6,50409,4,6,51131,7,23.25888921888938,-1.2628473,36.781805,-1.265715,36.823815,161,722,15,1033
15139,14616,22,2,Personal,14,1,36380,14,1,36392,14,1,36886,14,1,37207,14,1,38282,9,18.5,-1.3112325,36.8146321,-1.2789368,36.7864201,216,1075,12,815
15140,13277,248,3,Business,5,2,33565,5,2,33583,5,2,33601,5,2,35120,5,2,37805,9,17.9,-1.304735,36.7846054,-1.2592947,36.7698085,354,2685,18,1537
15141,14131,3291,3,Business,4,1,38838,4,1,39153,4,1,39382,4,1,40022,4,1,40541,5,25.8,-1.2628473,36.781805,-1.2600926,36.8088685,103,519,315,869
15142,4644,3517,3,Business,5,2,33800,5,2,33826,5,2,34053,5,2,38434,5,2,40312,16,25.5,-1.300921,36.828195,-1.3882008,36.7699445,519,1878,26,4608
15143,27288,3002,1,Personal,4,6,58945,4,6,59052,4,6,60452,4,6,60713,4,6,61424,6,22.5,-1.2925429,36.7799999,-1.2693017,36.8022778,670,711,107,1661
15144,7292,2644,2,Personal,17,2,42983,17,2,43120,17,2,43726,17,2,44635,17,2,45322,4,19.0,-1.2885417,36.8100523,-1.2906604,36.8318242,629,687,137,1515
15145,11382,2987,3,Business,22,3,49131,22,3,49689,22,3,49722,22,3,51544,22,3,52032,9,25.5,-1.270212,36.8210877,-1.3014461,36.7661381,179,488,558,1855
15146,27409,3201,3,Business,22,3,33847,22,3,33880,22,3,34379,22,3,34927,22,3,36628,9,19.0,-1.3014461,36.7661381,-1.2584143,36.8048002,161,1701,33,1047
15147,26067,2869,3,Business,5,5,41213,5,5,41258,5,5,42403,5,5,44253,5,5,46600,18,24.7,-1.2413316,36.8785525,-1.3025826,36.7670807,691,2347,45,2995
15148,14595,1925,2,Personal,19,2,55335,19,2,56933,19,2,57856,19,2,58821,19,2,60580,12,18.4,-1.2860183,36.8975338,-1.325808,36.861664,543,1759,1598,1888
15149,22192,2103,2,Personal,2,2,49226,2,2,49356,2,2,50798,2,2,51086,2,2,53953,7,26.0,-1.2557779,36.7879648,-1.282319,36.8190082,844,2867,130,1730
15150,4608,2767,3,Business,10,2,49032,10,2,49160,10,2,49910,10,2,50017,10,2,51499,8,20.9,-1.257773,36.795486,-1.2952784,36.7793271,467,1482,128,857
15151,5728,2066,3,Business,30,4,58654,30,4,58661,30,4,59383,30,4,59475,30,4,61007,9,20.9,-1.316961,36.820337,-1.2940429,36.7563303,449,1532,7,814
15152,10951,3175,3,Business,6,2,50900,6,2,51007,6,2,53702,6,2,53859,6,2,57314,11,27.7,-1.2681004,36.7952081,-1.3104734,36.7363698,532,3455,107,2852
15153,12958,2364,3,Personal,15,1,54024,15,1,54048,15,1,55018,15,1,55395,15,1,56855,12,23.25888921888938,-1.3121154,36.7109299,-1.273786,36.7806375,686,1460,24,1347
15154,6477,269,3,Business,7,2,49324,7,2,49354,7,2,49672,7,2,50711,7,2,51780,12,24.7,-1.267229,36.806399,-1.3332749,36.8708147,726,1069,30,1357
15155,4200,1346,3,Business,8,4,45604,8,4,46392,8,4,47987,8,4,48184,8,4,50155,6,26.3,-1.2917868,36.7872675,-1.2695287,36.7981777,726,1971,788,1792
15156,1921,1151,2,Personal,5,3,55495,5,3,55521,5,3,55697,5,3,57132,5,3,59065,15,23.7,-1.2696795,36.8640088,-1.304842,36.90576,182,1933,26,1611
15157,16946,635,3,Business,11,4,52457,11,4,52541,11,4,53539,11,4,54808,11,4,57731,8,27.2,-1.3081376,36.8329772,-1.2602337,36.7990548,155,2923,84,2267
15158,23546,1927,3,Business,7,4,50229,7,4,50266,7,4,52719,7,4,53231,7,4,55575,17,31.2,-1.3472066,36.7692638,-1.2551895,36.7822034,154,2344,37,2965
15159,8011,323,3,Business,9,4,40590,9,4,40598,9,4,40661,9,4,40924,9,4,43621,23,23.9,-1.3632162,36.9108253,-1.2611987,36.8060913,584,2697,8,326
15160,21193,2256,1,Personal,1,1,67656,1,1,67667,1,1,69700,1,1,69873,1,1,73607,22,23.4,-1.3255855,36.8647627,-1.2323938,36.7254545,532,3734,11,2206
15161,7122,1584,3,Business,2,5,49742,2,5,52427,2,5,53072,2,5,53785,2,5,56434,6,25.0,-1.2857524,36.8196806,-1.2969741,36.7856612,237,2649,2685,1358
15162,18683,3517,3,Business,5,2,34885,5,2,34889,5,2,34901,5,2,35121,5,2,38338,21,18.0,-1.3882008,36.7699445,-1.2878914,36.7728222,191,3217,4,232
15163,11122,59,3,Business,14,3,57531,14,3,59987,14,3,60870,14,3,64495,14,3,65943,9,23.7,-1.2859912,36.8756811,-1.290894,36.822971,926,1448,2456,4508
15164,4732,3321,3,Personal,28,1,52079,28,1,52100,28,1,52425,28,1,52805,28,1,56247,7,26.1,-1.2723552,36.7881306,-1.2945074,36.8083195,510,3442,21,705
15165,6414,928,3,Business,28,4,41854,28,4,42114,28,4,42623,28,4,42979,28,4,44215,9,27.9,-1.2551895,36.7822034,-1.2529072,36.8525066,576,1236,260,865
15166,20082,391,3,Business,7,2,53872,7,2,54019,7,2,54964,7,2,57310,7,2,57311,4,23.25888921888938,-1.2839729,36.8115146,-1.300921,36.828195,119,1,147,3291
15167,12248,1368,3,Business,22,2,60665,22,2,60678,22,2,60759,22,2,61085,22,2,61798,2,25.1,-1.2664491,36.8102685,-1.2571472,36.7950633,486,713,13,407
15168,21876,2289,3,Business,28,4,52936,28,4,52949,28,4,53426,28,4,53592,28,4,56276,19,29.8,-1.2551895,36.7822034,-1.3285517,36.9018,328,2684,13,643
15169,24953,2212,3,Business,11,5,53026,11,5,53136,11,5,53314,11,5,53936,11,5,55147,9,26.5,-1.2571472,36.7950633,-1.2310607,36.8035776,685,1211,110,800
15170,18855,186,3,Business,14,2,34915,14,2,34964,14,2,35512,14,2,35724,14,2,36451,4,23.25888921888938,-1.2571472,36.7950633,-1.2825816,36.8092346,435,727,49,760
15171,20444,2802,1,Personal,9,1,43759,9,1,43809,9,1,44673,9,1,45520,9,1,46484,9,20.3,-1.2765737,36.8175399,-1.2413316,36.8785525,103,964,50,1711
15172,27193,1473,3,Business,28,4,42460,28,4,46638,28,4,47332,28,4,47782,28,4,48707,13,23.25888921888938,-1.3700383,36.9190174,-1.3206958,36.8769553,6,925,4178,1144
15173,23766,286,3,Business,5,3,57113,5,3,58390,5,3,59797,5,3,60507,5,3,61533,6,22.4,-1.257314,36.80521,-1.2962967,36.8020231,434,1026,1277,2117
15174,18693,604,3,Business,26,2,32207,26,2,32247,26,2,32282,26,2,32579,26,2,33902,9,23.25888921888938,-1.2551895,36.7822034,-1.2959783,36.7860021,258,1323,40,332
15175,4291,2066,3,Business,25,1,51001,25,1,51136,25,1,51966,25,1,52458,25,1,53529,4,27.9,-1.3210189,36.8410551,-1.3263105,36.8622904,154,1071,135,1322
15176,18675,1959,3,Business,31,5,55965,31,5,56047,31,5,56873,31,5,57048,31,5,57951,10,24.8,-1.2551895,36.7822034,-1.2664227,36.7453671,96,903,82,1001
15177,4623,20,3,Business,3,1,40789,3,1,40815,3,1,41187,3,1,41578,3,1,42313,9,21.6,-1.2607331,36.7428881,-1.2629666,36.8068369,269,735,26,763
15178,10315,1034,1,Personal,20,1,45948,20,1,45972,20,1,47147,20,1,47424,20,1,48236,4,20.4,-1.26559,36.8027,-1.2946764,36.8184646,88,812,24,1452
15179,7597,2016,1,Personal,8,1,41531,8,1,41916,8,1,43365,8,1,43442,8,1,46015,9,24.7,-1.2871136,36.785507,-1.2883482,36.852724,932,2573,385,1526
15180,17876,640,3,Business,20,5,53199,20,5,53201,20,5,54142,20,5,55612,20,5,56555,5,20.6,-1.3012902,36.80964,-1.304033,36.7848695,229,943,2,2411
15181,4519,970,3,Business,25,1,51794,25,1,51845,25,1,51860,25,1,52296,25,1,53671,8,28.2,-1.2551895,36.7822034,-1.2935508,36.7948949,518,1375,51,451
15182,20159,1591,2,Personal,19,5,56350,19,5,56432,19,5,56808,19,5,56928,19,5,58220,10,27.2,-1.2967108,36.7871135,-1.2655306,36.828148,282,1292,82,496
15183,18108,1205,3,Business,18,2,39080,18,2,39119,18,2,39723,18,2,40163,18,2,43644,8,22.7,-1.2706815,36.7646286,-1.2810807,36.8144229,844,3481,39,1044
15184,16107,2789,3,Business,22,4,30657,22,4,30717,22,4,31297,22,4,31608,22,4,32342,5,19.4,-1.304735,36.7846054,-1.2946126,36.8059642,726,734,60,891
15185,10342,3647,3,Business,10,1,44480,10,1,44617,10,1,46005,10,1,46338,10,1,49030,14,18.5,-1.272639,36.794723,-1.2285835,36.8826468,766,2692,137,1721
15186,20527,2828,2,Business,5,4,48994,5,4,49026,5,4,49032,5,4,50549,5,4,50560,3,22.1,-1.2584143,36.8048002,-1.2615888,36.7928732,51,11,32,1523
15187,12979,2763,3,Business,6,2,48401,6,2,48706,6,2,49450,6,2,49690,6,2,51144,8,27.7,-1.2551895,36.7822034,-1.3038156,36.8122733,829,1454,305,984
15188,1853,3647,3,Business,2,3,61414,2,3,61448,2,3,62114,2,3,63243,2,3,63245,4,25.2,-1.272639,36.794723,-1.2776075,36.7692473,576,2,34,1795
15189,1854,1075,3,Business,5,3,57580,5,3,57602,5,3,57937,5,3,58492,5,3,58954,1,24.8,-1.2649605,36.7981777,-1.2527958,36.8003131,881,462,22,890
15190,26514,3203,3,Business,10,2,46272,10,2,46296,10,2,46570,10,2,47645,10,2,48950,16,20.1,-1.2628473,36.781805,-1.228911,36.881876,312,1305,24,1349
15191,3409,3283,3,Business,7,2,52797,7,2,52848,7,2,52873,7,2,53055,7,2,53920,5,25.0,-1.266837,36.799249,-1.2628473,36.781805,666,865,51,207
15192,19026,1209,3,Business,5,5,50950,5,5,51107,5,5,51686,5,5,52758,5,5,54602,4,27.5,-1.2770708,36.8231093,-1.3004062,36.829741,61,1844,157,1651
15193,887,115,3,Business,15,6,50056,15,6,50136,15,6,52178,15,6,52457,15,6,55289,6,21.8,-1.281854,36.8246889,-1.313971,36.8465202,109,2832,80,2321
15194,18397,2801,3,Business,13,3,36424,13,3,36573,13,3,37578,13,3,38101,13,3,38718,5,20.0,-1.2753109,36.8130185,-1.2595422,36.7871178,379,617,149,1528
15195,16964,3064,3,Business,22,4,34473,22,4,36150,22,4,37100,22,4,37597,22,4,38758,6,19.8,-1.2571472,36.7950633,-1.3012619,36.8213697,114,1161,1677,1447
15196,23583,2102,3,Business,10,1,45966,10,1,46085,10,1,46629,10,1,46871,10,1,48595,14,18.4,-1.3323107,36.8692616,-1.2613768,36.8019418,856,1724,119,786
15197,1581,1465,3,Personal,22,6,37988,22,6,38057,22,6,39401,22,6,39523,22,6,40940,12,23.0,-1.30482,36.756678,-1.2561298,36.7963749,368,1417,69,1466
15198,3107,3647,3,Business,18,5,36111,18,5,36126,18,5,36846,18,5,37561,18,5,37916,2,20.2,-1.272639,36.794723,-1.2741728,36.7969108,486,355,15,1435
15199,15270,1322,3,Business,12,2,49262,12,2,49317,12,2,52849,12,2,53115,12,2,54769,7,27.1,-1.2638132,36.7849775,-1.2948751,36.7938907,194,1654,55,3798
15200,20856,1792,3,Business,28,3,42091,28,3,42294,28,3,42788,28,3,43010,28,3,44158,12,23.25888921888938,-1.2809121,36.7852524,-1.2513529,36.752172,917,1148,203,716
15201,21005,893,3,Business,26,2,36243,26,2,36265,26,2,36576,26,2,36778,26,2,37267,4,21.9,-1.2594474,36.8089122,-1.2560455,36.7800867,472,489,22,513
15202,1470,49,3,Business,21,5,39259,21,5,43207,21,5,43218,21,5,43728,21,5,47639,5,22.7,-1.2866544,36.8217978,-1.2959006,36.8353606,698,3911,3948,521
15203,26921,265,3,Business,26,1,39202,26,1,39210,26,1,40381,26,1,42562,26,1,43716,19,23.2,-1.207546,36.7913976,-1.300921,36.828195,874,1154,8,3352
15204,16146,3457,3,Business,11,2,37604,11,2,37657,11,2,37948,11,2,38180,11,2,38633,1,19.4,-1.2684667,36.8002891,-1.266294,36.8057971,50,453,53,523
15205,19779,1520,2,Personal,8,2,33027,8,2,33407,8,2,34572,8,2,34887,8,2,36280,9,23.25888921888938,-1.2988168,36.8198572,-1.255956,36.789867,345,1393,380,1480
15206,26460,3326,3,Business,28,2,52524,28,2,52605,28,2,53121,28,2,53649,28,2,55975,8,23.3,-1.2571472,36.7950633,-1.3080696,36.8237191,42,2326,81,1044
15207,9258,540,3,Business,13,1,56822,13,1,57121,13,1,58113,13,1,58223,13,1,59570,5,23.25888921888938,-1.2551895,36.7822034,-1.270054,36.815164,289,1347,299,1102
15208,23172,1287,3,Business,10,3,49295,10,3,49322,10,3,49458,10,3,50093,10,3,50095,4,30.7,-1.2639238,36.7889646,-1.2551895,36.7822034,871,2,27,771
15209,25567,3222,3,Business,3,5,37802,3,5,37890,3,5,38278,3,5,38368,3,5,39948,8,23.25888921888938,-1.2551895,36.7822034,-1.2824577,36.7967953,570,1580,88,478
15210,18562,2956,3,Business,25,5,37841,25,5,38582,25,5,39203,25,5,43687,25,5,46232,19,21.2,-1.3632162,36.9108253,-1.290894,36.822971,100,2545,741,5105
15211,19814,302,3,Business,28,6,52050,28,6,52074,28,6,52721,28,6,54021,28,6,54782,6,25.1,-1.2649605,36.7981777,-1.2909634,36.7813995,415,761,24,1947
15212,8775,928,3,Business,30,3,32937,30,3,33283,30,3,34151,30,3,34241,30,3,35749,10,19.5,-1.2551895,36.7822034,-1.2999305,36.843617,576,1508,346,958
15213,23564,393,3,Business,22,5,54669,22,5,56205,22,5,57379,22,5,57548,22,5,58504,4,27.2,-1.3167113,36.8301563,-1.3004062,36.829741,778,956,1536,1343
15214,21805,20,3,Business,10,1,34077,10,1,34129,10,1,34527,10,1,34631,10,1,35566,5,16.4,-1.2566689,36.7796952,-1.2629666,36.8068369,708,935,52,502
15215,26337,2139,3,Personal,20,3,67581,20,3,67737,20,3,69217,20,3,69723,20,3,72022,9,27.9,-1.2336611,36.806181,-1.1926935,36.7574155,318,2299,156,1986
15216,15293,3044,3,Business,2,5,58038,2,5,58943,2,5,58981,2,5,59885,2,5,60927,13,24.1,-1.3257893,36.8940194,-1.3177547,36.8303703,813,1042,905,942
15217,17519,1245,3,Business,18,1,46157,18,1,46170,18,1,46174,18,1,48817,18,1,51176,17,31.0,-1.300921,36.828195,-1.3198615,36.7110323,519,2359,13,2647
15218,4178,706,3,Business,7,4,37642,7,4,37682,7,4,38482,7,4,41893,7,4,43408,12,24.1,-1.3559093,36.9100452,-1.3077869,36.8443207,863,1515,40,4211
15219,18454,540,3,Business,30,2,57991,30,2,58449,30,2,59577,30,2,59843,30,2,60341,4,23.25888921888938,-1.2551895,36.7822034,-1.2617028,36.7983849,315,498,458,1394
15220,18948,2801,3,Business,12,2,51194,12,2,51240,12,2,52002,12,2,52269,12,2,54087,14,23.25888921888938,-1.3104506,36.8687235,-1.2674274,36.7870827,495,1818,46,1029
15221,7472,1932,1,Business,16,1,33122,16,1,34990,16,1,35828,16,1,36067,16,1,37335,7,14.5,-1.2937193,36.8236214,-1.2985987,36.7809119,726,1268,1868,1077
15222,4841,3420,3,Business,10,4,39886,10,4,39935,10,4,40549,10,4,40663,10,4,42387,10,24.9,-1.3046007,36.8211743,-1.2541929,36.8515017,30,1724,49,728
15223,6015,1280,3,Business,13,4,39366,13,4,39389,13,4,39882,13,4,40230,13,4,41124,5,22.3,-1.2551895,36.7822034,-1.2708788,36.7661155,139,894,23,841
15224,19595,393,3,Business,15,3,31182,15,3,31213,15,3,31493,15,3,32602,15,3,34559,11,23.25888921888938,-1.3167113,36.8301563,-1.2638185,36.7930057,263,1957,31,1389
15225,3525,393,3,Business,25,3,42791,25,3,42929,25,3,43233,25,3,44761,25,3,47666,10,23.25888921888938,-1.3177547,36.8303703,-1.2574219,36.7927073,687,2905,138,1832
15226,6461,3582,3,Business,21,4,49916,21,4,49948,21,4,50128,21,4,50987,21,4,55921,37,26.5,-1.2384056,36.8718698,-1.0546336,36.7739108,75,4934,32,1039
15227,10008,3689,3,Business,17,1,44539,17,1,44590,17,1,45159,17,1,45845,17,1,46282,1,23.6,-1.2584143,36.8048002,-1.2527958,36.8003131,937,437,51,1255
15228,16704,1480,3,Personal,6,4,38600,6,4,38685,6,4,40256,6,4,40428,6,4,41363,7,19.8,-1.2911796,36.8215068,-1.2615888,36.7928732,158,935,85,1743
15229,22591,190,3,Business,28,2,46395,28,2,46437,28,2,47596,28,2,48791,28,2,48794,4,23.7,-1.329568,36.8520825,-1.3270347,36.8667362,161,3,42,2354
15230,2443,302,3,Business,23,4,59396,23,4,59880,23,4,60868,23,4,62601,23,4,64153,5,23.25888921888938,-1.2649605,36.7981777,-1.2757943,36.8197503,119,1552,484,2721
15231,12858,633,3,Business,28,4,46172,28,4,46265,28,4,47070,28,4,47635,28,4,48440,4,27.9,-1.3228003,36.8306435,-1.3004062,36.829741,813,805,93,1370
15232,835,2976,3,Business,25,4,32298,25,4,32321,25,4,33360,25,4,33659,25,4,34394,2,16.2,-1.2562797,36.8075858,-1.2544418,36.80197253,167,735,23,1338
15233,6210,517,3,Business,30,3,47242,30,3,47368,30,3,47891,30,3,48386,30,3,50229,14,24.9,-1.3167113,36.8301563,-1.2991441,36.7528804,523,1843,126,1018
15234,13678,2701,3,Business,15,6,49448,15,6,50451,15,6,50459,15,6,51898,15,6,53406,6,23.4,-1.28878,36.8168312,-1.2765736,36.8513646,26,1508,1003,1447
15235,26052,1594,3,Business,25,1,44036,25,1,45734,25,1,46076,25,1,47120,25,1,50151,24,27.3,-1.3562374,36.9042954,-1.2156006,36.8916865,206,3031,1698,1386
15236,24849,346,3,Business,4,3,35073,4,3,36009,4,3,36750,4,3,36983,4,3,39667,4,15.1,-1.2885529,36.8160141,-1.277055,36.813027,698,2684,936,974
15237,13518,2587,3,Business,13,4,33198,13,4,33869,13,4,35582,13,4,36331,13,4,37402,5,18.1,-1.2584143,36.8048002,-1.28878,36.8168312,899,1071,671,2462
15238,54,3010,1,Personal,5,5,58438,5,5,58472,5,5,58891,5,5,59430,5,5,60720,6,26.4,-1.2809121,36.7852524,-1.2590031,36.8078168,178,1290,34,958
15239,15997,1500,3,Business,9,2,55434,9,2,55478,9,2,55623,9,2,57884,9,2,59302,8,30.7,-1.3004062,36.829741,-1.2638185,36.7930057,686,1418,44,2406
15240,15797,355,1,Personal,3,3,41922,3,3,41965,3,3,42687,3,3,43421,3,3,43723,4,24.2,-1.2615616,36.8093033,-1.2741728,36.7969108,754,302,43,1456
15241,16807,2150,3,Business,4,6,55538,4,6,55569,4,6,56571,4,6,56646,4,6,59591,23,23.25888921888938,-1.228911,36.881876,-1.344446,36.756597,260,2945,31,1077
15242,7415,3669,3,Business,8,2,52547,8,2,52820,8,2,53266,8,2,53655,8,2,55972,11,25.2,-1.2615888,36.7928732,-1.308819,36.8421201,870,2317,273,835
15243,578,1237,1,Personal,26,3,51941,26,3,51981,26,3,52039,26,3,54763,26,3,54776,2,27.2,-1.2741728,36.7969108,-1.2599563,36.7993439,51,13,40,2782
15244,21800,1045,1,Personal,22,3,58458,22,3,58594,22,3,60137,22,3,61137,22,3,63279,9,23.0,-1.3169651,36.8340857,-1.3039695,36.7838267,521,2142,136,2543
15245,18439,2212,3,Business,11,1,44714,11,1,44726,11,1,45319,11,1,45483,11,1,46185,4,24.2,-1.2571472,36.7950633,-1.255956,36.772901,879,702,12,757
15246,8338,1385,1,Personal,4,2,53837,4,2,53868,4,2,54347,4,2,56737,4,2,58767,12,20.5,-1.2474857,36.8737362,-1.2578616,36.8012906,674,2030,31,2869
15247,1406,2272,1,Personal,19,5,56225,19,5,56281,19,5,56699,19,5,57367,19,5,58804,9,27.6,-1.281196,36.8179321,-1.2702719,36.7688649,208,1437,56,1086
15248,24188,111,3,Business,28,1,35462,28,1,35572,28,1,36129,28,1,36322,28,1,37354,8,19.3,-1.2551895,36.7822034,-1.2944292,36.7793569,674,1032,110,750
15249,18325,393,3,Business,9,3,50022,9,3,50172,9,3,50267,9,3,52663,9,3,53717,5,25.5,-1.3167113,36.8301563,-1.3077869,36.8443207,926,1054,150,2491
15250,21873,2112,3,Business,22,4,49371,22,4,56102,22,4,56428,22,4,56776,22,4,57406,4,26.6,-1.2297202,36.8819507,-1.2156006,36.8916865,130,630,6731,674
15251,27006,401,1,Personal,12,5,39570,12,5,39937,12,5,41257,12,5,41435,12,5,42832,7,24.4,-1.2844858,36.7955884,-1.2628638,36.8070399,532,1397,367,1498
15252,17791,1244,3,Business,16,5,53307,16,5,54404,16,5,54454,16,5,55924,16,5,57179,11,23.25888921888938,-1.331619,36.847976,-1.303596,36.778378,623,1255,1097,1520
15253,24053,265,3,Business,12,5,46546,12,5,46606,12,5,46973,12,5,47804,12,5,50501,13,26.4,-1.300921,36.828195,-1.2327842,36.8087639,699,2697,60,1198
15254,5321,2330,3,Business,4,2,61786,4,2,61973,4,2,62442,4,2,62584,4,2,64411,25,21.0,-1.2124582,36.802894,-1.1930572,36.9348901,116,1827,187,611
15255,18527,1246,3,Business,7,4,56843,7,4,56863,7,4,57126,7,4,57455,7,4,57952,2,20.2,-1.2579304,36.8019667,-1.2658335,36.8042867,425,497,20,592
15256,8235,2532,3,Business,31,3,32790,31,3,37787,31,3,38300,31,3,38761,31,3,39881,7,24.9,-1.2551895,36.7822034,-1.2934657,36.8212737,237,1120,4997,974
15257,11837,188,1,Personal,24,5,43914,24,5,43985,24,5,44485,24,5,45114,24,5,45849,5,21.1,-1.3078624,36.7697658,-1.2994772,36.804825,805,735,71,1129
15258,23839,393,3,Business,8,5,55973,8,5,56017,8,5,56861,8,5,57557,8,5,62150,14,27.0,-1.3167113,36.8301563,-1.306378,36.7519845,267,4593,44,1540
15259,20813,2436,3,Business,28,3,55722,28,3,56687,28,3,56802,28,3,56910,28,3,58211,7,23.25888921888938,-1.2551895,36.7822034,-1.2854453,36.8188363,878,1301,965,223
15260,15143,265,3,Business,28,1,43549,28,1,43558,28,1,43869,28,1,44694,28,1,48533,16,23.8,-1.300921,36.828195,-1.2521562,36.9260507,519,3839,9,1136
15261,17698,3128,1,Personal,19,5,36277,19,5,36285,19,5,36829,19,5,37080,19,5,38044,12,20.0,-1.2047753,36.7915359,-1.2604472,36.8365287,676,964,8,795
15262,14451,20,3,Business,1,3,56648,1,3,56692,1,3,58829,1,3,59324,1,3,60762,5,24.0,-1.2767064,36.8227148,-1.2629666,36.8068369,229,1438,44,2632
15263,9736,3149,3,Business,21,3,35114,21,3,35132,21,3,35893,21,3,36869,21,3,38553,15,17.0,-1.306378,36.7519845,-1.3177547,36.8303703,85,1684,18,1737
15264,21803,393,3,Business,4,6,38699,4,6,38902,4,6,39967,4,6,40069,4,6,41952,14,23.25888921888938,-1.3167113,36.8301563,-1.2991441,36.7528804,206,1883,203,1167
15265,13742,2999,1,Personal,3,5,49499,3,5,49504,3,5,49993,3,5,50266,3,5,51471,12,25.3,-1.2696183,36.8021778,-1.2489553,36.7695771,857,1205,5,762
15266,3496,114,1,Personal,27,4,51115,27,4,51133,27,4,51724,27,4,52577,27,4,53723,9,24.9,-1.28469,36.826112,-1.311943,36.8331134,31,1146,18,1444
15267,22265,2801,3,Business,5,2,59218,5,2,59563,5,2,60307,5,2,60588,5,2,61452,4,23.25888921888938,-1.2987276,36.8176337,-1.307726,36.839117,85,864,345,1025
15268,3210,1304,3,Business,7,3,49022,7,3,49053,7,3,50079,7,3,50488,7,3,53733,18,28.3,-1.3332749,36.8708147,-1.2343236,36.8861,114,3245,31,1435
15269,26361,2874,2,Personal,9,6,62397,9,6,62420,9,6,63711,9,6,63847,9,6,67068,23,19.2,-1.22606,36.80039,-1.3340505,36.7119038,116,3221,23,1427
15270,5246,2946,2,Personal,15,3,34681,15,3,34748,15,3,35899,15,3,36128,15,3,37048,8,16.3,-1.2749662,36.7658781,-1.2983462,36.8139996,726,920,67,1380
15271,7877,1671,3,Personal,27,5,55820,27,5,55917,27,5,57148,27,5,58082,27,5,58979,6,23.9,-1.273308,36.802847,-1.300452,36.779103,836,897,97,2165
15272,14629,393,3,Business,18,1,32024,18,1,32087,18,1,32183,18,1,33291,18,1,35474,14,22.1,-1.3167113,36.8301563,-1.306378,36.7519845,523,2183,63,1204
15273,12088,3295,3,Business,14,2,36475,14,2,36496,14,2,36845,14,2,37207,14,2,37740,3,15.6,-1.2571472,36.7950633,-1.263453,36.7955612,882,533,21,711
15274,7579,1500,3,Business,4,2,30322,4,2,30355,4,2,30672,4,2,31952,4,2,32965,8,16.3,-1.3004062,36.829741,-1.2638185,36.7930057,211,1013,33,1597
15275,20414,3149,3,Business,8,5,55993,8,5,56076,8,5,56083,8,5,57022,8,5,57026,1,30.3,-1.3276043,36.836922,-1.3167113,36.8301563,515,4,83,946
15276,876,3186,3,Business,19,2,52087,19,2,52182,19,2,52721,19,2,52863,19,2,54331,5,29.5,-1.2980229,36.78865,-1.2949455,36.8195238,906,1468,95,681
15277,21249,640,3,Business,22,4,39558,22,4,39596,22,4,39894,22,4,40109,22,4,40657,3,22.8,-1.304033,36.7848695,-1.3004846,36.7901591,558,548,38,513
15278,1327,586,3,Personal,15,2,30628,15,2,30639,15,2,32221,15,2,32614,15,2,33419,5,18.2,-1.2895261,36.8164407,-1.3058877,36.8349874,196,805,11,1975
15279,16954,661,3,Business,22,2,55552,22,2,55667,22,2,57184,22,2,58320,22,2,59202,4,21.2,-1.2950044,36.7512209,-1.2963097,36.7688221,116,882,115,2653
15280,26098,3222,3,Business,14,2,56228,14,2,56336,14,2,57426,14,2,57557,14,2,59385,8,23.25888921888938,-1.2551895,36.7822034,-1.295156,36.8094306,815,1828,108,1221
15281,4567,1304,3,Business,18,5,60348,18,5,60502,18,5,61069,18,5,61329,18,5,62304,6,22.5,-1.2626906,36.7827022,-1.2839568,36.8233106,123,975,154,827
15282,16199,1188,3,Personal,31,4,30937,31,4,30944,31,4,31966,31,4,32134,31,4,32861,7,17.6,-1.3039402,36.7762932,-1.2804375,36.7646128,648,727,7,1190
15283,23862,3621,3,Business,24,6,62103,24,6,62131,24,6,62463,24,6,62795,24,6,63864,9,22.5,-1.2836583,36.7886014,-1.3231061,36.84552242,427,1069,28,664
15284,15228,3372,3,Business,22,5,38475,22,5,38842,22,5,39707,22,5,40245,22,5,41989,16,21.8,-1.2297202,36.8745508,-1.2969741,36.7856612,334,1744,367,1403
15285,7520,393,3,Business,6,4,43166,6,4,43199,6,4,43341,6,4,43967,6,4,44768,5,19.5,-1.3228003,36.8306435,-1.3077869,36.8443207,2,801,33,768
15286,2299,3621,3,Business,7,5,38766,7,5,38805,7,5,39257,7,5,39502,7,5,40725,6,23.25888921888938,-1.2836583,36.7886014,-1.3001926,36.7659299,709,1223,39,697
15287,1114,170,3,Personal,20,1,47985,20,1,48005,20,1,49297,20,1,49391,20,1,53846,20,21.2,-1.3223238,36.8320056,-1.2081811,36.7945915,938,4455,20,1386
15288,22261,867,3,Business,6,4,32346,6,4,32371,6,4,32375,6,4,36716,6,4,36733,12,16.1,-1.2991441,36.7528804,-1.2996533,36.8292629,855,17,25,4345
15289,1597,393,3,Business,7,1,54691,7,1,55454,7,1,56104,7,1,56521,7,1,57815,11,26.8,-1.3167113,36.8301563,-1.2574219,36.7927073,436,1294,763,1067
15290,27355,816,3,Business,22,5,37471,22,5,37482,22,5,37599,22,5,40937,22,5,42315,9,23.25888921888938,-1.2859912,36.8756811,-1.290894,36.822971,248,1378,11,3455
15291,17314,3661,3,Business,10,5,35580,10,5,35657,10,5,36672,10,5,36963,10,5,39329,17,23.25888921888938,-1.2132866,36.8678274,-1.2955912,36.7947012,291,2366,77,1306
15292,21787,1845,3,Business,8,5,55461,8,5,55675,8,5,58345,8,5,58804,8,5,62017,9,21.5,-1.299813,36.7871392,-1.2567075,36.7739831,431,3213,214,3129
15293,1185,3653,2,Personal,5,3,39816,5,3,39886,5,3,40128,5,3,40965,5,3,41771,5,22.1,-1.2687582,36.8012024,-1.2867132,36.8118433,379,806,70,1079
15294,1254,496,3,Business,31,5,37102,31,5,37153,31,5,37373,31,5,37923,31,5,38932,10,21.8,-1.2551895,36.7822034,-1.2518814,36.859661,576,1009,51,770
15295,27161,3501,1,Personal,10,1,61508,10,1,61514,10,1,61545,10,1,62666,10,1,64963,10,18.9,-1.2855766,36.7928037,-1.3159197,36.8516724,929,2297,6,1152
15296,2983,677,3,Business,19,5,45784,19,5,46956,19,5,48036,19,5,48248,19,5,49844,12,23.25888921888938,-1.290894,36.822971,-1.2363092,36.8823617,910,1596,1172,1292
15297,2676,2412,3,Business,11,2,42868,11,2,42884,11,2,42926,11,2,43296,11,2,45567,10,19.4,-1.2765736,36.8513646,-1.2285835,36.8826468,845,2271,16,412
15298,21363,2894,3,Business,30,5,49514,30,5,50560,30,5,52489,30,5,52733,30,5,55727,6,24.7,-1.2906618,36.8131222,-1.2638898,36.8223638,725,2994,1046,2173
15299,23434,1646,3,Business,2,2,33556,2,2,33609,2,2,35552,2,2,36273,2,2,36884,7,20.5,-1.3006954,36.7416164,-1.3207446,36.6969684,855,611,53,2664
15300,14215,2987,3,Business,31,3,53869,31,3,53988,31,3,55334,31,3,55506,31,3,56481,12,27.1,-1.270212,36.8210877,-1.2156006,36.8916865,131,975,119,1518
15301,1489,2924,2,Personal,4,3,34593,4,3,34623,4,3,35666,4,3,36857,4,3,38972,18,14.9,-1.3233955,36.8562944,-1.2664227,36.7453671,833,2115,30,2234
15302,7667,1568,3,Business,30,2,53017,30,2,53673,30,2,54789,30,2,55286,30,2,56749,6,27.5,-1.2897368,36.8226783,-1.2657756,36.7926481,281,1463,656,1613
15303,24621,2233,2,Personal,28,5,48437,28,5,48569,28,5,48579,28,5,49241,28,5,50125,8,25.4,-1.2912247,36.7885452,-1.2835586,36.8125641,123,884,132,672
15304,448,186,3,Business,8,1,36791,8,1,36797,8,1,36801,8,1,36919,8,1,38933,23,21.7,-1.3700383,36.9190174,-1.2571472,36.7950633,953,2014,6,122
15305,13401,246,3,Business,22,2,51113,22,2,51124,22,2,51797,22,2,52457,22,2,54354,17,25.4,-1.3169591,36.7000029,-1.2584143,36.8048002,125,1897,11,1333
15306,9861,2315,1,Personal,22,7,35361,22,7,37279,22,7,38366,22,7,39404,22,7,40438,8,17.4,-1.2962832,36.7849683,-1.2649605,36.7981777,465,1034,1918,2125
15307,19601,3147,3,Business,21,3,36727,21,3,36743,21,3,37218,21,3,37735,21,3,39472,12,16.8,-1.2831203,36.8316065,-1.3472066,36.7692638,622,1737,16,992
15308,442,510,3,Business,3,3,44637,3,3,44654,3,3,44779,3,3,45730,3,3,46191,13,24.2,-1.2860183,36.8975338,-1.3189252,36.8617269,40,461,17,1076
15309,7848,2412,3,Business,6,6,41771,6,6,41841,6,6,42877,6,6,43409,6,6,45706,22,26.5,-1.2283403,36.8822756,-1.1269423,36.768821,75,2297,70,1568
15310,17140,1502,3,Business,12,2,39047,12,2,39191,12,2,40406,12,2,40469,12,2,42100,11,24.3,-1.2765736,36.8513646,-1.2232123,36.8932547,408,1631,144,1278
15311,12214,2523,3,Business,7,1,40681,7,1,40955,7,1,41614,7,1,41729,7,1,43718,7,24.7,-1.2551895,36.7822034,-1.293082,36.8278578,477,1989,274,774
15312,19976,101,2,Personal,13,3,47952,13,3,48452,13,3,48858,13,3,51703,13,3,55427,7,23.7,-1.2868973,36.8232984,-1.2872058,36.7802742,351,3724,500,3251
15313,2423,2523,3,Business,5,3,55907,5,3,55983,5,3,56646,5,3,56904,5,3,59648,19,25.1,-1.2551895,36.7822034,-1.3285517,36.9018,646,2744,76,921
15314,26086,3184,3,Business,8,2,52012,8,2,52493,8,2,52537,8,2,53145,8,2,54518,14,23.4,-1.2958383,36.8073162,-1.3457877,36.8811894,633,1373,481,652
15315,8676,1500,3,Business,2,4,57472,2,4,57501,2,4,57937,2,4,60321,2,4,60323,8,23.25888921888938,-1.3004062,36.829741,-1.2638185,36.7930057,403,2,29,2820
15316,22114,1500,3,Business,25,1,33622,25,1,33719,25,1,34122,25,1,37002,25,1,37959,8,21.0,-1.3004062,36.829741,-1.2638185,36.7930057,399,957,97,3283
15317,4503,3517,3,Business,2,4,46868,2,4,46878,2,4,46943,2,4,49070,2,4,50567,16,23.25888921888938,-1.300921,36.828195,-1.3882008,36.7699445,923,1497,10,2192
15318,2555,2523,3,Business,23,4,34732,23,4,35196,23,4,35593,23,4,36115,23,4,37495,7,23.25888921888938,-1.2551895,36.7822034,-1.2915969,36.8237639,96,1380,464,919
15319,1190,1578,3,Business,5,1,38463,5,1,38503,5,1,40486,5,1,40568,5,1,42013,6,24.7,-1.2765736,36.8513646,-1.28878,36.8168312,477,1445,40,2065
15320,4848,3517,3,Business,1,5,58594,1,5,58617,1,5,58629,1,5,59872,1,5,61911,15,26.6,-1.300921,36.828195,-1.3882008,36.7699445,925,2039,23,1255
15321,21366,1882,3,Business,11,5,44715,11,5,44770,11,5,45289,11,5,48112,11,5,48837,7,21.2,-1.2958783,36.7928125,-1.2588775,36.8079744,862,725,55,3342
15322,22137,3718,3,Business,29,1,36337,29,1,36452,29,1,36755,29,1,37048,29,1,38276,5,18.8,-1.2650027,36.8126242,-1.2906618,36.8131222,596,1228,115,596
15323,2160,71,3,Business,9,6,36854,9,6,36986,9,6,37204,9,6,37487,9,6,37785,2,15.2,-1.279395,36.825364,-1.2821108,36.8250555,379,298,132,501
15324,8233,3599,3,Business,11,6,31155,11,6,31181,11,6,33974,11,6,34588,11,6,37474,8,23.25888921888938,-1.3302996,36.8707935,-1.3074264,36.8226123,459,2886,26,3407
15325,12410,3201,3,Business,29,3,59309,29,3,59327,29,3,59336,29,3,60001,29,3,60717,3,19.2,-1.2649605,36.7981777,-1.2551895,36.7822034,822,716,18,674
15326,2046,3491,3,Business,9,3,48568,9,3,51488,9,3,53371,9,3,54016,9,3,56805,20,23.2,-1.2297202,36.8745508,-1.312124,36.76162,100,2789,2920,2528
15327,22568,3283,3,Business,9,4,45442,9,4,45541,9,4,46866,9,4,48126,9,4,48977,5,23.6,-1.2600926,36.8088685,-1.2628473,36.781805,700,851,99,2585
15328,27315,496,3,Business,20,4,63074,20,4,64244,20,4,65210,20,4,65586,20,4,67472,7,22.5,-1.2551895,36.7822034,-1.2915969,36.8237639,320,1886,1170,1342
15329,1593,2718,3,Business,1,5,56752,1,5,57943,1,5,58617,1,5,58772,1,5,59466,5,28.5,-1.2668815,36.8017244,-1.2962832,36.7849683,205,694,1191,829
15330,25466,517,3,Business,29,3,56439,29,3,56574,29,3,56602,29,3,58633,29,3,58635,4,21.3,-1.3228003,36.8306435,-1.3004062,36.829741,10,2,135,2059
15331,19034,2543,2,Personal,7,5,61254,7,5,61577,7,5,64055,7,5,64236,7,5,65247,5,22.4,-1.2915418,36.7979019,-1.3021964,36.7681681,86,1011,323,2659
15332,23919,3291,3,Business,12,2,47503,12,2,47538,12,2,47555,12,2,47996,12,2,48586,5,24.4,-1.2628473,36.781805,-1.2600926,36.8088685,188,590,35,458
15333,3485,1882,3,Business,3,7,36987,3,7,41863,3,7,44832,3,7,44913,3,7,46851,16,28.3,-1.3169591,36.7000029,-1.287781,36.817866,303,1938,4876,3050
15334,4313,3496,3,Business,28,5,55736,28,5,55825,28,5,56385,28,5,57037,28,5,59189,12,25.5,-1.300921,36.828195,-1.2925776,36.7456926,925,2152,89,1212
15335,16815,20,3,Business,17,3,45019,17,3,46149,17,3,46554,17,3,46816,17,3,50027,7,25.6,-1.2586742,36.8016438,-1.3090533,36.8371502,280,3211,1130,667
15336,9664,1724,3,Business,8,5,54823,8,5,56281,8,5,56932,8,5,57114,8,5,60212,7,30.2,-1.2551895,36.7822034,-1.2789469,36.7796691,576,3098,1458,833
15337,7845,635,3,Business,14,4,35554,14,4,36373,14,4,37253,14,4,37582,14,4,38628,7,17.8,-1.2602337,36.7990548,-1.3081376,36.8329772,724,1046,819,1209
15338,14744,81,3,Business,21,4,60722,21,4,60787,21,4,61491,21,4,61736,21,4,62341,5,20.1,-1.2641496,36.7914139,-1.263732,36.81391,427,605,65,949
15339,15845,2801,3,Business,7,3,41021,7,3,41082,7,3,41111,7,3,41638,7,3,41669,2,24.9,-1.2595422,36.7871178,-1.2635744,36.781677,215,31,61,556
15340,8762,203,3,Business,13,2,55931,13,2,55964,13,2,56984,13,2,57135,13,2,63349,17,26.2,-1.329449,36.890451,-1.3039706,36.7688174,559,6214,33,1171
15341,10686,2568,1,Personal,30,3,52083,30,3,52163,30,3,53194,30,3,53662,30,3,57388,30,25.2,-1.2861184,36.8159704,-1.1140714,37.0056922,101,3726,80,1499
15342,7185,265,3,Business,23,6,35060,23,6,35069,23,6,35091,23,6,35584,23,6,36737,9,19.0,-1.300921,36.828195,-1.2812624,36.7714609,576,1153,9,515
15343,7103,2561,3,Business,19,2,38817,19,2,39022,19,2,39815,19,2,40147,19,2,43120,8,23.25888921888938,-1.2551895,36.7822034,-1.2819711,36.8353333,752,2973,205,1125
15344,26317,635,3,Business,13,2,37037,13,2,37927,13,2,39240,13,2,39657,13,2,40625,9,22.4,-1.2599563,36.7993439,-1.2948887,36.7683938,952,968,890,1730
15345,7117,2200,3,Business,2,6,43519,2,6,49411,2,6,51282,2,6,52167,2,6,54526,12,31.2,-1.225322,36.80855,-1.290894,36.822971,434,2359,5892,2756
15346,10260,412,3,Business,2,2,35883,2,2,35910,2,2,38704,2,2,40553,2,2,40985,4,26.4,-1.2628473,36.781805,-1.266837,36.799249,436,432,27,4643
15347,13714,868,3,Business,8,1,42430,8,1,42627,8,1,42728,8,1,43843,8,1,43851,3,28.1,-1.2783849,36.8163445,-1.265715,36.823815,564,8,197,1216
15348,17458,3283,3,Business,20,5,38803,20,5,38817,20,5,38993,20,5,39906,20,5,40672,6,18.4,-1.272828,36.816608,-1.2628473,36.781805,951,766,14,1089
15349,7310,2066,3,Business,3,1,39034,3,1,39071,3,1,39389,3,1,39858,3,1,40861,2,20.7,-1.316961,36.820337,-1.3251584,36.8199384,328,1003,37,787
15350,23132,393,3,Business,24,3,41004,24,3,41467,24,3,41471,24,3,42303,24,3,43032,5,19.7,-1.3177547,36.8303703,-1.3077869,36.8443207,10,729,463,836
15351,2138,868,3,Business,8,5,50994,8,5,51047,8,5,51398,8,5,51981,8,5,52404,5,27.2,-1.2600926,36.8088685,-1.265715,36.823815,845,423,53,934
15352,6678,706,3,Business,25,5,48843,25,5,49044,25,5,50331,25,5,50445,25,5,51265,5,29.0,-1.3004062,36.829741,-1.3077869,36.8443207,206,820,201,1401
15353,184,3291,3,Business,31,2,49109,31,2,49157,31,2,49774,31,2,50478,31,2,51849,11,22.1,-1.303596,36.778378,-1.2600926,36.8088685,250,1371,48,1321
15354,25393,3104,3,Personal,17,4,45578,17,4,45721,17,4,46924,17,4,47078,17,4,47727,4,25.3,-1.3421985,36.9040545,-1.3276436,36.8833966,559,649,143,1357
15355,1229,1976,3,Business,11,5,52936,11,5,52973,11,5,53190,11,5,53374,11,5,53904,4,26.2,-1.267311,36.809196,-1.257028,36.7810435,648,530,37,401
15356,12807,2150,3,Business,14,5,34099,14,5,34208,14,5,35247,14,5,35704,14,5,39402,15,18.3,-1.272828,36.816608,-1.344446,36.756597,882,3698,109,1496
15357,16839,635,3,Business,3,4,53102,3,4,53128,3,4,53376,3,4,54778,3,4,55747,8,26.2,-1.3016417,36.8271679,-1.2599563,36.7993439,90,969,26,1650
15358,9309,629,1,Personal,13,5,64192,13,5,64211,13,5,64746,13,5,65203,13,5,66474,9,19.4,-1.3043961,36.7861511,-1.2615284,36.7897495,806,1271,19,992
15359,27660,1571,3,Personal,10,3,44922,10,3,44950,10,3,47027,10,3,47318,10,3,48729,14,27.7,-1.2924639,36.7795798,-1.2349573,36.8693675,205,1411,28,2368
15360,3594,2701,3,Business,6,3,45465,6,3,45480,6,3,45485,6,3,47159,6,3,47810,5,23.25888921888938,-1.290894,36.822971,-1.2765736,36.8513646,906,651,15,1679
15361,17980,867,3,Business,13,4,37378,13,4,40530,13,4,41183,13,4,41537,13,4,43196,14,22.0,-1.3077869,36.8443207,-1.2991441,36.7528804,914,1659,3152,1007
15362,2957,1245,3,Business,6,1,50000,6,1,50021,6,1,50178,6,1,52914,6,1,54600,22,23.25888921888938,-1.300921,36.828195,-1.3050342,36.6680211,206,1686,21,2893
15363,14181,3557,3,Business,16,2,53020,16,2,53028,16,2,53911,16,2,54522,16,2,55423,3,27.4,-1.269534,36.80697,-1.2546732,36.8086796,434,901,8,1494
15364,18772,813,1,Personal,8,2,61460,8,2,61673,8,2,63082,8,2,63275,8,2,65533,11,20.6,-1.299787,36.8335941,-1.2561231,36.7940997,549,2258,213,1602
15365,26740,788,3,Business,22,2,48904,22,2,48916,22,2,49149,22,2,49606,22,2,50564,7,25.8,-1.2527958,36.8003131,-1.225322,36.80855,882,958,12,690
15366,19840,393,3,Business,12,2,55534,12,2,55567,12,2,56179,12,2,57690,12,2,61135,14,26.9,-1.3167113,36.8301563,-1.306378,36.7519845,497,3445,33,2123
15367,21296,265,3,Business,6,3,56381,6,3,56411,6,3,56415,6,3,60020,6,3,61734,15,26.1,-1.300921,36.828195,-1.2156006,36.8916865,942,1714,30,3609
15368,13654,265,3,Business,7,3,54861,7,3,54985,7,3,55572,7,3,56322,7,3,57876,10,28.5,-1.300921,36.828195,-1.3014461,36.7661381,936,1554,124,1337
15369,9138,3283,3,Business,16,4,38154,16,4,38190,16,4,39630,16,4,40478,16,4,41162,6,23.25888921888938,-1.2663631,36.8163329,-1.2628473,36.781805,712,684,36,2288
15370,2589,1329,3,Business,9,6,50244,9,6,50289,9,6,50573,9,6,50652,9,6,52543,6,27.2,-1.273056,36.811298,-1.2870051,36.7716247,26,1891,45,363
15371,11719,393,3,Business,26,5,44007,26,5,44038,26,5,44045,26,5,45929,26,5,48219,14,23.25888921888938,-1.3177547,36.8303703,-1.306378,36.7519845,515,2290,31,1891
15372,11645,1927,3,Business,3,1,45728,3,1,45741,3,1,45758,3,1,45858,3,1,47862,26,21.4,-1.3472066,36.7692638,-1.3916459,36.9305892,778,2004,13,117
15373,20538,699,3,Personal,16,2,40801,16,2,41115,16,2,41838,16,2,41940,16,2,42663,4,23.5,-1.2850644,36.8343657,-1.2967702,36.8040381,22,723,314,825
15374,5565,393,3,Business,23,3,37823,23,3,42707,23,3,44273,23,3,45571,23,3,47333,14,21.6,-1.3177547,36.8303703,-1.306378,36.7519845,543,1762,4884,2864
15375,22035,346,3,Business,9,1,55161,9,1,55231,9,1,55827,9,1,57059,9,1,57975,1,21.0,-1.279395,36.825364,-1.2885529,36.8160141,421,916,70,1828
15376,25347,2677,3,Business,16,2,59449,16,2,59522,16,2,59940,16,2,60462,16,2,62084,9,23.25888921888938,-1.2638185,36.7930057,-1.2991441,36.7528804,193,1622,73,940
15377,16011,868,3,Business,22,4,44474,22,4,47116,22,4,47896,22,4,48379,22,4,49756,8,22.7,-1.303596,36.778378,-1.265715,36.823815,937,1377,2642,1263
15378,12890,2008,3,Business,1,1,51030,1,1,51049,1,1,51772,1,1,52014,1,1,53127,6,25.6,-1.2508229,36.7895263,-1.2608592,36.8311977,607,1113,19,965
15379,6531,1209,3,Business,3,3,39378,3,3,39775,3,3,41456,3,3,41604,3,3,42905,4,27.2,-1.2770708,36.8231093,-1.3004062,36.829741,740,1301,397,1829
15380,27867,2789,3,Business,26,2,53882,26,2,53901,26,2,54390,26,2,55074,26,2,56600,12,29.9,-1.304735,36.7846054,-1.2567512,36.8236011,361,1526,19,1173
15381,20860,2008,3,Business,12,4,48849,12,4,49050,12,4,49943,12,4,50420,12,4,54312,7,21.6,-1.2508229,36.7895263,-1.2785858,36.8289683,752,3892,201,1370
15382,24871,718,3,Business,30,5,35125,30,5,35259,30,5,37054,30,5,37174,30,5,38339,10,19.0,-1.2551895,36.7822034,-1.2363748,36.8177502,453,1165,134,1915
15383,24128,640,3,Business,18,4,45485,18,4,45522,18,4,46164,18,4,46993,18,4,50557,23,23.25888921888938,-1.2969741,36.7856612,-1.3724413,36.9284922,155,3564,37,1471
15384,2615,1075,3,Business,30,3,42889,30,3,42905,30,3,43349,30,3,43733,30,3,44165,1,25.2,-1.2649605,36.7981777,-1.2527958,36.8003131,428,432,16,828
15385,15421,250,2,Personal,20,3,47394,20,3,47457,20,3,48420,20,3,48745,20,3,50178,5,23.0,-1.2874314,36.7764912,-1.269534,36.80697,465,1433,63,1288
15386,8981,1749,3,Personal,5,2,59219,5,2,59346,5,2,59448,5,2,60143,5,2,62636,5,23.25888921888938,-1.288167,36.8181484,-1.2621576,36.8103473,674,2493,127,797
15387,26240,1724,3,Business,15,1,48621,15,1,48711,15,1,49215,15,1,50482,15,1,51844,7,23.25888921888938,-1.3014461,36.7661381,-1.286067,36.8146155,306,1362,90,1771
15388,14251,2956,3,Business,20,3,57691,20,3,57722,20,3,57987,20,3,59160,20,3,59551,3,23.4,-1.2584143,36.8048002,-1.2551895,36.7822034,116,391,31,1438
15389,7194,3420,3,Business,23,2,55705,23,2,57094,23,2,58182,23,2,58435,23,2,59888,7,18.8,-1.2678373,36.8359086,-1.3046007,36.8211743,612,1453,1389,1341
15390,22949,635,3,Business,24,3,57112,24,3,58244,24,3,58464,24,3,58901,24,3,60364,7,18.4,-1.2599563,36.7993439,-1.3016417,36.8271679,878,1463,1132,657
15391,27477,1245,3,Business,27,3,47190,27,3,47215,27,3,47589,27,3,50576,27,3,52889,19,29.7,-1.300921,36.828195,-1.3198615,36.7110323,519,2313,25,3361
15392,23584,1102,3,Business,11,4,29642,11,4,29654,11,4,31552,11,4,31774,11,4,33582,15,21.9,-1.3090241,36.7357231,-1.3004062,36.829741,855,1808,12,2120
15393,12391,928,3,Business,30,3,36341,30,3,36914,30,3,40741,30,3,41013,30,3,42634,8,25.2,-1.2551895,36.7822034,-1.2866381,36.7963662,829,1621,573,4099
15394,28017,1796,3,Business,30,2,34844,30,2,34870,30,2,35576,30,2,36455,30,2,37246,9,23.25888921888938,-1.3033561,36.8163631,-1.331619,36.847976,709,791,26,1585
15395,22628,3283,3,Business,29,1,33562,29,1,33601,29,1,34078,29,1,34160,29,1,35097,7,23.25888921888938,-1.2628473,36.781805,-1.265715,36.823815,770,937,39,559
15396,8627,412,3,Business,31,4,33432,31,4,33443,31,4,33866,31,4,33973,31,4,34432,2,20.6,-1.266837,36.799249,-1.2600926,36.8088685,535,459,11,530
15397,7342,31,3,Business,19,4,44678,19,4,44690,19,4,44722,19,4,45442,19,4,47086,13,20.1,-1.3121969,36.7238784,-1.2615888,36.7928732,326,1644,12,752
15398,14362,3739,1,Personal,19,2,54131,19,2,54180,19,2,54854,19,2,55373,19,2,56879,8,18.7,-1.2706948,36.7844665,-1.2963019,36.8120859,956,1506,49,1193
15399,19318,3222,3,Business,4,1,52221,4,1,52464,4,1,52851,4,1,53345,4,1,54667,10,28.5,-1.2551895,36.7822034,-1.2903067,36.8375634,219,1322,243,881
15400,6772,1927,3,Business,20,2,34516,20,2,34522,20,2,34909,20,2,35077,20,2,37623,15,19.1,-1.2584143,36.8048002,-1.3463042,36.768164,329,2546,6,555
15401,6991,3201,3,Business,27,4,57850,27,4,57861,27,4,58460,27,4,58822,27,4,58924,2,24.9,-1.2561334,36.7990458,-1.2649605,36.7981777,623,102,11,961
15402,1488,635,3,Business,30,3,35642,30,3,35668,30,3,36254,30,3,36426,30,3,37673,11,19.8,-1.2397191,36.8733845,-1.2602337,36.7990548,906,1247,26,758
15403,580,2982,3,Business,10,1,34434,10,1,34454,10,1,34900,10,1,38091,10,1,40898,18,18.3,-1.300921,36.828195,-1.177202,36.8351183,519,2807,20,3637
15404,16403,3521,3,Business,8,2,55799,8,2,56030,8,2,56963,8,2,57209,8,2,60299,3,25.3,-1.2696908,36.81519,-1.2665065,36.7970081,268,3090,231,1179
15405,2187,1271,3,Business,8,2,37684,8,2,37717,8,2,38189,8,2,38291,8,2,40452,14,23.5,-1.3244885,36.897792,-1.4136642,36.957045,418,2161,33,574
15406,9229,2066,3,Business,21,4,55752,21,4,56150,21,4,56661,21,4,57200,21,4,58252,8,22.4,-1.316961,36.820337,-1.3270347,36.8667362,444,1052,398,1050
15407,27923,2987,3,Business,21,3,57912,21,3,57997,21,3,59519,21,3,59585,21,3,60833,11,23.25888921888938,-1.270212,36.8210877,-1.2156006,36.8916865,208,1248,85,1588
15408,1339,972,3,Business,28,6,50219,28,6,50258,28,6,50607,28,6,50689,28,6,51495,4,25.1,-1.2862033,36.8152966,-1.3041129,36.8104939,844,806,39,431
15409,1265,1850,3,Business,20,1,56396,20,1,56880,20,1,57177,20,1,57265,20,1,58790,7,21.5,-1.2551895,36.7822034,-1.289498,36.818878,79,1525,484,385
15410,26839,1578,3,Business,17,1,32571,17,1,32652,17,1,33046,17,1,34976,17,1,35985,5,19.2,-1.2584143,36.8048002,-1.28878,36.8168312,150,1009,81,2324
15411,9135,3689,3,Business,13,1,57045,13,1,57057,13,1,57079,13,1,62075,13,1,62145,1,19.4,-1.264272,36.7978791,-1.2527958,36.8003131,875,70,12,5018
15412,18387,3195,1,Personal,4,1,32929,4,1,33884,4,1,35009,4,1,35403,4,1,36884,17,17.9,-1.2004287,36.8321556,-1.2945743,36.7732602,116,1481,955,1519
15413,13323,496,3,Business,30,2,55369,30,2,58128,30,2,60304,30,2,60897,30,2,62486,11,23.25888921888938,-1.2551895,36.7822034,-1.3080793,36.7505396,318,1589,2759,2769
15414,26387,627,3,Business,8,3,60090,8,3,60177,8,3,60413,8,3,60987,8,3,65468,10,23.8,-1.2551895,36.7822034,-1.221377,36.781314,415,4481,87,810
15415,6483,1363,3,Business,14,4,53640,14,4,54517,14,4,55372,14,4,55679,14,4,56619,1,28.0,-1.3004062,36.829741,-1.3068209,36.8282524,311,940,877,1162
15416,5289,2330,3,Business,29,5,60075,29,5,60314,29,5,61274,29,5,62479,29,5,64186,7,28.2,-1.2890715,36.8157588,-1.2873232,36.7658572,907,1707,239,2165
15417,20799,3432,3,Business,4,2,38643,4,2,38661,4,2,39323,4,2,39702,4,2,41906,8,18.7,-1.260812,36.807545,-1.3016279,36.7777746,216,2204,18,1041
15418,3670,3560,3,Business,26,5,31601,26,5,34651,26,5,34900,26,5,35971,26,5,35976,6,23.25888921888938,-1.279395,36.825364,-1.2571472,36.7950633,878,5,3050,1320
15419,912,2069,3,Business,11,1,39467,11,1,39560,11,1,42323,11,1,44102,11,1,44104,9,26.8,-1.265715,36.823815,-1.228911,36.881876,309,2,93,4542
15420,8700,2801,3,Business,27,4,46277,27,4,46284,27,4,46615,27,4,46905,27,4,48381,9,22.8,-1.2595422,36.7871178,-1.283905,36.8249272,726,1476,7,621
15421,7999,3175,3,Business,1,4,32211,1,4,32236,1,4,32393,1,4,32568,1,4,33618,4,23.25888921888938,-1.2681004,36.7952081,-1.263419,36.8060348,720,1050,25,332
15422,7358,2123,1,Personal,10,5,36007,10,5,36014,10,5,36288,10,5,36585,10,5,37878,14,13.6,-1.2870737,36.8327911,-1.3382857,36.8870715,414,1293,7,571
15423,2760,970,3,Business,5,5,54736,5,5,54756,5,5,54967,5,5,55443,5,5,57294,15,27.7,-1.2551895,36.7822034,-1.3319467,36.7766998,690,1851,20,687
15424,6351,1075,3,Business,31,5,45528,31,5,46019,31,5,46148,31,5,46860,31,5,47698,2,21.9,-1.2527958,36.8003131,-1.2690931,36.8065779,72,838,491,841
15425,11614,2763,3,Business,1,1,43173,1,1,43226,1,1,43285,1,1,43775,1,1,44275,3,23.25888921888938,-1.2551895,36.7822034,-1.260792,36.796768,177,500,53,549
15426,973,2582,3,Business,1,4,43830,1,4,43840,1,4,44530,1,4,45317,1,4,47414,19,23.25888921888938,-1.2825223,36.9014566,-1.2551895,36.7822034,699,2097,10,1477
15427,11173,1280,3,Business,11,1,47120,11,1,47143,11,1,47373,11,1,47684,11,1,48222,5,24.2,-1.2551895,36.7822034,-1.2647688,36.775086,622,538,23,541
15428,88,2358,4,Business,13,3,37441,13,3,37450,13,3,38055,13,3,38688,13,3,40593,21,20.0,-1.3256904,36.8747943,-1.255956,36.789867,543,1905,9,1238
15429,23301,3283,3,Business,28,4,46628,28,4,46724,28,4,49498,28,4,51274,28,4,52416,5,29.9,-1.2600926,36.8088685,-1.2628473,36.781805,52,1142,96,4550
15430,17857,584,1,Personal,25,5,42013,25,5,43287,25,5,44340,25,5,45181,25,5,45914,3,21.2,-1.2981102,36.8293513,-1.302559,36.819555,749,733,1274,1894
15431,2298,393,3,Business,15,3,41204,15,3,41228,15,3,41232,15,3,43458,15,3,43502,14,23.25888921888938,-1.3167113,36.8301563,-1.2991441,36.7528804,39,44,24,2230
15432,14973,2154,3,Business,12,2,45739,12,2,46362,12,2,47477,12,2,47565,12,2,48723,7,28.2,-1.2765736,36.8513646,-1.2591019,36.800577,291,1158,623,1203
15433,11129,2154,3,Business,6,3,54675,6,3,54685,6,3,55169,6,3,55780,6,3,57137,9,23.25888921888938,-1.2283403,36.8822756,-1.2765736,36.8513646,521,1357,10,1095
15434,3567,496,3,Business,24,5,41812,24,5,41857,24,5,42645,24,5,42882,24,5,43508,4,21.6,-1.2551895,36.7822034,-1.2662728,36.8151265,337,626,45,1025
15435,15491,517,3,Business,5,3,29470,5,3,35518,5,3,35827,5,3,36211,5,3,38577,10,17.9,-1.3177547,36.8303703,-1.2574219,36.7927073,523,2366,6048,693
15436,26790,1085,3,Business,12,3,53755,12,3,53933,12,3,54686,12,3,55350,12,3,57470,7,21.0,-1.2628638,36.8070399,-1.232864,36.8084708,36,2120,178,1417
15437,6903,326,3,Personal,17,1,34674,17,1,34892,17,1,35450,17,1,35647,17,1,36385,4,19.1,-1.2641662,36.8136393,-1.2718101,36.79176,112,738,218,755
15438,22033,1051,3,Business,24,4,36262,24,4,36282,24,4,36896,24,4,38171,24,4,41690,11,21.4,-1.2963097,36.7688221,-1.304969,36.846623,644,3519,20,1889
15439,17441,2437,2,Personal,25,2,53053,25,2,53456,25,2,54213,25,2,54603,25,2,56429,8,26.9,-1.3015998,36.8764939,-1.3255467,36.8804607,754,1826,403,1147
15440,10241,3404,3,Business,5,1,46429,5,1,47641,5,1,48374,5,1,48658,5,1,50034,5,24.5,-1.2588181,36.8106709,-1.279395,36.825364,660,1376,1212,1017
15441,21538,1263,2,Personal,19,2,57575,19,2,57594,19,2,58163,19,2,59045,19,2,60890,14,18.5,-1.269534,36.80697,-1.2962888,36.8892359,116,1845,19,1451
15442,20819,635,3,Business,26,5,32647,26,5,32680,26,5,33035,26,5,33454,26,5,34488,6,23.25888921888938,-1.2602337,36.7990548,-1.2925023,36.8259661,291,1034,33,774
15443,17325,635,3,Business,31,5,35134,31,5,35152,31,5,35357,31,5,36380,31,5,37623,16,23.25888921888938,-1.2602337,36.7990548,-1.2782208,36.7062622,90,1243,18,1228
15444,1381,1647,3,Business,27,6,56846,27,6,56859,27,6,57308,27,6,57791,27,6,59108,4,23.25888921888938,-1.2190317,36.8825092,-1.2238103,36.8772588,291,1317,13,932
15445,7763,2083,3,Personal,22,5,51324,22,5,51377,22,5,51835,22,5,51924,22,5,52966,8,27.5,-1.291768,36.8297208,-1.2615888,36.7928732,456,1042,53,547
15446,19635,3222,3,Business,25,5,49862,25,5,49893,25,5,49930,25,5,50303,25,5,54146,22,29.1,-1.2551895,36.7822034,-1.3190102,36.9230693,579,3843,31,410
15447,5577,2216,3,Business,23,5,58506,23,5,58665,23,5,58885,23,5,59030,23,5,59597,3,26.6,-1.2649605,36.7981777,-1.2551895,36.7822034,191,567,159,365
15448,15386,706,3,Business,14,5,50847,14,5,50880,14,5,50889,14,5,51399,14,5,51901,5,23.8,-1.3004062,36.829741,-1.3077869,36.8443207,31,502,33,519
15449,25439,1075,3,Business,13,3,43248,13,3,43280,13,3,43973,13,3,44239,13,3,46157,13,23.25888921888938,-1.2285835,36.8826468,-1.2527958,36.8003131,8,1918,32,959
15450,22554,2716,3,Business,24,1,43830,24,1,43877,24,1,45216,24,1,45829,24,1,49030,2,22.6,-1.2917868,36.7872675,-1.2978908,36.7963215,222,3201,47,1952
15451,20847,2982,3,Business,10,1,41846,10,1,42791,10,1,43973,10,1,46540,10,1,48757,18,18.6,-1.300921,36.828195,-1.177202,36.8351183,654,2217,945,3749
15452,16362,1527,3,Business,30,4,36062,30,4,36117,30,4,36221,30,4,38804,30,4,40797,16,23.25888921888938,-1.3004062,36.829741,-1.2197384,36.8904678,591,1993,55,2687
15453,13462,2989,3,Business,2,5,41628,2,5,41709,2,5,42425,2,5,45270,2,5,47404,15,23.5,-1.2571472,36.7950633,-1.3463042,36.768164,715,2134,81,3561
15454,3372,1191,1,Personal,3,1,59413,3,1,59432,3,1,60762,3,1,60911,3,1,61937,7,22.0,-1.32589,36.831679,-1.3282758,36.8590281,87,1026,19,1479
15455,14608,1502,3,Business,16,3,46907,16,3,49001,16,3,49924,16,3,50168,16,3,51883,10,26.9,-1.2859912,36.8756811,-1.2232123,36.8932547,817,1715,2094,1167
15456,19851,1927,3,Business,14,2,44338,14,2,44350,14,2,44576,14,2,45890,14,2,47389,19,23.25888921888938,-1.3562374,36.9042954,-1.3472066,36.7692638,438,1499,12,1540
15457,9750,635,3,Business,26,3,33615,26,3,33845,26,3,34412,26,3,37005,26,3,38284,7,19.2,-1.3016417,36.8271679,-1.2599563,36.7993439,279,1279,230,3160
15458,16759,389,1,Personal,19,2,57163,19,2,57752,19,2,58379,19,2,59186,19,2,60459,6,18.6,-1.294869,36.815327,-1.2806514,36.7774356,322,1273,589,1434
15459,27388,496,3,Business,22,1,59944,22,1,59996,22,1,60093,22,1,61063,22,1,62264,8,22.4,-1.2551895,36.7822034,-1.2941557,36.7792012,536,1201,52,1067
15460,8879,517,3,Business,13,2,28324,13,2,39813,13,2,40636,13,2,41943,13,2,42782,4,22.5,-1.3177547,36.8303703,-1.3004062,36.829741,654,839,11489,2130
15461,14890,2523,3,Business,13,3,40241,13,3,40265,13,3,40313,13,3,40772,13,3,42650,4,24.9,-1.2551895,36.7822034,-1.2516124,36.8018759,708,1878,24,507
15462,5497,1500,3,Business,27,4,28088,27,4,30005,27,4,30342,27,4,32185,27,4,32792,8,17.8,-1.3004062,36.829741,-1.2574219,36.7927073,424,607,1917,2180
15463,27649,391,3,Business,13,1,54914,13,1,55242,13,1,55847,13,1,58961,13,1,58964,5,23.25888921888938,-1.300921,36.828195,-1.2839729,36.8115146,843,3,328,3719
15464,3112,3032,3,Business,24,4,52134,24,4,52191,24,4,52778,24,4,54006,24,4,55080,5,28.3,-1.2429898,36.7851062,-1.2571472,36.7950633,329,1074,57,1815
15465,12916,894,1,Personal,15,7,63572,15,7,65034,15,7,65821,15,7,66757,15,7,68618,7,20.3,-1.346168,36.766149,-1.3757054,36.7581013,465,1861,1462,1723
15466,8847,2944,3,Personal,10,1,52746,10,1,52866,10,1,55069,10,1,57800,10,1,58113,10,18.1,-1.2772989,36.8526035,-1.2642333,36.7795483,139,313,120,4934
15467,19216,2180,2,Personal,19,2,41921,19,2,42151,19,2,43321,19,2,43477,19,2,46065,15,23.25888921888938,-1.329449,36.890451,-1.2659396,36.7903067,735,2588,230,1326
15468,26386,2289,3,Business,27,3,45384,27,3,45398,27,3,45556,27,3,46309,27,3,47909,12,26.2,-1.2551895,36.7822034,-1.3127877,36.8481987,206,1600,14,911
15469,6306,1500,3,Business,18,2,32733,18,2,37162,18,2,38360,18,2,38642,18,2,39557,8,23.25888921888938,-1.3004062,36.829741,-1.2574219,36.7927073,914,915,4429,1480
15470,717,3401,1,Personal,27,1,47180,27,1,47225,27,1,47821,27,1,48646,27,1,49092,2,23.9,-1.2621576,36.8103473,-1.2697141,36.7981777,886,446,45,1421
15471,10571,1850,3,Business,17,3,55834,17,3,55850,17,3,56175,17,3,56294,17,3,56954,2,23.25888921888938,-1.2551895,36.7822034,-1.2584143,36.8048002,690,660,16,444
15472,5039,2722,2,Personal,7,5,57766,7,5,57959,7,5,58486,7,5,59242,7,5,60689,11,24.9,-1.2321733,36.7974377,-1.2901669,36.7685878,410,1447,193,1283
15473,13689,1245,3,Business,19,2,48115,19,2,48166,19,2,50916,19,2,51499,19,2,53297,14,18.5,-1.300921,36.828195,-1.33355,36.72941,297,1798,51,3333
15474,15800,20,3,Business,7,4,45309,7,4,45677,7,4,46359,7,4,46922,7,4,48392,15,27.8,-1.2628638,36.8070399,-1.3324865,36.8938303,267,1470,368,1245
15475,16899,2763,3,Business,26,5,43008,26,5,43021,26,5,43051,26,5,44306,26,5,45355,12,23.25888921888938,-1.2551895,36.7822034,-1.2335612,36.8451892,291,1049,13,1285
15476,11463,706,3,Business,2,3,37325,2,3,37581,2,3,37611,2,3,38041,2,3,38869,6,24.0,-1.3077869,36.8443207,-1.3228003,36.8306435,848,828,256,460
15477,17336,1209,3,Business,6,3,40542,6,3,40581,6,3,41379,6,3,42555,6,3,43836,10,22.6,-1.3004062,36.829741,-1.3263285,36.8926624,11,1281,39,1974
15478,21006,776,1,Personal,10,2,39027,10,2,39038,10,2,39764,10,2,39828,10,2,41514,13,20.1,-1.278967,36.8236745,-1.3145553,36.7493849,629,1686,11,790
15479,23215,1410,3,Business,10,5,38251,10,5,38535,10,5,39192,10,5,40973,10,5,43422,22,23.25888921888938,-1.2847613,36.967084,-1.2292757,36.8704721,506,2449,284,2438
15480,9895,1500,3,Business,24,3,45412,24,3,45778,24,3,45834,24,3,46043,24,3,48244,15,20.0,-1.2574219,36.7927073,-1.3301235,36.7070434,731,2201,366,265
15481,281,566,1,Personal,13,6,40873,13,6,41430,13,6,41826,13,6,42469,13,6,44027,9,25.1,-1.2540928,36.69782,-1.2924733,36.7560649,731,1558,557,1039
15482,10567,1075,3,Business,21,4,49965,21,4,50263,21,4,51783,21,4,53101,21,4,53604,6,26.3,-1.2885029,36.825605,-1.2527958,36.8003131,330,503,298,2838
15483,21083,496,3,Business,17,4,56726,17,4,56868,17,4,57534,17,4,57793,17,4,59371,9,24.0,-1.2626906,36.7827022,-1.2980229,36.78865,279,1578,142,925
15484,20792,3702,1,Personal,1,6,44820,1,6,45838,1,6,47700,1,6,47910,1,6,49105,7,18.7,-1.2824577,36.7967953,-1.28365,36.828013,857,1195,1018,2072
15485,7971,1111,1,Personal,1,1,45335,1,1,45868,1,1,46633,1,1,47451,1,1,48260,5,24.2,-1.2821883,36.8269611,-1.291103,36.851413,21,809,533,1583
15486,26640,2407,2,Personal,10,3,54917,10,3,54949,10,3,56219,10,3,56518,10,3,57301,3,24.8,-1.2922888,36.7755707,-1.2901382,36.784678,612,783,32,1569
15487,12142,2683,2,Personal,23,3,62651,23,3,63803,23,3,64281,23,3,64506,23,3,65429,5,20.7,-1.2977387,36.8031447,-1.3071725,36.7742592,749,923,1152,703
15488,25748,2066,3,Business,23,4,50547,23,4,51223,23,4,51981,23,4,52087,23,4,55537,7,24.7,-1.3210189,36.8410551,-1.2871085,36.8303905,436,3450,676,864
15489,14037,3264,3,Business,8,2,58626,8,2,58639,8,2,58780,8,2,58908,8,2,59439,3,25.5,-1.2551895,36.7822034,-1.2642665,36.7788286,829,531,13,269
15490,24509,2627,3,Business,13,4,37264,13,4,37285,13,4,37586,13,4,37982,13,4,38316,2,21.9,-1.2584143,36.8048002,-1.2571472,36.7950633,147,334,21,697
15491,22460,1500,3,Business,22,5,29028,22,5,29040,22,5,29165,22,5,34452,22,5,34474,8,22.3,-1.3004062,36.829741,-1.2638185,36.7930057,119,22,12,5412
15492,20732,1500,3,Business,21,5,54833,21,5,55042,21,5,55764,21,5,59170,21,5,60172,8,27.1,-1.3004062,36.829741,-1.2574219,36.7927073,925,1002,209,4128
15493,4301,1484,3,Business,15,5,56305,15,5,56749,15,5,58439,15,5,58731,15,5,60576,9,18.0,-1.225322,36.80855,-1.2551895,36.7822034,61,1845,444,1982
15494,24303,2330,3,Business,29,5,63501,29,5,63778,29,5,64417,29,5,64983,29,5,66806,10,28.1,-1.2642903,36.8002137,-1.2687407,36.7373043,341,1823,277,1205
15495,21210,635,3,Business,3,4,55336,3,4,55402,3,4,56273,3,4,57560,3,4,58799,8,26.0,-1.3016417,36.8271679,-1.2599563,36.7993439,576,1239,66,2158
15496,25274,3291,3,Business,11,2,58189,11,2,60013,11,2,60968,11,2,61175,11,2,63434,12,20.6,-1.2600926,36.8088685,-1.228911,36.881876,27,2259,1824,1162
15497,26923,265,3,Business,9,4,53132,9,4,53173,9,4,53614,9,4,54091,9,4,54668,3,25.9,-1.3034072,36.8218035,-1.300921,36.828195,939,577,41,918
15498,25237,830,3,Business,20,1,54957,20,1,54988,20,1,55764,20,1,56154,20,1,57380,9,23.25888921888938,-1.2551895,36.7822034,-1.2966785,36.7896469,933,1226,31,1166
15499,2620,496,3,Business,7,2,36654,7,2,36733,7,2,37543,7,2,37805,7,2,38890,8,23.25888921888938,-1.2571472,36.7950633,-1.2980229,36.78865,768,1085,79,1072
15500,22535,2066,3,Business,22,5,50516,22,5,50524,22,5,51978,22,5,52247,22,5,53894,17,23.25888921888938,-1.316961,36.820337,-1.3332322,36.9289405,581,1647,8,1723
15501,18309,3149,3,Business,30,2,42197,30,2,42234,30,2,42414,30,2,42823,30,2,44139,12,22.1,-1.2574219,36.7927073,-1.3177547,36.8303703,551,1316,37,589
15502,16407,2801,3,Business,9,2,47177,9,2,47227,9,2,48432,9,2,49665,9,2,51042,9,30.4,-1.307726,36.839117,-1.2595422,36.7871178,695,1377,50,2438
15503,1022,3434,3,Business,19,3,42406,19,3,42436,19,3,43941,19,3,44779,19,3,46850,16,22.2,-1.3022899,36.869332,-1.2963097,36.7688221,895,2071,30,2343
15504,25681,1390,1,Personal,28,5,50873,28,5,50930,28,5,52179,28,5,52294,28,5,53825,5,25.3,-1.2994217,36.8009779,-1.3080784,36.776235,722,1531,57,1364
15505,18897,3194,3,Business,9,2,34863,9,2,34881,9,2,35539,9,2,36424,9,2,38088,16,20.7,-1.2551895,36.7822034,-1.1874676,36.7424548,438,1664,18,1543
15506,8084,2867,1,Personal,7,2,46538,7,2,46558,7,2,47486,7,2,48763,7,2,49907,8,25.0,-1.2156006,36.8916865,-1.1905588,36.9284611,895,1144,20,2205
15507,2600,1146,3,Business,7,4,52430,7,4,53425,7,4,54506,7,4,55160,7,4,56998,7,27.9,-1.3167113,36.8301563,-1.3083266,36.8494756,26,1838,995,1735
15508,6481,758,3,Business,9,2,36030,9,2,36095,9,2,38418,9,2,38718,9,2,41223,5,27.0,-1.2878081,36.8200516,-1.2917868,36.7872675,204,2505,65,2623
15509,8806,2700,3,Business,6,2,40933,6,2,41279,6,2,41700,6,2,42985,6,2,45419,5,25.1,-1.2757858,36.7886841,-1.2897368,36.8226783,956,2434,346,1706
15510,27833,439,3,Business,5,3,39092,5,3,39138,5,3,40202,5,3,40340,5,3,42519,13,22.6,-1.2613768,36.8019418,-1.3323107,36.8692616,90,2179,46,1202
15511,19036,2532,3,Business,9,4,39061,9,4,39144,9,4,40988,9,4,41845,9,4,43141,13,23.25888921888938,-1.3352545,36.8659639,-1.2942,36.7777614,25,1296,83,2701
15512,12947,1245,3,Business,15,1,53085,15,1,53110,15,1,53588,15,1,59573,15,1,62583,16,23.25888921888938,-1.300921,36.828195,-1.3441039,36.7177746,206,3010,25,6463
15513,15828,2894,3,Business,23,5,60400,23,5,60427,23,5,60591,23,5,60879,23,5,62321,3,24.5,-1.2906618,36.8131222,-1.2892359,36.7881212,74,1442,27,452
15514,3227,246,3,Business,8,2,51836,8,2,52167,8,2,52790,8,2,53282,8,2,54243,10,25.4,-1.2584143,36.8048002,-1.2413316,36.8785525,427,961,331,1115
15515,16126,2154,3,Business,19,6,37577,19,6,37758,19,6,38302,19,6,38440,19,6,39013,4,25.4,-1.2765736,36.8513646,-1.290894,36.822971,15,573,181,682
15516,22302,2150,3,Business,4,4,33379,4,4,33386,4,4,33881,4,4,34487,4,4,36749,11,21.6,-1.303596,36.778378,-1.344446,36.756597,693,2262,7,1101
15517,26070,1653,3,Business,19,3,45567,19,3,45590,19,3,46901,19,3,47022,19,3,48349,5,23.25888921888938,-1.3186549,36.8280233,-1.2970762,36.8453541,328,1327,23,1432
15518,12834,1245,3,Business,10,1,48943,10,1,48980,10,1,50093,10,1,50719,10,1,52355,11,18.1,-1.2948751,36.7938907,-1.3198615,36.7110323,429,1636,37,1739
15519,16121,269,3,Business,22,2,50271,22,2,50610,22,2,51142,22,2,52290,22,2,54305,15,21.3,-1.3332749,36.8708147,-1.2626906,36.7827022,543,2015,339,1680
15520,3545,1271,3,Business,23,2,43891,23,2,44000,23,2,44948,23,2,45383,23,2,46439,8,18.2,-1.3244885,36.897792,-1.3332749,36.8708147,532,1056,109,1383
15521,21708,393,3,Business,27,2,29375,27,2,33367,27,2,34376,27,2,35784,27,2,37285,10,18.5,-1.3177547,36.8303703,-1.2574219,36.7927073,708,1501,3992,2417
15522,19765,3149,3,Business,16,3,54840,16,3,54893,16,3,55369,16,3,58025,16,3,58627,4,25.5,-1.3004062,36.829741,-1.3177547,36.8303703,543,602,53,3132
15523,26392,3686,3,Business,5,2,43627,5,2,43867,5,2,45166,5,2,45228,5,2,47509,7,25.3,-1.2551895,36.7822034,-1.2989934,36.8136694,362,2281,240,1361
15524,3018,1245,3,Business,25,5,51923,25,5,51930,25,5,52703,25,5,53045,25,5,55851,20,29.3,-1.300921,36.828195,-1.310453,36.6902954,498,2806,7,1115
15525,20648,20,3,Business,9,4,47602,9,4,47661,9,4,49029,9,4,49130,9,4,50200,8,23.25888921888938,-1.2629666,36.8068369,-1.2763494,36.7671783,227,1070,59,1469
15526,17709,1801,1,Personal,3,3,43255,3,3,43488,3,3,46739,3,3,47146,3,3,48200,5,23.8,-1.2902869,36.8085396,-1.2951297,36.8335521,844,1054,233,3658
15527,8840,3222,3,Business,5,5,56103,5,5,56119,5,5,56253,5,5,56422,5,5,56801,3,27.7,-1.2551895,36.7822034,-1.2560455,36.7800867,708,379,16,303
15528,21566,647,3,Business,3,3,32922,3,3,33327,3,3,36228,3,3,37381,3,3,37960,4,21.5,-1.3077869,36.8443207,-1.3004062,36.829741,763,579,405,4054
15529,9803,995,2,Personal,9,2,43638,9,2,43726,9,2,44279,9,2,44804,9,2,47808,9,22.2,-1.293898,36.7583778,-1.2824535,36.8265153,844,3004,88,1078
15530,27895,868,3,Business,19,2,55883,19,2,55899,19,2,55984,19,2,56278,19,2,57132,5,30.1,-1.2600926,36.8088685,-1.265715,36.823815,343,854,16,379
15531,23309,2580,1,Personal,22,3,34824,22,3,34930,22,3,35662,22,3,36066,22,3,37231,10,15.1,-1.3271684,36.8173021,-1.3025667,36.7803495,343,1165,106,1136
15532,20254,3644,1,Personal,29,5,43651,29,5,44051,29,5,44372,29,5,45131,29,5,46734,5,19.8,-1.3205507,36.8426247,-1.317411,36.818222,212,1603,400,1080
15533,11502,2876,1,Personal,25,1,42483,25,1,42509,25,1,42515,25,1,43102,25,1,43873,6,23.25888921888938,-1.2684239,36.7952462,-1.2944292,36.7793569,379,771,26,593
15534,5588,592,1,Personal,3,3,53985,3,3,54038,3,3,54072,3,3,55572,3,3,56075,2,26.6,-1.2678628,36.7943665,-1.2615349,36.8068294,875,503,53,1534
15535,15160,868,3,Business,12,1,47585,12,1,47809,12,1,48626,12,1,48895,12,1,50021,8,26.9,-1.265715,36.823815,-1.303596,36.778378,279,1126,224,1086
15536,3377,2801,3,Business,21,1,55593,21,1,55625,21,1,56927,21,1,58371,21,1,60859,16,27.8,-1.3104506,36.8687235,-1.2595422,36.7871178,143,2488,32,2746
15537,11149,393,3,Business,6,1,36193,6,1,36214,6,1,36476,6,1,38205,6,1,39602,11,23.25888921888938,-1.3167113,36.8301563,-1.2638185,36.7930057,690,1397,21,1991
15538,23343,3283,3,Business,17,4,59707,17,4,59718,17,4,59908,17,4,60319,17,4,61833,7,25.9,-1.303596,36.778378,-1.2628473,36.781805,246,1514,11,601
15539,22858,187,3,Business,16,4,50573,16,4,50685,16,4,51088,16,4,51999,16,4,54455,17,18.8,-1.3169591,36.7000029,-1.2863535,36.8193957,74,2456,112,1314
15540,11600,3076,1,Personal,6,1,71948,6,1,72029,6,1,74054,6,1,74439,6,1,75155,9,18.3,-1.2606978,36.7512297,-1.2629701,36.7936628,116,716,81,2410
15541,13836,3264,3,Business,12,5,53132,12,5,53228,12,5,53401,12,5,53608,12,5,54922,6,23.25888921888938,-1.2551895,36.7822034,-1.2882462,36.8164538,709,1314,96,380
15542,6056,3689,3,Business,9,5,49460,9,5,61812,9,5,63386,9,5,63614,9,5,64421,2,25.0,-1.2615888,36.7928732,-1.2527958,36.8003131,432,807,12352,1802
15543,20573,1561,3,Business,7,3,41318,7,3,41405,7,3,41922,7,3,42173,7,3,46177,15,25.2,-1.2570088,36.801667,-1.328259,36.860975,660,4004,87,768
15544,27266,2328,2,Personal,3,4,44284,3,4,44306,3,4,45528,3,4,45800,3,4,47006,10,21.9,-1.298529,36.816482,-1.2355548,36.8474194,742,1206,22,1494
15545,9445,3291,3,Business,28,2,35118,28,2,35184,28,2,36066,28,2,36922,28,2,37686,6,18.8,-1.2783849,36.8163445,-1.2600926,36.8088685,341,764,66,1738
15546,24944,3669,3,Business,24,3,38571,24,3,38637,24,3,39737,24,3,40304,24,3,43344,8,23.25888921888938,-1.3025826,36.7670807,-1.2615888,36.7928732,958,3040,66,1667
15547,18349,3669,3,Business,11,1,60538,11,1,60593,11,1,61084,11,1,61300,11,1,62580,9,23.25888921888938,-1.2615888,36.7928732,-1.3124088,36.8252715,280,1280,55,707
15548,25635,5,1,Personal,16,1,55893,16,1,56001,16,1,56358,16,1,56565,16,1,57322,5,22.2,-1.2816351,36.8117147,-1.2648622,36.8000216,726,757,108,564
15549,6754,1920,3,Business,4,2,40080,4,2,42012,4,2,42583,4,2,42739,4,2,43398,4,19.5,-1.2551895,36.7822034,-1.2668454,36.7940642,547,659,1932,727
15550,1415,3686,3,Business,5,2,37809,5,2,37852,5,2,38209,5,2,38523,5,2,40798,8,25.6,-1.2551895,36.7822034,-1.29817,36.8001417,708,2275,43,671
15551,373,3381,3,Business,23,5,46485,23,5,47453,23,5,47904,23,5,48469,23,5,49705,9,24.3,-1.256522,36.7864132,-1.279662,36.814902,114,1236,968,1016
15552,3148,1850,3,Business,2,4,58577,2,4,58599,2,4,58631,2,4,59042,2,4,59364,2,23.25888921888938,-1.2551895,36.7822034,-1.2566889,36.7930784,695,322,22,443
15553,27351,393,3,Business,14,4,48053,14,4,48178,14,4,48725,14,4,49059,14,4,49503,4,27.7,-1.3167113,36.8301563,-1.3004062,36.829741,127,444,125,881
15554,21560,1719,3,Business,9,3,33538,9,3,33552,9,3,35244,9,3,35406,9,3,36010,3,20.4,-1.2859206,36.7888272,-1.296797,36.7764525,315,604,14,1854
15555,13752,393,3,Business,10,1,43452,10,1,43458,10,1,43464,10,1,44387,10,1,46112,14,23.7,-1.3228003,36.8306435,-1.306378,36.7519845,619,1725,6,929
15556,17562,1342,3,Business,23,2,51858,23,2,52026,23,2,52034,23,2,54152,23,2,56218,9,18.9,-1.28878,36.8168312,-1.3025826,36.7670807,928,2066,168,2126
15557,17448,2803,3,Business,1,4,37775,1,4,37807,1,4,38226,1,4,38293,1,4,39708,7,23.25888921888938,-1.2765736,36.8513646,-1.2896399,36.8124498,660,1415,32,486
15558,7625,1280,3,Business,16,2,52781,16,2,52842,16,2,53371,16,2,53665,16,2,55077,10,23.25888921888938,-1.2551895,36.7822034,-1.3138211,36.8257935,80,1412,61,823
15559,8247,3689,3,Business,27,4,41849,27,4,44384,27,4,44749,27,4,44964,27,4,45807,2,22.8,-1.2527958,36.8003131,-1.2620912,36.8013562,96,843,2535,580
15560,2959,3283,3,Business,3,1,46398,3,1,46437,3,1,46957,3,1,47384,3,1,47983,6,20.4,-1.272828,36.816608,-1.2628473,36.781805,726,599,39,947
15561,3012,718,3,Business,31,5,58935,31,5,59107,31,5,59141,31,5,59376,31,5,60329,5,24.9,-1.2551895,36.7822034,-1.2730278,36.7918788,709,953,172,269
15562,3972,302,3,Business,4,1,45837,4,1,45907,4,1,45937,4,1,47029,4,1,48360,10,26.8,-1.2649605,36.7981777,-1.3159197,36.8516724,81,1331,70,1122
15563,28074,3686,3,Business,20,5,33530,20,5,33546,20,5,33810,20,5,34303,20,5,35304,8,14.6,-1.2551895,36.7822034,-1.2893032,36.7739356,147,1001,16,757
15564,4234,2154,3,Business,24,4,60105,24,4,60710,24,4,62361,24,4,62837,24,4,64256,10,26.2,-1.2551895,36.7822034,-1.2765736,36.8513646,755,1419,605,2127
15565,11494,1329,3,Business,16,2,60473,16,2,60507,16,2,60746,16,2,60823,16,2,63303,19,23.25888921888938,-1.273056,36.811298,-1.3103985,36.9114173,953,2480,34,316
15566,7902,1329,3,Business,24,5,58772,24,5,58995,24,5,59109,24,5,59577,24,5,60964,8,19.9,-1.273056,36.811298,-1.324009,36.8458827,800,1387,223,582
15567,14369,3239,3,Personal,10,4,36133,10,4,37153,10,4,38281,10,4,38825,10,4,40629,8,23.25888921888938,-1.276154,36.8224165,-1.3104506,36.8687235,618,1804,1020,1672
15568,11160,1955,3,Business,17,1,32713,17,1,32739,17,1,33832,17,1,34539,17,1,36335,13,18.2,-1.330929,36.835151,-1.2571472,36.7950633,858,1796,26,1800
15569,20803,1329,3,Business,26,5,49328,26,5,49381,26,5,49701,26,5,49781,26,5,51016,10,23.25888921888938,-1.273056,36.811298,-1.3333155,36.8065341,96,1235,53,400
15570,27827,393,3,Business,10,3,31203,10,3,31273,10,3,31890,10,3,32711,10,3,34170,11,21.9,-1.3167113,36.8301563,-1.2638185,36.7930057,843,1459,70,1438
15571,6254,3222,3,Business,28,2,32464,28,2,32537,28,2,32557,28,2,32822,28,2,34034,6,18.6,-1.2551895,36.7822034,-1.2357748,36.7900524,576,1212,73,285
15572,26708,1785,1,Business,6,1,31815,6,1,31830,6,1,32496,6,1,32626,6,1,33868,10,15.0,-1.2892762,36.764129,-1.3205294,36.8197262,648,1242,15,796
15573,21555,868,3,Business,28,4,46799,28,4,46848,28,4,48062,28,4,51730,28,4,53239,13,30.0,-1.2600926,36.8088685,-1.331619,36.847976,26,1509,49,4882
15574,19168,3695,1,Personal,28,5,65328,28,5,65466,28,5,65989,28,5,66497,28,5,67004,3,23.25888921888938,-1.2857315,36.7953424,-1.2894917,36.8056192,279,507,138,1031
15575,12044,2457,3,Business,30,2,42796,30,2,42943,30,2,42994,30,2,43347,30,2,44350,6,22.1,-1.2551895,36.7822034,-1.2830989,36.8165739,215,1003,147,404
15576,7273,2609,1,Business,6,3,42819,6,3,43634,6,3,43968,6,3,44207,6,3,45652,14,20.2,-1.2553615,36.7895376,-1.3332749,36.8708147,4,1445,815,573
15577,19951,649,3,Business,10,1,35628,10,1,37996,10,1,38008,10,1,38427,10,1,40142,14,23.25888921888938,-1.20079,36.77198,-1.2551895,36.7822034,546,1715,2368,431
15578,2762,2900,3,Business,11,2,43341,11,2,44297,11,2,46089,11,2,47317,11,2,49695,21,19.2,-1.17595,36.83448,-1.2963097,36.7688221,551,2378,956,3020
15579,25746,3091,3,Business,4,2,48409,4,2,48488,4,2,48545,4,2,48913,4,2,50717,9,22.7,-1.3012008,36.764868,-1.290894,36.822971,709,1804,79,425
15580,5420,1365,1,Personal,22,2,52657,22,2,52883,22,2,54093,22,2,54842,22,2,55543,4,21.3,-1.292943,36.808292,-1.3005044,36.7871991,726,701,226,1959
15581,225,3669,3,Business,27,1,36280,27,1,37111,27,1,38480,27,1,39208,27,1,46014,24,21.0,-1.2615888,36.7928732,-1.34364,36.8925345,542,6806,831,2097
15582,24091,3469,3,Personal,18,5,38409,18,5,38648,18,5,40419,18,5,41071,18,5,42755,13,21.6,-1.2583393,36.7464632,-1.2900075,36.8032564,51,1684,239,2423
15583,4018,1746,3,Business,13,3,43336,13,3,43364,13,3,43591,13,3,43955,13,3,45511,7,23.25888921888938,-1.2850639,36.8179454,-1.2975066,36.7689423,378,1556,28,591
15584,9492,3426,3,Business,11,1,40841,11,1,40869,11,1,41336,11,1,41771,11,1,42768,9,26.6,-1.2584143,36.8048002,-1.3012008,36.764868,205,997,28,902
15585,767,1244,3,Business,28,5,44363,28,5,44406,28,5,45385,28,5,45675,28,5,50392,8,23.9,-1.272828,36.816608,-1.303596,36.778378,511,4717,43,1269
15586,11844,2499,2,Personal,19,5,51766,19,5,51774,19,5,52130,19,5,52837,19,5,53954,9,27.5,-1.2946769,36.7501951,-1.312469,36.815177,622,1117,8,1063
15587,27150,970,3,Business,11,1,52409,11,1,52641,11,1,53214,11,1,53760,11,1,54447,6,28.1,-1.2551895,36.7822034,-1.266533,36.7658382,932,687,232,1119
15588,21914,2956,3,Business,26,2,42718,26,2,44005,26,2,46069,26,2,46241,26,2,51036,14,27.3,-1.207546,36.7913976,-1.2584143,36.8048002,547,4795,1287,2236
15589,3273,2521,3,Business,27,4,49589,27,4,49615,27,4,49622,27,4,52762,27,4,52815,5,25.0,-1.3177547,36.8303703,-1.3077869,36.8443207,10,53,26,3147
15590,9247,1687,3,Business,13,4,32813,13,4,32838,13,4,35502,13,4,36168,13,4,36797,2,18.6,-1.2626574,36.8014034,-1.269571,36.807668,92,629,25,3330
15591,75,248,3,Business,21,4,35323,21,4,35365,21,4,36301,21,4,36456,21,4,38917,9,18.9,-1.304735,36.7846054,-1.2588381,36.7914147,269,2461,42,1091
15592,27346,346,3,Business,4,3,48217,4,3,48321,4,3,49324,4,3,50778,4,3,51639,2,18.1,-1.2891922,36.825189,-1.2885529,36.8160141,698,861,104,2457
15593,16860,718,3,Business,6,2,53428,6,2,57638,6,2,58248,6,2,61759,6,2,62801,10,23.25888921888938,-1.2551895,36.7822034,-1.321627,36.835193,208,1042,4210,4121
15594,12159,3517,3,Business,8,4,34405,8,4,34444,8,4,34774,8,4,36255,8,4,38228,15,20.4,-1.300921,36.828195,-1.3882008,36.7699445,329,1973,39,1811
15595,18412,1856,3,Business,5,1,38263,5,1,38349,5,1,40918,5,1,41247,5,1,42688,6,24.3,-1.273009,36.802807,-1.3001813,36.811122,206,1441,86,2898
15596,10758,3339,3,Business,7,4,57932,7,4,57986,7,4,58125,7,4,58334,7,4,59041,2,31.3,-1.2551895,36.7822034,-1.2566586,36.7929682,154,707,54,348
15597,8763,2431,3,Business,17,6,40609,17,6,40830,17,6,41152,17,6,41395,17,6,42113,5,23.7,-1.2679971,36.8088937,-1.276245,36.8363293,646,718,221,565
15598,22624,3647,3,Business,15,3,54304,15,3,54337,15,3,54844,15,3,55298,15,3,57069,6,25.8,-1.272639,36.794723,-1.2977387,36.8031447,155,1771,33,961
15599,20870,1,3,Business,12,2,56674,12,2,56922,12,2,57455,12,2,57991,12,2,59975,8,23.0,-1.2551895,36.7822034,-1.3034396,36.8329998,494,1984,248,1069
15600,15885,391,3,Business,9,4,52550,9,4,52837,9,4,53578,9,4,54519,9,4,55642,5,23.25888921888938,-1.300921,36.828195,-1.2867454,36.8259017,291,1123,287,1682
15601,22248,1557,3,Business,23,5,43367,23,5,45677,23,5,46339,23,5,46458,23,5,47649,8,24.3,-1.2551895,36.7822034,-1.3033012,36.8170864,726,1191,2310,781
15602,17124,85,2,Business,29,5,32079,29,5,32087,29,5,32582,29,5,32918,29,5,33712,5,23.25888921888938,-1.2903421,36.7885282,-1.3014461,36.7661381,334,794,8,831
15603,19337,909,3,Business,12,6,56882,12,6,56964,12,6,58685,12,6,59015,12,6,61386,11,25.2,-1.279395,36.825364,-1.225322,36.80855,899,2371,82,2051
15604,17428,1271,3,Business,12,5,63501,12,5,63547,12,5,64751,12,5,64890,12,5,68578,15,25.8,-1.3244885,36.897792,-1.281196,36.8179321,519,3688,46,1343
15605,21367,2649,3,Business,3,1,53664,3,1,53763,3,1,54696,3,1,54851,3,1,55515,2,23.3,-1.2752846,36.8027022,-1.2607674,36.8085644,539,664,99,1088
15606,23677,3186,3,Business,22,4,41129,22,4,41435,22,4,41990,22,4,42076,22,4,43061,5,22.4,-1.2980229,36.78865,-1.2797782,36.7627862,558,985,306,641
15607,8744,816,3,Business,16,3,38589,16,3,38608,16,3,39851,16,3,40748,16,3,43890,9,22.8,-1.3014461,36.7661381,-1.290894,36.822971,725,3142,19,2140
15608,28038,2395,1,Personal,18,3,46602,18,3,46736,18,3,47238,18,3,49478,18,3,51942,5,20.6,-1.2864298,36.8224345,-1.2657456,36.8087424,268,2464,134,2742
15609,27869,2330,3,Business,27,3,44017,27,3,44050,27,3,44728,27,3,44935,27,3,45969,5,25.9,-1.3015197,36.7658456,-1.2915247,36.8055757,119,1034,33,885
15610,7424,393,3,Business,1,1,53997,1,1,54013,1,1,54362,1,1,54705,1,1,56718,14,25.7,-1.3177547,36.8303703,-1.306378,36.7519845,731,2013,16,692
15611,8922,816,3,Business,6,3,52934,6,3,54934,6,3,56062,6,3,56570,6,3,57921,8,23.25888921888938,-1.2859912,36.8756811,-1.290894,36.822971,276,1351,2000,1636
15612,16411,537,2,Personal,10,4,32220,10,4,32271,10,4,33012,10,4,33372,10,4,35833,9,18.5,-1.2702844,36.8803209,-1.3100117,36.8226483,618,2461,51,1101
15613,13921,790,1,Personal,16,2,35216,16,2,35259,16,2,35690,16,2,37069,16,2,39100,15,23.25888921888938,-1.2590946,36.7607115,-1.3190714,36.8016277,568,2031,43,1810
15614,10666,1410,3,Business,28,1,43776,28,1,43790,28,1,45166,28,1,46988,28,1,48325,20,22.9,-1.300921,36.828195,-1.2847613,36.967084,888,1337,14,3198
15615,24651,2870,1,Personal,7,2,32487,7,2,32502,7,2,33081,7,2,33252,7,2,34606,13,16.8,-1.2592428,36.7894541,-1.32751,36.828812,754,1354,15,750
15616,21660,1329,3,Business,31,5,44209,31,5,44568,31,5,44627,31,5,45504,31,5,45940,4,21.8,-1.2795183,36.8238089,-1.273056,36.811298,812,436,359,936
15617,14067,1472,1,Personal,16,2,43892,16,2,43989,16,2,44366,16,2,45176,16,2,45856,5,23.5,-1.2686289,36.8073469,-1.2776982,36.83126,100,680,97,1187
15618,28215,393,3,Business,17,3,31249,17,3,31258,17,3,31455,17,3,33463,17,3,35264,14,21.2,-1.3177547,36.8303703,-1.306378,36.7519845,731,1801,9,2205
15619,4746,391,3,Business,18,1,37603,18,1,37710,18,1,42027,18,1,45157,18,1,45205,5,27.9,-1.300921,36.828195,-1.2784063,36.8222933,314,48,107,7447
15620,3360,1170,2,Personal,31,2,36188,31,2,36567,31,2,36868,31,2,37758,31,2,39042,6,17.2,-1.255956,36.772901,-1.3014461,36.7661381,101,1284,379,1191
15621,10817,3321,3,Personal,23,2,32258,23,2,32748,23,2,34666,23,2,35354,23,2,38711,15,23.25888921888938,-1.3339943,36.7263409,-1.2723552,36.7881306,572,3357,490,2606
15622,11057,3647,3,Business,27,4,57338,27,4,57602,27,4,58230,27,4,58394,27,4,59256,7,23.8,-1.272639,36.794723,-1.2950041,36.8143583,386,862,264,792
15623,10843,1920,3,Business,29,1,58422,29,1,58446,29,1,61459,29,1,64414,29,1,66139,4,23.3,-1.2551895,36.7822034,-1.2668454,36.7940642,866,1725,24,5968
15624,8712,1402,3,Business,10,1,42705,10,1,42903,10,1,44031,10,1,44645,10,1,45875,1,18.3,-1.2793686,36.8259233,-1.2813012,36.8323962,739,1230,198,1742
15625,5877,53,3,Business,14,5,49173,14,5,49191,14,5,49195,14,5,51008,14,5,51798,5,23.2,-1.2770708,36.8231093,-1.29508,36.796863,921,790,18,1817
15626,25601,2691,3,Business,29,1,46561,29,1,46588,29,1,47896,29,1,48527,29,1,50775,6,23.25888921888938,-1.281223,36.8239,-1.2857671,36.7875614,812,2248,27,1939
15627,28087,1326,1,Personal,28,1,30950,28,1,30978,28,1,31781,28,1,31940,28,1,32799,7,17.9,-1.2899256,36.815551,-1.2553615,36.7895376,808,859,28,962
15628,14194,1128,1,Personal,22,3,59247,22,3,59298,22,3,59528,22,3,61342,22,3,66096,28,23.2,-1.2571651,36.8032207,-1.4127217,36.9433886,56,4754,51,2044
15629,13600,3133,2,Personal,24,1,52361,24,1,52819,24,1,53687,24,1,53847,24,1,55578,9,23.25888921888938,-1.2562988,36.8129456,-1.3200117,36.8324011,38,1731,458,1028
15630,13581,733,3,Business,7,4,44369,7,4,44405,7,4,44641,7,4,44765,7,4,45982,7,27.7,-1.2551895,36.7822034,-1.2819415,36.7814934,206,1217,36,360
15631,12176,136,3,Business,19,2,53722,19,2,53733,19,2,54078,19,2,54748,19,2,56809,3,18.3,-1.2649605,36.7981777,-1.273854,36.8003368,116,2061,11,1015
15632,8533,867,3,Business,7,4,37683,7,4,37875,7,4,38347,7,4,41072,7,4,41359,10,27.6,-1.2996533,36.8292629,-1.2991441,36.7528804,137,287,192,3197
15633,22733,2271,3,Business,21,4,51631,21,4,54857,21,4,55254,21,4,56053,21,4,57414,11,26.5,-1.307143,36.825009,-1.293515,36.897607,332,1361,3226,1196
15634,13542,3727,3,Business,3,2,43867,3,2,43959,3,2,44232,3,2,44499,3,2,45914,8,18.4,-1.2963097,36.7688221,-1.2600616,36.7870182,74,1415,92,540
15635,6245,2463,2,Personal,13,6,34225,13,6,34311,13,6,35491,13,6,35559,13,6,37038,9,23.25888921888938,-1.2433667,36.7609493,-1.2698168,36.7421898,38,1479,86,1248
15636,27402,1404,2,Personal,25,5,63750,25,5,63842,25,5,65254,25,5,67027,25,5,68584,18,21.0,-1.3271247,36.8951605,-1.2918309,36.7963716,765,1557,92,3185
15637,16531,2492,3,Personal,5,2,46340,5,2,51028,5,2,52736,5,2,53005,5,2,54445,4,27.3,-1.2778447,36.8307214,-1.2927045,36.8279947,686,1440,4688,1977
15638,21730,2121,2,Personal,15,1,27322,15,1,27365,15,1,27657,15,1,28351,15,1,32377,4,23.25888921888938,-1.2874,36.8339667,-1.2925919,36.8170577,79,4026,43,986
15639,14874,1715,3,Business,31,2,34078,31,2,34095,31,2,34571,31,2,34766,31,2,35533,3,16.9,-1.2608993,36.799246,-1.2770765,36.8080553,882,767,17,671
15640,4201,3332,3,Personal,8,2,54046,8,2,54559,8,2,55410,8,2,58194,8,2,58916,5,25.2,-1.2508229,36.7895263,-1.2463396,36.7547983,205,722,513,3635
15641,20403,1051,3,Business,5,2,38950,5,2,38984,5,2,39232,5,2,39469,5,2,42043,14,21.6,-1.2963097,36.7688221,-1.313483,36.872126,846,2574,34,485
15642,19622,2190,3,Business,10,5,39467,10,5,39501,10,5,40067,10,5,40692,10,5,43026,11,19.4,-1.301953,36.788458,-1.2477887,36.7960085,279,2334,34,1191
15643,24507,2567,1,Personal,29,3,41055,29,3,41112,29,3,41828,29,3,41941,29,3,43034,7,18.7,-1.3182646,36.8213128,-1.2977387,36.8031447,249,1093,57,829
15644,21489,2112,3,Business,8,2,52515,8,2,53390,8,2,54675,8,2,54746,8,2,58001,12,25.3,-1.290894,36.822971,-1.2156006,36.8916865,687,3255,875,1356
15645,27986,393,3,Business,5,2,58611,5,2,58660,5,2,58663,5,2,59413,5,2,59414,6,23.25888921888938,-1.3004062,36.829741,-1.3167113,36.8301563,39,1,49,753
15646,18520,1368,3,Business,9,4,54884,9,4,54991,9,4,57509,9,4,58001,9,4,59329,8,25.8,-1.2907672,36.8252167,-1.2571472,36.7950633,213,1328,107,3010
15647,12803,598,1,Business,7,4,47710,7,4,47912,7,4,48665,7,4,48734,7,4,50561,7,20.2,-1.2536797,36.7995085,-1.284452,36.8300885,31,1827,202,822
15648,10790,1971,3,Personal,30,4,56045,30,4,56318,30,4,58194,30,4,58567,30,4,59286,3,23.25888921888938,-1.3142269,36.839245,-1.320246,36.8369384,643,719,273,2249
15649,13959,136,3,Business,15,2,41726,15,2,41731,15,2,43259,15,2,43475,15,2,48175,18,24.1,-1.3254522,36.7216584,-1.2760462,36.8074697,244,4700,5,1744
15650,1251,3557,3,Business,12,4,34739,12,4,34785,12,4,35769,12,4,36246,12,4,37369,8,16.2,-1.2793831,36.7617573,-1.2546732,36.8086796,735,1123,46,1461
15651,14777,2801,3,Business,27,5,44887,27,5,44929,27,5,45929,27,5,46240,27,5,48359,10,22.5,-1.3011583,36.8413189,-1.2595422,36.7871178,167,2119,42,1311
15652,8768,2801,3,Business,8,5,58520,8,5,58729,8,5,58782,8,5,59784,8,5,62094,13,25.4,-1.2595422,36.7871178,-1.298905,36.8538783,828,2310,209,1055
15653,17844,481,3,Personal,6,4,48822,6,4,48862,6,4,49300,6,4,49838,6,4,51845,8,23.2,-1.3016417,36.8271679,-1.2619756,36.800139,844,2007,40,976
15654,4777,602,3,Personal,20,1,36584,20,1,36598,20,1,36980,20,1,37436,20,1,40162,22,19.3,-1.3214562,36.8100828,-1.235002,36.9289349,183,2726,14,838
15655,19217,1724,3,Business,10,3,54763,10,3,54782,10,3,55355,10,3,55458,10,3,56039,7,30.6,-1.279395,36.825364,-1.2551895,36.7822034,291,581,19,676
15656,21924,1368,3,Business,22,1,40352,22,1,40397,22,1,40440,22,1,41443,22,1,42324,5,25.0,-1.2571472,36.7950633,-1.2578831,36.7755412,446,881,45,1046
15657,15442,1075,3,Business,29,5,43101,29,5,43140,29,5,45054,29,5,45649,29,5,47175,5,26.8,-1.279395,36.825364,-1.2527958,36.8003131,291,1526,39,2509
15658,21392,1148,3,Business,20,5,45886,20,5,46267,20,5,47076,20,5,48468,20,5,49854,10,18.4,-1.3100586,36.8500329,-1.2615584,36.8149506,616,1386,381,2201
15659,4126,830,3,Business,5,1,57984,5,1,58021,5,1,58064,5,1,58520,5,1,59468,10,25.9,-1.2551895,36.7822034,-1.275931,36.8516227,937,948,37,499
15660,15882,633,3,Business,31,4,53021,31,4,54135,31,4,56067,31,4,56232,31,4,57914,11,28.9,-1.2991441,36.7528804,-1.3004062,36.829741,523,1682,1114,2097
15661,12654,2869,3,Business,8,3,51553,8,3,51653,8,3,53663,8,3,55309,8,3,57955,21,23.25888921888938,-1.2860183,36.8975338,-1.3025826,36.7670807,883,2646,100,3656
15662,12490,517,3,Business,31,5,41777,31,5,41821,31,5,42302,31,5,45397,31,5,45666,1,21.7,-1.3002554,36.8256566,-1.3004062,36.829741,158,269,44,3576
15663,24522,136,3,Business,9,5,32804,9,5,32924,9,5,33740,9,5,36061,9,5,36422,15,20.4,-1.3254522,36.7216584,-1.2560874,36.7931031,288,361,120,3137
15664,17393,2174,3,Business,10,1,38452,10,1,38456,10,1,38641,10,1,42738,10,1,44670,16,23.25888921888938,-1.2482781,36.884092,-1.2037968,36.7802765,82,1932,4,4282
15665,3090,1017,3,Business,30,4,41749,30,4,41778,30,4,41791,30,4,42300,30,4,43211,3,23.25888921888938,-1.2551895,36.7822034,-1.2649605,36.7981777,576,911,29,522
15666,4079,3647,3,Business,20,4,51666,20,4,51742,20,4,53138,20,4,53353,20,4,53898,5,25.1,-1.272639,36.794723,-1.2628638,36.8070399,290,545,76,1611
15667,18549,3344,2,Business,26,3,44037,26,3,44055,26,3,45322,26,3,45455,26,3,47569,7,24.2,-1.3245107,36.8049625,-1.281337,36.818968,328,2114,18,1400
15668,10729,1527,3,Business,9,2,29709,9,2,29730,9,2,30295,9,2,31074,9,2,31479,4,20.7,-1.3077869,36.8443207,-1.3004062,36.829741,206,405,21,1344
15669,5198,1363,3,Business,21,2,53387,21,2,54148,21,2,54438,21,2,54679,21,2,54961,2,25.0,-1.3004062,36.829741,-1.2945128,36.8396881,953,282,761,531
15670,4311,2476,3,Business,22,5,34849,22,5,34921,22,5,35818,22,5,36170,22,5,38412,8,23.25888921888938,-1.2795594,36.8472647,-1.2649605,36.7981777,467,2242,72,1249
15671,6756,2358,4,Business,25,3,46261,25,3,46325,25,3,47434,25,3,50481,25,3,52747,11,17.9,-1.3256904,36.8747943,-1.2658527,36.8012693,6,2266,64,4156
15672,8331,2112,3,Business,1,6,57122,1,6,57128,1,6,57133,1,6,57462,1,6,58961,18,22.0,-1.2156006,36.8916865,-1.2962832,36.7849683,704,1499,6,334
15673,13374,3291,3,Business,18,2,46371,18,2,46572,18,2,49011,18,2,49229,18,2,53253,12,25.4,-1.318062,36.849326,-1.2600926,36.8088685,75,4024,201,2657
15674,25486,867,3,Business,26,2,31040,26,2,31055,26,2,31295,26,2,32743,26,2,34278,10,21.9,-1.2996533,36.8292629,-1.2991441,36.7528804,99,1535,15,1688
15675,2266,478,3,Business,8,5,27684,8,5,27703,8,5,27895,8,5,29683,8,5,30817,3,22.8,-1.2551895,36.7822034,-1.2642903,36.8002137,720,1134,19,1980
15676,27059,868,3,Business,3,3,37848,3,3,38625,3,3,39124,3,3,39200,3,3,39202,3,27.5,-1.2783849,36.8163445,-1.265715,36.823815,728,2,777,575
15677,10986,2789,3,Business,4,1,56677,4,1,56737,4,1,57868,4,1,58114,4,1,59039,5,23.25888921888938,-1.304735,36.7846054,-1.2877501,36.8146599,590,925,60,1377
15678,14868,2216,3,Business,5,5,47148,5,5,47209,5,5,48326,5,5,50796,5,5,51648,8,26.8,-1.2551895,36.7822034,-1.2854174,36.7951152,247,852,61,3587
15679,2235,1642,3,Business,6,2,38365,6,2,38597,6,2,39760,6,2,39902,6,2,41495,5,24.9,-1.2728069,36.7962362,-1.2834816,36.8219031,88,1593,232,1305
15680,7522,269,3,Business,2,7,53709,2,7,55634,2,7,56035,2,7,56291,2,7,57074,9,25.0,-1.3226302,36.8719901,-1.3700383,36.9190174,932,783,1925,657
15681,16600,3080,3,Business,21,4,40286,21,4,40374,21,4,40854,21,4,41133,21,4,44940,8,21.9,-1.2551895,36.7822034,-1.2879618,36.8200863,444,3807,88,759
15682,1194,868,3,Business,30,4,33701,30,4,33746,30,4,34275,30,4,34661,30,4,35656,8,19.4,-1.303596,36.778378,-1.265715,36.823815,548,995,45,915
15683,8155,3222,3,Business,8,3,55905,8,3,55978,8,3,56045,8,3,56272,8,3,57884,13,23.25888921888938,-1.2551895,36.7822034,-1.3133713,36.8541174,168,1612,73,294
15684,24013,2008,3,Business,7,1,52844,7,1,54125,7,1,54810,7,1,55160,7,1,56400,6,20.7,-1.285244,36.832159,-1.2508229,36.7895263,280,1240,1281,1035
15685,3124,2801,3,Business,21,3,48633,21,3,48646,21,3,50630,21,3,50781,21,3,53014,15,23.1,-1.2595422,36.7871178,-1.3219125,36.714515,817,2233,13,2135
15686,2618,3149,3,Business,15,5,52659,15,5,57432,15,5,57978,15,5,58637,15,5,59404,5,28.1,-1.3004062,36.829741,-1.3167113,36.8301563,156,767,4773,1205
15687,986,1271,3,Business,25,5,41781,25,5,41838,25,5,42313,25,5,42661,25,5,45367,19,26.2,-1.3244885,36.897792,-1.2649605,36.7981777,418,2706,57,823
15688,11223,2183,3,Business,18,4,56338,18,4,56369,18,4,56464,18,4,56672,18,4,58845,9,26.9,-1.2551895,36.7822034,-1.2920375,36.7632608,268,2173,31,303
15689,3436,1927,3,Business,10,1,56047,10,1,59070,10,1,59677,10,1,61469,10,1,63259,18,18.6,-1.2859912,36.8756811,-1.3472066,36.7692638,85,1790,3023,2399
15690,26325,485,3,Personal,7,1,45525,7,1,46591,7,1,48620,7,1,48937,7,1,51801,14,26.8,-1.3463429,36.9069888,-1.289498,36.818878,420,2864,1066,2346
15691,13102,2784,3,Business,15,5,71288,15,5,71349,15,5,71743,15,5,72822,15,5,72824,4,22.0,-1.2963097,36.7688221,-1.287332,36.744498,26,2,61,1473
15692,3537,2216,3,Business,4,2,33546,4,2,38006,4,2,39034,4,2,39363,4,2,40538,8,19.6,-1.2551895,36.7822034,-1.2980815,36.8085686,607,1175,4460,1357
15693,14862,1882,3,Business,2,2,70469,2,2,70603,2,2,70957,2,2,71900,2,2,72149,5,23.2,-1.2628638,36.8070399,-1.287781,36.817866,119,249,134,1297
15694,28113,1529,1,Personal,14,5,48848,14,5,48895,14,5,49732,14,5,49861,14,5,51325,8,26.9,-1.2873232,36.7658572,-1.274381,36.7272265,548,1464,47,966
15695,13223,1082,2,Personal,28,5,35936,28,5,36008,28,5,37061,28,5,37604,28,5,38331,3,20.8,-1.2963097,36.7688221,-1.2924173,36.7797814,565,727,72,1596
15696,1958,2515,1,Personal,21,5,35315,21,5,35435,21,5,36277,21,5,36700,21,5,37779,6,20.2,-1.305716,36.809882,-1.26733,36.82368,65,1079,120,1265
15697,13513,1594,3,Business,11,4,39097,11,4,39105,11,4,39119,11,4,39292,11,4,40846,16,25.6,-1.2551895,36.7822034,-1.2156006,36.8916865,539,1554,8,187
15698,946,1329,3,Business,27,3,45153,27,3,45198,27,3,45450,27,3,45566,27,3,46323,5,26.0,-1.273056,36.811298,-1.2950408,36.8098172,783,757,45,368
15699,20332,3331,3,Business,7,4,55069,7,4,55495,7,4,56265,7,4,56357,7,4,57176,6,27.5,-1.2551895,36.7822034,-1.2897368,36.8226783,903,819,426,862
15700,17450,393,3,Business,18,5,50386,18,5,50393,18,5,50396,18,5,52605,18,5,52606,11,27.2,-1.3167113,36.8301563,-1.2574219,36.7927073,619,1,7,2212
15701,18621,868,3,Business,21,5,37699,21,5,38049,21,5,40319,21,5,40422,21,5,41340,6,22.9,-1.307143,36.825009,-1.265715,36.823815,436,918,350,2373
15702,14559,2982,3,Business,27,4,39051,27,4,39088,27,4,39791,27,4,40020,27,4,42673,18,22.8,-1.300921,36.828195,-1.177202,36.8351183,715,2653,37,932
15703,13082,265,3,Business,3,5,45591,3,5,45619,3,5,45696,3,5,46868,3,5,48341,4,21.4,-1.300921,36.828195,-1.3173869,36.8112044,471,1473,28,1249
15704,8798,3051,3,Personal,6,3,39159,6,3,39273,6,3,40312,6,3,40826,6,3,42028,6,19.9,-1.2702333,36.80065,-1.303664,36.818777,844,1202,114,1553
15705,14280,533,3,Business,29,2,55606,29,2,59095,29,2,59951,29,2,60033,29,2,60813,3,23.25888921888938,-1.2765492,36.7669809,-1.3014461,36.7661381,523,780,3489,938
15706,7096,1205,3,Business,18,3,35403,18,3,35474,18,3,35716,18,3,35997,18,3,36886,3,14.6,-1.2810807,36.8144229,-1.298529,36.816482,208,889,71,523
15707,27552,1051,3,Business,17,3,40577,17,3,40607,17,3,41051,17,3,41607,17,3,46296,21,25.3,-1.2963097,36.7688221,-1.3160977,36.9131642,328,4689,30,1000
15708,4671,2207,3,Business,3,1,34941,3,1,35004,3,1,36031,3,1,37467,3,1,38949,8,18.2,-1.2597649,36.775631,-1.2768326,36.8073804,446,1482,63,2463
15709,20337,2436,3,Business,2,2,45004,2,2,45133,2,2,48292,2,2,48932,2,2,50005,9,29.6,-1.2931286,36.7584407,-1.2551895,36.7822034,850,1073,129,3799
15710,26000,1281,3,Business,16,3,56738,16,3,56844,16,3,57816,16,3,58932,16,3,60327,6,27.1,-1.2675334,36.7658246,-1.2985294,36.782493,246,1395,106,2088
15711,5049,3291,3,Business,4,5,45830,4,5,48465,4,5,49447,4,5,51304,4,5,52961,18,23.25888921888938,-1.3393547,36.8910035,-1.2600926,36.8088685,439,1657,2635,2839
15712,3928,1724,3,Business,20,4,54152,20,4,57941,20,4,58888,20,4,58966,20,4,60516,9,25.1,-1.2907854,36.7774108,-1.2647206,36.7259313,829,1550,3789,1025
15713,18723,2828,1,Business,3,5,56742,3,5,56807,3,5,58181,3,5,58636,3,5,61171,16,25.3,-1.2615888,36.7928732,-1.2515509,36.9076672,520,2535,65,1829
15714,24025,3165,3,Personal,7,1,65830,7,1,66312,7,1,68789,7,1,69086,7,1,70456,3,20.2,-1.293973,36.80169,-1.2883775,36.8280496,159,1370,482,2774
15715,26284,1425,3,Business,9,2,38013,9,2,38060,9,2,38198,9,2,39366,9,2,39972,5,27.2,-1.3193819,36.8743424,-1.338283,36.8871775,394,606,47,1306
15716,5480,2216,3,Business,18,4,54926,18,4,54939,18,4,55017,18,4,55625,18,4,55633,4,23.25888921888938,-1.2551895,36.7822034,-1.2566689,36.7796952,99,8,13,686
15717,13616,422,2,Personal,29,5,39339,29,5,39355,29,5,39657,29,5,40320,29,5,41601,11,19.8,-1.2684319,36.8165853,-1.3271684,36.8173021,589,1281,16,965
15718,20346,1721,3,Business,1,1,43632,1,1,43676,1,1,44430,1,1,45025,1,1,46049,7,23.25888921888938,-1.2551895,36.7822034,-1.2896399,36.8124498,682,1024,44,1349
15719,5038,2216,3,Business,14,2,47412,14,2,51372,14,2,53568,14,2,54733,14,2,57645,12,23.25888921888938,-1.2551895,36.7822034,-1.3104734,36.7363698,930,2912,3960,3361
15720,19123,2956,3,Business,8,3,29674,8,3,29728,8,3,33338,8,3,33613,8,3,35123,6,23.25888921888938,-1.2584143,36.8048002,-1.2907726,36.7860794,207,1510,54,3885
15721,12194,1724,3,Business,2,4,44540,2,4,44775,2,4,45487,2,4,45840,2,4,47164,8,23.25888921888938,-1.2551895,36.7822034,-1.3015998,36.8166465,96,1324,235,1065
15722,12343,3565,3,Business,2,6,41569,2,6,41623,2,6,41984,2,6,42623,2,6,44803,18,27.7,-1.2844665,36.7866113,-1.207546,36.7913976,862,2180,54,1000
15723,21968,1329,3,Business,8,2,46101,8,2,46137,8,2,46358,8,2,46587,8,2,48438,9,23.5,-1.273056,36.811298,-1.3191318,36.8042377,427,1851,36,450
15724,10832,3264,3,Business,26,1,42609,26,1,44874,26,1,45670,26,1,45774,26,1,47801,8,22.9,-1.2551895,36.7822034,-1.2963316,36.7863289,441,2027,2265,900
15725,10580,2523,3,Business,25,4,45587,25,4,46602,25,4,47405,25,4,47470,25,4,50159,7,19.8,-1.2551895,36.7822034,-1.2989934,36.8136694,578,2689,1015,868
15726,9443,3288,3,Business,21,1,45540,21,1,45994,21,1,46891,21,1,47170,21,1,47998,4,25.7,-1.3080696,36.8237191,-1.2845766,36.8245168,758,828,454,1176
15727,20969,1838,3,Business,31,4,55825,31,4,56030,31,4,57831,31,4,58113,31,4,60201,10,22.9,-1.2649605,36.7981777,-1.214328,36.7911903,103,2088,205,2083
15728,13050,2436,3,Business,18,4,51144,18,4,51169,18,4,51321,18,4,51594,18,4,52249,4,26.8,-1.2551895,36.7822034,-1.2728947,36.8079426,848,655,25,425
15729,17660,2828,1,Business,4,1,51618,4,1,52387,4,1,53293,4,1,54236,4,1,55689,14,22.7,-1.3207349,36.8819157,-1.2909665,36.8150406,789,1453,769,1849
15730,21261,1535,1,Business,12,5,38849,12,5,40407,12,5,41215,12,5,41774,12,5,42327,2,24.6,-1.2897368,36.8226783,-1.288709,36.802659,662,553,1558,1367
15731,8482,868,3,Business,13,4,38761,13,4,39309,13,4,39373,13,4,42777,13,4,44636,10,23.3,-1.228911,36.881876,-1.265715,36.823815,900,1859,548,3468
15732,16732,45,3,Business,4,1,41276,4,1,41323,4,1,41778,4,1,42139,4,1,42468,2,21.0,-1.2945041,36.8151527,-1.305716,36.809882,124,329,47,816
15733,16399,2330,3,Business,15,5,44106,15,5,44158,15,5,44376,15,5,44565,15,5,45169,3,26.2,-1.3015197,36.7658456,-1.2873232,36.7658572,575,604,52,407
15734,28197,540,3,Business,12,2,56412,12,2,56588,12,2,56642,12,2,58233,12,2,58920,5,23.25888921888938,-1.2551895,36.7822034,-1.2665065,36.7970081,242,687,176,1645
15735,14493,1754,3,Business,6,2,35884,6,2,35906,6,2,37297,6,2,37516,6,2,39336,12,19.9,-1.2860183,36.8975338,-1.3052491,36.8223899,237,1820,22,1610
15736,26981,3557,3,Business,14,2,43110,14,2,43171,14,2,43259,14,2,43577,14,2,45002,7,23.25888921888938,-1.2546732,36.8086796,-1.292462,36.7972911,930,1425,61,406
15737,25016,393,3,Business,22,5,43782,22,5,43796,22,5,43843,22,5,44582,22,5,46684,14,23.25888921888938,-1.3167113,36.8301563,-1.306378,36.7519845,26,2102,14,786
15738,8517,633,3,Business,21,4,30937,21,4,30977,21,4,31358,21,4,31929,21,4,32533,4,22.0,-1.3077869,36.8443207,-1.3004062,36.829741,448,604,40,952
15739,27820,3635,1,Business,28,5,54260,28,5,55647,28,5,56660,28,5,57220,28,5,58779,9,25.5,-1.2615888,36.7928732,-1.3131504,36.8159265,38,1559,1387,1573
15740,11882,3147,3,Business,19,2,34517,19,2,34526,19,2,34751,19,2,36289,19,2,38439,15,23.25888921888938,-1.2571472,36.7950633,-1.3472066,36.7692638,770,2150,9,1763
15741,176,2469,3,Business,11,5,49130,11,5,49232,11,5,50165,11,5,50921,11,5,51876,10,26.4,-1.303924,36.8758792,-1.2389425,36.8775718,124,955,102,1689
15742,1109,455,3,Business,5,2,54945,5,2,54974,5,2,55187,5,2,56321,5,2,57405,7,27.3,-1.2956882,36.7861845,-1.2588775,36.8079744,576,1084,29,1347
15743,292,1070,1,Personal,30,4,32308,30,4,32348,30,4,32917,30,4,33245,30,4,35222,14,16.3,-1.25537,36.7756,-1.3193656,36.7957179,334,1977,40,897
15744,13026,2696,3,Personal,13,4,47251,13,4,49220,13,4,50604,13,4,51290,13,4,52484,11,26.4,-1.2540878,36.7044367,-1.296797,36.7764525,536,1194,1969,2070
15745,16364,2587,3,Business,21,1,43119,21,1,43169,21,1,43625,21,1,44276,21,1,46675,5,25.3,-1.2584143,36.8048002,-1.28878,36.8168312,289,2399,50,1107
15746,21978,1500,3,Business,10,3,42469,10,3,42498,10,3,42516,10,3,43943,10,3,45416,8,27.9,-1.3004062,36.829741,-1.2638185,36.7930057,258,1473,29,1445
15747,22251,540,3,Business,9,4,30971,9,4,31220,9,4,31225,9,4,31549,9,4,32409,8,23.25888921888938,-1.2551895,36.7822034,-1.2934638,36.7668028,576,860,249,329
15748,19395,1753,2,Business,5,5,46028,5,5,46089,5,5,46142,5,5,46469,5,5,48854,17,23.6,-1.2551895,36.7822034,-1.3472066,36.7692638,574,2385,61,380
15749,28244,3295,3,Business,19,2,44357,19,2,44394,19,2,46305,19,2,46879,19,2,48772,5,27.7,-1.2571472,36.7950633,-1.2803414,36.8265456,118,1893,37,2485
15750,6005,1281,3,Business,7,1,55610,7,1,55737,7,1,57438,7,1,58015,7,1,59705,8,20.6,-1.2707348,36.7651767,-1.269534,36.80697,729,1690,127,2278
15751,6025,2509,3,Business,31,3,53930,31,3,53954,31,3,54968,31,3,55088,31,3,57417,20,27.0,-1.2571472,36.7950633,-1.3700383,36.9190174,956,2329,24,1134
15752,18089,1363,3,Business,20,3,50918,20,3,51053,20,3,51913,20,3,51979,20,3,54003,7,28.4,-1.3004062,36.829741,-1.2862436,36.791017,448,2024,135,926
15753,12012,2828,2,Business,2,1,33946,2,1,33967,2,1,34516,2,1,34940,2,1,35483,3,16.5,-1.2584143,36.8048002,-1.2615888,36.7928732,71,543,21,973
15754,4530,517,3,Business,28,5,49762,28,5,49770,28,5,50042,28,5,50317,28,5,51378,11,25.3,-1.3167113,36.8301563,-1.2574219,36.7927073,523,1061,8,547
15755,12205,3392,1,Personal,19,5,47499,19,5,50273,19,5,51579,19,5,52213,19,5,53932,6,27.2,-1.2834669,36.8297516,-1.2942764,36.7969749,559,1719,2774,1940
15756,4737,3291,3,Business,30,1,37195,30,1,37394,30,1,39705,30,1,40028,30,1,41090,11,22.6,-1.2296618,36.8438272,-1.2600926,36.8088685,906,1062,199,2634
15757,4208,1882,3,Business,12,2,36119,12,2,41701,12,2,42696,12,2,43589,12,2,44995,7,24.6,-1.2958783,36.7928125,-1.2588775,36.8079744,332,1406,5582,1888
15758,13141,265,3,Business,12,2,33283,12,2,33303,12,2,34358,12,2,34644,12,2,37737,8,18.2,-1.2945798,36.7737755,-1.300921,36.828195,778,3093,20,1341
15759,6928,393,3,Business,6,4,52251,6,4,52348,6,4,54174,6,4,54308,6,4,56562,4,21.3,-1.3228003,36.8306435,-1.3004062,36.829741,271,2254,97,1960
15760,21504,3283,3,Business,30,2,53887,30,2,56055,30,2,57475,30,2,58356,30,2,60200,5,23.25888921888938,-1.2600926,36.8088685,-1.2628473,36.781805,519,1844,2168,2301
15761,22944,1024,1,Personal,26,3,54381,26,3,54447,26,3,55043,26,3,55264,26,3,56207,5,27.0,-1.2977387,36.8031447,-1.2892762,36.764129,722,943,66,817
15762,7506,3147,3,Business,31,4,52573,31,4,53240,31,4,55152,31,4,55472,31,4,58572,17,22.9,-1.3404187,36.7614685,-1.2546732,36.8086796,898,3100,667,2232
15763,8445,983,1,Personal,18,2,52476,18,2,53158,18,2,53369,18,2,53852,18,2,55045,8,27.5,-1.2753109,36.8130185,-1.2969741,36.7856612,216,1193,682,694
15764,3993,391,3,Business,4,2,50516,4,2,50825,4,2,51900,4,2,52977,4,2,54654,5,22.7,-1.300921,36.828195,-1.2867454,36.8259017,643,1677,309,2152
15765,14417,391,3,Business,6,3,37962,6,3,39371,6,3,40043,6,3,40697,6,3,43044,23,23.25888921888938,-1.2784063,36.8222933,-1.2847613,36.967084,769,2347,1409,1326
15766,4950,136,3,Business,17,1,36057,17,1,36068,17,1,36393,17,1,36889,17,1,41682,26,19.0,-1.246585,36.880373,-1.3254522,36.7216584,685,4793,11,821
15767,12607,2750,3,Business,13,1,39302,13,1,39332,13,1,39647,13,1,39900,13,1,40463,6,23.25888921888938,-1.2675334,36.7658246,-1.2551895,36.7822034,99,563,30,568
15768,16281,3621,3,Business,15,7,50476,15,7,50500,15,7,51252,15,7,51422,15,7,54569,8,19.6,-1.2836583,36.7886014,-1.306803,36.831527,722,3147,24,922
15769,7861,469,3,Personal,15,6,45754,15,6,45822,15,6,46541,15,6,47334,15,6,48679,11,21.9,-1.3162019,36.8133238,-1.3253826,36.8822315,620,1345,68,1512
15770,26533,1544,3,Business,4,5,33493,4,5,40635,4,5,41244,4,5,42793,4,5,43490,5,22.3,-1.2858323,36.8299948,-1.3037058,36.7957447,100,697,7142,2158
15771,13858,2285,3,Personal,4,2,43402,4,2,43450,4,2,44297,4,2,44885,4,2,46350,7,20.4,-1.2690837,36.8006261,-1.2950041,36.8143583,123,1465,48,1435
15772,16339,491,1,Personal,29,5,60590,29,5,60767,29,5,61602,29,5,61813,29,5,63764,5,20.3,-1.263987,36.798891,-1.2808482,36.8003686,192,1951,177,1046
15773,18255,1148,3,Business,23,6,33512,23,6,34490,23,6,35354,23,6,36353,23,6,36995,3,19.1,-1.3100586,36.8500329,-1.3120712,36.8567865,332,642,978,1863
15774,8313,477,1,Personal,18,1,58667,18,1,62778,18,1,63586,18,1,63857,18,1,67781,24,23.25888921888938,-1.3308191,36.9019697,-1.2358386,36.767204,584,3924,4111,1079
15775,14917,2436,3,Business,4,2,60308,4,2,60564,4,2,60597,4,2,61233,4,2,63694,14,22.4,-1.2551895,36.7822034,-1.242902,36.870334,651,2461,256,669
15776,18222,816,3,Business,17,1,49564,17,1,50847,17,1,51823,17,1,53196,17,1,55005,6,24.7,-1.2534301,36.8000983,-1.290894,36.822971,300,1809,1283,2349
15777,22877,778,3,Business,11,2,47574,11,2,47656,11,2,50647,11,2,50794,11,2,53076,9,22.3,-1.2535486,36.7933541,-1.2290218,36.8000283,755,2282,82,3138
15778,16233,507,1,Personal,27,5,52753,27,5,52795,27,5,53728,27,5,54639,27,5,55688,8,24.1,-1.2875013,36.8171787,-1.301093,36.7790314,88,1049,42,1844
15779,8962,3072,2,Personal,3,3,59462,3,3,59726,3,3,60090,3,3,60434,3,3,61169,4,23.5,-1.282543,36.824618,-1.2875012,36.7927159,726,735,264,708
15780,25961,2037,1,Personal,5,2,39837,5,2,40531,5,2,41038,5,2,41363,5,2,42054,4,21.6,-1.286431,36.818411,-1.296168,36.808564,852,691,694,832
15781,9754,3583,3,Personal,8,2,36717,8,2,36743,8,2,38374,8,2,38650,8,2,42057,12,21.4,-1.3288576,36.8465936,-1.2842588,36.902807,549,3407,26,1907
15782,8705,1920,3,Business,6,4,50842,6,4,51308,6,4,51317,6,4,52020,6,4,54119,7,23.25888921888938,-1.2551895,36.7822034,-1.257569,36.842164,382,2099,466,712
15783,17007,970,3,Business,6,1,41105,6,1,41131,6,1,41202,6,1,41469,6,1,42813,9,23.25888921888938,-1.2551895,36.7822034,-1.306431,36.812042,168,1344,26,338
15784,21301,393,3,Business,27,4,38557,27,4,38575,27,4,38901,27,4,39143,27,4,41098,14,22.9,-1.3177547,36.8303703,-1.306378,36.7519845,731,1955,18,568
15785,502,891,1,Personal,15,6,38762,15,6,38773,15,6,39383,15,6,40241,15,6,41420,11,23.25888921888938,-1.2674274,36.7870827,-1.3197099,36.8312312,56,1179,11,1468
15786,27876,3291,3,Business,18,2,53145,18,2,53203,18,2,53640,18,2,53980,18,2,54303,2,25.7,-1.2673935,36.8030328,-1.2600926,36.8088685,24,323,58,777
15787,28150,1482,3,Business,15,1,36117,15,1,36133,15,1,36578,15,1,36870,15,1,38737,14,23.25888921888938,-1.2750257,36.8157165,-1.338579,36.8963038,167,1867,16,737
15788,13421,1154,3,Business,2,3,36395,2,3,36409,2,3,36669,2,3,37190,2,3,38223,8,20.1,-1.300722,36.7882234,-1.2551895,36.7822034,829,1033,14,781
15789,25251,2190,3,Business,12,4,43209,12,4,43259,12,4,43929,12,4,44758,12,4,45408,5,19.1,-1.301953,36.788458,-1.277261,36.790856,312,650,50,1499
15790,14266,265,3,Business,28,4,53842,28,4,55757,28,4,56129,28,4,57597,28,4,59312,6,29.8,-1.300921,36.828195,-1.326825,36.864345,6,1715,1915,1840
15791,14092,3483,1,Personal,2,4,31707,2,4,31797,2,4,32608,2,4,32775,2,4,33367,3,13.6,-1.2630521,36.8068019,-1.2787096,36.8157336,857,592,90,978
15792,27426,3517,3,Business,12,3,37268,12,3,37329,12,3,37378,12,3,39632,12,3,41810,16,19.2,-1.300921,36.828195,-1.3882008,36.7699445,95,2178,61,2303
15793,24630,3283,3,Business,9,3,34826,9,3,34853,9,3,35057,9,3,35961,9,3,36556,5,20.4,-1.2600926,36.8088685,-1.2628473,36.781805,550,595,27,1108
15794,1350,540,3,Business,25,4,55503,25,4,55512,25,4,55610,25,4,55700,25,4,56689,5,20.9,-1.2551895,36.7822034,-1.270054,36.815164,531,989,9,188
15795,20504,3222,3,Business,13,3,38384,13,3,38400,13,3,38983,13,3,39179,13,3,39935,3,23.25888921888938,-1.2551895,36.7822034,-1.2546732,36.8086796,448,756,16,779
15796,11944,733,3,Business,5,2,42443,5,2,42505,5,2,42934,5,2,43265,5,2,45962,15,23.7,-1.2551895,36.7822034,-1.3265961,36.8718676,167,2697,62,760
15797,1891,3326,3,Business,8,4,33049,8,4,33068,8,4,33457,8,4,33951,8,4,34027,3,20.5,-1.2551895,36.7822034,-1.2560455,36.7800867,405,76,19,883
15798,420,2132,3,Business,19,1,32221,19,1,33939,19,1,35983,19,1,37476,19,1,38920,9,19.4,-1.2384056,36.8718698,-1.2881663,36.8314013,669,1444,1718,3537
15799,20895,2154,3,Business,3,4,35935,3,4,37155,3,4,37996,3,4,38629,3,4,40292,6,21.8,-1.3036637,36.7853135,-1.2885529,36.8160141,753,1663,1220,1474
15800,17544,3062,3,Personal,4,5,62583,4,5,62757,4,5,64034,4,5,65540,4,5,67451,7,21.6,-1.2791224,36.8306878,-1.2765625,36.7809301,332,1911,174,2783
15801,18647,3115,3,Business,20,3,44101,20,3,44131,20,3,46477,20,3,47244,20,3,50967,20,20.0,-1.2963097,36.7688221,-1.3160977,36.9131642,354,3723,30,3113
15802,8692,3291,3,Business,3,6,50992,3,6,51062,3,6,51512,3,6,52825,3,6,52998,4,22.1,-1.265715,36.823815,-1.2600926,36.8088685,137,173,70,1763
15803,12241,520,2,Personal,8,1,40742,8,1,41061,8,1,41090,8,1,42048,8,1,43342,12,24.7,-1.28878,36.8168312,-1.2238103,36.8772588,731,1294,319,987
15804,26905,3647,3,Business,24,3,42054,24,3,42080,24,3,42738,24,3,43138,24,3,44377,8,23.25888921888938,-1.272639,36.794723,-1.302559,36.819555,177,1239,26,1058
15805,21095,248,3,Business,5,4,51782,5,4,51894,5,4,53693,5,4,54750,5,4,57796,9,22.4,-1.2560455,36.7800867,-1.304735,36.7846054,844,3046,112,2856
15806,9077,3661,3,Business,7,2,40478,7,2,41076,7,2,42301,7,2,42476,7,2,43618,10,23.25888921888938,-1.2132866,36.8678274,-1.2326041,36.8009029,8,1142,598,1400
15807,6369,478,3,Business,29,5,47071,29,5,47206,29,5,47576,29,5,48369,29,5,49316,8,19.9,-1.2551895,36.7822034,-1.2900272,36.7935096,101,947,135,1163
15808,8611,1693,1,Business,22,2,55776,22,2,56704,22,2,57256,22,2,58144,22,2,58859,4,21.3,-1.2903886,36.8063847,-1.2729324,36.8115622,726,715,928,1440
15809,26453,1271,3,Business,3,4,42008,3,4,48373,3,4,49358,3,4,50269,3,4,52028,11,25.9,-1.3244885,36.897792,-1.2669247,36.9086497,501,1759,6365,1896
15810,3801,733,3,Business,24,5,51354,24,5,52240,24,5,52754,24,5,53081,24,5,54420,7,22.9,-1.2551895,36.7822034,-1.2891614,36.8163497,709,1339,886,841
15811,12182,3621,3,Business,8,5,56033,8,5,56075,8,5,56474,8,5,56755,8,5,57666,6,21.5,-1.2836583,36.7886014,-1.3014461,36.7661381,322,911,42,680
15812,26362,2200,3,Business,9,6,42908,9,6,47493,9,6,50245,9,6,50347,9,6,52543,9,30.2,-1.3025826,36.7670807,-1.290894,36.822971,118,2196,4585,2854
15813,21482,3650,3,Business,12,1,40876,12,1,40906,12,1,41512,12,1,41639,12,1,45086,21,23.9,-1.2848376,36.8027622,-1.3930099,36.743146,30,3447,30,733
15814,8754,1584,3,Business,10,5,51484,10,5,51569,10,5,54242,10,5,54418,10,5,55618,5,23.25888921888938,-1.2969741,36.7856612,-1.2896399,36.8124498,304,1200,85,2849
15815,8958,2190,3,Business,15,3,57913,15,3,57930,15,3,58366,15,3,60489,15,3,63769,16,21.0,-1.301953,36.788458,-1.206696,36.847709,848,3280,17,2559
15816,13943,1158,3,Personal,25,1,32974,25,1,32985,25,1,34244,25,1,34376,25,1,34947,4,14.9,-1.2790803,36.8156909,-1.2661264,36.8030359,89,571,11,1391
15817,13541,1276,3,Business,31,2,43854,31,2,45162,31,2,46021,31,2,46818,31,2,49136,17,18.4,-1.3103985,36.9114173,-1.2745107,36.7974503,345,2318,1308,1656
15818,22075,2956,3,Business,21,2,42131,21,2,42173,21,2,42486,21,2,43018,21,2,43613,5,22.3,-1.279395,36.825364,-1.2584143,36.8048002,622,595,42,845
15819,7075,1402,3,Business,28,2,31559,28,2,31891,28,2,32880,28,2,33396,28,2,34343,6,18.6,-1.2571472,36.7950633,-1.2813012,36.8323962,89,947,332,1505
15820,6777,248,3,Business,13,3,41393,13,3,41444,13,3,41941,13,3,42244,13,3,44078,9,23.25888921888938,-1.304735,36.7846054,-1.2753109,36.8130185,548,1834,51,800
15821,24263,3283,3,Business,9,2,35074,9,2,35086,9,2,35214,9,2,36596,9,2,38438,6,20.7,-1.272828,36.816608,-1.2628473,36.781805,79,1842,12,1510
15822,8867,1637,3,Business,1,4,57766,1,4,57792,1,4,58094,1,4,58225,1,4,58838,6,23.25888921888938,-1.2765492,36.7669809,-1.2615888,36.7928732,240,613,26,433
15823,22639,3186,3,Business,29,5,44170,29,5,44200,29,5,44420,29,5,44726,29,5,45373,5,19.8,-1.2980229,36.78865,-1.3014515,36.8120092,919,647,30,526
15824,15111,3283,3,Business,13,3,44839,13,3,44861,13,3,45105,13,3,46165,13,3,47038,5,23.25888921888938,-1.2600926,36.8088685,-1.2628473,36.781805,215,873,22,1304
15825,9906,2829,3,Business,31,2,55433,31,2,55491,31,2,56091,31,2,56257,31,2,57081,4,22.1,-1.2571472,36.7950633,-1.2885529,36.8160141,452,824,58,766
15826,7571,3251,3,Business,3,4,47701,3,4,47730,3,4,49191,3,4,49361,3,4,50813,10,25.2,-1.2703462,36.7684896,-1.30797,36.82655,486,1452,29,1631
15827,6423,1363,3,Business,4,4,53391,4,4,53401,4,4,53467,4,4,54188,4,4,56508,13,27.4,-1.3004062,36.829741,-1.238805,36.884373,871,2320,10,787
15828,24189,1244,3,Business,14,4,49227,14,4,49263,14,4,52712,14,4,53605,14,4,54903,11,28.1,-1.331619,36.847976,-1.303596,36.778378,856,1298,36,4342
15829,352,3599,3,Business,23,4,40579,23,4,40648,23,4,43174,23,4,43898,23,4,49784,8,23.2,-1.3302996,36.8707935,-1.2953659,36.8249462,787,5886,69,3250
15830,7481,3283,3,Business,17,5,38599,17,5,39187,17,5,40058,17,5,40601,17,5,41931,6,17.4,-1.272828,36.816608,-1.2628473,36.781805,322,1330,588,1414
15831,10892,2718,3,Business,28,1,58499,28,1,58525,28,1,59554,28,1,59703,28,1,60240,2,22.6,-1.267022,36.807941,-1.2601,36.796528,37,537,26,1178
15832,20862,2030,3,Business,1,5,51820,1,5,52236,1,5,53432,1,5,53632,1,5,55694,5,31.8,-1.3100586,36.8500329,-1.29658,36.823699,590,2062,416,1396
15833,15894,2653,1,Personal,1,3,60415,1,3,60437,1,3,61111,1,3,61267,1,3,62223,8,23.4,-1.2860372,36.7549573,-1.2663135,36.7973895,449,956,22,830
15834,14008,2987,3,Business,17,2,46012,17,2,46049,17,2,46057,17,2,46980,17,2,47644,11,18.9,-1.270212,36.8210877,-1.2156006,36.8916865,874,664,37,931
15835,12699,2330,3,Business,1,5,66553,1,5,66576,1,5,67670,1,5,67839,1,5,69088,9,26.4,-1.2649605,36.7981777,-1.2326041,36.8009029,547,1249,23,1263
15836,15010,1721,3,Business,30,2,47025,30,2,47925,30,2,49520,30,2,49608,30,2,51657,4,23.25888921888938,-1.2551895,36.7822034,-1.2737314,36.8072694,422,2049,900,1683
15837,16734,393,3,Business,14,4,38967,14,4,38988,14,4,39263,14,4,41071,14,4,42960,14,23.8,-1.3167113,36.8301563,-1.306378,36.7519845,724,1889,21,2083
15838,6758,2956,3,Business,15,4,39718,15,4,39733,15,4,40537,15,4,41090,15,4,41588,2,24.6,-1.2527958,36.8003131,-1.2584143,36.8048002,407,498,15,1357
15839,9706,906,1,Personal,26,2,31792,26,2,31925,26,2,32882,26,2,33274,26,2,34562,6,23.25888921888938,-1.2874314,36.7764912,-1.2947777,36.8194497,752,1288,133,1349
15840,15742,633,3,Business,27,3,48362,27,3,50128,27,3,50885,27,3,51433,27,3,52921,4,23.25888921888938,-1.2770708,36.8231093,-1.3004062,36.829741,571,1488,1766,1305
15841,19163,1990,3,Business,21,2,35320,21,2,35409,21,2,35635,21,2,36764,21,2,36979,2,23.25888921888938,-1.2763494,36.7671783,-1.275442,36.7660207,205,215,89,1355
15842,7570,3426,3,Business,9,5,59140,9,5,59300,9,5,60969,9,5,61348,9,5,63721,11,24.9,-1.2584143,36.8048002,-1.3025826,36.7670807,40,2373,160,2048
15843,27217,1754,3,Business,6,2,35511,6,2,38941,6,2,39496,6,2,41375,6,2,42619,16,25.2,-1.3632162,36.9108253,-1.2860183,36.8975338,136,1244,3430,2434
15844,28103,1845,3,Business,8,5,40137,8,5,40292,8,5,42157,8,5,43066,8,5,46161,7,23.25888921888938,-1.2567075,36.7739831,-1.299813,36.7871392,844,3095,155,2774
15845,25980,893,3,Business,20,3,45723,20,3,45869,20,3,45908,20,3,46171,20,3,46699,4,26.2,-1.2810453,36.8118035,-1.2663194,36.809901,669,528,146,302
15846,21078,1535,1,Business,23,4,36171,23,4,36208,23,4,36547,23,4,36854,23,4,38092,7,15.8,-1.2897368,36.8226783,-1.2571472,36.7950633,71,1238,37,646
15847,9877,269,3,Business,30,3,55615,30,3,57184,30,3,57525,30,3,57768,30,3,59009,14,25.2,-1.3332749,36.8708147,-1.3404187,36.7614685,890,1241,1569,584
15848,28229,2100,3,Business,28,3,45885,28,3,46310,28,3,46397,28,3,46554,28,3,47660,6,23.25888921888938,-1.2765736,36.8513646,-1.2905033,36.8096462,933,1106,425,244
15849,3280,393,3,Business,11,5,37439,11,5,37460,11,5,37464,11,5,40389,11,5,40393,14,21.1,-1.3167113,36.8301563,-1.306378,36.7519845,239,4,21,2929
15850,14821,2956,3,Business,8,3,39039,8,3,39051,8,3,39063,8,3,39948,8,3,39956,2,22.2,-1.2584143,36.8048002,-1.2571472,36.7950633,51,8,12,897
15851,25651,838,3,Business,16,4,45012,16,4,45124,16,4,45128,16,4,45808,16,4,47774,13,23.25888921888938,-1.1648303,36.951368,-1.2241625,36.8851115,68,1966,112,684
15852,22058,2866,3,Business,2,4,50469,2,4,50492,2,4,50567,2,4,52502,2,4,55127,26,26.0,-1.2551895,36.7822034,-1.3916459,36.9305892,105,2625,23,2010
15853,799,3547,3,Business,3,3,45428,3,3,45465,3,3,47284,3,3,47745,3,3,50770,17,27.2,-1.2761408,36.7710839,-1.3194518,36.869396,269,3025,37,2280
15854,8851,2412,3,Business,14,4,48116,14,4,48555,14,4,49558,14,4,50063,14,4,50619,3,27.8,-1.2156006,36.8916865,-1.2285835,36.8826468,75,556,439,1508
15855,18806,246,3,Business,11,1,53557,11,1,53755,11,1,53901,11,1,55592,11,1,55620,3,23.4,-1.2584143,36.8048002,-1.2551895,36.7822034,354,28,198,1837
15856,13564,1500,3,Business,26,2,52932,26,2,52945,26,2,52952,26,2,54406,26,2,54413,10,30.8,-1.2991441,36.7528804,-1.2638185,36.7930057,239,7,13,1461
15857,19794,2283,2,Personal,15,1,40126,15,1,40154,15,1,40193,15,1,40883,15,1,40900,1,23.25888921888938,-1.2562797,36.8075858,-1.2661959,36.807544,51,17,28,729
15858,27598,238,3,Business,2,5,48075,2,5,48184,2,5,48663,2,5,49767,2,5,50703,7,25.3,-1.3077869,36.8443207,-1.2969356,36.8183395,906,936,109,1583
15859,17746,3647,3,Business,27,3,46245,27,3,46288,27,3,47159,27,3,47407,27,3,48661,6,25.9,-1.272639,36.794723,-1.2951386,36.7970089,576,1254,43,1119
15860,10517,680,2,Personal,12,5,37256,12,5,39227,12,5,41165,12,5,41815,12,5,42618,5,24.3,-1.2883346,36.8148489,-1.2762775,36.8173551,299,803,1971,2588
15861,9283,1726,1,Personal,9,2,32703,9,2,34698,9,2,36068,9,2,36316,9,2,37515,7,17.6,-1.3191114,36.844874,-1.2863371,36.8200261,662,1199,1995,1618
15862,1817,3521,3,Business,25,1,33949,25,1,34001,25,1,34308,25,1,34750,25,1,36092,5,23.25888921888938,-1.2696908,36.81519,-1.2615888,36.7928732,205,1342,52,749
15863,20944,412,3,Business,27,6,35443,27,6,35470,27,6,37180,27,6,37995,27,6,39124,10,23.25888921888938,-1.303596,36.778378,-1.266837,36.799249,155,1129,27,2525
15864,23830,265,3,Business,5,5,52171,5,5,52222,5,5,52247,5,5,54760,5,5,54765,4,27.4,-1.300921,36.828195,-1.3226515,36.8195682,510,5,51,2538
15865,13376,635,3,Business,14,4,56092,14,4,56312,14,4,57555,14,4,58412,14,4,60558,17,28.1,-1.177202,36.8351183,-1.2602337,36.7990548,56,2146,220,2100
15866,15394,2350,1,Personal,4,1,55852,4,1,56020,4,1,57120,4,1,57366,4,1,58683,10,22.5,-1.2946287,36.7585367,-1.3114711,36.8088708,312,1317,168,1346
15867,7005,2358,4,Business,11,3,31158,11,3,31201,11,3,33182,11,3,34056,11,3,37288,34,15.4,-1.3256904,36.8747943,-1.3256159,36.8617394,121,3232,43,2855
15868,9252,3573,1,Personal,18,3,43263,18,3,43448,18,3,45362,18,3,45906,18,3,47743,5,20.1,-1.263194,36.797624,-1.2836832,36.8306719,844,1837,185,2458
15869,26465,3355,3,Business,18,2,32885,18,2,32905,18,2,33339,18,2,33461,18,2,34427,8,16.5,-1.3052491,36.8223899,-1.2551895,36.7822034,674,966,20,556
15870,4113,1874,3,Business,18,2,38880,18,2,38890,18,2,39263,18,2,40251,18,2,40681,3,23.25888921888938,-1.2571472,36.7950633,-1.263453,36.7955612,259,430,10,1361
15871,26513,2625,1,Personal,27,5,53370,27,5,53382,27,5,54386,27,5,54825,27,5,57333,14,24.1,-1.2248308,36.8012573,-1.2962832,36.7849683,882,2508,12,1443
15872,23529,1271,3,Business,1,5,46844,1,5,46869,1,5,46886,1,5,47476,1,5,49191,9,28.6,-1.2649605,36.7981777,-1.3014461,36.7661381,698,1715,25,607
15873,22417,552,3,Business,23,5,54176,23,5,54278,23,5,54338,23,5,55641,23,5,59841,21,26.2,-1.2551895,36.7822034,-1.3632162,36.9108253,19,4200,102,1363
15874,156,2587,3,Business,8,3,56243,8,3,56370,8,3,56697,8,3,56949,8,3,58042,7,23.25888921888938,-1.28878,36.8168312,-1.2551895,36.7822034,155,1093,127,579
15875,22893,1404,2,Personal,15,3,49097,15,3,49155,15,3,50181,15,3,50968,15,3,52086,9,21.7,-1.2973827,36.7942871,-1.258348,36.8449018,234,1118,58,1813
15876,3105,2265,1,Personal,14,1,46772,14,1,46910,14,1,48446,14,1,48765,14,1,51601,13,25.8,-1.3141805,36.7397786,-1.269534,36.80697,520,2836,138,1855
15877,6982,1271,3,Business,28,3,46420,28,3,49868,28,3,51124,28,3,51943,28,3,53011,12,23.25888921888938,-1.3244885,36.897792,-1.302527,36.8546572,69,1068,3448,2075
15878,6989,346,3,Business,2,2,46435,2,2,46653,2,2,47486,2,2,47649,2,2,48382,7,26.0,-1.28878,36.8168312,-1.2551895,36.7822034,953,733,218,996
15879,23141,633,3,Business,10,4,58089,10,4,58117,10,4,58123,10,4,61921,10,4,61924,4,23.7,-1.3228003,36.8306435,-1.3004062,36.829741,39,3,28,3804
15880,22321,53,3,Business,27,6,43639,27,6,43690,27,6,44827,27,6,45779,27,6,46725,5,23.25888921888938,-1.3004062,36.829741,-1.2770708,36.8231093,790,946,51,2089
15881,13853,1719,3,Business,29,5,52042,29,5,52372,29,5,53693,29,5,54743,29,5,55938,7,28.8,-1.2897368,36.8226783,-1.296797,36.7764525,907,1195,330,2371
15882,23056,635,3,Business,23,4,48937,23,4,49013,23,4,49432,23,4,49912,23,4,52276,6,24.8,-1.2602337,36.7990548,-1.2963367,36.8094235,119,2364,76,899
15883,12669,3450,3,Business,15,1,53952,15,1,53989,15,1,54247,15,1,54437,15,1,56130,18,23.25888921888938,-1.2657464,36.7801144,-1.2155671,36.8898931,120,1693,37,448
15884,6349,3039,2,Personal,9,3,62619,9,3,62826,9,3,63288,9,3,63986,9,3,64547,3,21.9,-1.2892762,36.764129,-1.2962603,36.7766164,355,561,207,1160
15885,13365,186,3,Business,18,2,42154,18,2,42743,18,2,43600,18,2,44023,18,2,45247,6,23.25888921888938,-1.2571472,36.7950633,-1.2925919,36.8170577,548,1224,589,1280
15886,1091,393,3,Business,16,3,45946,16,3,45965,16,3,45970,16,3,48462,16,3,48463,4,22.8,-1.3167113,36.8301563,-1.3004062,36.829741,39,1,19,2497
15887,3850,3463,2,Personal,29,6,53719,29,6,53743,29,6,54249,29,6,54904,29,6,55303,4,28.0,-1.2872344,36.7773949,-1.274755,36.7906585,750,399,24,1161
15888,22342,2956,3,Business,13,3,48628,13,3,48808,13,3,48955,13,3,49633,13,3,49637,2,27.3,-1.2551895,36.7822034,-1.2584143,36.8048002,651,4,180,825
15889,4263,419,3,Business,12,1,45475,12,1,45611,12,1,46494,12,1,47499,12,1,48394,9,24.0,-1.289882,36.8105888,-1.2571472,36.7950633,726,895,136,1888
15890,8251,2069,3,Business,25,6,46087,25,6,46147,25,6,46863,25,6,48012,25,6,48779,6,23.25888921888938,-1.2296618,36.8438272,-1.228911,36.881876,8,767,60,1865
15891,22909,1670,1,Personal,19,5,45772,19,5,46145,19,5,47039,19,5,47387,19,5,48575,7,24.8,-1.290239,36.7620412,-1.266264,36.762418,565,1188,373,1242
15892,23152,2200,3,Business,11,4,40820,11,4,41108,11,4,42647,11,4,43365,11,4,45219,9,23.9,-1.2859912,36.8756811,-1.290894,36.822971,622,1854,288,2257
15893,12996,1500,3,Business,6,1,55565,6,1,55635,6,1,55755,6,1,57333,6,1,58534,8,23.25888921888938,-1.3004062,36.829741,-1.2638185,36.7930057,298,1201,70,1698
15894,5150,286,3,Business,14,2,60904,14,2,60937,14,2,61563,14,2,61980,14,2,63269,8,23.25888921888938,-1.2855404,36.7944306,-1.2551895,36.7822034,76,1289,33,1043
15895,18119,312,3,Personal,28,6,36624,28,6,36657,28,6,37293,28,6,37736,28,6,38981,12,17.7,-1.28469,36.826112,-1.3257473,36.8592068,754,1245,33,1079
15896,27486,3560,3,Business,20,4,47594,20,4,48277,20,4,49672,20,4,50879,20,4,52732,5,25.3,-1.3001909,36.8163627,-1.279395,36.825364,725,1853,683,2602
15897,22938,3647,3,Business,19,3,54340,19,3,55025,19,3,55209,19,3,56492,19,3,56516,5,24.6,-1.272639,36.794723,-1.266736,36.7989348,813,24,685,1467
15898,2444,1850,3,Business,13,3,40627,13,3,40708,13,3,41143,13,3,41271,13,3,42712,7,23.25888921888938,-1.2551895,36.7822034,-1.296613,36.819823,674,1441,81,563
15899,6615,2423,3,Business,29,5,51606,29,5,58111,29,5,58708,29,5,58847,29,5,60840,8,21.4,-1.2551895,36.7822034,-1.300722,36.816865,726,1993,6505,736
15900,26129,2344,3,Business,31,2,56490,31,2,56502,31,2,56846,31,2,57583,31,2,58433,4,22.0,-1.2571472,36.7950633,-1.2809914,36.8123591,882,850,12,1081
15901,28111,346,3,Business,28,4,39043,28,4,39235,28,4,39806,28,4,40010,28,4,41299,6,23.25888921888938,-1.2885529,36.8160141,-1.3039695,36.7838267,21,1289,192,775
15902,14234,2801,3,Business,26,2,41631,26,2,41645,26,2,42332,26,2,42478,26,2,43488,4,27.4,-1.2595422,36.7871178,-1.2738522,36.7992818,290,1010,14,833
15903,4836,2415,1,Personal,11,3,48842,11,3,49553,11,3,52613,11,3,52945,11,3,53887,6,20.7,-1.2766474,36.8155764,-1.2899733,36.7908611,752,942,711,3392
15904,6324,1073,3,Business,6,4,60868,6,4,60882,6,4,61674,6,4,61804,6,4,62739,8,22.4,-1.2491515,36.79076848,-1.2866305,36.7754914,103,935,14,922
15905,22393,2750,3,Business,4,4,39913,4,4,39924,4,4,40278,4,4,40538,4,4,41292,6,23.25888921888938,-1.275442,36.7660207,-1.2659149,36.8054322,663,754,11,614
15906,14066,1389,3,Business,12,2,35597,12,2,35615,12,2,37124,12,2,38759,12,2,40502,22,28.0,-1.3014461,36.7661381,-1.207546,36.7913976,315,1743,18,3144
15907,8965,391,3,Business,18,1,42537,18,1,42556,18,1,43618,18,1,44823,18,1,47205,16,27.8,-1.300921,36.828195,-1.2121839,36.8924274,95,2382,19,2267
15908,3351,1148,3,Business,17,5,51254,17,5,51302,17,5,53339,17,5,53565,17,5,55865,15,23.25888921888938,-1.3104867,36.8495593,-1.3671327,36.7564238,321,2300,48,2263
15909,23440,633,3,Business,28,1,55216,28,1,55222,28,1,55235,28,1,58280,28,1,58283,4,26.1,-1.3228003,36.8306435,-1.3004062,36.829741,914,3,6,3058
15910,26670,3332,3,Personal,1,3,48109,1,3,48118,1,3,49367,1,3,49799,1,3,52136,10,24.1,-1.2801075,36.8100471,-1.23894,36.76171,234,2337,9,1681
15911,14005,2457,3,Business,13,1,45914,13,1,45929,13,1,46016,13,1,46320,13,1,49057,19,23.25888921888938,-1.2551895,36.7822034,-1.32943,36.894243,25,2737,15,391
15912,7080,393,3,Business,25,1,47171,25,1,47214,25,1,47924,25,1,48069,25,1,49287,6,26.9,-1.3167113,36.8301563,-1.3077869,36.8443207,111,1218,43,855
15913,6023,867,3,Business,11,5,57315,11,5,57361,11,5,57378,11,5,58230,11,5,59707,10,26.5,-1.2996533,36.8292629,-1.2991441,36.7528804,914,1477,46,869
15914,15950,2521,3,Business,25,5,39017,25,5,39033,25,5,39166,25,5,39585,25,5,41390,11,26.3,-1.3167113,36.8301563,-1.2574219,36.7927073,523,1805,16,552
15915,2675,3688,3,Business,28,1,54766,28,1,55025,28,1,57280,28,1,57630,28,1,58227,4,26.3,-1.2551895,36.7822034,-1.2768326,36.8073804,489,597,259,2605
15916,15944,1500,3,Business,3,1,30784,3,1,30855,3,1,31276,3,1,31540,3,1,33302,13,18.2,-1.2638185,36.7930057,-1.3228003,36.8306435,582,1762,71,685
15917,23654,136,3,Business,11,2,48246,11,2,48409,11,2,49063,11,2,49285,11,2,50515,14,21.5,-1.3254522,36.7216584,-1.2950408,36.8098172,821,1230,163,876
15918,25222,246,3,Business,13,3,52046,13,3,52276,13,3,54368,13,3,57324,13,3,60149,6,23.5,-1.290894,36.822971,-1.2584143,36.8048002,431,2825,230,5048
15919,11984,2306,3,Business,4,1,43025,4,1,43089,4,1,44487,4,1,45092,4,1,46756,13,25.5,-1.2271998,36.8084905,-1.296416,36.828281,268,1664,64,2003
15920,8484,2801,3,Business,9,5,54289,9,5,55318,9,5,55430,9,5,56018,9,5,57382,8,26.3,-1.2595422,36.7871178,-1.2873708,36.814908,848,1364,1029,700
15921,27654,3599,3,Business,19,2,41363,19,2,42981,19,2,44553,19,2,45161,19,2,48724,30,27.7,-1.3302996,36.8707935,-1.2747526,36.6514681,218,3563,1618,2180
15922,25793,3283,3,Business,3,4,47508,3,4,47526,3,4,47860,3,4,48811,3,4,50321,9,25.2,-1.303596,36.778378,-1.2628473,36.781805,543,1510,18,1285
15923,12879,2212,3,Business,22,4,44393,22,4,44544,22,4,46065,22,4,46580,22,4,47049,4,22.5,-1.2571472,36.7950633,-1.282435,36.817051,71,469,151,2036
15924,26814,635,3,Business,6,3,45845,6,3,45869,6,3,46310,6,3,49339,6,3,50065,6,27.6,-1.3081376,36.8329772,-1.3229345,36.8566974,95,726,24,3470
15925,24327,2271,3,Business,31,4,48575,31,4,48773,31,4,49981,31,4,50433,31,4,51822,11,28.8,-1.331619,36.847976,-1.293515,36.897607,416,1389,198,1660
15926,22767,3283,3,Business,8,5,49341,8,5,58411,8,5,59027,8,5,59857,8,5,62513,13,20.1,-1.331619,36.847976,-1.2628473,36.781805,192,2656,9070,1446
15927,23497,2828,3,Business,12,5,34241,12,5,34252,12,5,34695,12,5,35220,12,5,36805,13,18.4,-1.2615888,36.7928732,-1.330929,36.835151,932,1585,11,968
15928,12134,393,3,Business,29,1,29540,29,1,31709,29,1,31713,29,1,33143,29,1,34529,10,18.8,-1.3177547,36.8303703,-1.2574219,36.7927073,39,1386,2169,1434
15929,18392,2412,3,Business,4,4,37072,4,4,37595,4,4,37611,4,4,40404,4,4,40655,5,25.5,-1.2077728,36.8705319,-1.2283403,36.8822756,633,251,523,2809
15930,18045,2195,3,Business,23,6,38155,23,6,38212,23,6,39109,23,6,39585,23,6,42303,16,23.25888921888938,-1.303596,36.778378,-1.228911,36.881876,306,2718,57,1373
15931,10718,393,3,Business,20,2,34999,20,2,35652,20,2,35669,20,2,37380,20,2,39841,14,18.9,-1.3177547,36.8303703,-1.306378,36.7519845,39,2461,653,1728
15932,25167,3599,3,Business,27,3,48578,27,3,48606,27,3,49606,27,3,51420,27,3,53142,20,29.3,-1.3302996,36.8707935,-1.3636899,36.9468353,715,1722,28,2814
15933,2814,2801,3,Business,8,5,35096,8,5,35167,8,5,35527,8,5,35616,8,5,37091,5,20.6,-1.2674274,36.7870827,-1.2712193,36.8256876,576,1475,71,449
15934,10210,283,3,Business,18,2,51990,18,2,52092,18,2,53011,18,2,53186,18,2,54017,3,27.4,-1.2804227,36.8250375,-1.2883158,36.8199114,207,831,102,1094
15935,16977,2195,3,Business,9,2,36832,9,2,36846,9,2,37167,9,2,37831,9,2,39251,16,20.8,-1.303596,36.778378,-1.228911,36.881876,299,1420,14,985
15936,15205,3291,3,Business,10,1,38985,10,1,39008,10,1,39728,10,1,40140,10,1,41804,12,23.7,-1.228911,36.881876,-1.2600926,36.8088685,685,1664,23,1132
15937,23019,3560,3,Business,20,3,46294,20,3,46393,20,3,47106,20,3,47406,20,3,48477,2,26.2,-1.2813012,36.8323962,-1.279395,36.825364,448,1071,99,1013
15938,15345,1152,3,Personal,3,5,63302,3,5,63473,3,5,63543,3,5,64196,3,5,65605,6,23.25888921888938,-1.2990813,36.8034213,-1.2905113,36.7591138,564,1409,171,723
15939,21477,3017,3,Business,20,4,54828,20,4,55724,20,4,56608,20,4,56960,20,4,58698,8,28.1,-1.2993231,36.7753372,-1.3472066,36.7692638,532,1738,896,1236
15940,16282,2828,3,Business,16,6,65013,16,6,65063,16,6,65926,16,6,66343,16,6,68217,11,23.8,-1.3207349,36.8819157,-1.28872,36.90297,675,1874,50,1280
15941,22027,2982,3,Business,27,6,44176,27,6,45117,27,6,46289,27,6,46914,27,6,50005,13,23.25888921888938,-1.300921,36.828195,-1.2235201,36.8020608,184,3091,941,1797
15942,6748,1471,3,Business,17,1,45818,17,1,46236,17,1,47122,17,1,49018,17,1,49052,9,24.5,-1.2551895,36.7822034,-1.2972916,36.7880497,847,34,418,2782
15943,16008,3277,2,Personal,10,1,36454,10,1,36845,10,1,39020,10,1,39511,10,1,41645,9,23.25888921888938,-1.3376959,36.7605707,-1.3096061,36.8158239,328,2134,391,2666
15944,23618,1359,2,Personal,20,5,50183,20,5,52082,20,5,53539,20,5,54024,20,5,58641,17,20.5,-1.3688433,36.7402114,-1.3025667,36.7803495,939,4617,1899,1942
15945,5545,393,3,Business,31,3,42217,31,3,42682,31,3,43384,31,3,43637,31,3,45300,7,24.9,-1.3177547,36.8303703,-1.3083266,36.8494756,731,1663,465,955
15946,28151,1959,3,Business,30,2,57414,30,2,58098,30,2,58910,30,2,59447,30,2,60243,3,23.25888921888938,-1.2649605,36.7981777,-1.2551895,36.7822034,318,796,684,1349
15947,1056,3291,3,Business,28,5,42989,28,5,43035,28,5,43418,28,5,43547,28,5,44383,4,25.0,-1.272828,36.816608,-1.2600926,36.8088685,882,836,46,512
15948,24076,391,3,Business,26,2,51038,26,2,51136,26,2,51183,26,2,51733,26,2,52222,4,29.8,-1.2867454,36.8259017,-1.290641,36.812941,845,489,98,597
15949,26641,2931,3,Business,4,2,51260,4,2,52461,4,2,54811,4,2,55774,4,2,59028,13,23.8,-1.3081087,36.7405924,-1.2452664,36.8028541,677,3254,1201,3313
15950,20623,3295,3,Business,30,2,57278,30,2,60821,30,2,61469,30,2,61811,30,2,61837,2,23.25888921888938,-1.2571472,36.7950633,-1.2739424,36.8155357,903,26,3543,990
15951,6735,627,3,Business,22,5,37747,22,5,37842,22,5,38209,22,5,38862,22,5,38864,3,28.3,-1.2551895,36.7822034,-1.2672749,36.7851294,598,2,95,1020
15952,16478,1336,3,Business,24,3,38588,24,3,39598,24,3,40263,24,3,40640,24,3,41744,2,20.1,-1.2891922,36.825189,-1.2866012,36.8195691,857,1104,1010,1042
15953,9543,1047,3,Personal,18,2,51494,18,2,51594,18,2,55154,18,2,55250,18,2,60562,12,25.8,-1.2608592,36.8311977,-1.3077869,36.8443207,522,5312,100,3656
15954,3577,2982,3,Business,27,6,32099,27,6,32119,27,6,33635,27,6,35447,27,6,37736,18,23.25888921888938,-1.300921,36.828195,-1.177202,36.8351183,796,2289,20,3328
15955,10942,2591,1,Personal,16,2,34334,16,2,36036,16,2,37289,16,2,37501,16,2,39455,16,23.25888921888938,-1.2311903,36.8102105,-1.3223238,36.8320056,85,1954,1702,1465
15956,23580,3418,3,Business,6,4,48735,6,4,48741,6,4,50038,6,4,50698,6,4,51647,5,23.3,-1.2828186,36.8232798,-1.25954,36.802977,336,949,6,1957
15957,27083,53,3,Business,9,4,34805,9,4,34973,9,4,35199,9,4,36423,9,4,37965,8,23.25888921888938,-1.3167113,36.8301563,-1.2770708,36.8231093,709,1542,168,1450
15958,11992,519,3,Personal,12,3,30968,12,3,31078,12,3,32469,12,3,32757,12,3,34094,6,16.5,-1.2662524,36.8244795,-1.2745551,36.7979797,698,1337,110,1679
15959,2660,393,3,Business,22,2,48562,22,2,48670,22,2,49919,22,2,50241,22,2,52069,14,25.8,-1.3167113,36.8301563,-1.306378,36.7519845,518,1828,108,1571
15960,14710,3426,3,Business,17,7,40238,17,7,40567,17,7,41565,17,7,43635,17,7,44412,9,28.5,-1.290894,36.822971,-1.3012008,36.764868,119,777,329,3068
15961,3727,2436,3,Business,2,2,38918,2,2,39077,2,2,40330,2,2,40541,2,2,43430,6,26.1,-1.2571472,36.7950633,-1.300722,36.816865,177,2889,159,1464
15962,7798,346,3,Business,3,2,54985,3,2,55365,3,2,56195,3,2,57405,3,2,57799,2,20.2,-1.295162,36.8115914,-1.2885529,36.8160141,890,394,380,2040
15963,3187,1209,3,Business,18,4,44783,18,4,45106,18,4,46122,18,4,47112,18,4,47771,4,23.25888921888938,-1.3077869,36.8443207,-1.3004062,36.829741,281,659,323,2006
15964,7703,346,3,Business,27,3,31239,27,3,31272,27,3,31273,27,3,33339,27,3,34820,16,23.25888921888938,-1.207546,36.7913976,-1.28878,36.8168312,101,1481,33,2067
15965,14721,2174,3,Business,14,4,37174,14,4,37192,14,4,37601,14,4,38523,14,4,39493,8,24.8,-1.2482781,36.884092,-1.2845996,36.9018814,307,970,18,1331
15966,8727,391,3,Business,26,4,40470,26,4,41385,26,4,42984,26,4,43473,26,4,44388,5,19.0,-1.300921,36.828195,-1.2784063,36.8222933,844,915,915,2088
15967,19934,2085,3,Personal,11,4,37695,11,4,37721,11,4,38430,11,4,38737,11,4,40739,12,25.5,-1.3270347,36.8667362,-1.2678814,36.8157574,459,2002,26,1016
15968,22109,120,1,Personal,9,4,31069,9,4,31084,9,4,31430,9,4,31679,9,4,33072,12,17.0,-1.2795197,36.8168287,-1.2907854,36.8996371,726,1393,15,595
15969,21623,111,3,Business,13,1,42260,13,1,42274,13,1,42314,13,1,43423,13,1,46348,12,23.25888921888938,-1.2551895,36.7822034,-1.315745,36.847565,99,2925,14,1149
15970,7695,2804,3,Business,21,4,42794,21,4,42841,21,4,44045,21,4,44351,21,4,44901,4,25.3,-1.2690017,36.7985246,-1.2551895,36.7822034,167,550,47,1510
15971,21500,1051,3,Business,29,1,39258,29,1,44601,29,1,46159,29,1,46788,29,1,48343,19,23.25888921888938,-1.2482465,36.8889062,-1.1538233,36.950874,237,1555,5343,2187
15972,8853,3647,3,Business,6,4,42382,6,4,42501,6,4,43086,6,4,43201,6,4,44173,6,23.9,-1.272639,36.794723,-1.3023756,36.7949276,375,972,119,700
15973,4938,2328,2,Personal,6,3,55229,6,3,55373,6,3,57297,6,3,58054,6,3,60375,12,21.9,-1.2762513,36.7964048,-1.2423801,36.8478805,536,2321,144,2681
15974,10786,3194,3,Business,14,4,46243,14,4,46466,14,4,46484,14,4,46726,14,4,46986,3,23.7,-1.2551895,36.7822034,-1.2659149,36.8054322,56,260,223,260
15975,12741,412,3,Business,28,6,43050,28,6,43153,28,6,43194,28,6,43928,28,6,44432,4,24.2,-1.2628473,36.781805,-1.266837,36.799249,101,504,103,775
15976,16103,1085,3,Business,3,7,37146,3,7,42082,3,7,42632,3,7,42779,3,7,44017,7,28.3,-1.2536275,36.7987932,-1.232864,36.8084708,467,1238,4936,697
15977,5066,2330,3,Business,22,5,45056,22,5,45168,22,5,45638,22,5,46793,22,5,46796,4,28.7,-1.2873232,36.7658572,-1.2921463,36.8029626,613,3,112,1625
15978,22034,1370,3,Personal,27,1,50733,27,1,50775,27,1,54150,27,1,54309,27,1,55790,8,22.9,-1.261692,36.80161,-1.2804664,36.7701111,139,1481,42,3534
15979,5615,2436,3,Business,27,2,56944,27,2,62714,27,2,63520,27,2,63609,27,2,64763,7,22.1,-1.2551895,36.7822034,-1.2854453,36.8188363,260,1154,5770,895
15980,13830,1724,3,Business,8,5,51166,8,5,51196,8,5,51325,8,5,52251,8,5,54556,10,30.3,-1.2551895,36.7822034,-1.3090111,36.7683275,576,2305,30,1055
15981,17680,1927,3,Business,24,4,31581,24,4,31599,24,4,32632,24,4,32955,24,4,35211,18,19.2,-1.2859912,36.8756811,-1.3472066,36.7692638,817,2256,18,1356
15982,445,1444,1,Personal,25,5,61203,25,5,61246,25,5,61913,25,5,62386,25,5,63180,3,21.4,-1.2536042,36.8064895,-1.269534,36.80697,89,794,43,1140
15983,14022,3417,1,Personal,1,6,52776,1,6,52803,1,6,52875,1,6,54072,1,6,56219,23,19.3,-1.3773235,36.9365672,-1.2826972,36.9702813,890,2147,27,1269
15984,26254,627,3,Business,16,4,54178,16,4,54214,16,4,54653,16,4,55210,16,4,58002,19,23.25888921888938,-1.2571472,36.7950633,-1.3339943,36.7263409,147,2792,36,996
15985,27234,1081,3,Business,7,4,51109,7,4,51155,7,4,51237,7,4,53078,7,4,56068,15,27.6,-1.2571472,36.7950633,-1.3472066,36.7692638,669,2990,46,1923
15986,18359,1642,3,Business,15,5,46886,15,5,47646,15,5,49394,15,5,49471,15,5,50347,4,28.2,-1.278191,36.8143267,-1.2726506,36.7960153,411,876,760,1825
15987,11386,3091,3,Business,3,3,31463,3,3,31482,3,3,32148,3,3,32492,3,3,33863,13,18.7,-1.3012008,36.764868,-1.3293565,36.7867025,648,1371,19,1010
15988,16990,1329,3,Business,20,2,35233,20,2,35861,20,2,36446,20,2,36586,20,2,37597,6,19.1,-1.273056,36.811298,-1.2832105,36.7777664,131,1011,628,725
15989,16894,1469,3,Business,19,1,54296,19,1,54382,19,1,56212,19,1,56361,19,1,57883,16,25.2,-1.2551895,36.7822034,-1.325469,36.862403,147,1522,86,1979
15990,2696,2876,1,Personal,2,1,42196,2,1,42205,2,1,42502,2,1,42945,2,1,43802,6,19.0,-1.2684239,36.7952462,-1.2944292,36.7793569,148,857,9,740
15991,24540,2344,3,Business,20,3,38018,20,3,38238,20,3,38500,20,3,38728,20,3,39984,8,26.6,-1.2551895,36.7822034,-1.291282,36.798229,489,1256,220,490
15992,514,136,3,Business,14,5,45645,14,5,45665,14,5,46280,14,5,46477,14,5,48278,9,24.4,-1.2248308,36.8012573,-1.2560874,36.7931031,847,1801,20,812
15993,26391,3602,3,Business,11,2,33832,11,2,33856,11,2,34334,11,2,34586,11,2,38048,20,16.8,-1.2963097,36.7688221,-1.3329455,36.8885006,226,3462,24,730
15994,18153,2521,3,Business,13,6,29929,13,6,30934,13,6,32455,13,6,32688,13,6,34137,14,23.25888921888938,-1.3177547,36.8303703,-1.306378,36.7519845,208,1449,1005,1754
15995,3405,1205,3,Business,30,2,40010,30,2,41074,30,2,41951,30,2,44424,30,2,45826,5,22.2,-1.257309,36.8060084,-1.2814178,36.8154096,303,1402,1064,3350
15996,25568,391,3,Business,16,6,39867,16,6,39963,16,6,43368,16,6,44143,16,6,45146,5,25.6,-1.300921,36.828195,-1.2784063,36.8222933,448,1003,96,4180
15997,23179,2008,3,Business,22,1,48648,22,1,48745,22,1,49341,22,1,49892,22,1,51304,6,26.4,-1.2508229,36.7895263,-1.2714569,36.8278662,279,1412,97,1147
15998,22446,2697,2,Personal,6,6,41389,6,6,41404,6,6,42979,6,6,43165,6,6,44133,7,24.1,-1.2720806,36.7751959,-1.2622444,36.7596633,496,968,15,1761
15999,5086,1329,3,Business,22,2,44305,22,2,44335,22,2,44373,22,2,45299,22,2,46128,6,19.4,-1.273056,36.811298,-1.2946581,36.7792921,51,829,30,964
16000,20293,3651,3,Business,13,2,46189,13,2,47490,13,2,47631,13,2,48822,13,2,52131,6,26.4,-1.2571472,36.7950633,-1.2883346,36.8148489,881,3309,1301,1332
16001,10154,2809,2,Personal,25,1,58902,25,1,58931,25,1,59333,25,1,59607,25,1,62938,31,23.25888921888938,-1.2672213,36.8275035,-1.1559779,36.6405079,101,3331,29,676
16002,27943,496,3,Business,19,1,53688,19,1,53803,19,1,53950,19,1,54302,19,1,55592,11,25.1,-1.2967108,36.7871135,-1.2551895,36.7822034,597,1290,115,499
16003,12677,2229,3,Business,12,3,37728,12,3,37991,12,3,38632,12,3,38816,12,3,40175,10,19.6,-1.3247683,36.85803,-1.301893,36.815245,243,1359,263,825
16004,11907,635,3,Business,2,4,55316,2,4,55395,2,4,55400,2,4,58945,2,4,60249,8,23.25888921888938,-1.3081376,36.8329772,-1.2602337,36.7990548,926,1304,79,3550
16005,26080,59,3,Business,14,2,50951,14,2,51468,14,2,53027,14,2,53555,14,2,55168,18,24.0,-1.3216456,36.7145156,-1.290894,36.822971,549,1613,517,2087
16006,24684,3743,3,Business,26,2,56622,26,2,56657,26,2,57121,26,2,58131,26,2,59314,4,29.9,-1.2571472,36.7950633,-1.2890399,36.8164942,595,1183,35,1474
16007,15200,393,3,Business,15,5,49794,15,5,50106,15,5,50403,15,5,51153,15,5,52129,4,17.9,-1.3167113,36.8301563,-1.3004062,36.829741,233,976,312,1047
16008,13166,2801,3,Business,23,5,40554,23,5,40867,23,5,41135,23,5,42111,23,5,42980,6,24.0,-1.2684319,36.8165853,-1.2595422,36.7871178,547,869,313,1244
16009,14725,3496,3,Business,8,5,50995,8,5,52435,8,5,55516,8,5,56669,8,5,57727,6,21.5,-1.3053408,36.8771044,-1.300921,36.828195,192,1058,1440,4234
16010,14279,2174,3,Business,21,1,42843,21,1,42847,21,1,43022,21,1,44986,21,1,46934,25,25.5,-1.2482781,36.884092,-1.4136642,36.957045,12,1948,4,2139
16011,27471,865,3,Business,28,2,60976,28,2,60992,28,2,61787,28,2,61970,28,2,62509,2,21.4,-1.2456412,36.7955298,-1.2576123,36.8054354,139,539,16,978
16012,19041,2008,3,Business,27,1,47788,27,1,47802,27,1,48996,27,1,49379,27,1,52595,33,22.9,-1.2508229,36.7895263,-1.11377,37.002043,161,3216,14,1577
16013,21597,393,3,Business,15,6,32989,15,6,38880,15,6,38894,15,6,40340,15,6,41500,11,22.2,-1.3167113,36.8301563,-1.2574219,36.7927073,619,1160,5891,1460
16014,20070,2523,3,Business,3,2,52242,3,2,52276,3,2,52749,3,2,53100,3,2,54414,5,20.1,-1.2551895,36.7822034,-1.2650523,36.7866798,851,1314,34,824
16015,12893,186,3,Business,13,3,31961,13,3,31979,13,3,32738,13,3,33047,13,3,35758,23,17.4,-1.3700383,36.9190174,-1.2571472,36.7950633,427,2711,18,1068
16016,7171,970,3,Business,16,4,35193,16,4,35363,16,4,35882,16,4,36305,16,4,37236,7,23.25888921888938,-1.2551895,36.7822034,-1.2902589,36.8219257,344,931,170,942
16017,25976,3259,3,Business,12,2,48685,12,2,53443,12,2,54619,12,2,55082,12,2,56280,10,22.9,-1.2956517,36.8036292,-1.326825,36.864345,379,1198,4758,1639
16018,5184,2539,3,Business,17,5,54328,17,5,54458,17,5,55176,17,5,56379,17,5,57426,6,23.25888921888938,-1.2930037,36.8126474,-1.2760462,36.8074697,410,1047,130,1921
16019,27823,432,3,Business,2,2,49590,2,2,49646,2,2,50879,2,2,50996,2,2,54467,3,29.3,-1.3012008,36.764868,-1.2765492,36.7669809,76,3471,56,1350
16020,10794,2560,1,Personal,13,1,43223,13,1,43286,13,1,43712,13,1,43939,13,1,44804,4,17.1,-1.2658335,36.8042867,-1.280753,36.8191175,531,865,63,653
16021,2688,2946,2,Personal,8,3,45380,8,3,45497,8,3,45976,8,3,47669,8,3,49108,7,22.2,-1.2749662,36.7658781,-1.289521,36.8190724,179,1439,117,2172
16022,618,2701,3,Business,6,3,48873,6,3,48953,6,3,49796,6,3,50220,6,3,51469,8,23.25888921888938,-1.2584143,36.8048002,-1.2765736,36.8513646,25,1249,80,1267
16023,14408,1809,3,Business,26,1,56238,26,1,58685,26,1,59265,26,1,59631,26,1,60781,11,19.8,-1.2571472,36.7950633,-1.2413316,36.8785525,607,1150,2447,946
16024,1263,1190,1,Personal,23,4,54452,23,4,55091,23,4,56091,23,4,56669,23,4,57611,6,20.9,-1.257623,36.7463064,-1.2654136,36.7825146,722,942,639,1578
16025,9926,733,3,Business,2,4,50250,2,4,50258,2,4,50262,2,4,51063,2,4,53101,23,23.25888921888938,-1.2551895,36.7822034,-1.3452448,36.9101666,438,2038,8,805
16026,23191,2847,2,Personal,19,5,59732,19,5,59806,19,5,60339,19,5,61183,19,5,62353,6,24.2,-1.2675613,36.8133001,-1.2822773,36.7953121,607,1170,74,1377
16027,6926,2989,3,Business,11,5,48141,11,5,48613,11,5,50148,11,5,50788,11,5,52370,19,26.3,-1.3562374,36.9042954,-1.3472066,36.7692638,114,1582,472,2175
16028,16922,909,3,Business,11,4,50297,11,4,50313,11,4,50925,11,4,51429,11,4,53797,13,26.5,-1.225322,36.80855,-1.2857117,36.7968296,191,2368,16,1116
16029,13822,1051,3,Business,31,2,54942,31,2,54983,31,2,55421,31,2,55569,31,2,57404,9,22.2,-1.2963097,36.7688221,-1.2930128,36.8356869,140,1835,41,586
16030,19703,1724,3,Business,5,1,43265,5,1,43276,5,1,43708,5,1,43839,5,1,44439,3,24.4,-1.2593061,36.8071016,-1.2551895,36.7822034,660,600,11,563
16031,24942,393,3,Business,25,1,43287,25,1,43310,25,1,43498,25,1,44168,25,1,45749,14,25.4,-1.3167113,36.8301563,-1.306378,36.7519845,839,1581,23,858
16032,24799,214,1,Personal,13,3,33631,13,3,33847,13,3,34362,13,3,35232,13,3,36547,5,16.1,-1.2616213,36.8221128,-1.2538731,36.7850223,808,1315,216,1385
16033,79,1244,3,Business,9,6,38551,9,6,38574,9,6,38759,9,6,39381,9,6,40430,8,24.7,-1.307143,36.825009,-1.303596,36.778378,326,1049,23,807
16034,24708,824,1,Business,19,5,47783,19,5,47801,19,5,48981,19,5,49484,19,5,51331,21,27.2,-1.207546,36.7913976,-1.1234436,36.6770756,337,1847,18,1683
16035,3031,457,3,Personal,10,3,60023,10,3,60130,10,3,60667,10,3,61137,10,3,62716,8,27.4,-1.2697893,36.8124106,-1.3095666,36.7698746,461,1579,107,1007
16036,2283,3005,3,Personal,8,2,47099,8,2,47118,8,2,47492,8,2,48155,8,2,48792,5,21.2,-1.2753109,36.8130185,-1.2650042,36.7903927,100,637,19,1037
16037,27620,53,3,Business,8,2,33713,8,2,37331,8,2,38312,8,2,38916,8,2,40164,5,23.5,-1.3004062,36.829741,-1.2770708,36.8231093,725,1248,3618,1585
16038,15967,1085,3,Business,4,1,44975,4,1,45001,4,1,46616,4,1,46742,4,1,48458,7,25.5,-1.232864,36.8084708,-1.2536275,36.7987932,131,1716,26,1741
16039,7052,1459,3,Business,4,2,56785,4,2,56831,4,2,57126,4,2,57212,4,2,59336,17,20.6,-1.264945,36.784678,-1.3429554,36.7262559,848,2124,46,381
16040,25199,2184,1,Personal,30,1,53043,30,1,54285,30,1,55796,30,1,55965,30,1,57333,6,20.7,-1.2764786,36.8194788,-1.2444408,36.7934817,882,1368,1242,1680
16041,25135,2532,3,Business,9,2,57285,9,2,58647,9,2,58691,9,2,60200,9,2,61102,6,27.6,-1.2571472,36.7950633,-1.2824911,36.8218042,119,902,1362,1553
16042,3658,3222,3,Business,25,5,50991,25,5,51282,25,5,51948,25,5,52141,25,5,53574,7,29.0,-1.2551895,36.7822034,-1.2936941,36.8156795,512,1433,291,859
16043,19600,393,3,Business,14,5,35988,14,5,36004,14,5,36011,14,5,36625,14,5,38334,14,17.3,-1.3228003,36.8306435,-1.2991441,36.7528804,168,1709,16,621
16044,5747,1502,3,Business,13,1,57814,13,1,58027,13,1,59461,13,1,61306,13,1,63364,13,23.25888921888938,-1.2232123,36.8932547,-1.279395,36.825364,787,2058,213,3279
16045,15618,53,3,Business,8,5,49837,8,5,52807,8,5,54332,8,5,55045,8,5,57594,4,30.4,-1.2770708,36.8231093,-1.3024505,36.8243189,349,2549,2970,2238
16046,24612,1690,3,Business,27,3,55029,27,3,55604,27,3,56578,27,3,57439,27,3,58874,6,23.25888921888938,-1.2938211,36.8270021,-1.304033,36.7848695,431,1435,575,1835
16047,24479,2869,3,Business,5,2,32224,5,2,32251,5,2,34339,5,2,34969,5,2,36065,10,21.0,-1.2584143,36.8048002,-1.3025826,36.7670807,880,1096,27,2718
16048,13942,633,3,Business,14,3,42584,14,3,42606,14,3,42613,14,3,43247,14,3,43679,4,24.7,-1.3077869,36.8443207,-1.3004062,36.829741,239,432,22,641
16049,30,419,3,Business,7,2,51851,7,2,51873,7,2,52289,7,2,52650,7,2,56482,23,23.25888921888938,-1.3700383,36.9190174,-1.2571472,36.7950633,238,3832,22,777
16050,7586,1439,3,Business,6,3,50173,6,3,50202,6,3,51314,6,3,51516,6,3,52312,5,27.7,-1.2962487,36.7772971,-1.261403,36.7692242,246,796,29,1314
16051,11307,439,3,Business,29,4,47965,29,4,48043,29,4,48308,29,4,49272,29,4,50329,8,24.7,-1.3323107,36.8692616,-1.3002148,36.8353103,410,1057,78,1229
16052,9383,2711,1,Personal,30,4,36435,30,4,36828,30,4,37464,30,4,37551,30,4,38703,5,16.3,-1.3047132,36.8089553,-1.2924639,36.7795798,343,1152,393,723
16053,24542,1500,3,Business,21,1,47936,21,1,50939,21,1,51485,21,1,52290,21,1,53849,10,21.6,-1.3177547,36.8303703,-1.2569006,36.7925141,948,1559,3003,1351
16054,24893,2066,3,Business,30,5,30855,30,5,31116,30,5,32201,30,5,32444,30,5,33588,6,19.1,-1.3210189,36.8410551,-1.3291155,36.8861,114,1144,261,1328
16055,7456,1081,3,Business,13,3,39634,13,3,39662,13,3,39840,13,3,40136,13,3,41903,11,25.0,-1.2551895,36.7822034,-1.3173869,36.8112044,523,1767,28,474
16056,17381,393,3,Business,21,3,27485,21,3,32040,21,3,33245,21,3,34893,21,3,36653,14,16.8,-1.3177547,36.8303703,-1.306378,36.7519845,208,1760,4555,2853
16057,13558,2701,3,Business,22,4,33881,22,4,33911,22,4,35769,22,4,37154,22,4,39640,11,19.4,-1.2283403,36.8822756,-1.2765736,36.8513646,925,2486,30,3243
16058,1883,2922,2,Personal,23,3,40226,23,3,40393,23,3,41450,23,3,41931,23,3,42883,4,21.9,-1.2697141,36.7981777,-1.270054,36.815164,167,952,167,1538
16059,4594,3496,3,Business,11,4,54959,11,4,55965,11,4,57499,11,4,57675,11,4,58062,2,26.7,-1.300921,36.828195,-1.2929109,36.8315767,88,387,1006,1710
16060,18475,3561,3,Personal,24,5,42095,24,5,42172,24,5,43716,24,5,44351,24,5,45022,6,21.1,-1.2807298,36.8299116,-1.2658315,36.809049,857,671,77,2179
16061,18907,1594,3,Business,10,5,44917,10,5,45027,10,5,45880,10,5,46511,10,5,48056,9,23.25888921888938,-1.225322,36.80855,-1.2551895,36.7822034,607,1545,110,1484
16062,19080,1280,3,Business,25,4,51403,25,4,51431,25,4,51478,25,4,51831,25,4,53239,16,23.25888921888938,-1.2551895,36.7822034,-1.3297531,36.7063699,695,1408,28,400
16063,6123,2804,3,Business,22,5,44395,22,5,44425,22,5,45376,22,5,46138,22,5,46146,3,21.7,-1.254191,36.8099132,-1.2579304,36.8019667,427,8,30,1713
16064,5134,393,3,Business,22,2,51270,22,2,53468,22,2,53969,22,2,56507,22,2,56533,14,21.4,-1.3177547,36.8303703,-1.306378,36.7519845,656,26,2198,3039
16065,7260,540,3,Business,14,4,38995,14,4,39036,14,4,40053,14,4,40332,14,4,40335,3,23.7,-1.2551895,36.7822034,-1.2673725,36.8077775,647,3,41,1296
16066,8838,1242,3,Business,12,5,46703,12,5,49680,12,5,50325,12,5,50870,12,5,51427,4,23.25888921888938,-1.217907,36.8709199,-1.2167531,36.8825885,484,557,2977,1190
16067,11970,706,3,Business,4,5,50445,4,5,50462,4,5,50999,4,5,51423,4,5,52034,4,23.25888921888938,-1.3004062,36.829741,-1.3077869,36.8443207,237,611,17,961
16068,4843,2069,3,Business,7,5,57087,7,5,57384,7,5,58378,7,5,58510,7,5,60148,6,23.25888921888938,-1.2296618,36.8438272,-1.228911,36.881876,834,1638,297,1126
16069,1928,1336,3,Business,16,2,44609,16,2,44732,16,2,45126,16,2,46224,16,2,46584,2,23.5,-1.290894,36.822971,-1.2891922,36.825189,208,360,123,1492
16070,12311,2358,4,Business,3,1,62926,3,1,62946,3,1,62987,3,1,63724,3,1,64080,2,22.0,-1.302222,36.75873,-1.296797,36.7764525,449,356,20,778
16071,25670,2616,3,Personal,24,1,52569,24,1,52579,24,1,53263,24,1,53670,24,1,55040,10,23.25888921888938,-1.2294985,36.8775495,-1.2785465,36.8179074,858,1370,10,1091
16072,14216,3565,3,Business,30,5,58021,30,5,58043,30,5,58342,30,5,59051,30,5,60454,9,24.5,-1.2844665,36.7866113,-1.3207146,36.8305771,609,1403,22,1008
16073,371,3647,3,Business,6,2,42998,6,2,43069,6,2,43526,6,2,43843,6,2,44790,11,24.8,-1.272639,36.794723,-1.235348,36.760016,574,947,71,774
16074,13056,868,3,Business,7,5,41347,7,5,41395,7,5,43151,7,5,43627,7,5,44916,7,23.25888921888938,-1.2628473,36.781805,-1.2663631,36.8163329,427,1289,48,2232
16075,15658,1209,3,Business,6,1,39456,6,1,39491,6,1,41531,6,1,41786,6,1,42630,5,23.25888921888938,-1.2770708,36.8231093,-1.3004062,36.829741,790,844,35,2295
16076,1659,20,3,Business,22,4,60325,22,4,60333,22,4,60620,22,4,63173,22,4,66005,27,24.2,-1.413547,36.9550764,-1.2628638,36.8070399,886,2832,8,2840
16077,4725,993,1,Personal,20,1,56233,20,1,56284,20,1,56842,20,1,59616,20,1,60916,11,20.2,-1.2800881,36.8147037,-1.2643343,36.7447423,229,1300,51,3332
16078,5676,92,1,Personal,29,2,50171,29,2,50274,29,2,52720,29,2,52873,29,2,55007,17,23.8,-1.214328,36.7911903,-1.2846195,36.7958316,147,2134,103,2599
16079,6562,1293,3,Personal,20,1,40179,20,1,41725,20,1,43175,20,1,43659,20,1,44521,6,20.3,-1.2348866,36.8029959,-1.2543164,36.831861,882,862,1546,1934
16080,934,1347,1,Personal,27,4,40543,27,4,40764,27,4,40802,27,4,42958,27,4,43629,6,22.9,-1.3085095,36.8342635,-1.326825,36.864345,179,671,221,2194
16081,9887,1402,3,Business,16,2,30903,16,2,31723,16,2,32615,16,2,32804,16,2,33731,8,23.25888921888938,-1.2891922,36.825189,-1.2551895,36.7822034,726,927,820,1081
16082,10062,346,3,Business,18,1,33489,18,1,33512,18,1,33658,18,1,34427,18,1,34628,1,21.2,-1.28878,36.8168312,-1.2857548,36.819062,378,201,23,915
16083,2682,3291,3,Business,13,3,52581,13,3,52714,13,3,53946,13,3,54478,13,3,55821,5,23.3,-1.2628473,36.781805,-1.2600926,36.8088685,726,1343,133,1764
16084,5018,1902,1,Personal,25,1,49163,25,1,49191,25,1,49713,25,1,50042,25,1,50827,5,23.25888921888938,-1.2854453,36.8188363,-1.3038912,36.7961524,89,785,28,851
16085,16249,1464,2,Personal,10,5,45076,10,5,45088,10,5,47212,10,5,47634,10,5,49911,17,19.4,-1.2912419,36.8775284,-1.301774,36.7711066,234,2277,12,2546
16086,13986,2412,3,Business,14,4,46316,14,4,49963,14,4,52962,14,4,53276,14,4,56137,11,27.8,-1.2285835,36.8826468,-1.2803414,36.8265456,686,2861,3647,3313
16087,15643,136,3,Business,6,1,31518,6,1,33714,6,1,34693,6,1,34838,6,1,37104,22,23.25888921888938,-1.3254522,36.7216584,-1.23966,36.75258,572,2266,2196,1124
16088,24088,2080,3,Personal,15,1,52080,15,1,52266,15,1,53069,15,1,53385,15,1,54144,7,23.25888921888938,-1.2948998,36.789164,-1.2671137,36.8102851,291,759,186,1119
16089,16958,2532,3,Business,11,5,56340,11,5,60547,11,5,61462,11,5,61540,11,5,62855,6,24.3,-1.2551895,36.7822034,-1.285382,36.8162878,899,1315,4207,993
16090,19226,3647,3,Business,10,5,57180,10,5,57254,10,5,58234,10,5,58573,10,5,61275,19,23.25888921888938,-1.272639,36.794723,-1.3443917,36.6700333,279,2702,74,1319
16091,23034,2987,3,Business,23,2,37228,23,2,41902,23,2,42754,23,2,43277,23,2,45366,7,17.8,-1.270212,36.8210877,-1.3064585,36.8119065,518,2089,4674,1375
16092,11142,1004,3,Business,13,1,54506,13,1,55339,13,1,58385,13,1,58743,13,1,60852,12,23.25888921888938,-1.3250048,36.8697188,-1.277551,36.8273641,364,2109,833,3404
16093,18651,2216,3,Business,15,5,52952,15,5,53014,15,5,53477,15,5,55433,15,5,55436,19,28.2,-1.2551895,36.7822034,-1.3327654,36.8853117,953,3,62,2419
16094,23598,3674,3,Business,20,5,33403,20,5,33436,20,5,33601,20,5,33981,20,5,35686,8,14.7,-1.2551895,36.7822034,-1.2910974,36.7902687,726,1705,33,545
16095,19380,3517,3,Business,30,4,50344,30,4,50359,30,4,50666,30,4,51983,30,4,54313,15,23.25888921888938,-1.300921,36.828195,-1.3882008,36.7699445,211,2330,15,1624
16096,15024,1584,3,Business,4,1,50614,4,1,51993,4,1,52221,4,1,53008,4,1,53858,6,23.25888921888938,-1.2969741,36.7856612,-1.2857524,36.8196806,906,850,1379,1015
16097,9642,868,3,Business,7,4,37670,7,4,39572,7,4,39903,7,4,40531,7,4,41432,5,17.2,-1.2600926,36.8088685,-1.265715,36.823815,727,901,1902,959
16098,25853,391,3,Business,31,1,47522,31,1,47566,31,1,48082,31,1,48424,31,1,49018,6,21.1,-1.2599563,36.7993439,-1.2867454,36.8259017,576,594,44,858
16099,21724,2561,3,Business,5,5,45201,5,5,45409,5,5,48697,5,5,49027,5,5,50309,7,27.4,-1.2551895,36.7822034,-1.2871938,36.8195031,448,1282,208,3618
16100,20897,3203,3,Business,26,2,55085,26,2,55118,26,2,56184,26,2,56837,26,2,57753,9,23.25888921888938,-1.265715,36.823815,-1.228911,36.881876,427,916,33,1719
16101,12772,111,3,Business,21,5,54641,21,5,54712,21,5,55132,21,5,55336,21,5,56907,10,27.1,-1.2551895,36.7822034,-1.3201096,36.8180968,848,1571,71,624
16102,9406,2469,3,Business,18,2,56413,18,2,56421,18,2,57160,18,2,62947,18,2,65413,20,23.7,-1.3802726,36.9442993,-1.308231,36.857306,43,2466,8,6526
16103,1348,412,3,Business,5,2,55470,5,2,56500,5,2,58263,5,2,58785,5,2,61026,15,27.5,-1.344446,36.756597,-1.266837,36.799249,812,2241,1030,2285
16104,26877,3438,1,Personal,3,2,50935,3,2,51060,3,2,51810,3,2,52109,3,2,53358,4,20.0,-1.2953803,36.8156295,-1.2810205,36.8248105,88,1249,125,1049
16105,7254,419,3,Business,18,5,54029,18,5,54051,18,5,54518,18,5,55232,18,5,56097,5,27.0,-1.2884146,36.8107668,-1.2571472,36.7950633,137,865,22,1181
16106,158,868,3,Business,14,5,57986,14,5,58554,14,5,59229,14,5,59928,14,5,59934,3,23.1,-1.2783849,36.8163445,-1.265715,36.823815,510,6,568,1374
16107,12774,186,3,Business,8,1,33585,8,1,33620,8,1,33932,8,1,35126,8,1,36533,17,22.1,-1.2902869,36.8085396,-1.3700383,36.9190174,953,1407,35,1506
16108,27539,2378,2,Personal,26,3,30377,26,3,30573,26,3,31201,26,3,32004,26,3,33474,11,18.8,-1.2669736,36.8040985,-1.309124,36.8468293,279,1470,196,1431
16109,9961,2956,3,Business,1,1,54750,1,1,55373,1,1,56087,1,1,56293,1,1,57688,4,23.25888921888938,-1.2584143,36.8048002,-1.2821422,36.8161565,506,1395,623,920
16110,24062,1103,3,Business,3,4,53927,3,4,53995,3,4,54865,3,4,55649,3,4,56388,7,25.8,-1.290894,36.822971,-1.2551895,36.7822034,404,739,68,1654
16111,920,214,1,Personal,6,3,30697,6,3,30714,6,3,32202,6,3,32482,6,3,33475,7,15.8,-1.2616213,36.8221128,-1.2838866,36.7802282,103,993,17,1768
16112,19133,3283,3,Business,21,4,45939,21,4,45959,21,4,46098,21,4,46391,21,4,47669,7,25.2,-1.303596,36.778378,-1.2628473,36.781805,958,1278,20,432
16113,11546,3147,3,Business,9,2,65193,9,2,65231,9,2,65857,9,2,66170,9,2,68348,17,27.8,-1.2859912,36.8756811,-1.3467389,36.7690312,709,2178,38,939
16114,2732,2532,3,Business,13,3,50754,13,3,51077,13,3,51366,13,3,51633,13,3,56085,9,27.1,-1.2551895,36.7822034,-1.2942,36.7777614,411,4452,323,556
16115,11005,972,3,Business,26,6,55576,26,6,55610,26,6,56423,26,6,56647,26,6,58420,9,28.2,-1.2862033,36.8152966,-1.290239,36.7620412,21,1773,34,1037
16116,1745,1642,3,Business,9,3,41675,9,3,43789,9,3,44386,9,3,45311,9,3,47423,5,25.2,-1.288269,36.8182753,-1.2728069,36.7962362,425,2112,2114,1522
16117,10774,3214,3,Business,26,2,36934,26,2,36948,26,2,37221,26,2,37455,26,2,38154,3,22.0,-1.289795,36.7957132,-1.304735,36.7846054,829,699,14,507
16118,23624,288,1,Personal,30,1,33543,30,1,45377,30,1,45897,30,1,46291,30,1,47303,7,22.4,-1.2876365,36.816096,-1.296797,36.7764525,19,1012,11834,914
16119,131,3525,3,Business,5,3,53992,5,3,56279,5,3,56999,5,3,57259,5,3,59927,17,24.9,-1.3700383,36.9190174,-1.295324,36.839629,532,2668,2287,980
16120,23702,2066,3,Business,1,6,40841,1,6,40859,1,6,41041,1,6,41895,1,6,42397,5,18.4,-1.316961,36.820337,-1.3230485,36.839476,179,502,18,1036
16121,16198,3517,3,Business,17,3,54732,17,3,54757,17,3,55773,17,3,58640,17,3,60315,16,23.25888921888938,-1.300921,36.828195,-1.3882008,36.7699445,126,1675,25,3883
16122,7736,3647,3,Business,10,1,53952,10,1,55243,10,1,56708,10,1,57156,10,1,58144,5,18.2,-1.272639,36.794723,-1.2833106,36.8240238,155,988,1291,1913
16123,2739,661,3,Business,22,5,42175,22,5,42303,22,5,43882,22,5,45599,22,5,46325,4,21.5,-1.2963097,36.7688221,-1.2950044,36.7512209,312,726,128,3296
16124,26381,1500,3,Business,26,5,37134,26,5,37159,26,5,37196,26,5,37824,26,5,39115,5,23.25888921888938,-1.2638185,36.7930057,-1.2615048,36.8116724,576,1291,25,665
16125,764,1091,1,Personal,13,3,46325,13,3,46442,13,3,46862,13,3,47754,13,3,49039,5,20.3,-1.2660357,36.7898223,-1.2764786,36.8194788,268,1285,117,1312
16126,10107,2828,2,Business,26,4,41931,26,4,41943,26,4,43397,26,4,43977,26,4,45370,14,19.0,-1.2429937,36.8754167,-1.2615888,36.7928732,510,1393,12,2034
16127,20830,868,3,Business,11,1,55835,11,1,56024,11,1,56701,11,1,57650,11,1,58379,4,28.8,-1.2600926,36.8088685,-1.265715,36.823815,205,729,189,1626
16128,7743,46,3,Business,13,4,55178,13,4,55433,13,4,55709,13,4,58408,13,4,58661,8,23.0,-1.2996396,36.8520799,-1.278847,36.8253462,864,253,255,2975
16129,17642,53,3,Business,18,4,48633,18,4,48738,18,4,49340,18,4,51624,18,4,52396,5,23.25888921888938,-1.3004062,36.829741,-1.2770708,36.8231093,910,772,105,2886
16130,21471,1882,3,Business,26,2,30961,26,2,31068,26,2,31913,26,2,33102,26,2,34238,7,23.25888921888938,-1.2958783,36.7928125,-1.2588775,36.8079744,332,1136,107,2034
16131,14564,3589,1,Personal,22,5,35804,22,5,35812,22,5,35976,22,5,36693,22,5,38525,12,16.3,-1.2579304,36.8019667,-1.3080793,36.7505396,228,1832,8,881
16132,25816,35,2,Personal,2,6,57129,2,6,57164,2,6,57613,2,6,58069,2,6,59740,17,23.8,-1.2824577,36.7967953,-1.3703367,36.7466655,322,1671,35,905
16133,18524,3283,3,Business,25,5,36933,25,5,36969,25,5,37351,25,5,37774,25,5,38265,5,20.5,-1.2600926,36.8088685,-1.2628473,36.781805,4,491,36,805
16134,24994,1787,3,Business,13,4,48595,13,4,48611,13,4,48655,13,4,49034,13,4,50168,5,23.2,-1.2283403,36.8822756,-1.2467896,36.8698733,416,1134,16,423
16135,14789,793,3,Personal,8,3,40265,8,3,40309,8,3,40707,8,3,41420,8,3,41798,6,22.4,-1.2681211,36.7792474,-1.2559294,36.788465,116,378,44,1111
16136,10109,3698,3,Business,15,3,35105,15,3,35138,15,3,36362,15,3,36424,15,3,37300,5,23.25888921888938,-1.3103985,36.9114173,-1.3244885,36.897792,411,876,33,1286
16137,1168,3091,3,Business,18,5,53707,18,5,53764,18,5,54480,18,5,54560,18,5,55577,3,27.0,-1.3012008,36.764868,-1.3002865,36.7491504,548,1017,57,796
16138,3812,1719,3,Business,22,3,52881,22,3,54461,22,3,54589,22,3,54991,22,3,58042,13,24.5,-1.2963097,36.7688221,-1.23966,36.75258,819,3051,1580,530
16139,26511,1932,3,Business,9,1,44942,9,1,44954,9,1,45889,9,1,46252,9,1,46592,2,20.3,-1.2873232,36.7658572,-1.2985987,36.7809119,312,340,12,1298
16140,11710,3372,3,Business,3,5,35442,3,5,35448,3,5,35628,3,5,35817,3,5,38229,18,17.5,-1.304033,36.7848695,-1.2143387,36.7914548,414,2412,6,369
16141,27989,3283,3,Business,3,4,33768,3,4,34157,3,4,34213,3,4,35902,3,4,37118,9,17.5,-1.307143,36.825009,-1.2628473,36.781805,813,1216,389,1745
16142,26581,60,3,Business,11,1,40478,11,1,40496,11,1,40506,11,1,43158,11,1,45436,15,23.8,-1.303596,36.778378,-1.2296618,36.8438272,26,2278,18,2662
16143,14877,1209,3,Business,23,2,48341,23,2,48490,23,2,49673,23,2,49929,23,2,51501,12,23.25888921888938,-1.2991441,36.7528804,-1.3004062,36.829741,306,1572,149,1439
16144,14320,2528,3,Business,4,1,30640,4,1,30679,4,1,31574,4,1,32422,4,1,33049,3,21.9,-1.2584143,36.8048002,-1.2551895,36.7822034,267,627,39,1743
16145,23911,3404,3,Business,6,3,52158,6,3,52233,6,3,52862,6,3,53337,6,3,58938,22,27.5,-1.279395,36.825364,-1.159242,36.922571,812,5601,75,1104
16146,8789,1060,1,Personal,13,5,33769,13,5,33781,13,5,34449,13,5,34912,13,5,37224,17,15.7,-1.263194,36.797624,-1.317767,36.8982529,116,2312,12,1131
16147,21132,346,3,Business,8,5,42377,8,5,43306,8,5,43381,8,5,45611,8,5,47090,14,28.6,-1.2156006,36.8916865,-1.28878,36.8168312,836,1479,929,2305
16148,24658,2209,3,Business,13,3,51078,13,3,51269,13,3,52672,13,3,52933,13,3,54458,7,23.5,-1.268768,36.841871,-1.3031805,36.818276,890,1525,191,1664
16149,1446,2521,3,Business,11,6,41704,11,6,41900,11,6,41915,11,6,42326,11,6,42902,8,21.0,-1.3177547,36.8303703,-1.2770708,36.8231093,586,576,196,426
16150,7547,3291,3,Business,2,2,48328,2,2,48662,2,2,48668,2,2,49441,2,2,51877,12,29.3,-1.228911,36.881876,-1.2600926,36.8088685,518,2436,334,779
16151,8059,2279,3,Business,18,2,36467,18,2,36516,18,2,37641,18,2,38447,18,2,40229,12,22.8,-1.3196809,36.8410572,-1.2571472,36.7950633,956,1782,49,1931
16152,14992,2523,3,Business,5,2,42587,5,2,42688,5,2,44251,5,2,45174,5,2,46525,14,23.8,-1.2551895,36.7822034,-1.2402455,36.8791753,25,1351,101,2486
16153,820,391,3,Business,3,1,48171,3,1,51028,3,1,51488,3,1,53355,3,1,53841,7,23.4,-1.2522036,36.8565636,-1.2784063,36.8222933,472,486,2857,2327
16154,13684,3711,3,Business,14,5,55447,14,5,56388,14,5,56647,14,5,57807,14,5,59326,9,23.9,-1.2676026,36.8103629,-1.3014461,36.7661381,454,1519,941,1419
16155,15563,776,1,Personal,1,5,55020,1,5,55750,1,5,55766,1,5,56551,1,5,57494,6,24.2,-1.278967,36.8236745,-1.2796952,36.7829895,805,943,730,801
16156,17798,2415,1,Personal,11,3,49744,11,3,49829,11,3,50210,11,3,50842,11,3,52751,4,20.5,-1.285521,36.816526,-1.2619982,36.8136975,159,1909,85,1013
16157,727,1046,1,Personal,12,5,56743,12,5,57487,12,5,58578,12,5,58685,12,5,59451,7,27.0,-1.3054537,36.8284768,-1.3321614,36.7820281,299,766,744,1198
16158,26233,3203,3,Business,17,1,54028,17,1,54038,17,1,54066,17,1,54866,17,1,55491,10,24.6,-1.2727269,36.8298864,-1.228911,36.881876,408,625,10,828
16159,12637,1271,3,Business,11,1,46853,11,1,46863,11,1,46879,11,1,48565,11,1,49858,14,23.9,-1.310613,36.8101948,-1.3244885,36.897792,925,1293,10,1702
16160,25046,1088,1,Personal,17,1,53336,17,1,53344,17,1,54546,17,1,54609,17,1,55873,14,28.2,-1.3175119,36.8058513,-1.3281885,36.8937091,409,1264,8,1265
16161,9004,867,3,Business,18,1,57166,18,1,57224,18,1,58224,18,1,59369,18,1,60109,11,30.9,-1.2991441,36.7528804,-1.2996533,36.8292629,327,740,58,2145
16162,10984,411,3,Business,17,1,58415,17,1,58446,17,1,60003,17,1,62970,17,1,66348,11,22.8,-1.3111623,36.8436727,-1.2768326,36.8073804,206,3378,31,4524
16163,14291,867,3,Business,19,2,46114,19,2,46192,19,2,46521,19,2,48876,19,2,48879,10,29.9,-1.2996533,36.8292629,-1.2991441,36.7528804,953,3,78,2684
16164,17524,571,3,Business,4,4,58482,4,4,58489,4,4,58500,4,4,59011,4,4,61665,15,27.3,-1.3236332,36.701152,-1.2793503,36.8039715,831,2654,7,522
16165,21683,2509,3,Business,28,4,39906,28,4,40002,28,4,41280,28,4,41395,28,4,44353,12,23.25888921888938,-1.2579304,36.8019667,-1.3332749,36.8708147,520,2958,96,1393
16166,15757,391,3,Business,19,2,54819,19,2,55076,19,2,55583,19,2,56057,19,2,57094,5,29.5,-1.2602337,36.7990548,-1.2867454,36.8259017,785,1037,257,981
16167,14358,540,3,Business,1,4,56982,1,4,57159,1,4,57889,1,4,57971,1,4,58701,4,23.25888921888938,-1.2551895,36.7822034,-1.2753109,36.8130185,79,730,177,812
16168,11350,1237,1,Personal,14,5,34234,14,5,34323,14,5,34944,14,5,35387,14,5,36177,2,18.4,-1.2741728,36.7969108,-1.2611987,36.8060913,228,790,89,1064
16169,3623,136,3,Business,15,2,45571,15,2,45580,15,2,46544,15,2,47123,15,2,48920,15,24.2,-1.2943371,36.8267,-1.3254522,36.7216584,45,1797,9,1543
16170,1884,2154,3,Business,17,1,52130,17,1,54501,17,1,55220,17,1,56866,17,1,58744,10,24.4,-1.2551895,36.7822034,-1.2765736,36.8513646,150,1878,2371,2365
16171,7179,391,3,Business,1,4,43461,1,4,46890,1,4,47952,1,4,49846,1,4,51408,5,23.25888921888938,-1.2599563,36.7993439,-1.2867454,36.8259017,685,1562,3429,2956
16172,12123,393,3,Business,15,3,39991,15,3,40027,15,3,40701,15,3,41171,15,3,41650,4,23.25888921888938,-1.3167113,36.8301563,-1.3004062,36.829741,211,479,36,1144
16173,18540,2532,3,Business,17,5,46049,17,5,46061,17,5,46136,17,5,46288,17,5,47837,8,23.25888921888938,-1.2551895,36.7822034,-1.3024794,36.8228284,709,1549,12,227
16174,22350,246,3,Business,27,2,48819,27,2,48828,27,2,48985,27,2,49273,27,2,50370,10,25.8,-1.2584143,36.8048002,-1.2413316,36.8785525,685,1097,9,445
16175,12998,2212,3,Business,11,2,42593,11,2,42625,11,2,43035,11,2,43329,11,2,43887,2,19.4,-1.2571472,36.7950633,-1.2682478,36.8072852,770,558,32,704
16176,14004,635,3,Business,26,6,40092,26,6,40286,26,6,40781,26,6,42300,26,6,43131,8,26.0,-1.3081376,36.8329772,-1.2602337,36.7990548,842,831,194,2014
16177,2275,3560,3,Business,7,4,36413,7,4,36476,7,4,36753,7,4,37094,7,4,39026,14,23.25888921888938,-1.279395,36.825364,-1.324731,36.907109,378,1932,63,618
16178,1135,1205,3,Business,27,3,40651,27,3,40661,27,3,40829,27,3,41062,27,3,42491,8,25.9,-1.2495931,36.8065087,-1.2973188,36.7895013,484,1429,10,401
16179,24769,393,3,Business,30,2,34114,30,2,34148,30,2,34430,30,2,35039,30,2,36795,14,17.3,-1.3177547,36.8303703,-1.306378,36.7519845,555,1756,34,891
16180,22428,1500,3,Business,13,1,58569,13,1,59400,13,1,59701,13,1,59797,13,1,60824,9,23.25888921888938,-1.2638185,36.7930057,-1.3004062,36.829741,381,1027,831,397
16181,9442,1245,3,Business,27,3,29064,27,3,29300,27,3,32049,27,3,34302,27,3,36111,19,23.25888921888938,-1.300921,36.828195,-1.3198615,36.7110323,581,1809,236,5002
16182,27801,3470,3,Business,30,5,51102,30,5,51721,30,5,52232,30,5,52686,30,5,55184,1,24.6,-1.28878,36.8168312,-1.2858424,36.8190802,267,2498,619,965
16183,4015,3149,3,Business,8,1,48609,8,1,48672,8,1,49100,8,1,49640,8,1,50554,7,29.8,-1.3077869,36.8443207,-1.3167113,36.8301563,349,914,63,968
16184,2672,3291,3,Business,13,4,46075,13,4,46235,13,4,48557,13,4,48736,13,4,50697,16,22.9,-1.293515,36.897607,-1.2600926,36.8088685,746,1961,160,2501
16185,24441,868,3,Business,16,4,61340,16,4,61658,16,4,63339,16,4,63999,16,4,65199,8,19.2,-1.303596,36.778378,-1.265715,36.823815,82,1200,318,2341
16186,909,265,3,Business,6,6,39660,6,6,39735,6,6,40533,6,6,42226,6,6,43501,10,26.9,-1.300921,36.828195,-1.3323949,36.8915219,709,1275,75,2491
16187,10263,2140,1,Personal,4,2,59659,4,2,61164,4,2,61734,4,2,63278,4,2,63630,4,21.3,-1.2790175,36.8151778,-1.2545163,36.8243717,620,352,1505,2114
16188,426,186,3,Business,19,2,58820,19,2,58875,19,2,59586,19,2,60741,19,2,61103,4,28.5,-1.2571472,36.7950633,-1.2825816,36.8092346,678,362,55,1866
16189,5613,478,3,Business,6,3,32628,6,3,32659,6,3,32965,6,3,33157,6,3,33735,3,23.25888921888938,-1.2551895,36.7822034,-1.2628638,36.8070399,958,578,31,498
16190,11035,1693,3,Business,24,1,57422,24,1,57452,24,1,58519,24,1,58911,24,1,59536,4,23.25888921888938,-1.269534,36.80697,-1.2574088,36.799712,434,625,30,1459
16191,12656,893,3,Business,22,1,47357,22,1,48808,22,1,50005,22,1,50254,22,1,51378,5,26.2,-1.2663194,36.809901,-1.2872652,36.8267613,612,1124,1451,1446
16192,7815,868,3,Business,31,1,37149,31,1,37166,31,1,37191,31,1,39004,31,1,39719,4,21.0,-1.2600926,36.8088685,-1.265715,36.823815,427,715,17,1838
16193,4391,567,3,Business,29,1,39475,29,1,39519,29,1,40652,29,1,41057,29,1,41713,3,23.25888921888938,-1.2745551,36.7979797,-1.295908,36.791433,559,656,44,1538
16194,7942,868,3,Business,16,2,59896,16,2,59935,16,2,60444,16,2,60740,16,2,61730,6,23.25888921888938,-1.3033561,36.8163631,-1.265715,36.823815,570,990,39,805
16195,17291,3331,3,Business,25,5,46254,25,5,46300,25,5,46373,25,5,46736,25,5,47606,4,26.2,-1.2551895,36.7822034,-1.273526,36.80664,15,870,46,436
16196,27795,246,3,Business,4,2,52835,4,2,61723,4,2,61802,4,2,62433,4,2,64605,6,22.2,-1.281754,36.8324229,-1.2584143,36.8048002,878,2172,8888,710
16197,3632,2976,3,Business,29,1,29236,29,1,33105,29,1,33894,29,1,34221,29,1,35213,4,23.25888921888938,-1.2606251,36.7833256,-1.2562797,36.8075858,427,992,3869,1116
16198,20528,204,3,Personal,31,2,55937,31,2,55963,31,2,57526,31,2,57782,31,2,59803,16,22.3,-1.2309879,36.8873186,-1.3043821,36.7840586,812,2021,26,1819
16199,4064,2861,1,Personal,2,2,35172,2,2,35210,2,2,36361,2,2,36768,2,2,37679,9,15.3,-1.2942632,36.8113036,-1.2560455,36.7800867,100,911,38,1558
16200,27295,1193,1,Personal,16,3,39828,16,3,39904,16,3,40520,16,3,40844,16,3,41948,10,24.0,-1.3020912,36.808145,-1.2579304,36.8019667,742,1104,76,940
16201,27077,2801,3,Business,29,4,46263,29,4,46299,29,4,46382,29,4,47799,29,4,48422,5,21.7,-1.2595422,36.7871178,-1.2753109,36.8130185,322,623,36,1500
16202,26862,1075,3,Business,6,3,46000,6,3,46030,6,3,46083,6,3,47053,6,3,49126,5,23.25888921888938,-1.279395,36.825364,-1.2527958,36.8003131,267,2073,30,1023
16203,25868,3667,3,Personal,24,2,44423,24,2,44436,24,2,44697,24,2,45038,24,2,46771,14,17.3,-1.2684239,36.7952462,-1.3248448,36.8564697,229,1733,13,602
16204,23091,3147,3,Business,28,5,49317,28,5,50747,28,5,52154,28,5,52669,28,5,54780,22,25.2,-1.3632162,36.9108253,-1.3472066,36.7692638,711,2111,1430,1922
16205,17526,2873,1,Personal,13,5,56051,13,5,56144,13,5,56823,13,5,57174,13,5,58904,13,19.1,-1.2406196,36.7736495,-1.2947442,36.7624888,752,1730,93,1030
16206,24459,2363,1,Personal,6,5,65168,6,5,65176,6,5,65494,6,5,66087,6,5,67688,12,23.25888921888938,-1.2649605,36.7981777,-1.20079,36.77198,103,1601,8,911
16207,15177,2287,1,Personal,4,3,49166,4,3,49226,4,3,50514,4,3,50599,4,3,51331,10,18.3,-1.296797,36.7764525,-1.315756,36.813058,74,732,60,1373
16208,9424,3647,3,Business,9,5,41083,9,5,41104,9,5,42709,9,5,42786,9,5,45481,16,25.9,-1.272639,36.794723,-1.2701894,36.90246,620,2695,21,1682
16209,20461,2596,3,Business,18,2,44063,18,2,44110,18,2,44505,18,2,44986,18,2,45628,2,23.25888921888938,-1.2975066,36.7689423,-1.3014461,36.7661381,649,642,47,876
16210,24375,3689,3,Business,5,1,48917,5,1,49755,5,1,50310,5,1,50499,5,1,51528,5,26.1,-1.279395,36.825364,-1.2527958,36.8003131,634,1029,838,744
16211,11918,795,3,Personal,17,2,51482,17,2,51671,17,2,51863,17,2,52041,17,2,56237,11,24.3,-1.3104734,36.7363698,-1.2551895,36.7822034,735,4196,189,370
16212,15433,2015,1,Personal,24,1,39830,24,1,39889,24,1,41588,24,1,42681,24,1,43809,9,22.7,-1.3472066,36.7692638,-1.2956882,36.7861845,65,1128,59,2792
16213,17509,246,3,Business,13,4,30323,13,4,30334,13,4,30790,13,4,31113,13,4,33932,6,18.6,-1.2584143,36.8048002,-1.2597436,36.8282526,847,2819,11,779
16214,27372,633,3,Business,17,4,43394,17,4,43481,17,4,43956,17,4,44307,17,4,44803,4,25.6,-1.3077869,36.8443207,-1.3004062,36.829741,588,496,87,826
16215,25150,788,3,Business,23,5,51893,23,5,54639,23,5,57258,23,5,57393,23,5,58635,9,26.2,-1.2551895,36.7822034,-1.225322,36.80855,878,1242,2746,2754
16216,1498,1451,1,Personal,20,1,64782,20,1,64796,20,1,65190,20,1,65487,20,1,66928,9,20.3,-1.2931317,36.7778105,-1.3182646,36.8213128,105,1441,14,691
16217,26315,3057,2,Personal,2,4,33758,2,4,33783,2,4,34155,2,4,36510,2,4,37063,6,13.3,-1.2543164,36.831861,-1.258984,36.835837,427,553,25,2727
16218,23642,3517,3,Business,26,5,51573,26,5,53669,26,5,55050,26,5,56603,26,5,58862,20,23.25888921888938,-1.300921,36.828195,-1.2847613,36.967084,61,2259,2096,2934
16219,18532,2716,3,Business,9,2,55232,9,2,55266,9,2,55837,9,2,56426,9,2,62062,5,30.4,-1.2917868,36.7872675,-1.3038156,36.8122733,548,5636,34,1160
16220,6227,2989,3,Business,2,4,51432,2,4,52414,2,4,53797,2,4,54851,2,4,55949,12,26.4,-1.3463042,36.768164,-1.2863535,36.8193957,101,1098,982,2437
16221,12689,2801,3,Business,22,5,43392,22,5,43408,22,5,44332,22,5,45976,22,5,47852,15,23.25888921888938,-1.3104506,36.8687235,-1.2595422,36.7871178,883,1876,16,2568
16222,26504,2541,1,Personal,9,1,63100,9,1,63198,9,1,65393,9,1,66219,9,1,67795,8,20.4,-1.29237,36.8241297,-1.2955042,36.7714687,858,1576,98,3021
16223,26913,633,3,Business,21,4,52048,21,4,52572,21,4,52705,21,4,54530,21,4,54536,4,31.0,-1.2770708,36.8231093,-1.3004062,36.829741,436,6,524,1958
16224,13727,186,3,Business,6,3,43767,6,3,43782,6,3,44973,6,3,45175,6,3,47540,17,23.25888921888938,-1.2571472,36.7950633,-1.3169591,36.7000029,4,2365,15,1393
16225,15182,3496,3,Business,26,6,42614,26,6,42643,26,6,43153,26,6,43826,26,6,45578,19,26.2,-1.300921,36.828195,-1.2016807,36.9153397,882,1752,29,1183
16226,11880,3217,1,Business,3,1,52590,3,1,52669,3,1,53266,3,1,54963,3,1,56097,15,23.1,-1.28878,36.8168312,-1.2143387,36.7914548,249,1134,79,2294
16227,13395,1927,3,Business,14,2,53578,14,2,53614,14,2,53984,14,2,54408,14,2,56064,15,23.25888921888938,-1.2584143,36.8048002,-1.3472066,36.7692638,953,1656,36,794
16228,13394,3727,3,Business,16,2,42220,16,2,43717,16,2,43948,16,2,44134,16,2,45019,3,23.25888921888938,-1.2963097,36.7688221,-1.293393,36.790237,154,885,1497,417
16229,9701,111,3,Business,9,4,56638,9,4,57758,9,4,58815,9,4,59196,9,4,59753,4,23.25888921888938,-1.2551895,36.7822034,-1.2707177,36.8009828,576,557,1120,1438
16230,2727,2102,3,Business,30,2,41861,30,2,41886,30,2,42658,30,2,43036,30,2,45578,15,22.2,-1.3323107,36.8692616,-1.2613768,36.8019418,329,2542,25,1150
16231,15954,136,3,Business,27,1,44683,27,1,44719,27,1,46422,27,1,46539,27,1,47406,4,20.8,-1.2654716,36.7983635,-1.2553627,36.8196282,344,867,36,1820
16232,23235,1724,3,Business,18,2,40907,18,2,42227,18,2,44064,18,2,44187,18,2,48171,15,23.25888921888938,-1.2551895,36.7822034,-1.206696,36.847709,899,3984,1320,1960
16233,13339,265,3,Business,4,1,48246,4,1,48276,4,1,49600,4,1,51954,4,1,53175,13,22.6,-1.300921,36.828195,-1.374589,36.772046,844,1221,30,3678
16234,20626,1819,1,Personal,30,4,41323,30,4,41763,30,4,42452,30,4,42740,30,4,43818,7,20.1,-1.3108368,36.8226308,-1.3231598,36.7821562,224,1078,440,977
16235,18476,2763,3,Business,22,3,28679,22,3,28726,22,3,30523,22,3,30801,22,3,32705,5,19.0,-1.2551895,36.7822034,-1.2696908,36.81519,228,1904,47,2075
16236,21986,868,3,Business,9,3,54060,9,3,54140,9,3,54439,9,3,54572,9,3,55341,7,25.5,-1.2628473,36.781805,-1.265715,36.823815,72,769,80,432
16237,4035,136,3,Business,11,1,46639,11,1,46680,11,1,47557,11,1,47893,11,1,49114,11,23.8,-1.2313147,36.8016863,-1.2560874,36.7931031,959,1221,41,1213
16238,22798,2448,2,Personal,9,3,55179,9,3,55531,9,3,55548,9,3,56722,9,3,58399,7,23.3,-1.28713,36.818133,-1.2962603,36.7766164,410,1677,352,1191
16239,23570,91,3,Personal,15,3,54667,15,3,54704,15,3,57496,15,3,58439,15,3,59293,9,25.8,-1.2990731,36.8488058,-1.2809134,36.8145375,819,854,37,3735
16240,8733,2507,2,Personal,3,4,34492,3,4,34557,3,4,35896,3,4,36054,3,4,38002,14,17.1,-1.2930931,36.7559267,-1.3170904,36.8509938,648,1948,65,1497
16241,27184,2008,3,Business,26,5,41446,26,5,42830,26,5,43406,26,5,43836,26,5,45269,7,23.25888921888938,-1.2508229,36.7895263,-1.285244,36.832159,713,1433,1384,1006
16242,15297,1340,3,Business,22,5,54746,22,5,54862,22,5,55820,22,5,56104,22,5,57182,7,27.2,-1.2943795,36.7591248,-1.2707179,36.7979713,315,1078,116,1242
16243,1278,2330,3,Business,15,2,54169,15,2,54288,15,2,54335,15,2,54534,15,2,56046,5,24.8,-1.2890715,36.8157588,-1.2637057,36.80517,247,1512,119,246
16244,2320,3291,3,Business,8,6,35887,8,6,35934,8,6,37556,8,6,38167,8,6,39095,5,20.0,-1.2628473,36.781805,-1.2600926,36.8088685,523,928,47,2233
16245,12717,3222,3,Business,27,2,40663,27,2,40738,27,2,40760,27,2,41869,27,2,42382,5,23.6,-1.2977565,36.8025534,-1.2821378,36.7740428,390,513,75,1131
16246,19559,2207,3,Business,28,2,50846,28,2,50858,28,2,52071,28,2,52762,28,2,54869,12,19.7,-1.2100103,36.797424,-1.2696908,36.81519,882,2107,12,1904
16247,2037,3291,3,Business,17,3,48395,17,3,48434,17,3,49123,17,3,50040,17,3,50714,5,23.25888921888938,-1.2566689,36.7796952,-1.2600926,36.8088685,217,674,39,1606
16248,27672,909,3,Business,30,5,37511,30,5,37594,30,5,38470,30,5,38544,30,5,40401,13,23.8,-1.225322,36.80855,-1.1668055,36.8304448,928,1857,83,950
16249,13111,3621,3,Business,24,4,62131,24,4,62147,24,4,63360,24,4,63430,24,4,64820,5,26.2,-1.2836583,36.7886014,-1.2859576,36.8197604,462,1390,16,1283
16250,26863,1926,3,Business,8,2,43312,8,2,45170,8,2,45541,8,2,46208,8,2,46754,3,21.6,-1.2897368,36.8226783,-1.267548,36.803249,100,546,1858,1038
16251,20553,1205,3,Business,27,3,39409,27,3,39452,27,3,39453,27,3,40309,27,3,42261,17,26.2,-1.2495931,36.8065087,-1.3218455,36.7213009,831,1952,43,857
16252,11997,978,1,Personal,17,2,50394,17,2,50928,17,2,52242,17,2,53764,17,2,55556,4,24.4,-1.3084067,36.8345014,-1.2805312,36.8326687,939,1792,534,2836
16253,14187,3641,3,Business,13,3,43663,13,3,43670,13,3,43717,13,3,43934,13,3,44401,3,23.25888921888938,-1.2551895,36.7822034,-1.25537,36.7756,709,467,7,264
16254,2432,1210,1,Personal,6,7,41751,6,7,41812,6,7,43257,6,7,43445,6,7,44601,5,21.9,-1.2867132,36.8118433,-1.2747671,36.8139951,159,1156,61,1633
16255,18824,3264,3,Business,11,5,37001,11,5,37018,11,5,37862,11,5,37947,11,5,39287,9,20.9,-1.2551895,36.7822034,-1.2963316,36.7863289,269,1340,17,929
16256,25265,1856,3,Business,2,5,58496,2,5,58522,2,5,59030,2,5,59183,2,5,60841,8,25.0,-1.273009,36.802807,-1.2592335,36.8449224,620,1658,26,661
16257,27701,1544,3,Business,10,1,46643,10,1,46805,10,1,47351,10,1,47765,10,1,49526,7,18.5,-1.2813012,36.8323962,-1.2860203,36.7832538,868,1761,162,960
16258,28203,1865,1,Personal,7,7,50537,7,7,51951,7,7,53026,7,7,53278,7,7,54640,16,28.0,-1.2166078,36.882501,-1.2790653,36.7907262,397,1362,1414,1327
16259,14943,3291,3,Business,30,6,35249,30,6,35262,30,6,35280,30,6,40410,30,6,42189,12,26.5,-1.228911,36.881876,-1.2600926,36.8088685,260,1779,13,5148
16260,640,1368,3,Business,11,1,53291,11,1,53679,11,1,54136,11,1,54935,11,1,57549,15,28.2,-1.2571472,36.7950633,-1.3366311,36.7690928,205,2614,388,1256
16261,23653,1966,3,Business,12,3,58409,12,3,59565,12,3,59654,12,3,60484,12,3,62514,21,20.4,-1.3700383,36.9190174,-1.2917868,36.7872675,56,2030,1156,919
16262,12282,1300,3,Personal,5,2,57691,5,2,57801,5,2,59755,5,2,59848,5,2,61187,7,24.8,-1.2795819,36.8307141,-1.277783,36.7816464,959,1339,110,2047
16263,26120,20,3,Business,4,2,40454,4,2,41156,4,2,43010,4,2,43617,4,2,47311,6,19.6,-1.2628638,36.8070399,-1.300722,36.816865,62,3694,702,2461
16264,21523,516,3,Business,30,2,39168,30,2,39243,30,2,40092,30,2,40319,30,2,41986,7,23.25888921888938,-1.2551895,36.7822034,-1.2540684,36.8239518,547,1667,75,1076
16265,9966,393,3,Business,10,5,38614,10,5,38622,10,5,38627,10,5,39760,10,5,42028,14,23.25888921888938,-1.3167113,36.8301563,-1.2991441,36.7528804,349,2268,8,1138
16266,27788,1642,3,Business,10,3,54012,10,3,54255,10,3,55451,10,3,55740,10,3,56605,5,30.7,-1.2728069,36.7962362,-1.2876365,36.816096,709,865,243,1485
16267,19798,346,3,Business,7,4,56747,7,4,60267,7,4,61093,7,4,61431,7,4,64196,16,29.2,-1.3165542,36.700067,-1.28878,36.8168312,831,2765,3520,1164
16268,8776,286,3,Business,30,5,58004,30,5,58168,30,5,59055,30,5,59487,30,5,60695,17,24.7,-1.2551895,36.7822034,-1.214301,36.895182,516,1208,164,1319
16269,17361,635,3,Business,28,5,53583,28,5,53761,28,5,54139,28,5,54235,28,5,54757,7,25.3,-1.2599563,36.7993439,-1.3016417,36.8271679,937,522,178,474
16270,21007,2521,3,Business,9,6,40060,9,6,40073,9,6,40077,9,6,42974,9,6,42977,4,27.1,-1.3167113,36.8301563,-1.3004062,36.829741,39,3,13,2901
16271,3304,2619,2,Personal,5,4,39221,5,4,39238,5,4,40232,5,4,42519,5,4,44913,5,23.25888921888938,-1.2795796,36.819062,-1.2649605,36.7981777,951,2394,17,3281
16272,27210,3291,3,Business,23,3,42369,23,3,42483,23,3,43636,23,3,44436,23,3,45027,5,21.8,-1.2628473,36.781805,-1.2600926,36.8088685,360,591,114,1953
16273,20764,1304,3,Business,9,1,59337,9,1,59407,9,1,59807,9,1,60513,9,1,63554,15,20.2,-1.2551895,36.7822034,-1.3038645,36.8684596,279,3041,70,1106
16274,7384,2789,3,Business,21,5,34170,21,5,34220,21,5,34718,21,5,35240,21,5,36851,10,19.6,-1.304735,36.7846054,-1.3297531,36.7063699,829,1611,50,1020
16275,11787,635,3,Business,21,4,27927,21,4,28140,21,4,29161,21,4,30042,21,4,36375,19,21.9,-1.3081376,36.8329772,-1.223961,36.7169413,419,6333,213,1902
16276,22154,2075,1,Personal,23,1,44582,23,1,44612,23,1,45429,23,1,45735,23,1,46654,7,18.6,-1.29276,36.783799,-1.2551895,36.7822034,519,919,30,1123
16277,24667,1724,3,Business,26,5,37028,26,5,37053,26,5,37403,26,5,38124,26,5,39828,11,23.25888921888938,-1.32189,36.8589727,-1.2941648,36.7977315,709,1704,25,1071
16278,3228,3291,3,Business,11,6,32039,11,6,32056,11,6,32199,11,6,32687,11,6,34617,11,23.25888921888938,-1.303596,36.778378,-1.2600926,36.8088685,650,1930,17,631
16279,11410,1246,3,Business,25,5,56563,25,5,56589,25,5,57522,25,5,58792,25,5,59120,3,29.3,-1.2571472,36.7950633,-1.2515637,36.8119508,822,328,26,2203
16280,21413,3091,3,Business,26,1,43716,26,1,43726,26,1,44058,26,1,45048,26,1,46641,10,23.2,-1.2527958,36.8003131,-1.3012008,36.764868,322,1593,10,1322
16281,23604,3669,3,Business,10,5,49849,10,5,52978,10,5,53426,10,5,54054,10,5,56122,12,23.25888921888938,-1.2615888,36.7928732,-1.2095044,36.7832064,553,2068,3129,1076
16282,26844,186,3,Business,10,3,42397,10,3,42448,10,3,44604,10,3,47199,10,3,47299,20,27.9,-1.2571472,36.7950633,-1.3700383,36.9190174,652,100,51,4751
16283,27195,3091,3,Business,8,2,60768,8,2,63487,8,2,64354,8,2,65648,8,2,67021,9,23.6,-1.3165542,36.700067,-1.3012008,36.764868,237,1373,2719,2161
16284,16982,1307,3,Business,19,6,42351,19,6,42367,19,6,42871,19,6,43274,19,6,44273,5,21.8,-1.2844665,36.7866113,-1.2948802,36.766374,898,999,16,907
16285,10011,2330,3,Business,28,4,52348,28,4,52705,28,4,52828,28,4,53124,28,4,55443,13,30.0,-1.2284323,36.8757058,-1.2649605,36.7981777,101,2319,357,419
16286,11701,868,3,Business,25,5,31560,25,5,31598,25,5,33413,25,5,35546,25,5,37344,14,20.8,-1.293515,36.897607,-1.265715,36.823815,332,1798,38,3948
16287,24050,2195,3,Business,15,6,38281,15,6,38293,15,6,38694,15,6,39758,15,6,40562,9,19.4,-1.265715,36.823815,-1.228911,36.881876,591,804,12,1465
16288,5955,3561,3,Personal,18,4,50536,18,4,50581,18,4,50740,18,4,50935,18,4,52137,3,26.8,-1.2658315,36.809049,-1.2719878,36.7907694,434,1202,45,354
16289,25588,375,3,Business,12,2,66186,12,2,66194,12,2,66247,12,2,66798,12,2,67135,2,26.5,-1.2551895,36.7822034,-1.2566078,36.7832089,958,337,8,604
16290,25682,3291,3,Business,30,4,37462,30,4,37551,30,4,37565,30,4,38803,30,4,38812,4,23.25888921888938,-1.2663631,36.8163329,-1.2600926,36.8088685,497,9,89,1252
16291,2535,3201,3,Business,31,4,35414,31,4,35454,31,4,35701,31,4,36179,31,4,36381,2,20.4,-1.2584143,36.8048002,-1.2591019,36.800577,607,202,40,725
16292,15331,2587,3,Business,16,2,55820,16,2,55874,16,2,59513,16,2,59738,16,2,60710,4,23.25888921888938,-1.28878,36.8168312,-1.2922992,36.7983035,123,972,54,3864
16293,644,3530,1,Personal,25,2,45231,25,2,45292,25,2,48373,25,2,48580,25,2,49711,4,23.8,-1.2813498,36.7930729,-1.2804664,36.7701111,565,1131,61,3288
16294,19048,3752,3,Business,12,3,53340,12,3,53513,12,3,53987,12,3,54125,12,3,55783,7,20.9,-1.2495931,36.8065087,-1.2962832,36.7849683,155,1658,173,612
16295,21362,393,3,Business,23,2,39801,23,2,39814,23,2,39820,23,2,41707,23,2,41718,4,23.25888921888938,-1.3167113,36.8301563,-1.3004062,36.829741,619,11,13,1893
16296,25586,2131,3,Personal,21,4,75062,21,4,75096,21,4,75418,21,4,75674,21,4,76347,4,24.7,-1.2963097,36.7688221,-1.2981858,36.747492,678,673,34,578
16297,14257,1502,3,Business,4,1,56828,4,1,57311,4,1,57318,4,1,57533,4,1,60987,23,23.25888921888938,-1.3472066,36.7692638,-1.2232123,36.8932547,649,3454,483,222
16298,12074,262,3,Business,28,1,51130,28,1,51360,28,1,52297,28,1,52894,28,1,53474,2,24.3,-1.2679971,36.8088937,-1.2696908,36.81519,726,580,230,1534
16299,11252,1687,3,Business,3,2,48994,3,2,49570,3,2,50282,3,2,50495,3,2,51245,4,20.2,-1.2817542,36.816867,-1.263453,36.7955612,266,750,576,925
16300,22024,3647,3,Business,2,4,43866,2,4,43921,2,4,44542,2,4,44930,2,4,45670,5,23.25888921888938,-1.272639,36.794723,-1.2655477,36.8001682,279,740,55,1009
16301,17989,3688,3,Business,13,3,57435,13,3,57463,13,3,59469,13,3,59534,13,3,62294,14,27.4,-1.2551895,36.7822034,-1.3263105,36.8622904,579,2760,28,2071
16302,11321,2804,3,Business,18,4,51653,18,4,51744,18,4,52987,18,4,53297,18,4,53789,1,26.7,-1.262805,36.7942423,-1.2571472,36.7950633,893,492,91,1553
16303,22668,393,3,Business,6,1,49776,6,1,49820,6,1,49827,6,1,50641,6,1,52007,11,23.25888921888938,-1.3167113,36.8301563,-1.2638185,36.7930057,386,1366,44,821
16304,26787,1578,3,Business,24,4,56310,24,4,59246,24,4,59748,24,4,60259,24,4,64568,7,25.8,-1.28878,36.8168312,-1.3083495,36.840715,34,4309,2936,1013
16305,26368,733,3,Business,5,5,43773,5,5,43847,5,5,44821,5,5,45212,5,5,46256,5,24.7,-1.2571472,36.7950633,-1.2793503,36.8039715,576,1044,74,1365
16306,21402,1205,3,Business,9,2,31723,9,2,31837,9,2,33113,9,2,33840,9,2,35345,8,17.6,-1.2706815,36.7646286,-1.257309,36.8060084,368,1505,114,2003
16307,5953,60,3,Business,10,1,55410,10,1,55613,10,1,58854,10,1,59772,10,1,61494,9,18.7,-1.2783849,36.8163445,-1.2296618,36.8438272,158,1722,203,4159
16308,23018,302,3,Business,1,4,68094,1,4,68182,1,4,70941,1,4,71191,1,4,71745,4,19.3,-1.2649605,36.7981777,-1.262896,36.8231727,4,554,88,3009
16309,1988,592,3,Personal,20,1,50465,20,1,50483,20,1,51182,20,1,53320,20,1,55196,15,23.25888921888938,-1.312745,36.875715,-1.2637791,36.7920072,68,1876,18,2837
16310,12711,3208,3,Personal,11,1,43972,11,1,45649,11,1,46631,11,1,46954,11,1,48522,7,17.9,-1.3068448,36.8348641,-1.3123652,36.7964266,791,1568,1677,1305
16311,13559,393,3,Business,7,5,34513,7,5,34534,7,5,34538,7,5,37563,7,5,37565,14,23.25888921888938,-1.3228003,36.8306435,-1.2991441,36.7528804,39,2,21,3029
16312,9582,3647,3,Business,28,2,37936,28,2,38067,28,2,39170,28,2,39664,28,2,40540,5,21.3,-1.272639,36.794723,-1.2854174,36.7951152,617,876,131,1597
16313,14926,1500,3,Business,21,4,33094,21,4,33107,21,4,33114,21,4,35609,21,4,35729,8,21.8,-1.3004062,36.829741,-1.2638185,36.7930057,41,120,13,2502
16314,26452,3303,3,Business,3,2,52426,3,2,52638,3,2,53616,3,2,53789,3,2,54130,3,20.1,-1.2934527,36.7755139,-1.271606,36.791095,312,341,212,1151
16315,10760,2310,1,Business,24,1,37092,24,1,37125,24,1,38861,24,1,40123,24,1,40126,6,22.3,-1.2711571,36.9017288,-1.2859912,36.8756811,771,3,33,2998
16316,13802,633,3,Business,3,4,31597,3,4,32547,3,4,33283,3,4,33671,3,4,34945,9,20.2,-1.2574219,36.7927073,-1.3004062,36.829741,576,1274,950,1124
16317,25507,246,3,Business,31,1,44441,31,1,44492,31,1,44867,31,1,46288,31,1,46293,6,20.9,-1.290894,36.822971,-1.2584143,36.8048002,456,5,51,1796
16318,24398,926,3,Personal,19,2,36494,19,2,36694,19,2,37236,19,2,38301,19,2,40314,6,23.25888921888938,-1.2560455,36.7800867,-1.2637057,36.80517,116,2013,200,1607
16319,14649,2718,3,Business,4,3,60247,4,3,61605,4,3,63901,4,3,64712,4,3,67859,18,23.25888921888938,-1.3103985,36.9114173,-1.2601,36.796528,248,3147,1358,3107
16320,5928,3283,3,Business,14,2,34543,14,2,34593,14,2,35901,14,2,37448,14,2,39187,19,23.25888921888938,-1.293515,36.897607,-1.2628473,36.781805,195,1739,50,2855
16321,1053,2931,3,Business,11,5,35930,11,5,35945,11,5,35959,11,5,36024,11,5,38765,22,20.8,-1.2452664,36.8028541,-1.3433181,36.9138018,512,2741,15,79
16322,3784,717,1,Personal,1,3,48501,1,3,48521,1,3,49136,1,3,49269,1,3,51321,12,23.7,-1.3067965,36.849351,-1.2583976,36.7980465,648,2052,20,748
16323,12429,136,3,Business,11,2,49900,11,2,50271,11,2,51990,11,2,52641,11,2,53521,6,21.2,-1.3360945,36.7445491,-1.3254522,36.7216584,155,880,371,2370
16324,26456,2030,3,Business,8,3,52638,8,3,52674,8,3,52912,8,3,53066,8,3,53884,3,25.7,-1.2963097,36.7688221,-1.295908,36.791433,754,818,36,392
16325,1634,2763,3,Business,22,5,53359,22,5,53415,22,5,53496,22,5,53649,22,5,54278,4,30.9,-1.2551895,36.7822034,-1.2768326,36.8073804,263,629,56,234
16326,28162,598,2,Business,19,3,48973,19,3,49006,19,3,49962,19,3,53248,19,3,53864,2,25.8,-1.2536797,36.7995085,-1.2655332,36.8094648,101,616,33,4242
16327,28160,978,1,Personal,16,2,55974,16,2,57553,16,2,58485,16,2,59106,16,2,61420,5,27.6,-1.3084067,36.8345014,-1.2805312,36.8326687,942,2314,1579,1553
16328,4772,867,3,Business,25,1,40262,25,1,40528,25,1,41294,25,1,42548,25,1,44398,10,27.3,-1.2996533,36.8292629,-1.2991441,36.7528804,506,1850,266,2020
16329,14013,2073,3,Business,17,1,49850,17,1,50811,17,1,51972,17,1,53612,17,1,55238,21,28.4,-1.3882008,36.7699445,-1.2849829,36.8542111,539,1626,961,2801
16330,15701,517,3,Business,18,6,35998,18,6,36014,18,6,36332,18,6,36805,18,6,37310,4,23.25888921888938,-1.3167113,36.8301563,-1.3004062,36.829741,211,505,16,791
16332,7709,1687,3,Business,27,3,45723,27,3,45757,27,3,46255,27,3,47166,27,3,47881,3,26.0,-1.2626574,36.8014034,-1.2732803,36.7940377,952,715,34,1409
16333,3443,1068,1,Personal,19,5,37105,19,5,37127,19,5,37814,19,5,38577,19,5,39967,7,24.7,-1.2615006,36.8012725,-1.277585,36.77145,611,1390,22,1450
16334,15192,2423,3,Business,11,1,46457,11,1,46591,11,1,47072,11,1,47560,11,1,48715,7,26.4,-1.2551895,36.7822034,-1.285213,36.817885,576,1155,134,969
16335,13093,3291,3,Business,21,1,36330,21,1,36359,21,1,36696,21,1,37587,21,1,38321,5,22.6,-1.2628473,36.781805,-1.2600926,36.8088685,322,734,29,1228
16336,16316,2701,3,Business,3,1,44028,3,1,44495,3,1,45715,3,1,46364,3,1,48400,8,21.4,-1.2527958,36.7976244,-1.2765736,36.8513646,567,2036,467,1869
16337,18242,1075,3,Business,23,4,33433,23,4,33464,23,4,34350,23,4,35276,23,4,36179,5,23.25888921888938,-1.2527958,36.8003131,-1.279395,36.825364,491,903,31,1812
16338,18051,2330,3,Business,13,2,55642,13,2,57293,13,2,57424,13,2,58769,13,2,59254,3,26.1,-1.3015197,36.7658456,-1.2868601,36.7738025,45,485,1651,1476
16339,8877,1340,3,Business,31,4,42633,31,4,42646,31,4,42776,31,4,43615,31,4,43618,2,26.4,-1.2667532,36.8024002,-1.2707179,36.7979713,19,3,13,969
16340,23892,2994,1,Personal,26,2,54533,26,2,54598,26,2,55096,26,2,55467,26,2,56557,7,23.25888921888938,-1.268027,36.8037005,-1.2913246,36.8019522,832,1090,65,869
16341,1046,1089,1,Personal,6,3,50626,6,3,52054,6,3,55869,6,3,56529,6,3,58010,6,21.9,-1.2871938,36.8195031,-1.2536042,36.8064895,192,1481,1428,4475
16342,19527,3355,3,Business,9,3,30228,9,3,36890,9,3,37273,9,3,38131,9,3,38818,4,21.3,-1.3052491,36.8223899,-1.2866012,36.8195691,100,687,6662,1241
16343,1095,661,3,Business,6,4,40373,6,4,40402,6,4,41424,6,4,42885,6,4,43987,4,21.8,-1.3092046,36.7458722,-1.2963097,36.7688221,548,1102,29,2483
16344,4158,2216,3,Business,5,2,45705,5,2,46832,5,2,47586,5,2,49774,5,2,52153,17,23.25888921888938,-1.2867627,36.883446,-1.2876804,36.7802778,699,2379,1127,2942
16345,23180,3147,3,Business,10,5,46263,10,5,46316,10,5,47426,10,5,47911,10,5,50514,12,23.25888921888938,-1.2831203,36.8316065,-1.3472066,36.7692638,591,2603,53,1595
16346,2456,1271,3,Business,12,5,33167,12,5,33176,12,5,35310,12,5,39151,12,5,41821,13,24.6,-1.2772469,36.8370656,-1.3107918,36.761794,208,2670,9,5975
16347,16039,813,3,Personal,14,1,37434,14,1,37457,14,1,37730,14,1,38057,14,1,39114,6,23.3,-1.299207,36.8414337,-1.2986123,36.8076281,111,1057,23,600
16348,12674,265,3,Business,21,1,46114,21,1,46135,21,1,46160,21,1,47737,21,1,49628,13,25.5,-1.2482465,36.8889062,-1.300921,36.828195,75,1891,21,1602
16349,22886,661,3,Business,22,5,42211,22,5,42296,22,5,43876,22,5,45593,22,5,46320,4,21.7,-1.2963097,36.7688221,-1.2950044,36.7512209,312,727,85,3297
16350,10777,2869,3,Business,18,4,46243,18,4,46332,18,4,48248,18,4,49129,18,4,50658,9,23.25888921888938,-1.279395,36.825364,-1.3025826,36.7670807,338,1529,89,2797
16351,10633,2523,3,Business,22,2,56786,22,2,57255,22,2,60179,22,2,60821,22,2,62350,17,18.1,-1.2626906,36.7827022,-1.206542,36.9012626,844,1529,469,3566
16352,13563,186,3,Business,2,3,57060,2,3,57090,2,3,57626,2,3,58597,2,3,59231,5,26.2,-1.2890399,36.8164942,-1.2571472,36.7950633,698,634,30,1507
16353,17397,3222,3,Business,17,1,53217,17,1,53234,17,1,53252,17,1,53614,17,1,53770,3,24.8,-1.2551895,36.7822034,-1.25537,36.7756,107,156,17,380
16354,8794,2330,3,Business,26,4,52742,26,4,52779,26,4,53235,26,4,53338,26,4,55883,22,21.9,-1.2614329,36.8094365,-1.380892,36.923378,726,2545,37,559
16355,18451,467,3,Business,8,3,33699,8,3,33732,8,3,34303,8,3,34499,8,3,35826,7,23.25888921888938,-1.304735,36.7846054,-1.2619185,36.759662,548,1327,33,767
16356,27934,2956,3,Business,26,1,59222,26,1,59235,26,1,59498,26,1,59969,26,1,60825,3,20.0,-1.2584143,36.8048002,-1.2551895,36.7822034,50,856,13,734
16357,11528,633,3,Business,19,2,54564,19,2,54595,19,2,54985,19,2,55743,19,2,56210,4,29.3,-1.3077869,36.8443207,-1.3004062,36.829741,206,467,31,1148
16358,5691,1245,3,Business,13,5,47361,13,5,47442,13,5,49853,13,5,50763,13,5,53078,17,19.2,-1.300921,36.828195,-1.3198615,36.7110323,618,2315,81,3321
16359,4379,2858,3,Business,23,5,32806,23,5,33009,23,5,34080,23,5,34232,23,5,36205,12,20.3,-1.3166008,36.7021489,-1.2675334,36.7658246,871,1973,203,1223
16360,23571,1484,3,Business,30,3,52804,30,3,52916,30,3,53216,30,3,53338,30,3,54166,4,29.0,-1.2551895,36.7822034,-1.2738522,36.7992818,576,828,112,422
16361,10927,393,3,Business,6,3,33316,6,3,33324,6,3,33330,6,3,34599,6,3,36447,14,16.6,-1.3228003,36.8306435,-1.306378,36.7519845,523,1848,8,1275
16362,18638,2457,3,Business,5,1,60640,5,1,60780,5,1,61550,5,1,61784,5,1,62467,4,24.5,-1.2551895,36.7822034,-1.269534,36.80697,279,683,140,1004
16363,6569,1932,3,Business,5,2,37584,5,2,37609,5,2,37982,5,2,38213,5,2,38671,2,21.4,-1.2873232,36.7658572,-1.2922857,36.7813274,65,458,25,604
16364,7383,2956,3,Business,14,2,35600,14,2,35664,14,2,36418,14,2,36887,14,2,38548,7,23.25888921888938,-1.225322,36.80855,-1.2584143,36.8048002,383,1661,64,1223
16365,14892,3560,3,Business,19,6,39163,19,6,39203,19,6,40892,19,6,41471,19,6,48056,8,25.3,-1.3014461,36.7661381,-1.279395,36.825364,362,6585,40,2268
16366,2747,3434,3,Business,20,1,57139,20,1,57193,20,1,57435,20,1,58166,20,1,60279,19,21.2,-1.2963097,36.7688221,-1.3261259,36.904086,100,2113,54,973
16367,15496,3493,1,Personal,24,1,34362,24,1,34388,24,1,35507,24,1,35730,24,1,37492,16,15.4,-1.3278463,36.819099,-1.2623805,36.7805404,328,1762,26,1342
16368,23158,136,3,Business,10,3,47966,10,3,48001,10,3,49059,10,3,49182,10,3,51745,16,30.6,-1.3254522,36.7216584,-1.2561502,36.8077003,545,2563,35,1181
16369,22044,2154,3,Business,17,3,56519,17,3,56596,17,3,56942,17,3,58576,17,3,60198,5,23.25888921888938,-1.290894,36.822971,-1.2765736,36.8513646,910,1622,77,1980
16370,4489,3283,3,Business,4,2,43634,4,2,43661,4,2,43673,4,2,44464,4,2,45264,6,20.5,-1.2663631,36.8163329,-1.2628473,36.781805,800,800,27,803
16371,16250,2579,3,Business,6,2,37406,6,2,37416,6,2,37718,6,2,37950,6,2,39237,7,24.8,-1.287428,36.7800821,-1.3031315,36.8175661,854,1287,10,534
16372,19180,2520,2,Personal,27,1,31706,27,1,31747,27,1,32355,27,1,32718,27,1,34113,13,16.6,-1.277783,36.7816464,-1.3083777,36.8590077,249,1395,41,971
16373,3348,3560,3,Business,29,2,60718,29,2,60950,29,2,60980,29,2,62205,29,2,62753,2,23.25888921888938,-1.2813012,36.8323962,-1.279395,36.825364,237,548,232,1255
16374,4574,391,3,Business,29,3,40140,29,3,40242,29,3,40724,29,3,41226,29,3,42761,5,23.25888921888938,-1.2602337,36.7990548,-1.2784063,36.8222933,139,1535,102,984
16375,10474,246,3,Business,3,1,31241,3,1,31252,3,1,31321,3,1,31660,3,1,31671,3,15.2,-1.2584143,36.8048002,-1.2551895,36.7822034,875,11,11,408
16376,18981,1995,3,Business,17,3,65229,17,3,65313,17,3,65932,17,3,66106,17,3,67855,7,23.25888921888938,-1.2551895,36.7822034,-1.2813012,36.8323962,96,1749,84,793
16377,1975,2030,3,Business,16,5,52144,16,5,55132,16,5,55652,16,5,57440,16,5,58345,4,23.25888921888938,-1.2508229,36.7895263,-1.2753109,36.8130185,434,905,2988,2308
16378,27431,1927,3,Business,8,5,41727,8,5,41781,8,5,42316,8,5,42448,8,5,44889,14,28.4,-1.3472066,36.7692638,-1.265715,36.808525,263,2441,54,667
16379,8571,2956,3,Business,15,4,32907,15,4,33124,15,4,33514,15,4,33744,15,4,36459,10,19.5,-1.2584143,36.8048002,-1.2413316,36.8785525,103,2715,217,620
16380,27437,2767,3,Business,10,6,29859,10,6,31052,10,6,32586,10,6,35784,10,6,37456,10,20.9,-1.3079928,36.8389933,-1.257773,36.795486,646,1672,1193,4732
16381,26106,498,1,Personal,15,2,32516,15,2,32626,15,2,33830,15,2,33919,15,2,34842,5,18.1,-1.3046965,36.8016456,-1.3178672,36.8121663,782,923,110,1293
16382,27282,2987,3,Business,26,1,37109,26,1,39933,26,1,41456,26,1,41670,26,1,42588,4,22.9,-1.270212,36.8210877,-1.2534301,36.8000983,322,918,2824,1737
16383,8390,1567,2,Personal,10,3,38566,10,3,38586,10,3,38941,10,3,39174,10,3,41458,15,22.3,-1.2705739,36.8023118,-1.2326779,36.6871223,74,2284,20,588
16384,27627,2676,3,Business,5,2,40223,5,2,40258,5,2,40560,5,2,41227,5,2,48941,2,25.3,-1.2963097,36.7688221,-1.3014461,36.7661381,365,7714,35,969
16385,22332,1131,3,Business,30,1,40996,30,1,41010,30,1,41429,30,1,42248,30,1,44325,16,22.7,-1.2914308,36.8018867,-1.214328,36.7911903,882,2077,14,1238
16386,8748,2306,3,Business,12,2,37678,12,2,37699,12,2,38925,12,2,39395,12,2,41487,10,28.0,-1.2271998,36.8084905,-1.2787076,36.8315314,785,2092,21,1696
16387,21715,1299,3,Business,2,1,42551,2,1,42563,2,1,43301,2,1,45239,2,1,46622,3,19.3,-1.2652093,36.8064216,-1.282543,36.824618,616,1383,12,2676
16388,14043,1075,3,Business,22,6,60088,22,6,62583,22,6,62608,22,6,64523,22,6,65541,5,23.9,-1.2777926,36.8215788,-1.2527958,36.8003131,40,1018,2495,1940
16389,14623,3283,3,Business,18,5,41115,18,5,41123,18,5,41252,18,5,42377,18,5,42989,5,19.9,-1.2600926,36.8088685,-1.2628473,36.781805,383,612,8,1254
16390,20946,1329,3,Business,11,1,57051,11,1,57092,11,1,57307,11,1,58112,11,1,60356,16,28.2,-1.273056,36.811298,-1.1855066,36.8254646,584,2244,41,1020
16391,8807,2682,1,Personal,27,4,43546,27,4,43556,27,4,43852,27,4,44566,27,4,45499,6,22.9,-1.2950408,36.8098172,-1.2753109,36.8130185,932,933,10,1010
16392,21082,1927,3,Business,18,1,35141,18,1,35159,18,1,36059,18,1,36372,18,1,39102,14,21.2,-1.3012008,36.764868,-1.3472066,36.7692638,517,2730,18,1213
16393,15562,1850,3,Business,13,3,57636,13,3,57776,13,3,58136,13,3,58890,13,3,61982,8,29.4,-1.2551895,36.7822034,-1.3033012,36.8170864,865,3092,140,1114
16394,15133,1849,3,Business,20,4,58410,20,4,58592,20,4,59211,20,4,59428,20,4,61654,5,25.1,-1.290894,36.822971,-1.2900089,36.7885633,576,2226,182,836
16395,22073,246,3,Business,12,1,46632,12,1,46653,12,1,47035,12,1,47309,12,1,47555,2,24.0,-1.2584143,36.8048002,-1.2591019,36.800577,756,246,21,656
16396,5770,1850,3,Business,6,4,55806,6,4,55921,6,4,56077,6,4,56218,6,4,56446,2,23.3,-1.2551895,36.7822034,-1.2638185,36.7832391,116,228,115,297
16397,16692,1724,3,Business,24,4,43243,24,4,43255,24,4,43454,24,4,44022,24,4,45410,9,21.4,-1.2553615,36.7895376,-1.2970279,36.761356,228,1388,12,767
16398,24502,1500,3,Business,29,5,33988,29,5,34078,29,5,36697,29,5,38728,29,5,40060,8,26.6,-1.3004062,36.829741,-1.2638185,36.7930057,763,1332,90,4650
16399,14699,393,3,Business,7,2,34543,7,2,34628,7,2,35360,7,2,37590,7,2,38695,6,23.25888921888938,-1.3167113,36.8301563,-1.3077869,36.8443207,155,1105,85,2962
16400,4847,1244,3,Business,29,5,46095,29,5,46377,29,5,47658,29,5,49712,29,5,51546,9,29.0,-1.272828,36.816608,-1.303596,36.778378,655,1834,282,3335
16401,16662,3445,1,Personal,21,4,58211,21,4,58263,21,4,58505,21,4,58738,21,4,59569,4,22.3,-1.2615983,36.8083096,-1.2516793,36.786481,216,831,52,475
16402,22912,3149,3,Business,26,5,53557,26,5,53996,26,5,54145,26,5,55716,26,5,56101,5,23.25888921888938,-1.3004062,36.829741,-1.3177547,36.8303703,97,385,439,1720
16403,17780,3727,3,Business,6,2,49162,6,2,49981,6,2,50246,6,2,50372,6,2,51110,3,27.4,-1.2963097,36.7688221,-1.2884128,36.7906666,958,738,819,391
16404,16505,2166,2,Personal,11,3,40280,11,3,40505,11,3,41776,11,3,42148,11,3,43042,8,19.0,-1.2804989,36.8303462,-1.2343087,36.84749,808,894,225,1643
16405,10908,1209,3,Business,3,3,29690,3,3,29843,3,3,30075,3,3,30632,3,3,32321,5,21.4,-1.3004062,36.829741,-1.3228003,36.8306435,690,1689,153,789
16406,15824,1368,3,Business,29,4,50859,29,4,51454,29,4,52800,29,4,53244,29,4,54501,8,24.9,-1.2571472,36.7950633,-1.2905979,36.8442582,404,1257,595,1790
16407,21974,2423,3,Business,3,3,54811,3,3,55110,3,3,56610,3,3,57239,3,3,58513,7,28.0,-1.2571472,36.7950633,-1.2963546,36.8037035,177,1274,299,2129
16408,15013,2180,3,Personal,18,1,32058,18,1,32093,18,1,34255,18,1,36007,18,1,39756,22,21.3,-1.207546,36.7913976,-1.2963097,36.7688221,190,3749,35,3914
16409,24333,496,3,Business,2,4,42686,2,4,42783,2,4,42795,2,4,43286,2,4,44063,6,23.25888921888938,-1.2551895,36.7822034,-1.2889024,36.8187402,291,777,97,503
16410,18828,635,3,Business,26,2,47469,26,2,47582,26,2,48961,26,2,52140,26,2,53427,6,29.8,-1.3042118,36.8301215,-1.2602337,36.7990548,649,1287,113,4558
16411,20365,685,3,Business,27,1,45902,27,1,46046,27,1,47074,27,1,47371,27,1,48931,12,20.9,-1.2489594,36.7358883,-1.265432,36.795034,269,1560,144,1325
16412,17348,1502,3,Business,20,3,41131,20,3,41162,20,3,41855,20,3,42167,20,3,42827,5,26.2,-1.2283403,36.8822756,-1.2232123,36.8932547,75,660,31,1005
16413,19487,2102,3,Business,22,5,59310,22,5,59571,22,5,60335,22,5,62729,22,5,66518,13,28.6,-1.3323107,36.8692616,-1.387054,36.919474,127,3789,261,3158
16414,14188,2174,3,Business,30,6,43500,30,6,43509,30,6,43708,30,6,46609,30,6,49178,22,26.4,-1.2482781,36.884092,-1.3470009,36.7619454,82,2569,9,3100
16415,16371,478,3,Business,29,5,54809,29,5,54824,29,5,55518,29,5,56844,29,5,58795,14,21.4,-1.3060302,36.7665044,-1.2579304,36.8019667,247,1951,15,2020
16416,24647,136,3,Business,11,1,33352,11,1,33457,11,1,34911,11,1,35959,11,1,36876,12,17.8,-1.2738338,36.782403,-1.3254522,36.7216584,205,917,105,2502
16417,13508,635,3,Business,10,4,31812,10,4,31840,10,4,32232,10,4,32966,10,4,35465,17,19.3,-1.2599563,36.7993439,-1.177202,36.8351183,427,2499,28,1126
16418,16132,2358,4,Business,28,1,42253,28,1,42377,28,1,43632,28,1,44010,28,1,45001,12,22.8,-1.2805198,36.8277612,-1.2154586,36.8830064,208,991,124,1633
16419,1925,3599,3,Business,10,5,35438,10,5,36153,10,5,37634,10,5,38288,10,5,38902,9,23.25888921888938,-1.3302996,36.8707935,-1.3280558,36.8816781,675,614,715,2135
16420,21525,503,1,Business,29,6,42176,29,6,42705,29,6,42763,29,6,44500,29,6,45806,13,25.2,-1.285382,36.8162878,-1.2859912,36.8756811,497,1306,529,1795
16421,19639,2801,3,Business,28,3,46551,28,3,46818,28,3,47260,28,3,48481,28,3,51693,9,23.25888921888938,-1.2595422,36.7871178,-1.2948468,36.8235652,137,3212,267,1663
16422,19861,627,3,Business,20,2,47985,20,2,49607,20,2,50342,20,2,50513,20,2,51756,10,24.1,-1.2551895,36.7822034,-1.2380935,36.8072947,72,1243,1622,906
16423,5238,3686,3,Business,10,4,37143,10,4,37152,10,4,37256,10,4,37688,10,4,40404,18,18.4,-1.255956,36.789867,-1.2198413,36.9054958,247,2716,9,536
16424,19822,291,1,Personal,29,5,40708,29,5,41888,29,5,42775,29,5,42925,29,5,43904,6,19.5,-1.255683,36.813771,-1.2920972,36.8102988,616,979,1180,1037
16425,11973,2898,1,Personal,21,2,47307,21,2,47323,21,2,48677,21,2,49259,21,2,49918,4,21.1,-1.2543164,36.831861,-1.2619538,36.8087637,400,659,16,1936
16426,13622,1482,3,Business,23,2,44241,23,2,44620,23,2,44642,23,2,46151,23,2,49129,23,18.1,-1.338579,36.8963038,-1.2311903,36.8102105,747,2978,379,1531
16427,20415,2587,3,Business,18,1,40641,18,1,40678,18,1,41214,18,1,41678,18,1,43391,6,26.8,-1.2615888,36.7928732,-1.28878,36.8168312,778,1713,37,1000
16428,9686,3621,3,Business,8,3,40481,8,3,40529,8,3,41465,8,3,41646,8,3,42708,6,23.25888921888938,-1.2836583,36.7886014,-1.2951243,36.8281344,291,1062,48,1117
16429,22883,3404,3,Business,28,3,42794,28,3,47181,28,3,49077,28,3,50202,28,3,52022,12,23.25888921888938,-1.2860183,36.8975338,-1.279395,36.825364,554,1820,4387,3021
16430,6063,334,3,Personal,5,6,53888,5,6,61268,5,6,61843,5,6,62038,5,6,63953,17,23.0,-1.2963097,36.7688221,-1.3253826,36.8822315,522,1915,7380,770
16431,9032,419,3,Business,31,3,35615,31,3,36084,31,3,36423,31,3,36738,31,3,37764,6,19.2,-1.2571472,36.7950633,-1.3001813,36.811122,726,1026,469,654
16432,20296,2174,3,Business,30,3,37674,30,3,37678,30,3,37977,30,3,42726,30,3,45480,33,25.2,-1.2482781,36.884092,-1.324878,36.7070285,82,2754,4,5048
16433,27229,375,3,Business,11,3,38011,11,3,41562,11,3,44521,11,3,45911,11,3,48470,8,19.2,-1.2870803,36.8152302,-1.2551895,36.7822034,752,2559,3551,4349
16434,18892,1287,3,Business,28,4,37408,28,4,37418,28,4,37552,28,4,37891,28,4,40594,16,22.4,-1.2551895,36.7822034,-1.2227899,36.8851953,523,2703,10,473
16435,2077,1072,1,Personal,9,6,34814,9,6,34868,9,6,35477,9,6,35722,9,6,36446,7,15.4,-1.261849,36.808254,-1.2966323,36.7875842,103,724,54,854
16436,22780,2627,3,Business,19,2,47813,19,2,47843,19,2,47974,19,2,49608,19,2,49928,2,29.8,-1.2527958,36.8003131,-1.2571472,36.7950633,205,320,30,1765
16437,2837,640,3,Business,21,3,31731,21,3,31782,21,3,32240,21,3,32969,21,3,33156,2,17.2,-1.304033,36.7848695,-1.2980229,36.78865,88,187,51,1187
16438,25845,867,3,Business,2,4,46307,2,4,46463,2,4,47369,2,4,47596,2,4,49246,12,23.25888921888938,-1.2991441,36.7528804,-1.2996533,36.8292629,99,1650,156,1133
16439,8832,3547,3,Business,6,1,47125,6,1,47225,6,1,48131,6,1,48673,6,1,51096,5,23.25888921888938,-1.2761408,36.7710839,-1.2651574,36.7474347,106,2423,100,1448
16440,42,2069,3,Business,28,2,56104,28,2,56161,28,2,57240,28,2,57419,28,2,58476,9,23.4,-1.265715,36.823815,-1.228911,36.881876,233,1057,57,1258
16441,11342,778,3,Business,7,4,30536,7,4,30819,7,4,32732,7,4,33007,7,4,34599,7,23.25888921888938,-1.2535486,36.7933541,-1.2782978,36.8273238,101,1592,283,2188
16442,18129,868,3,Business,21,5,60542,21,5,62099,21,5,63676,21,5,64639,21,5,65656,10,23.0,-1.228911,36.881876,-1.265715,36.823815,147,1017,1557,2540
16443,22328,3436,3,Personal,11,5,47717,11,5,47788,11,5,48415,11,5,48512,11,5,51394,9,20.9,-1.2571472,36.7950633,-1.3133622,36.7876337,362,2882,71,724
16444,8344,2402,3,Business,19,2,52115,19,2,52329,19,2,53978,19,2,54161,19,2,56484,7,29.4,-1.2902539,36.8211322,-1.2975066,36.7689423,341,2323,214,1832
16445,6341,635,3,Business,31,5,52129,31,5,52291,31,5,53564,31,5,53795,31,5,55453,7,24.6,-1.2599563,36.7993439,-1.3081376,36.8329772,582,1658,162,1504
16446,15928,3326,3,Business,21,4,53822,21,4,53867,21,4,54538,21,4,55388,21,4,58965,22,26.4,-1.2551895,36.7822034,-1.3433296,36.9106128,329,3577,45,1521
16447,20752,1792,3,Business,14,2,59298,14,2,59314,14,2,59757,14,2,60099,14,2,60571,3,23.3,-1.2805537,36.7920739,-1.2791535,36.8041561,427,472,16,785
16448,20095,53,3,Business,12,5,42168,12,5,42813,12,5,42848,12,5,44905,12,5,46608,5,26.7,-1.3004062,36.829741,-1.2770708,36.8231093,161,1703,645,2092
16449,14558,955,2,Personal,27,5,49369,27,5,49393,27,5,50377,27,5,50635,27,5,53132,19,24.0,-1.2579172,36.7938337,-1.327079,36.881469,951,2497,24,1242
16450,2384,1724,3,Business,9,5,34163,9,5,35453,9,5,35834,9,5,36180,9,5,37003,8,20.4,-1.2941648,36.7977315,-1.2608592,36.8311977,315,823,1290,727
16451,9815,2523,3,Business,4,1,41383,4,1,41402,4,1,41560,4,1,41796,4,1,45825,17,26.7,-1.2551895,36.7822034,-1.2216605,36.9051793,409,4029,19,394
16452,14607,186,3,Business,17,3,57878,17,3,58380,17,3,58734,17,3,61241,17,3,64105,20,23.25888921888938,-1.2571472,36.7950633,-1.3700383,36.9190174,177,2864,502,2861
16453,22744,1556,3,Business,13,2,47337,13,2,47476,13,2,48490,13,2,49204,13,2,50121,2,26.4,-1.2584143,36.8048002,-1.2701354,36.8072167,446,917,139,1728
16454,26803,3547,3,Business,31,5,45908,31,5,46434,31,5,48760,31,5,49579,31,5,51486,11,24.7,-1.2856319,36.7672998,-1.2549476,36.8269576,269,1907,526,3145
16455,21835,630,3,Personal,21,1,38078,21,1,38098,21,1,38345,21,1,38499,21,1,40595,22,20.1,-1.2664331,36.8000478,-1.3361484,36.9161128,167,2096,20,401
16456,550,2383,3,Business,27,3,38130,27,3,38257,27,3,38491,27,3,38618,27,3,39869,5,26.1,-1.2608993,36.799246,-1.2795796,36.819062,253,1251,127,361
16457,11669,3387,2,Personal,20,4,36530,20,4,36558,20,4,37028,20,4,37259,20,4,37940,7,17.7,-1.2624366,36.7632187,-1.2628638,36.8070399,38,681,28,701
16458,1791,190,3,Business,9,2,40158,9,2,40195,9,2,41825,9,2,45731,9,2,45734,6,26.8,-1.3278522,36.8711134,-1.3270347,36.8667362,459,3,37,5536
16459,4583,1693,3,Business,20,3,33075,20,3,33139,20,3,35094,20,3,35328,20,3,36542,9,21.1,-1.2574088,36.799712,-1.2983864,36.8166668,205,1214,64,2189
16460,5449,2828,2,Business,3,2,57256,3,2,57303,3,2,57475,3,2,57641,3,2,58232,3,20.0,-1.2584143,36.8048002,-1.2615888,36.7928732,103,591,47,338
16461,13441,1754,3,Business,9,7,43191,9,7,43634,9,7,44477,9,7,44555,9,7,45952,12,23.6,-1.2860183,36.8975338,-1.3052491,36.8223899,532,1397,443,921
16462,1671,265,3,Business,3,1,53294,3,1,54100,3,1,54108,3,1,55010,3,1,55610,6,23.4,-1.3022899,36.869332,-1.3016417,36.8271679,406,600,806,910
16463,23305,259,3,Personal,7,4,45366,7,4,51850,7,4,52212,7,4,52490,7,4,56522,6,20.3,-1.304033,36.7848695,-1.3066143,36.8161046,312,4032,6484,640
16464,24409,3338,3,Business,11,2,46865,11,2,46978,11,2,47567,11,2,47990,11,2,49506,5,19.6,-1.2736695,36.8028996,-1.2551895,36.7822034,815,1516,113,1012
16465,13897,1796,3,Business,17,3,48671,17,3,48709,17,3,50053,17,3,50771,17,3,52453,18,23.25888921888938,-1.228911,36.881876,-1.331619,36.847976,691,1682,38,2062
16466,26026,1363,3,Business,10,1,35245,10,1,35419,10,1,36246,10,1,36422,10,1,40656,6,16.7,-1.3004062,36.829741,-1.290815,36.7969312,271,4234,174,1003
16467,8644,1178,3,Business,5,3,60062,5,3,60291,5,3,60714,5,3,63996,5,3,64343,5,22.3,-1.2868515,36.7844247,-1.2677371,36.7729723,882,347,229,3705
16468,20333,2587,3,Business,15,5,56409,15,5,56674,15,5,57283,15,5,57980,15,5,59093,4,27.9,-1.28878,36.8168312,-1.2636814,36.8029965,268,1113,265,1306
16469,18987,393,3,Business,6,1,36245,6,1,36264,6,1,37259,6,1,38103,6,1,39144,11,23.25888921888938,-1.3167113,36.8301563,-1.2638185,36.7930057,910,1041,19,1839
16470,2622,3096,3,Personal,22,5,69806,22,5,69821,22,5,70537,22,5,70799,22,5,73046,11,21.5,-1.2285835,36.8826468,-1.1971022,36.9268952,895,2247,15,978
16471,2457,2222,3,Business,2,1,52931,2,1,53751,2,1,55850,2,1,56494,2,1,58388,7,20.2,-1.2930128,36.8356869,-1.3259463,36.850258,844,1894,820,2743
16472,6444,186,3,Business,30,4,58585,30,4,58709,30,4,59358,30,4,59988,30,4,62471,4,23.25888921888938,-1.2571472,36.7950633,-1.2825816,36.8092346,42,2483,124,1279
16473,25535,60,3,Business,13,1,48547,13,1,48774,13,1,51221,13,1,51893,13,1,54435,16,23.25888921888938,-1.293515,36.897607,-1.2296618,36.8438272,408,2542,227,3119
16474,16227,2008,3,Business,10,5,57002,10,5,58045,10,5,59075,10,5,59362,10,5,61018,6,23.25888921888938,-1.2508229,36.7895263,-1.2788257,36.82877,843,1656,1043,1317
16475,22098,3689,3,Business,30,3,40488,30,3,40582,30,3,40627,30,3,42102,30,3,42412,2,22.7,-1.2579304,36.8019667,-1.2601709,36.8002238,51,310,94,1520
16476,9945,1075,3,Business,27,3,42439,27,3,42484,27,3,43058,27,3,43227,27,3,45175,11,26.2,-1.30435,36.86001,-1.2527958,36.8003131,448,1948,45,743
16477,5147,3647,3,Business,9,4,54781,9,4,54983,9,4,57345,9,4,58507,9,4,62583,18,23.25888921888938,-1.272639,36.794723,-1.3768823,36.7608932,815,4076,202,3524
16478,14426,238,3,Business,29,4,41095,29,4,41108,29,4,41139,29,4,41404,29,4,42820,15,21.4,-1.3077869,36.8443207,-1.3559093,36.9100452,10,1416,13,296
16479,9599,2691,3,Business,26,1,37426,26,1,38404,26,1,38539,26,1,39919,26,1,41540,8,22.9,-1.2857671,36.7875614,-1.2571472,36.7950633,536,1621,978,1515
16480,21773,1792,3,Business,22,4,32918,22,4,33111,22,4,33604,22,4,34003,22,4,35093,5,19.5,-1.2684998,36.7998268,-1.2809121,36.7852524,147,1090,193,892
16481,17718,3295,3,Business,19,2,43836,19,2,44048,19,2,46710,19,2,47927,19,2,48465,6,27.6,-1.2814233,36.8251177,-1.2571472,36.7950633,119,538,212,3879
16482,9170,3675,1,Personal,16,1,49775,16,1,49796,16,1,50042,16,1,51121,16,1,52095,6,22.4,-1.2682179,36.8009289,-1.29387,36.7907813,519,974,21,1325
16483,12526,1417,3,Business,18,1,57012,18,1,57324,18,1,58115,18,1,58461,18,1,59809,7,29.6,-1.2932569,36.8318009,-1.2741728,36.7969108,506,1348,312,1137
16484,24825,3222,3,Business,30,4,47774,30,4,47974,30,4,48533,30,4,48779,30,4,51080,15,23.25888921888938,-1.2551895,36.7822034,-1.3212161,36.8692769,576,2301,200,805
16485,17949,2587,3,Business,23,1,41458,23,1,41691,23,1,42363,23,1,42894,23,1,43833,5,18.7,-1.2527958,36.8003131,-1.2885529,36.8160141,726,939,233,1203
16486,23730,1244,3,Business,14,5,54776,14,5,54853,14,5,55734,14,5,56205,14,5,58445,16,23.7,-1.303596,36.778378,-1.228911,36.881876,708,2240,77,1352
16487,26457,2436,3,Business,3,3,56692,3,3,56742,3,3,57301,3,3,57624,3,3,62361,9,28.0,-1.2551895,36.7822034,-1.2931286,36.7584407,32,4737,50,882
16488,23586,718,3,Business,10,5,39190,10,5,39822,10,5,42143,10,5,43665,10,5,43781,7,23.25888921888938,-1.2551895,36.7822034,-1.2897289,36.8271257,603,116,632,3843
16489,22726,893,3,Business,13,2,39556,13,2,40218,13,2,41260,13,2,41955,13,2,45041,8,22.4,-1.301953,36.788458,-1.2594474,36.8089122,578,3086,662,1737
16490,4967,1246,3,Business,28,4,51740,28,4,51760,28,4,51864,28,4,52796,28,4,53152,2,27.2,-1.2571472,36.7950633,-1.273488,36.804158,770,356,20,1036
16491,26369,1502,3,Business,16,7,40934,16,7,40971,16,7,41467,16,7,43843,16,7,46719,12,23.3,-1.28878,36.8168312,-1.2232123,36.8932547,26,2876,37,2872
16492,10414,2412,3,Business,5,6,63201,5,6,63213,5,6,63217,5,6,64437,5,6,65138,3,21.8,-1.2156006,36.8916865,-1.2285835,36.8826468,338,701,12,1224
16493,20664,3647,3,Business,10,1,63041,10,1,63251,10,1,64206,10,1,64529,10,1,65594,5,18.9,-1.272639,36.794723,-1.292943,36.808292,755,1065,210,1278
16494,19964,2412,3,Business,15,6,44655,15,6,45101,15,6,46287,15,6,46378,15,6,49980,9,22.1,-1.2859912,36.8756811,-1.2285835,36.8826468,547,3602,446,1277
16495,7679,3647,3,Business,14,3,47325,14,3,49915,14,3,50811,14,3,50898,14,3,52051,4,25.6,-1.272639,36.794723,-1.2762965,36.8211047,85,1153,2590,983
16496,9195,3557,3,Business,7,5,44082,7,5,44661,7,5,45228,7,5,46684,7,5,46723,3,24.9,-1.269534,36.80697,-1.2546732,36.8086796,503,39,579,2023
16497,14419,265,3,Business,6,1,55376,6,1,55445,6,1,55811,6,1,57710,6,1,58990,5,23.25888921888938,-1.3117439,36.8108257,-1.300921,36.828195,910,1280,69,2265
16498,13824,2884,2,Personal,1,5,32898,1,5,32946,1,5,34842,1,5,35147,1,5,40979,12,17.9,-1.2764692,36.7580111,-1.3084771,36.6897163,651,5832,48,2201
16499,25501,1136,2,Personal,25,2,27919,25,2,27934,25,2,28680,25,2,28890,25,2,30886,13,18.0,-1.1992343,36.7884894,-1.267452,36.806015,881,1996,15,956
16500,16523,1926,3,Business,9,4,47954,9,4,47976,9,4,48694,9,4,49258,9,4,50601,15,25.6,-1.3332749,36.8708147,-1.346168,36.766149,74,1343,22,1282
16501,16337,1926,3,Business,15,1,46452,15,1,46576,15,1,47068,15,1,48713,15,1,50004,16,23.25888921888938,-1.3263105,36.8622904,-1.2551895,36.7822034,484,1291,124,2137
16502,1747,136,3,Business,15,3,55768,15,3,55799,15,3,56122,15,3,56431,15,3,57479,7,21.5,-1.2649605,36.7981777,-1.2962832,36.7849683,415,1048,31,632
16503,23630,2982,3,Business,7,2,33032,7,2,33044,7,2,33486,7,2,36245,7,2,40134,18,23.25888921888938,-1.300921,36.828195,-1.177202,36.8351183,519,3889,12,3201
16504,6656,3300,3,Business,22,3,55910,22,3,56013,22,3,56955,22,3,57291,22,3,59737,9,24.1,-1.2600926,36.8088685,-1.303596,36.778378,930,2446,103,1278
16505,14585,3517,3,Business,5,3,57926,5,3,58525,5,3,59582,5,3,60544,5,3,60550,2,22.3,-1.278956,36.8375411,-1.2867454,36.8259017,179,6,599,2019
16506,23486,1809,3,Business,3,3,57180,3,3,57202,3,3,57269,3,3,58267,3,3,58275,2,26.6,-1.264272,36.7978791,-1.2646084,36.8028645,446,8,22,1065
16507,24771,517,3,Business,9,1,34353,9,1,34434,9,1,34456,9,1,37096,9,1,37103,8,15.1,-1.3177547,36.8303703,-1.2770708,36.8231093,333,7,81,2662
16508,5867,3434,3,Business,10,1,57087,10,1,58007,10,1,59382,10,1,60321,10,1,64766,29,18.9,-1.1612808,36.9563278,-1.2963097,36.7688221,520,4445,920,2314
16509,18365,2330,3,Business,15,3,38346,15,3,38426,15,3,39737,15,3,39801,15,3,41207,11,23.25888921888938,-1.2890715,36.8157588,-1.2987264,36.8831224,204,1406,80,1375
16510,13361,3043,3,Business,9,3,45375,9,3,47442,9,3,47565,9,3,48081,9,3,52767,7,21.0,-1.2893753,36.8242869,-1.2884831,36.773488,813,4686,2067,639
16511,168,1586,3,Personal,14,4,51072,14,4,51217,14,4,51635,14,4,51751,14,4,54517,18,28.2,-1.3324865,36.8938303,-1.2896972,36.8080357,205,2766,145,534
16512,2888,1363,3,Business,22,4,41092,22,4,41226,22,4,41730,22,4,41798,22,4,42374,2,22.4,-1.3004062,36.829741,-1.298744,36.8178237,867,576,134,572
16513,19515,1500,3,Business,13,6,40712,13,6,41510,13,6,43157,13,6,43418,13,6,44181,6,25.8,-1.2759989,36.820884,-1.2638185,36.7930057,660,763,798,1908
16514,16238,203,3,Business,28,4,68986,28,4,69381,28,4,69790,28,4,70175,28,4,71278,8,28.1,-1.2963097,36.7688221,-1.2622145,36.8087391,164,1103,395,794
16515,19406,496,3,Business,20,1,45305,20,1,45318,20,1,45373,20,1,45987,20,1,47465,15,23.25888921888938,-1.2285835,36.8826468,-1.2551895,36.7822034,839,1478,13,669
16516,14676,1209,3,Business,17,3,47234,17,3,47261,17,3,48402,17,3,48742,17,3,49913,9,23.25888921888938,-1.2638185,36.7930057,-1.3004062,36.829741,177,1171,27,1481
16517,26598,2718,3,Business,3,3,41574,3,3,41658,3,3,42297,3,3,42423,3,3,43524,3,23.8,-1.2668815,36.8017244,-1.269534,36.80697,755,1101,84,765
16518,762,3108,3,Business,13,3,51114,13,3,51143,13,3,51715,13,3,51808,13,3,53589,25,27.2,-1.2551895,36.7822034,-1.1648303,36.951368,598,1781,29,665
16519,803,232,3,Personal,28,2,47135,28,2,47140,28,2,48476,28,2,48634,28,2,50768,21,17.4,-1.329648,36.678007,-1.266294,36.8057971,754,2134,5,1494
16520,17019,867,3,Business,13,4,44428,13,4,44485,13,4,45684,13,4,46171,13,4,48513,9,22.1,-1.2638185,36.7930057,-1.2991441,36.7528804,827,2342,57,1686
16521,19853,2360,3,Business,24,1,52215,24,1,52420,24,1,54674,24,1,54860,24,1,55817,8,24.5,-1.2703375,36.8247799,-1.2551895,36.7822034,362,957,205,2440
16522,1887,1231,3,Business,21,5,43432,21,5,43832,21,5,45291,21,5,45754,21,5,48585,8,22.8,-1.2821422,36.8161565,-1.3014461,36.7661381,831,2831,400,1922
16523,875,1166,2,Personal,25,2,63527,25,2,63591,25,2,64411,25,2,64857,25,2,67260,7,23.9,-1.2884997,36.8183895,-1.2606291,36.796951,96,2403,64,1266
16524,18653,1687,3,Business,5,1,37665,5,1,37736,5,1,38408,5,1,38736,5,1,39520,5,24.4,-1.2626574,36.8014034,-1.2655381,36.8354648,148,784,71,1000
16525,19841,3521,3,Business,18,4,32151,18,4,32180,18,4,32710,18,4,33130,18,4,33471,2,23.25888921888938,-1.2701354,36.8072167,-1.2696908,36.81519,607,341,29,950
16526,8874,1222,3,Personal,29,3,35085,29,3,35199,29,3,36161,29,3,37001,29,3,38719,8,18.1,-1.2566689,36.7796952,-1.2876365,36.816096,155,1718,114,1802
16527,8822,1329,3,Business,28,2,47816,28,2,47842,28,2,48007,28,2,48412,28,2,50171,8,21.4,-1.273056,36.811298,-1.3193233,36.840991,591,1759,26,570
16528,27938,3403,3,Business,6,3,47918,6,3,50188,6,3,53447,6,3,53571,6,3,55175,8,21.8,-1.2553615,36.7895376,-1.3038353,36.8107609,742,1604,2270,3383
16529,16691,3070,3,Business,22,3,50900,22,3,50991,22,3,51981,22,3,52766,22,3,55511,19,24.5,-1.3127834,36.8696399,-1.2521881,36.7537237,691,2745,91,1775
16530,25226,1075,3,Business,29,1,54989,29,1,55016,29,1,55174,29,1,55319,29,1,56934,3,23.25888921888938,-1.2527958,36.8003131,-1.2551895,36.7822034,204,1615,27,303
16531,14338,1271,3,Business,13,2,36810,13,2,38453,13,2,39050,13,2,39431,13,2,40647,10,22.3,-1.2943371,36.8267,-1.3107918,36.761794,276,1216,1643,978
16532,26711,3434,3,Business,13,5,52521,13,5,52537,13,5,53112,13,5,53570,13,5,55614,17,19.0,-1.2963097,36.7688221,-1.2482465,36.8889062,951,2044,16,1033
16533,1300,704,1,Business,22,3,50059,22,3,50075,22,3,50792,22,3,53488,22,3,57401,21,25.7,-1.2564152,36.7792803,-1.2860183,36.8975338,228,3913,16,3413
16534,12869,1304,3,Business,13,2,37803,13,2,38854,13,2,39617,13,2,39805,13,2,42234,12,22.2,-1.3332749,36.8708147,-1.2693662,36.8085295,559,2429,1051,951
16535,4729,3271,1,Personal,8,5,46687,8,5,47428,8,5,48387,8,5,48945,8,5,49908,5,21.7,-1.2924222,36.7892865,-1.2670058,36.8041388,268,963,741,1517
16536,6152,3185,1,Personal,25,3,35102,25,3,42038,25,3,42065,25,3,43106,25,3,45141,16,23.25888921888938,-1.291216,36.8746657,-1.2295205,36.8120426,618,2035,6936,1068
16537,24798,102,3,Personal,11,4,48921,11,4,53497,11,4,56205,11,4,58049,11,4,58199,4,27.2,-1.2676134,36.8339269,-1.2866976,36.8315965,790,150,4576,4552
16538,23210,1469,3,Business,2,4,53382,2,4,53594,2,4,55051,2,4,55859,2,4,57066,7,23.25888921888938,-1.2571472,36.7950633,-1.3038156,36.8122733,607,1207,212,2265
16539,16530,136,3,Business,6,1,32851,6,1,34743,6,1,36342,6,1,39894,6,1,42505,16,23.25888921888938,-1.2908945,36.8246514,-1.3254522,36.7216584,106,2611,1892,5151
16540,5448,2150,3,Business,10,1,44977,10,1,45073,10,1,45081,10,1,45558,10,1,47480,9,18.6,-1.303596,36.778378,-1.344446,36.756597,855,1922,96,485
16541,825,635,3,Business,12,2,39167,12,2,40224,12,2,40950,12,2,41206,12,2,42210,7,24.7,-1.2602337,36.7990548,-1.3081376,36.8329772,550,1004,1057,982
16542,7032,3528,3,Business,31,5,39976,31,5,41295,31,5,42473,31,5,42701,31,5,44447,3,21.5,-1.3014515,36.8120092,-1.2904753,36.8144721,502,1746,1319,1406
16543,289,2956,3,Business,27,6,51837,27,6,52320,27,6,53041,27,6,53272,27,6,54816,5,23.25888921888938,-1.2584143,36.8048002,-1.281754,36.8324229,171,1544,483,952
16544,6888,2330,3,Business,24,5,46983,24,5,47076,24,5,47281,24,5,48161,24,5,50152,9,21.4,-1.3015197,36.7658456,-1.2645318,36.7981775,155,1991,93,1085
16545,23789,1207,3,Business,26,2,35151,26,2,35299,26,2,36502,26,2,36821,26,2,38345,7,23.25888921888938,-1.2629666,36.8068369,-1.2745321,36.765088,72,1524,148,1522
16546,2729,3551,1,Personal,9,3,46489,9,3,46951,9,3,47326,9,3,47624,9,3,49234,10,20.9,-1.2850638,36.813096,-1.2295205,36.8120426,865,1610,462,673
16547,20017,393,3,Business,23,4,39172,23,4,39186,23,4,40050,23,4,40768,23,4,42305,8,23.5,-1.3228003,36.8306435,-1.2770708,36.8231093,438,1537,14,1582
16548,16810,3283,3,Business,23,6,35594,23,6,35606,23,6,36202,23,6,36790,23,6,37846,7,19.1,-1.303596,36.778378,-1.2628473,36.781805,112,1056,12,1184
16549,21460,2990,1,Personal,3,5,45482,3,5,45505,3,5,47713,3,5,47934,3,5,50749,9,21.4,-1.2762743,36.8152789,-1.3183189,36.8493704,903,2815,23,2429
16550,21021,517,3,Business,28,5,48094,28,5,48191,28,5,48195,28,5,51696,28,5,51702,4,25.5,-1.3167113,36.8301563,-1.3004062,36.829741,239,6,97,3505
16551,26698,1962,1,Personal,9,1,48751,9,1,49696,9,1,50420,9,1,50704,9,1,52505,14,20.9,-1.3208162,36.8451209,-1.2569503,36.7834728,45,1801,945,1008
16552,9168,1232,1,Personal,19,2,47623,19,2,48510,19,2,49333,19,2,49723,19,2,51495,15,18.5,-1.2631312,36.7138908,-1.3101721,36.8049755,735,1772,887,1213
16553,7650,1511,3,Personal,26,4,49773,26,4,49816,26,4,50348,26,4,50439,26,4,52110,10,22.0,-1.3053806,36.7830636,-1.2654199,36.8008276,898,1671,43,623
16554,7611,646,3,Personal,19,3,44528,19,3,45570,19,3,45742,19,3,46044,19,3,46305,2,22.1,-1.2809121,36.7852524,-1.2884066,36.7866984,881,261,1042,474
16555,26031,1882,3,Business,7,5,35747,7,5,35771,7,5,36569,7,5,36722,7,5,38753,22,18.4,-1.2156006,36.8916865,-1.3014461,36.7661381,846,2031,24,951
16556,9272,2454,3,Business,7,5,54130,7,5,54521,7,5,55199,7,5,55341,7,5,56938,4,23.25888921888938,-1.2942023,36.7958179,-1.2867538,36.7765986,429,1597,391,820
16557,20746,647,3,Business,15,1,54450,15,1,54547,15,1,55516,15,1,56615,15,1,57656,5,23.25888921888938,-1.2770708,36.8231093,-1.3004062,36.829741,790,1041,97,2068
16558,7558,391,3,Business,24,3,31750,24,3,33547,24,3,34546,24,3,35016,24,3,39617,5,23.25888921888938,-1.300921,36.828195,-1.2784063,36.8222933,106,4601,1797,1469
16559,7442,1205,3,Business,1,3,47249,1,3,47281,1,3,48675,1,3,50258,1,3,50268,3,24.1,-1.2810807,36.8144229,-1.2974472,36.8156997,19,10,32,2977
16560,14819,2956,3,Business,6,3,41258,6,3,41285,6,3,43766,6,3,44023,6,3,45268,10,20.2,-1.2584143,36.8048002,-1.2413316,36.8785525,742,1245,27,2738
16561,22549,3080,3,Business,13,3,46292,13,3,46387,13,3,46948,13,3,47074,13,3,48961,7,24.8,-1.2551895,36.7822034,-1.2884243,36.8207248,199,1887,95,687
16562,16207,3621,3,Business,13,3,54332,13,3,54501,13,3,55959,13,3,56181,13,3,57869,6,27.4,-1.2836583,36.7886014,-1.2915265,36.8298478,513,1688,169,1680
16563,693,2829,3,Business,12,1,50901,12,1,51031,12,1,52263,12,1,54120,12,1,57287,21,26.9,-1.2571472,36.7950633,-1.3562374,36.9042954,333,3167,130,3089
16564,18564,3469,3,Personal,23,1,43918,23,1,43941,23,1,44628,23,1,45225,23,1,46679,13,18.6,-1.2521881,36.7537237,-1.2900075,36.8032564,334,1454,23,1284
16565,24898,186,3,Business,3,4,39377,3,4,42496,3,4,43961,3,4,44299,3,4,47898,24,22.1,-1.3700383,36.9190174,-1.2579304,36.8019667,761,3599,3119,1803
16566,5385,3686,3,Business,8,5,33273,8,5,33305,8,5,33312,8,5,33648,8,5,35048,8,20.6,-1.2551895,36.7822034,-1.2950408,36.8098172,926,1400,32,343
16567,7412,393,3,Business,7,1,57635,7,1,58564,7,1,58570,7,1,59330,7,1,60269,4,26.9,-1.3167113,36.8301563,-1.3004062,36.829741,39,939,929,766
16568,17835,302,3,Business,21,5,65200,21,5,65837,21,5,66297,21,5,66676,21,5,68287,8,23.2,-1.2649605,36.7981777,-1.307376,36.813404,576,1611,637,839
16569,27093,173,3,Business,19,5,40398,19,5,40448,19,5,40822,19,5,42932,19,5,44265,11,25.0,-1.3207146,36.8305771,-1.2993231,36.7753372,1,1333,50,2484
16570,4888,3496,3,Business,31,2,54841,31,2,54848,31,2,54856,31,2,56992,31,2,57757,13,22.3,-1.332175,36.8819641,-1.300921,36.828195,813,765,7,2144
16571,25257,3752,3,Business,23,2,45102,23,2,48094,23,2,49090,23,2,49502,23,2,50566,14,23.25888921888938,-1.1648303,36.951368,-1.2285835,36.8826468,710,1064,2992,1408
16572,11490,1329,3,Business,27,2,58448,27,2,58548,27,2,58866,27,2,59441,27,2,60023,6,25.5,-1.273056,36.811298,-1.2668265,36.7680484,439,582,100,893
16573,18256,1926,3,Business,4,1,66335,4,1,66449,4,1,67911,4,1,68392,4,1,70083,10,21.1,-1.3332749,36.8708147,-1.2810586,36.8838294,890,1691,114,1943
16574,15579,661,3,Business,25,3,53482,25,3,57653,25,3,58185,25,3,58371,25,3,59239,4,17.9,-1.2950044,36.7512209,-1.2963097,36.7688221,140,868,4171,718
16575,23881,432,3,Business,4,4,61013,4,4,61032,4,4,61063,4,4,61418,4,4,64083,28,25.9,-1.3012008,36.764868,-1.3916459,36.9305892,871,2665,19,386
16576,11811,234,2,Personal,10,5,46467,10,5,46526,10,5,48303,10,5,48662,10,5,50184,11,19.4,-1.3234104,36.7989459,-1.3015998,36.8764939,882,1522,59,2136
16577,10429,2306,3,Business,11,1,43564,11,1,43769,11,1,44704,11,1,46857,11,1,48496,8,26.7,-1.2684761,36.8348947,-1.2271998,36.8084905,76,1639,205,3088
16578,26470,2956,3,Business,23,6,47708,23,6,47832,23,6,48075,23,6,48440,23,6,49244,2,23.25888921888938,-1.2527958,36.8003131,-1.2584143,36.8048002,318,804,124,608
16579,14045,1217,3,Personal,28,2,38316,28,2,38395,28,2,38962,28,2,39026,28,2,40610,16,21.3,-1.2175583,36.884343,-1.269534,36.80697,152,1584,79,631
16580,26483,893,3,Business,11,5,36062,11,5,36223,11,5,36917,11,5,37156,11,5,38533,7,17.8,-1.2663194,36.809901,-1.3001909,36.8163627,207,1377,161,933
16581,9007,1500,3,Business,28,5,51805,28,5,52321,28,5,52750,28,5,52831,28,5,54072,11,25.7,-1.3077869,36.8443207,-1.2574219,36.7927073,188,1241,516,510
16582,27558,1482,3,Business,26,1,45143,26,1,45991,26,1,46590,26,1,46731,26,1,47178,10,23.2,-1.338579,36.8963038,-1.3341604,36.8669741,105,447,848,740
16583,23326,2467,3,Personal,23,4,50031,23,4,50234,23,4,51842,23,4,52273,23,4,53769,16,20.7,-1.263546,36.716171,-1.311407,36.798891,116,1496,203,2039
16584,26111,2358,4,Business,3,3,42960,3,3,43036,3,3,43417,3,3,43990,3,3,44374,1,23.9,-1.302222,36.75873,-1.2945498,36.7547491,88,384,76,954
16585,23614,2423,3,Business,3,4,47220,3,4,47231,3,4,48011,3,4,48161,3,4,50331,6,21.9,-1.255956,36.789867,-1.2793148,36.8148394,676,2170,11,930
16586,6842,970,3,Business,2,2,43866,2,2,44036,2,2,44362,2,2,44523,2,2,45840,7,26.1,-1.2551895,36.7822034,-1.2872652,36.8267613,245,1317,170,487
16587,20816,635,3,Business,25,4,47352,25,4,49726,25,4,50014,25,4,50452,25,4,52033,7,23.25888921888938,-1.2602337,36.7990548,-1.234958,36.8104235,461,1581,2374,726
16588,4964,2331,3,Business,12,3,38088,12,3,39442,12,3,40047,12,3,40253,12,3,45050,46,19.6,-1.3398006,36.717935,-1.1838303,36.9543295,815,4797,1354,811
16589,10390,633,3,Business,11,5,36260,11,5,36559,11,5,37362,11,5,38263,11,5,39556,11,21.1,-1.2991441,36.7528804,-1.3004062,36.829741,580,1293,299,1704
16590,15855,1075,3,Business,18,1,45527,18,1,46533,18,1,47511,18,1,47894,18,1,49682,16,27.8,-1.339046,36.762596,-1.2527958,36.8003131,468,1788,1006,1361
16591,2997,1500,3,Business,9,4,51717,9,4,53143,9,4,53355,9,4,53631,9,4,54821,8,23.25888921888938,-1.3004062,36.829741,-1.2638185,36.7930057,448,1190,1426,488
16592,6453,2937,2,Personal,6,4,27839,6,4,28797,6,4,30245,6,4,30433,6,4,31981,10,17.9,-1.2269178,36.8392393,-1.2881035,36.8142095,453,1548,958,1636
16593,25292,1981,2,Personal,15,1,42823,15,1,43811,15,1,45336,15,1,45672,15,1,47129,14,23.25888921888938,-1.3239363,36.7298423,-1.2744447,36.7861339,379,1457,988,1861
16594,27158,3434,3,Business,28,2,43648,28,2,43704,28,2,46729,28,2,47359,28,2,49518,14,17.6,-1.2321358,36.8727847,-1.1612808,36.9563278,384,2159,56,3655
16595,2841,1410,3,Business,9,3,30997,9,3,31989,9,3,32734,9,3,34212,9,3,35193,12,20.1,-1.300921,36.828195,-1.2742942,36.9194976,813,981,992,2223
16596,9613,3283,3,Business,23,6,37681,23,6,37695,23,6,37713,23,6,39857,23,6,40479,5,26.1,-1.2600926,36.8088685,-1.2628473,36.781805,427,622,14,2162
16597,20772,1792,3,Business,12,2,41892,12,2,41902,12,2,42681,12,2,42909,12,2,44368,11,20.9,-1.288159,36.7925275,-1.251921,36.828379,635,1459,10,1007
16598,5791,3201,3,Business,20,2,56690,20,2,56700,20,2,57037,20,2,57427,20,2,58338,5,24.2,-1.2584143,36.8048002,-1.263964,36.7854632,79,911,10,727
16599,19535,1329,3,Business,11,2,36301,11,2,38562,11,2,39702,11,2,39882,11,2,41258,4,19.6,-1.273056,36.811298,-1.2720282,36.784531,112,1376,2261,1320
16600,4817,1642,3,Business,15,1,37123,15,1,37313,15,1,38562,15,1,38831,15,1,39645,5,23.25888921888938,-1.2726506,36.7960153,-1.2876365,36.816096,438,814,190,1518
16601,19479,1724,3,Business,6,2,37039,6,2,37253,6,2,37956,6,2,38214,6,2,39363,9,24.9,-1.2551895,36.7822034,-1.2941648,36.7977315,726,1149,214,961
16602,15710,3291,3,Business,8,5,58631,8,5,58837,8,5,59690,8,5,59953,8,5,60777,4,28.2,-1.265715,36.823815,-1.2600926,36.8088685,427,824,206,1116
16603,6188,3727,3,Business,20,1,59129,20,1,59248,20,1,61471,20,1,61627,20,1,62758,6,23.25888921888938,-1.2963097,36.7688221,-1.2825816,36.8092346,277,1131,119,2379
16604,372,1075,3,Business,17,3,54205,17,3,54272,17,3,55505,17,3,55865,17,3,59766,7,23.25888921888938,-1.2527958,36.8003131,-1.2861471,36.7903723,641,3901,67,1593
16605,10763,393,3,Business,28,2,45420,28,2,46311,28,2,46895,28,2,47649,28,2,48317,5,21.3,-1.3228003,36.8306435,-1.3077869,36.8443207,2,668,891,1338
16606,22208,867,3,Business,21,4,29538,21,4,29560,21,4,29769,21,4,31369,21,4,32955,10,18.8,-1.2996533,36.8292629,-1.2991441,36.7528804,31,1586,22,1809
16607,7615,2195,1,Business,1,6,35235,1,6,35283,1,6,35472,1,6,35797,1,6,36346,6,15.3,-1.307143,36.825009,-1.3313643,36.8577422,670,549,48,514
16608,11832,1824,3,Business,9,1,63133,9,1,63774,9,1,64502,9,1,65176,9,1,65943,4,20.6,-1.3043821,36.7840586,-1.3099145,36.8022774,465,767,641,1402
16609,17738,3647,3,Business,3,3,41029,3,3,41070,3,3,41551,3,3,42010,3,3,43010,6,27.6,-1.272639,36.794723,-1.290789,36.8024859,520,1000,41,940
16610,26468,798,3,Business,21,4,38385,21,4,38562,21,4,39846,21,4,40011,21,4,41170,8,21.7,-1.2594237,36.8000866,-1.304033,36.7848695,88,1159,177,1449
16611,11665,53,3,Business,10,5,37209,10,5,37519,10,5,38382,10,5,38589,10,5,39804,5,23.25888921888938,-1.3004062,36.829741,-1.2770708,36.8231093,790,1215,310,1070
16612,17622,2587,3,Business,12,1,43452,12,1,44563,12,1,44998,12,1,46000,12,1,47315,13,24.0,-1.2232123,36.8932547,-1.28878,36.8168312,744,1315,1111,1437
16613,9179,1360,1,Personal,3,3,59184,3,3,60002,3,3,60373,3,3,62736,3,3,63176,4,23.7,-1.25789,36.79268,-1.2768326,36.8073804,86,440,818,2734
16614,23534,391,3,Business,27,2,47232,27,2,47564,27,2,47840,27,2,49465,27,2,50834,7,25.6,-1.300921,36.828195,-1.2566892,36.8154517,871,1369,332,1901
16615,2052,2330,3,Business,20,3,42593,20,3,42627,20,3,44840,20,3,46286,20,3,49778,11,27.4,-1.2684123,36.8143348,-1.3015197,36.7658456,132,3492,34,3659
16616,4921,2330,3,Business,2,5,47380,2,5,47463,2,5,48784,2,5,48851,2,5,50995,5,24.9,-1.2846026,36.8219425,-1.2642903,36.8002137,268,2144,83,1388
16617,10131,635,3,Business,4,1,41747,4,1,42036,4,1,43392,4,1,45551,4,1,46812,6,26.6,-1.3081376,36.8329772,-1.3229345,36.8566974,513,1261,289,3515
16618,4275,3283,3,Business,21,4,52211,21,4,52246,21,4,53074,21,4,54535,21,4,54539,7,26.1,-1.303596,36.778378,-1.2628473,36.781805,919,4,35,2289
16619,27489,2066,3,Business,30,4,48199,30,4,48374,30,4,51383,30,4,51540,30,4,52552,6,20.7,-1.316961,36.820337,-1.2896399,36.8124498,447,1012,175,3166
16620,7601,2521,3,Business,25,5,30592,25,5,30619,25,5,30623,25,5,30845,25,5,30853,4,20.7,-1.3167113,36.8301563,-1.3004062,36.829741,239,8,27,226
16621,12164,1329,3,Business,10,1,52553,10,1,53853,10,1,55319,10,1,55393,10,1,56757,8,18.9,-1.273056,36.811298,-1.324009,36.8458827,267,1364,1300,1540
16622,1775,2158,3,Personal,17,3,54278,17,3,54372,17,3,55062,17,3,56877,17,3,57247,7,23.25888921888938,-1.2888734,36.8268027,-1.25896,36.8016691,843,370,94,2505
16623,21506,782,1,Personal,20,4,38537,20,4,38550,20,4,38719,20,4,39206,20,4,42778,9,24.5,-1.2655332,36.8094648,-1.3134524,36.8064495,38,3572,13,656
16624,4731,3194,3,Business,23,4,56138,23,4,56165,23,4,56564,23,4,57005,23,4,57661,6,20.8,-1.2551895,36.7822034,-1.2811695,36.8200313,726,656,27,840
16625,22093,1231,3,Business,10,4,59807,10,4,60005,10,4,60713,10,4,60793,10,4,61219,2,22.0,-1.2821422,36.8161565,-1.290894,36.822971,100,426,198,788
16626,15053,729,1,Personal,25,2,44031,25,2,44045,25,2,44499,25,2,45015,25,2,46695,6,23.9,-1.292688,36.7744727,-1.2697141,36.7981777,650,1680,14,970
16627,10821,1370,1,Personal,7,4,59437,7,4,59781,7,4,61668,7,4,62352,7,4,63454,4,17.5,-1.276974,36.8226145,-1.261692,36.80161,808,1102,344,2571
16628,12102,265,3,Business,30,2,45872,30,2,46094,30,2,46404,30,2,48765,30,2,50162,16,23.25888921888938,-1.300921,36.828195,-1.3710624,36.7483481,923,1397,222,2671
16629,19154,866,1,Personal,5,2,41722,5,2,42570,5,2,44849,5,2,45126,5,2,46694,8,21.5,-1.296797,36.7764525,-1.2886685,36.8297138,100,1568,848,2556
16630,4217,1500,3,Business,24,3,42513,24,3,46076,24,3,46435,24,3,48835,24,3,49744,8,18.3,-1.3004062,36.829741,-1.2574219,36.7927073,260,909,3563,2759
16631,11824,3560,3,Business,7,2,41442,7,2,41741,7,2,42014,7,2,42966,7,2,44860,21,23.3,-1.279395,36.825364,-1.3916459,36.9305892,124,1894,299,1225
16632,19342,1764,1,Personal,1,1,35149,1,1,35233,1,1,36759,1,1,37136,1,1,38408,8,18.4,-1.3253972,36.8014639,-1.2962832,36.7849683,38,1272,84,1903
16633,525,346,3,Business,23,2,47091,23,2,47111,23,2,48171,23,2,48828,23,2,51695,15,23.25888921888938,-1.3562374,36.9042954,-1.28878,36.8168312,276,2867,20,1717
16634,14385,554,1,Personal,23,3,36730,23,3,36777,23,3,37280,23,3,38040,23,3,38962,8,21.8,-1.2942764,36.7969749,-1.269059,36.8108027,726,922,47,1263
16635,20872,3647,3,Business,21,5,57738,21,5,57800,21,5,58541,21,5,58758,21,5,60604,10,27.2,-1.272639,36.794723,-1.234958,36.8104235,882,1846,62,958
16636,2934,393,3,Business,12,1,57274,12,1,57490,12,1,58315,12,1,58521,12,1,59070,6,26.7,-1.3177547,36.8303703,-1.3077869,36.8443207,436,549,216,1031
16637,22521,2545,2,Personal,2,4,32919,2,4,32927,2,4,33054,2,4,34780,2,4,39187,18,13.3,-1.2800277,36.7877207,-1.2049707,36.7858957,680,4407,8,1853
16638,27977,2738,3,Business,11,2,45492,11,2,46063,11,2,46837,11,2,47520,11,2,51145,27,19.4,-1.3888629,36.935984,-1.2528485,36.7953722,654,3625,571,1457
16639,2418,1075,3,Business,22,5,53798,22,5,54524,22,5,55507,22,5,55703,22,5,57178,13,30.9,-1.2285835,36.8826468,-1.2527958,36.8003131,520,1475,726,1179
16640,14916,1614,1,Personal,23,4,56036,23,4,56131,23,4,56881,23,4,57289,23,4,58414,4,21.0,-1.2791224,36.8306878,-1.267022,36.807941,213,1125,95,1158
16641,16219,2521,3,Business,15,5,49818,15,5,49826,15,5,49833,15,5,50670,15,5,50692,5,27.9,-1.3167113,36.8301563,-1.3077869,36.8443207,10,22,8,844
16642,646,238,3,Business,25,4,54998,25,4,55012,25,4,55054,25,4,55591,25,4,56059,5,23.25888921888938,-1.3004062,36.829741,-1.3077869,36.8443207,349,468,14,579
16643,7653,2262,1,Personal,29,2,51233,29,2,51887,29,2,54581,29,2,55136,29,2,56690,6,23.6,-1.2877907,36.830065,-1.2897215,36.7945959,752,1554,654,3249
16644,24922,2621,2,Personal,3,1,31973,3,1,31997,3,1,33984,3,1,34498,3,1,36162,11,14.8,-1.3138389,36.8407568,-1.2985032,36.7821448,654,1664,24,2501
16645,16361,3738,3,Business,3,5,55347,3,5,55357,3,5,56140,3,5,56324,3,5,57683,9,25.4,-1.3014461,36.7661381,-1.2597034,36.8003065,898,1359,10,967
16646,5872,1304,3,Business,16,3,41101,16,3,41162,16,3,41357,16,3,42036,16,3,43648,9,24.1,-1.2626906,36.7827022,-1.2973028,36.7876144,650,1612,61,874
16647,13331,2070,3,Business,8,2,37526,8,2,37546,8,2,37986,8,2,38476,8,2,39995,17,23.6,-1.298529,36.816482,-1.3361484,36.9161128,31,1519,20,930
16648,18687,2005,3,Business,11,6,53728,11,6,53761,11,6,54457,11,6,55171,11,6,55970,7,21.6,-1.2872996,36.8310969,-1.3043649,36.7816132,229,799,33,1410
16649,25628,2066,3,Business,13,4,56011,13,4,56036,13,4,56586,13,4,56812,13,4,58320,10,22.9,-1.3210189,36.8410551,-1.2649605,36.7981777,344,1508,25,776
16650,22891,2349,3,Business,17,1,37988,17,1,38757,17,1,39168,17,1,39390,17,1,41375,5,23.5,-1.2784495,36.7981729,-1.2927422,36.8183358,48,1985,769,633
16651,6592,3046,2,Personal,28,5,49812,28,5,50017,28,5,50213,28,5,50392,28,5,51437,4,25.4,-1.2795796,36.819062,-1.2658335,36.8042867,21,1045,205,375
16652,5870,1882,3,Business,8,1,66323,8,1,66397,8,1,66513,8,1,67047,8,1,69523,7,29.2,-1.2958783,36.7928125,-1.2588775,36.8079744,300,2476,74,650
16653,10959,3283,3,Business,27,4,45984,27,4,46003,27,4,46287,27,4,49730,27,4,50844,10,23.9,-1.307143,36.825009,-1.2628473,36.781805,498,1114,19,3727
16654,19343,2041,1,Business,11,4,42968,11,4,42996,11,4,43779,11,4,44904,11,4,45681,5,24.0,-1.290894,36.822971,-1.29387,36.7907813,265,777,28,1908
16655,20561,1915,2,Personal,4,1,63644,4,1,63796,4,1,64664,4,1,65178,4,1,66288,7,21.2,-1.28621,36.825633,-1.2622212,36.7865781,116,1110,152,1382
16656,1312,136,3,Business,1,1,36241,1,1,36579,1,1,37072,1,1,37316,1,1,38233,5,21.5,-1.2654716,36.7983635,-1.2633232,36.8305068,910,917,338,737
16657,8521,2008,3,Business,16,2,38014,16,2,38044,16,2,39410,16,2,39642,16,2,41864,17,23.25888921888938,-1.2508229,36.7895263,-1.2482377,36.6673782,690,2222,30,1598
16658,7700,1250,1,Personal,5,6,43441,5,6,43448,5,6,43918,5,6,44750,5,6,46119,5,22.6,-1.2904078,36.8301231,-1.2620741,36.8158147,948,1369,7,1302
16659,10596,86,1,Personal,3,5,30173,3,5,30223,3,5,31314,3,5,31652,3,5,32823,10,17.3,-1.3014461,36.7661381,-1.2598589,36.7470168,105,1171,50,1429
16660,1173,1075,3,Business,28,2,34588,28,2,34612,28,2,34807,28,2,34996,28,2,35486,1,18.5,-1.2649605,36.7981777,-1.2527958,36.8003131,96,490,24,384
16661,7274,393,3,Business,7,4,57490,7,4,57564,7,4,58344,7,4,58986,7,4,60518,11,30.9,-1.3167113,36.8301563,-1.2638185,36.7930057,178,1532,74,1422
16662,23383,393,3,Business,30,2,44173,30,2,44427,30,2,45190,30,2,45611,30,2,47174,11,23.25888921888938,-1.3167113,36.8301563,-1.2638185,36.7930057,709,1563,254,1184
16663,10917,2987,3,Business,7,4,41027,7,4,41612,7,4,42362,7,4,42731,7,4,45933,10,16.8,-1.270212,36.8210877,-1.3014461,36.7661381,771,3202,585,1119
16664,2991,868,3,Business,26,5,31630,26,5,31707,26,5,34639,26,5,35536,26,5,38124,6,23.25888921888938,-1.307143,36.825009,-1.265715,36.823815,204,2588,77,3829
16665,14379,393,3,Business,11,2,52343,11,2,52452,11,2,53217,11,2,53419,11,2,53932,4,21.1,-1.3228003,36.8306435,-1.3004062,36.829741,2,513,109,967
16666,4995,1745,2,Personal,11,2,35963,11,2,36939,11,2,38276,11,2,38487,11,2,40157,11,24.0,-1.3169591,36.7000029,-1.304033,36.7848695,844,1670,976,1548
16667,20624,2978,3,Business,11,2,34749,11,2,34966,11,2,35309,11,2,36927,11,2,36945,6,18.2,-1.2551895,36.7822034,-1.2817758,36.7980252,295,18,217,1961
16668,21235,142,3,Business,28,5,44505,28,5,44941,28,5,45830,28,5,46084,28,5,46965,6,25.2,-1.2857723,36.8088058,-1.2963097,36.7688221,932,881,436,1143
16669,22282,2544,3,Personal,21,2,46929,21,2,46983,21,2,47127,21,2,47406,21,2,48184,5,22.4,-1.2664677,36.7793258,-1.2580991,36.7941519,269,778,54,423
16670,13200,3283,3,Business,7,1,50093,7,1,52230,7,1,53249,7,1,53724,7,1,53776,6,27.0,-1.272828,36.816608,-1.2628473,36.781805,574,52,2137,1494
16671,495,3283,3,Business,15,1,49127,15,1,49168,15,1,49795,15,1,51294,15,1,52685,14,23.25888921888938,-1.228911,36.881876,-1.2628473,36.781805,96,1391,41,2126
16672,10168,1250,1,Personal,10,4,53695,10,4,53957,10,4,55148,10,4,55419,10,4,57151,7,21.6,-1.2891773,36.8455788,-1.2620741,36.8158147,727,1732,262,1462
16673,16424,496,3,Business,27,5,46619,27,5,46658,27,5,46966,27,5,47408,27,5,48046,6,22.4,-1.2551895,36.7822034,-1.2843046,36.7746132,445,638,39,750
16674,8983,1882,3,Business,13,7,34575,13,7,34587,13,7,35064,13,7,35368,13,7,37705,14,20.1,-1.2268871,36.8073946,-1.2237773,36.8861711,101,2337,12,781
16675,20809,532,3,Personal,4,1,40299,4,1,40313,4,1,41026,4,1,42266,4,1,43580,14,21.1,-1.2363092,36.8823617,-1.274755,36.7906585,735,1314,14,1953
16676,3471,2423,3,Business,26,5,32073,26,5,32119,26,5,32703,26,5,33501,26,5,34451,7,23.25888921888938,-1.2551895,36.7822034,-1.2934657,36.8212737,205,950,46,1382
16677,4808,3277,2,Personal,18,5,49662,18,5,51321,18,5,52171,18,5,52533,18,5,53882,5,24.4,-1.2863177,36.8237972,-1.2913382,36.8018508,89,1349,1659,1212
16678,27090,2042,3,Business,6,4,43948,6,4,43954,6,4,44000,6,4,44867,6,4,46900,12,22.1,-1.2860183,36.8975338,-1.3189252,36.8617269,900,2033,6,913
16679,4044,3042,3,Business,31,2,36098,31,2,36138,31,2,36960,31,2,37045,31,2,38175,4,17.1,-1.2903421,36.7885282,-1.2935057,36.8101802,933,1130,40,907
16680,3662,3560,3,Business,5,2,48992,5,2,50581,5,2,50616,5,2,51032,5,2,52425,9,27.7,-1.279395,36.825364,-1.2413316,36.8785525,365,1393,1589,451
16681,3561,1329,3,Business,9,6,38166,9,6,38210,9,6,38230,9,6,39387,9,6,40542,10,25.0,-1.273056,36.811298,-1.2879162,36.7548254,40,1155,44,1177
16682,4907,2943,2,Personal,16,4,63740,16,4,64023,16,4,66640,16,4,66923,16,4,69165,9,19.3,-1.3032455,36.7691712,-1.2482518,36.7550829,229,2242,283,2900
16683,10781,3465,3,Business,2,4,29650,2,4,29695,2,4,30293,2,4,30630,2,4,30975,3,23.25888921888938,-1.2551895,36.7822034,-1.268501,36.801065,72,345,45,935
16684,18110,1919,3,Business,15,2,51134,15,2,51217,15,2,52068,15,2,52233,15,2,54548,7,24.5,-1.257569,36.842164,-1.2731645,36.7900343,685,2315,83,1016
16685,26567,2330,3,Business,31,4,46036,31,4,48904,31,4,51319,31,4,51504,31,4,53763,5,28.9,-1.2671943,36.8062533,-1.293082,36.8278578,362,2259,2868,2600
16686,27299,238,3,Business,29,5,52064,29,5,52101,29,5,52698,29,5,52857,29,5,53230,3,29.0,-1.3077869,36.8443207,-1.3166812,36.8594608,519,373,37,756
16687,14319,3355,3,Business,23,3,37732,23,3,38148,23,3,39077,23,3,40825,23,3,41710,7,22.0,-1.2620912,36.8013562,-1.3052491,36.8223899,397,885,416,2677
16688,20533,393,3,Business,6,2,59912,6,2,61219,6,2,62016,6,2,62111,6,2,62882,4,23.25888921888938,-1.3177547,36.8303703,-1.3004062,36.829741,333,771,1307,892
16689,4796,1280,3,Business,8,4,62677,8,4,62727,8,4,63687,8,4,63856,8,4,64492,3,25.6,-1.2551895,36.7822034,-1.2654348,36.8022464,578,636,50,1129
16690,21165,2691,3,Business,15,5,42978,15,5,43026,15,5,44007,15,5,44774,15,5,46477,10,26.3,-1.2551895,36.7822034,-1.3159617,36.8117934,331,1703,48,1748
16691,20818,868,3,Business,24,4,57302,24,4,60400,24,4,60930,24,4,61046,24,4,62482,8,21.0,-1.303596,36.778378,-1.265715,36.823815,88,1436,3098,646
16692,28236,3557,3,Business,22,3,42665,22,3,42689,22,3,42866,22,3,43088,22,3,44034,3,23.2,-1.2546732,36.8086796,-1.2753109,36.8130185,930,946,24,399
16693,20410,1402,3,Business,12,5,39362,12,5,39373,12,5,40750,12,5,41046,12,5,42543,13,26.4,-1.2232123,36.8932547,-1.2813012,36.8323962,76,1497,11,1673
16694,15782,709,2,Personal,25,2,29197,25,2,29207,25,2,30131,25,2,30802,25,2,32208,10,18.0,-1.2982544,36.7500835,-1.2626765,36.795599,640,1406,10,1595
16695,593,1502,3,Business,12,6,47358,12,6,47370,12,6,48444,12,6,48906,12,6,51064,15,24.9,-1.225322,36.80855,-1.2232123,36.8932547,199,2158,12,1536
16696,7411,3686,3,Business,30,4,40329,30,4,40354,30,4,40397,30,4,40920,30,4,47955,12,23.25888921888938,-1.2551895,36.7822034,-1.3210622,36.802019,187,7035,25,566
16697,306,478,3,Business,30,2,38651,30,2,39022,30,2,39956,30,2,40289,30,2,41455,5,23.25888921888938,-1.2551895,36.7822034,-1.2658315,36.809049,40,1166,371,1267
16698,18988,3689,3,Business,14,5,63532,14,5,63576,14,5,63632,14,5,64416,14,5,66776,3,23.0,-1.2551895,36.7822034,-1.2527958,36.8003131,107,2360,44,840
16699,19992,2787,1,Personal,24,4,50335,24,4,50440,24,4,52755,24,4,52951,24,4,53615,6,22.8,-1.2797311,36.821852,-1.2553615,36.7895376,844,664,105,2511
16700,19790,1469,3,Business,29,2,39873,29,2,40044,29,2,40223,29,2,40372,29,2,42141,8,23.5,-1.2551895,36.7822034,-1.2931812,36.8176469,881,1769,171,328
16701,14995,2587,3,Business,30,1,59695,30,1,59773,30,1,61297,30,1,62192,30,1,64512,11,15.9,-1.2859912,36.8756811,-1.2885529,36.8160141,281,2320,78,2419
16702,17652,633,3,Business,26,2,55621,26,2,55805,26,2,55857,26,2,56820,26,2,57923,4,30.8,-1.2770708,36.8231093,-1.3004062,36.829741,80,1103,184,1015
16703,214,2890,3,Personal,7,5,68712,7,5,68742,7,5,69671,7,5,69848,7,5,70786,7,22.3,-1.2615584,36.8149506,-1.2670847,36.7858231,598,938,30,1106
16704,17051,797,3,Business,25,5,49818,25,5,49865,25,5,50230,25,5,50822,25,5,51972,13,29.4,-1.2551895,36.7822034,-1.2336076,36.8336102,328,1150,47,957
16705,10437,2828,1,Business,20,1,53701,20,1,53922,20,1,54368,20,1,54651,20,1,55589,8,21.5,-1.2696183,36.8021778,-1.31522,36.837006,249,938,221,729
16706,2918,535,3,Business,11,6,43686,11,6,43725,11,6,44116,11,6,44751,11,6,47472,18,23.25888921888938,-1.2549259,36.7919494,-1.2715944,36.9114173,438,2721,39,1026
16707,26758,3701,3,Business,30,1,42078,30,1,42103,30,1,42537,30,1,42797,30,1,43871,5,22.4,-1.2684239,36.7952462,-1.2762743,36.8152789,519,1074,25,694
16708,25006,1724,3,Business,24,5,42457,24,5,42543,24,5,43255,24,5,43343,24,5,46197,6,21.4,-1.2551895,36.7822034,-1.2647975,36.8215183,930,2854,86,800
16709,1332,393,3,Business,25,4,57974,25,4,58009,25,4,58029,25,4,58911,25,4,59604,4,23.25888921888938,-1.3167113,36.8301563,-1.3004062,36.829741,168,693,35,902
16710,27791,1271,3,Business,11,5,35147,11,5,35153,11,5,35377,11,5,35543,11,5,38445,22,20.9,-1.3244885,36.897792,-1.2831463,36.7636022,457,2902,6,390
16711,12940,2066,3,Business,4,5,52570,4,5,52759,4,5,53596,4,5,54182,4,5,55576,12,24.1,-1.316961,36.820337,-1.327079,36.881469,101,1394,189,1423
16712,22567,2317,1,Personal,28,5,43483,28,5,43509,28,5,44486,28,5,44689,28,5,46901,4,25.1,-1.3003196,36.8171416,-1.2966535,36.8123136,532,2212,26,1180
16713,21326,1340,3,Business,19,4,39621,19,4,39651,19,4,40167,19,4,40780,19,4,43037,15,20.0,-1.3301121,36.89331,-1.2707179,36.7979713,670,2257,30,1129
16714,9703,706,3,Business,9,3,41830,9,3,41849,9,3,42510,9,3,42848,9,3,46255,15,25.2,-1.2991441,36.7528804,-1.3077869,36.8443207,436,3407,19,999
16715,5804,1363,3,Business,3,3,44752,3,3,44985,3,3,46018,3,3,46359,3,3,47245,3,24.0,-1.3004062,36.829741,-1.2830186,36.8232619,21,886,233,1374
16716,22470,2069,3,Business,3,1,50628,3,1,52097,3,1,52573,3,1,53532,3,1,54637,12,23.1,-1.2600926,36.8088685,-1.228911,36.881876,675,1105,1469,1435
16717,14410,248,3,Business,23,2,56094,23,2,56171,23,2,57676,23,2,58080,23,2,59455,9,19.1,-1.2557779,36.7879648,-1.304735,36.7846054,46,1375,77,1909
16718,5196,2801,3,Business,13,2,52931,13,2,53752,13,2,54624,13,2,54695,13,2,57721,10,26.2,-1.2595422,36.7871178,-1.307726,36.839117,916,3026,821,943
16719,3978,666,2,Personal,13,3,47184,13,3,47989,13,3,48292,13,3,49278,13,3,50472,6,23.3,-1.2801026,36.7825749,-1.2883346,36.8148489,101,1194,805,1289
16720,21937,868,3,Business,1,1,32671,1,1,32839,1,1,33474,1,1,34389,1,1,34783,3,21.3,-1.2783849,36.8163445,-1.265715,36.823815,119,394,168,1550
16721,14645,647,3,Business,7,5,44683,7,5,44739,7,5,44820,7,5,45464,7,5,46723,6,23.25888921888938,-1.3004062,36.829741,-1.274291,36.8334934,2,1259,56,725
16722,22684,2523,3,Business,19,2,36996,19,2,37209,19,2,37899,19,2,38477,19,2,39326,9,27.3,-1.2551895,36.7822034,-1.2724387,36.8212279,365,849,213,1268
16723,21911,3517,3,Business,11,5,54980,11,5,55000,11,5,55013,11,5,55895,11,5,58821,15,26.5,-1.300921,36.828195,-1.3882008,36.7699445,581,2926,20,895
16724,11060,649,3,Business,27,4,54645,27,4,54661,27,4,54762,27,4,55595,27,4,59144,22,24.9,-1.2551895,36.7822034,-1.3562374,36.9042954,64,3549,16,934
16725,23311,540,3,Business,24,4,45556,24,4,45565,24,4,45590,24,4,45847,24,4,46844,4,24.4,-1.2551895,36.7822034,-1.2753109,36.8130185,876,997,9,282
16726,17735,1500,3,Business,4,4,33425,4,4,33457,4,4,37499,4,4,39149,4,4,40106,11,25.5,-1.3077869,36.8443207,-1.2638185,36.7930057,127,957,32,5692
16727,5352,3283,3,Business,13,4,57262,13,4,57294,13,4,58022,13,4,58671,13,4,60693,14,22.9,-1.228911,36.881876,-1.2628473,36.781805,60,2022,32,1377
16728,23978,2829,3,Business,9,4,62591,9,4,62622,9,4,63130,9,4,63626,9,4,64820,6,23.2,-1.2571472,36.7950633,-1.2857671,36.7875614,898,1194,31,1004
16729,15762,186,3,Business,19,2,52546,19,2,52592,19,2,53092,19,2,54225,19,2,54959,5,29.9,-1.2825816,36.8092346,-1.2571472,36.7950633,267,734,46,1633
16730,6524,2700,1,Business,10,2,62276,10,2,62289,10,2,62739,10,2,63224,10,2,64218,6,20.4,-1.2665974,36.7921181,-1.293973,36.80169,951,994,13,935
16731,25374,435,3,Business,23,4,32652,23,4,32724,23,4,33925,23,4,34667,23,4,35577,7,23.25888921888938,-1.2908072,36.7860517,-1.300921,36.828195,119,910,72,1943
16732,2250,868,3,Business,5,6,49060,5,6,49068,5,6,49265,5,6,49603,5,6,51389,7,22.0,-1.2628473,36.781805,-1.265715,36.823815,512,1786,8,535
16733,13075,633,3,Business,22,5,37845,22,5,37961,22,5,38611,22,5,39342,22,5,41058,12,28.3,-1.2991441,36.7528804,-1.3004062,36.829741,306,1716,116,1381
16734,13036,269,3,Business,25,4,54921,25,4,58437,25,4,58652,25,4,58876,25,4,60437,10,20.8,-1.3332749,36.8708147,-1.2810586,36.8838294,620,1561,3516,439
16735,3789,1405,3,Business,18,2,37921,18,2,37939,18,2,39381,18,2,39605,18,2,41658,19,22.5,-1.2986828,36.7927414,-1.3478563,36.8935824,456,2053,18,1666
16736,20820,59,3,Business,22,5,34468,22,5,34643,22,5,36437,22,5,38389,22,5,38789,6,28.4,-1.29387,36.7907813,-1.290894,36.822971,119,400,175,3746
16737,9515,3491,3,Business,25,5,40042,25,5,40054,25,5,41009,25,5,42165,25,5,44498,23,21.2,-1.3562374,36.9042954,-1.2297202,36.8745508,543,2333,12,2111
16738,15908,1075,3,Business,16,2,57990,16,2,58035,16,2,58853,16,2,59151,16,2,59912,1,23.25888921888938,-1.2649605,36.7981777,-1.2527958,36.8003131,318,761,45,1116
16739,7781,3091,1,Business,28,6,45068,28,6,45091,28,6,45587,28,6,46308,28,6,47457,10,24.0,-1.2536042,36.8064895,-1.3014461,36.7661381,116,1149,23,1217
16740,18344,393,3,Business,7,5,31663,7,5,31896,7,5,33653,7,5,35036,7,5,35815,8,23.25888921888938,-1.3228003,36.8306435,-1.2770708,36.8231093,921,779,233,3140
16741,24706,2561,3,Business,29,4,44225,29,4,44261,29,4,44647,29,4,44980,29,4,45557,4,21.7,-1.2564152,36.7792803,-1.2551895,36.7822034,920,577,36,719
16742,7381,1075,3,Business,17,4,48936,17,4,48993,17,4,49876,17,4,50332,17,4,51211,8,28.2,-1.2326041,36.8009029,-1.2527958,36.8003131,250,879,57,1339
16743,18554,1341,3,Business,27,3,60803,27,3,60824,27,3,61391,27,3,61834,27,3,63688,15,27.6,-1.2628473,36.781805,-1.331619,36.847976,177,1854,21,1010
16744,7086,198,3,Business,20,1,43485,20,1,43676,20,1,44550,20,1,44957,20,1,45334,10,20.3,-1.3396256,36.8863135,-1.3382057,36.8944104,248,377,191,1281
16745,18461,2066,3,Business,15,1,51232,15,1,51311,15,1,53273,15,1,54835,15,1,55730,6,23.25888921888938,-1.2978549,36.8564807,-1.3210189,36.8410551,168,895,79,3524
16746,20609,1874,3,Business,22,4,40998,22,4,41176,22,4,42873,22,4,42958,22,4,43758,7,22.7,-1.2571472,36.7950633,-1.2950041,36.8143583,744,800,178,1782
16747,26956,3291,3,Business,10,1,42286,10,1,42352,10,1,42398,10,1,43655,10,1,44101,5,18.5,-1.2628473,36.781805,-1.2600926,36.8088685,258,446,66,1303
16748,20749,136,3,Business,15,3,52339,15,3,52426,15,3,53556,15,3,54966,15,3,57978,17,25.9,-1.2629838,36.8086926,-1.3254522,36.7216584,325,3012,87,2540
16749,11702,1500,3,Business,16,4,39707,16,4,39785,16,4,40211,16,4,40886,16,4,42127,8,23.25888921888938,-1.3004062,36.829741,-1.2638185,36.7930057,92,1241,78,1101
16750,23355,2780,1,Personal,21,5,40223,21,5,40233,21,5,42313,21,5,42422,21,5,43362,5,20.0,-1.2854406,36.789409,-1.2739488,36.8060493,722,940,10,2189
16751,4377,2330,3,Business,31,4,38408,31,4,38450,31,4,38868,31,4,39216,31,4,40538,19,26.4,-1.2642903,36.8002137,-1.185943,36.9276394,648,1322,42,766
16752,25763,1271,3,Business,30,5,38806,30,5,39106,30,5,39971,30,5,40238,30,5,43590,29,23.5,-1.3244885,36.897792,-1.1404395,36.9668024,254,3352,300,1132
16753,8704,1502,3,Business,14,1,55979,14,1,56040,14,1,56192,14,1,57006,14,1,58293,13,25.8,-1.2584143,36.8048002,-1.2232123,36.8932547,685,1287,61,966
16754,25285,3283,3,Business,27,6,40181,27,6,40202,27,6,40417,27,6,42391,27,6,43089,6,23.25888921888938,-1.272828,36.816608,-1.2628473,36.781805,19,698,21,2189
16755,22011,33,3,Personal,9,4,48635,9,4,49149,9,4,50861,9,4,51387,9,4,52954,6,23.25888921888938,-1.2814609,36.8265932,-1.2544051,36.7982934,341,1567,514,2238
16756,26882,928,3,Business,15,2,35456,15,2,35521,15,2,36011,15,2,37746,15,2,41106,9,20.4,-1.2985749,36.8088,-1.2571472,36.7950633,829,3360,65,2225
16757,19492,1209,3,Business,18,4,52377,18,4,53458,18,4,54336,18,4,54808,18,4,54810,4,23.25888921888938,-1.3077869,36.8443207,-1.3004062,36.829741,515,2,1081,1350
16758,22510,2516,1,Personal,29,3,44598,29,3,44663,29,3,45303,29,3,45601,29,3,46818,6,18.4,-1.2860203,36.7832538,-1.2934657,36.8212737,249,1217,65,938
16759,15395,2154,3,Business,31,3,42509,31,3,42568,31,3,42932,31,3,43419,31,3,44125,5,24.8,-1.279395,36.825364,-1.2765736,36.8513646,878,706,59,851
16760,26676,2963,1,Personal,18,1,38371,18,1,38591,18,1,38945,18,1,39615,18,1,40033,2,23.25888921888938,-1.3007534,36.7964576,-1.2860203,36.7832538,865,418,220,1024
16761,11932,557,3,Business,29,1,35054,29,1,35064,29,1,35955,29,1,36453,29,1,38074,14,23.25888921888938,-1.238874,36.807889,-1.2969741,36.7856612,96,1621,10,1389
16762,16472,391,3,Business,28,4,29895,28,4,38459,28,4,38470,28,4,41382,28,4,41395,5,23.25888921888938,-1.300921,36.828195,-1.2867454,36.8259017,927,13,8564,2923
16763,23532,788,3,Business,22,5,48911,22,5,49149,22,5,51148,22,5,51235,22,5,53568,9,27.2,-1.225322,36.80855,-1.2551895,36.7822034,154,2333,238,2086
16764,17807,2869,3,Business,15,5,42282,15,5,42294,15,5,42377,15,5,43550,15,5,44946,10,25.9,-1.2584143,36.8048002,-1.3025826,36.7670807,345,1396,12,1256
16765,6606,2154,3,Business,5,4,30247,5,4,32260,5,4,33993,5,4,35437,5,4,36977,5,23.25888921888938,-1.290894,36.822971,-1.2765736,36.8513646,159,1540,2013,3177
16766,26695,2987,3,Business,14,3,59285,14,3,59510,14,3,59523,14,3,60181,14,3,60951,3,23.3,-1.260232,36.807334,-1.270212,36.8210877,40,770,225,671
16767,22277,1329,3,Business,1,4,32761,1,4,32826,1,4,33653,1,4,33837,1,4,35713,14,23.25888921888938,-1.273056,36.811298,-1.2970848,36.8878229,279,1876,65,1011
16768,24742,2986,3,Personal,18,5,37281,18,5,37335,18,5,37931,18,5,39031,18,5,40718,13,20.3,-1.338484,36.883377,-1.2903886,36.8063847,418,1687,54,1696
16769,27919,2956,3,Business,12,1,57502,12,1,58306,12,1,58363,12,1,59175,12,1,61226,9,26.7,-1.3014461,36.7661381,-1.2584143,36.8048002,699,2051,804,869
16770,15212,640,3,Business,16,5,52923,16,5,53143,16,5,54247,16,5,54526,16,5,55650,3,23.25888921888938,-1.304033,36.7848695,-1.2945106,36.7728398,353,1124,220,1383
16771,564,3017,3,Business,13,5,68702,13,5,68735,13,5,69282,13,5,69395,13,5,70192,3,19.2,-1.299313,36.7831488,-1.2894256,36.7620285,648,797,33,660
16772,19316,1075,3,Business,28,2,37738,28,2,37825,28,2,38179,28,2,39835,28,2,41086,5,21.2,-1.279395,36.825364,-1.2527958,36.8003131,843,1251,87,2010
16773,4816,1244,3,Business,14,4,45469,14,4,47470,14,4,48662,14,4,49188,14,4,50238,7,27.9,-1.2628473,36.781805,-1.303596,36.778378,210,1050,2001,1718
16774,15348,3635,1,Business,25,6,44111,25,6,44153,25,6,44476,25,6,45327,25,6,45855,3,23.25888921888938,-1.2584143,36.8048002,-1.2615888,36.7928732,770,528,42,1174
16775,10514,3283,3,Business,3,4,35488,3,4,35789,3,4,36560,3,4,37176,3,4,39247,7,20.2,-1.2783849,36.8163445,-1.2628473,36.781805,14,2071,301,1387
16776,4156,533,3,Business,6,3,40284,6,3,40641,6,3,41615,6,3,42825,6,3,45660,8,22.6,-1.2765492,36.7669809,-1.2811503,36.8235884,277,2835,357,2184
16777,21293,3404,3,Business,21,3,49369,21,3,51143,21,3,52716,21,3,52941,21,3,54407,13,23.2,-1.2232123,36.8932547,-1.279395,36.825364,622,1466,1774,1798
16778,14315,309,3,Personal,1,2,67704,1,2,68694,1,2,70131,1,2,70616,1,2,71469,10,18.6,-1.3314506,36.8408164,-1.2750415,36.7965813,404,853,990,1922
16779,27931,2425,1,Personal,3,1,54518,3,1,54626,3,1,56083,3,1,56194,3,1,56985,6,22.8,-1.2840002,36.829922,-1.3195185,36.8180902,857,791,108,1568
16780,17717,3613,3,Business,12,1,41176,12,1,41493,12,1,43643,12,1,43754,12,1,44555,4,23.9,-1.2733622,36.7704045,-1.2941849,36.7895754,829,801,317,2261
16781,7988,970,3,Business,11,1,40564,11,1,41619,11,1,42483,11,1,42760,11,1,43539,7,23.8,-1.2551895,36.7822034,-1.293082,36.8278578,210,779,1055,1141
16782,23751,2358,4,Business,18,1,50650,18,1,50688,18,1,50995,18,1,51325,18,1,53011,31,17.3,-1.3256904,36.8747943,-1.2847178,36.6896108,543,1686,38,637
16783,1195,3091,3,Business,9,4,49108,9,4,49406,9,4,51028,9,4,51556,9,4,52048,2,23.25888921888938,-1.279395,36.825364,-1.290894,36.822971,522,492,298,2150
16784,7643,1679,1,Personal,18,4,66225,18,4,66279,18,4,66514,18,4,67538,18,4,68718,5,23.5,-1.2629666,36.8068369,-1.2839568,36.8233106,956,1180,54,1259
16785,7192,2200,3,Business,5,5,41153,5,5,41227,5,5,42294,5,5,42360,5,5,45579,6,24.6,-1.2527958,36.8003131,-1.290894,36.822971,831,3219,74,1133
16786,20920,1642,3,Business,28,3,42395,28,3,46393,28,3,47413,28,3,47774,28,3,48946,6,23.25888921888938,-1.2883829,36.8177296,-1.2726506,36.7960153,698,1172,3998,1381
16787,9382,3470,3,Business,26,1,56644,26,1,56936,26,1,56988,26,1,58113,26,1,60574,21,22.4,-1.3165542,36.700067,-1.28878,36.8168312,647,2461,292,1177
16788,9096,393,3,Business,8,5,36023,8,5,36034,8,5,36274,8,5,37196,8,5,38962,14,20.4,-1.3167113,36.8301563,-1.306378,36.7519845,523,1766,11,1162
16789,7183,1439,3,Business,9,4,40294,9,4,40349,9,4,40799,9,4,41011,9,4,42257,6,23.25888921888938,-1.2962487,36.7772971,-1.274927,36.8028302,548,1246,55,662
16790,19484,3291,3,Business,13,3,54637,13,3,55008,13,3,56494,13,3,57632,13,3,58946,12,29.1,-1.3259463,36.850258,-1.2600926,36.8088685,377,1314,371,2624
16791,4467,435,3,Business,31,5,41194,31,5,41472,31,5,41974,31,5,42553,31,5,43636,7,21.9,-1.300921,36.828195,-1.2918159,36.8773479,591,1083,278,1081
16792,877,310,3,Personal,24,1,40767,24,1,40875,24,1,41554,24,1,42176,24,1,44499,16,22.6,-1.1855066,36.8254646,-1.2824535,36.8265153,281,2323,108,1301
16793,13662,3404,3,Business,19,3,63396,19,3,63568,19,3,64319,19,3,64498,19,3,64961,2,22.6,-1.2882184,36.826346,-1.279395,36.825364,150,463,172,930
16794,22299,198,3,Business,9,2,36320,9,2,36384,9,2,37142,9,2,37246,9,2,41864,33,20.9,-1.3396256,36.8863135,-1.1427075,36.9541727,418,4618,64,862
16795,10513,1879,1,Personal,15,2,49140,15,2,49294,15,2,51794,15,2,52457,15,2,55283,13,24.7,-1.235348,36.760016,-1.2994595,36.7885482,543,2826,154,3163
16796,12812,1594,3,Business,10,5,55363,10,5,55501,10,5,56785,10,5,56861,10,5,58717,15,23.25888921888938,-1.225322,36.80855,-1.2952639,36.7562606,689,1856,138,1360
16797,23956,1304,3,Business,29,4,40507,29,4,41583,29,4,42086,29,4,42229,29,4,43489,10,21.6,-1.3226302,36.8719901,-1.295156,36.8094306,195,1260,1076,646
16798,7880,1363,3,Business,18,1,34839,18,1,35552,18,1,35645,18,1,35877,18,1,37301,10,22.1,-1.3004062,36.829741,-1.249738,36.863184,178,1424,713,325
16799,994,1927,3,Business,1,1,53119,1,1,53523,1,1,54153,1,1,54943,1,1,59272,12,25.4,-1.3463042,36.768164,-1.2866012,36.8195691,268,4329,404,1420
16800,23432,510,3,Business,22,3,57895,22,3,57989,22,3,59626,22,3,60754,22,3,63160,18,23.9,-1.2860183,36.8975338,-1.2668093,36.7966542,697,2406,94,2765
16801,17916,248,3,Business,14,4,56412,14,4,56644,14,4,57053,14,4,57355,14,4,62321,10,21.3,-1.304735,36.7846054,-1.2556717,36.8100876,89,4966,232,711
16802,24314,2127,3,Personal,11,1,53015,11,1,54475,11,1,57245,11,1,57778,11,1,58415,5,28.0,-1.2770708,36.8231093,-1.3004062,36.829741,26,637,1460,3303
16803,8659,1578,3,Business,6,2,41021,6,2,41217,6,2,41492,6,2,43016,6,2,46373,10,25.0,-1.28878,36.8168312,-1.2413316,36.8785525,101,3357,196,1799
16804,3039,1426,1,Personal,8,6,33601,8,6,33612,8,6,34058,8,6,36373,8,6,37454,10,18.2,-1.2574308,36.796051,-1.2941988,36.7685658,379,1081,11,2761
16805,10188,3283,3,Business,19,2,50190,19,2,50228,19,2,50592,19,2,51168,19,2,52171,9,18.7,-1.303596,36.778378,-1.2628473,36.781805,851,1003,38,940
16806,19667,3222,3,Business,6,4,34438,6,4,35581,6,4,36654,6,4,37138,6,4,38339,10,18.8,-1.2551895,36.7822034,-1.2287282,36.8115304,383,1201,1143,1557
16807,22889,478,3,Business,13,1,35766,13,1,35812,13,1,36620,13,1,36791,13,1,37785,9,15.4,-1.2551895,36.7822034,-1.29387,36.7907813,415,994,46,979
16808,19590,1271,3,Business,8,5,39095,8,5,39111,8,5,40697,8,5,41268,8,5,43854,26,24.1,-1.3244885,36.897792,-1.3949989,36.7654761,411,2586,16,2157
16809,375,1538,1,Personal,29,3,56243,29,3,56292,29,3,58089,29,3,58354,29,3,59621,8,18.8,-1.2996681,36.8068413,-1.3260468,36.8015034,421,1267,49,2062
16810,23908,627,3,Business,13,4,43618,13,4,43640,13,4,43853,13,4,44585,13,4,44892,3,23.4,-1.2571472,36.7950633,-1.2569383,36.7880021,647,307,22,945
16811,28259,432,3,Business,27,1,41493,27,1,41618,27,1,44671,27,1,45685,27,1,47512,7,20.9,-1.3012008,36.764868,-1.2980815,36.8085686,706,1827,125,4067
16812,21599,2649,3,Business,3,1,52826,3,1,52842,3,1,53128,3,1,53316,3,1,55842,14,23.1,-1.2752846,36.8027022,-1.206751,36.8356839,706,2526,16,474
16813,4327,1500,3,Business,18,2,37606,18,2,37612,18,2,37616,18,2,37798,18,2,38822,10,19.8,-1.2991441,36.7528804,-1.2574219,36.7927073,518,1024,6,186
16814,19366,627,3,Business,8,1,51336,8,1,51389,8,1,51584,8,1,52385,8,1,53313,2,29.5,-1.2571472,36.7950633,-1.2517841,36.8013388,507,928,53,996
16815,21631,3781,3,Business,14,3,43086,14,3,43546,14,3,44244,14,3,44730,14,3,45861,9,24.8,-1.2308211,36.8679041,-1.26071,36.8206332,761,1131,460,1184
16816,1329,3283,3,Business,18,4,46469,18,4,46514,18,4,46782,18,4,47815,18,4,48205,5,23.25888921888938,-1.266837,36.799249,-1.2628473,36.781805,484,390,45,1301
16817,5347,504,1,Personal,27,4,46665,27,4,46681,27,4,47313,27,4,47758,27,4,49225,9,22.7,-1.3104734,36.7363698,-1.2650523,36.7866798,565,1467,16,1077
16818,20742,1461,2,Personal,13,3,39024,13,3,39057,13,3,39452,13,3,40112,13,3,42690,13,20.1,-1.2720769,36.8180604,-1.2037823,36.7733347,409,2578,33,1055
16819,6727,3203,3,Business,2,6,38504,2,6,38544,2,6,38654,2,6,39354,2,6,39965,9,23.6,-1.265715,36.823815,-1.228911,36.881876,852,611,40,810
16820,8537,3295,3,Business,28,1,32962,28,1,32969,28,1,33182,28,1,33310,28,1,33905,8,17.9,-1.2983698,36.8072332,-1.255956,36.772901,207,595,7,341
16821,491,1961,3,Business,20,1,54916,20,1,54982,20,1,55654,20,1,55940,20,1,58454,17,23.25888921888938,-1.266837,36.799249,-1.3188359,36.7038526,720,2514,66,958
16822,11788,3291,3,Business,17,4,36442,17,4,36523,17,4,37847,17,4,38199,17,4,39289,6,25.2,-1.2783849,36.8163445,-1.2600926,36.8088685,899,1090,81,1676
16823,13409,3283,3,Business,21,1,48693,21,1,48728,21,1,49000,21,1,49351,21,1,49863,4,27.8,-1.266837,36.799249,-1.2628473,36.781805,279,512,35,623
16824,20631,1880,3,Business,7,4,41270,7,4,42155,7,4,43427,7,4,44340,7,4,48281,25,27.6,-1.2156006,36.8916865,-1.3310785,36.8933109,75,3941,885,2185
16825,1125,1279,2,Personal,7,4,45742,7,4,45954,7,4,46581,7,4,47424,7,4,48250,6,16.8,-1.2882965,36.7789573,-1.2973782,36.7942334,116,826,212,1470
16826,9414,1081,3,Business,13,3,39400,13,3,39425,13,3,39435,13,3,39980,13,3,40924,8,24.8,-1.2551895,36.7822034,-1.287428,36.7800821,518,944,25,555
16827,16412,2212,3,Business,5,5,56853,5,5,56882,5,5,57768,5,5,60869,5,5,60899,14,26.2,-1.2571472,36.7950633,-1.3291155,36.8861,307,30,29,3987
16828,5954,3599,3,Business,10,1,40619,10,1,40620,10,1,41166,10,1,42490,10,1,44445,14,18.3,-1.3302996,36.8707935,-1.2819302,36.7769795,675,1955,1,1870
16829,2226,3669,3,Business,11,2,60375,11,2,61681,11,2,62571,11,2,63045,11,2,65085,13,20.6,-1.2615888,36.7928732,-1.2095044,36.7832064,675,2040,1306,1364
16830,13234,1389,3,Business,8,4,56692,8,4,56826,8,4,57861,8,4,60343,8,4,64167,24,25.6,-1.3103985,36.9114173,-1.207546,36.7913976,532,3824,134,3517
16831,26425,393,3,Business,10,4,30968,10,4,30975,10,4,31041,10,4,31978,10,4,33895,14,19.3,-1.3167113,36.8301563,-1.306378,36.7519845,523,1917,7,1003
16832,12033,2436,3,Business,5,5,51385,5,5,51402,5,5,52278,5,5,52394,5,5,55162,29,26.6,-1.2551895,36.7822034,-1.13707,36.971041,188,2768,17,992
16833,25513,1927,3,Business,1,5,53238,1,5,53267,1,5,55060,1,5,55685,1,5,57212,6,24.5,-1.3404187,36.7614685,-1.3411202,36.7271342,549,1527,29,2418
16834,20914,391,3,Business,3,1,39238,3,1,39244,3,1,39525,3,1,42287,3,1,43838,5,20.5,-1.300921,36.828195,-1.2784063,36.8222933,402,1551,6,3043
16835,11942,909,3,Business,28,5,41353,28,5,43343,28,5,44160,28,5,44543,28,5,45714,9,25.1,-1.225322,36.80855,-1.2551895,36.7822034,453,1171,1990,1200
16836,5926,1402,3,Business,30,2,53784,30,2,55048,30,2,55691,30,2,56777,30,2,59521,13,23.25888921888938,-1.339046,36.762596,-1.2813012,36.8323962,155,2744,1264,1729
16837,16160,1148,3,Business,7,2,53909,7,2,53955,7,2,54485,7,2,55342,7,2,58316,14,24.8,-1.3100586,36.8500329,-1.2294985,36.8775495,471,2974,46,1387
16838,1292,2069,3,Business,7,3,40107,7,3,40169,7,3,40477,7,3,41032,7,3,41710,9,24.9,-1.272828,36.816608,-1.228911,36.881876,320,678,62,863
16839,11563,3291,3,Business,17,3,39925,17,3,40014,17,3,40071,17,3,41388,17,3,42293,5,23.25888921888938,-1.2628473,36.781805,-1.2600926,36.8088685,245,905,89,1374
16840,11411,393,3,Business,12,5,41014,12,5,41053,12,5,41060,12,5,41703,12,5,41707,4,26.7,-1.3167113,36.8301563,-1.3004062,36.829741,239,4,39,650
16841,8019,2353,1,Personal,6,5,46364,6,5,46612,6,5,46631,6,5,47391,6,5,48260,5,20.3,-1.28633,36.82125,-1.2903643,36.8319433,79,869,248,779
16842,21536,1500,3,Business,15,3,39421,15,3,39444,15,3,39469,15,3,41367,15,3,42342,13,23.25888921888938,-1.2638185,36.7930057,-1.2434951,36.6760986,291,975,23,1923
16843,27132,733,3,Business,11,4,59772,11,4,59960,11,4,59989,11,4,60429,11,4,61834,11,26.4,-1.2571472,36.7950633,-1.3257473,36.8592068,881,1405,188,469
16844,19102,1527,3,Business,27,1,37896,27,1,37982,27,1,38385,27,1,38676,27,1,39891,9,20.7,-1.2638185,36.7930057,-1.3004062,36.829741,96,1215,86,694
16845,8241,2523,3,Business,3,2,49080,3,2,49217,3,2,49759,3,2,50051,3,2,51161,8,20.0,-1.2551895,36.7822034,-1.304394,36.818995,88,1110,137,834
16846,9083,3194,3,Business,22,4,56414,22,4,56504,22,4,56940,22,4,57126,22,4,58121,4,26.2,-1.2551895,36.7822034,-1.2618632,36.8100226,190,995,90,622
16847,15281,3686,3,Business,14,4,40445,14,4,43138,14,4,44641,14,4,44720,14,4,44727,6,23.7,-1.2551895,36.7822034,-1.2912287,36.8178977,634,7,2693,1582
16848,27031,1527,3,Business,17,5,31881,17,5,31954,17,5,32194,17,5,33121,17,5,34064,7,23.25888921888938,-1.3004062,36.829741,-1.2909735,36.7782587,538,943,73,1167
16849,13784,893,3,Business,19,1,45635,19,1,45705,19,1,46144,19,1,46531,19,1,47283,5,24.9,-1.2594474,36.8089122,-1.2850523,36.7859591,675,752,70,826
16850,21368,3115,3,Business,8,3,67243,8,3,67428,8,3,67815,8,3,68757,8,3,69384,2,23.25888921888938,-1.2969741,36.7856612,-1.2963097,36.7688221,226,627,185,1329
16851,6628,2523,3,Business,5,2,43333,5,2,43449,5,2,44102,5,2,44546,5,2,45578,8,25.6,-1.2551895,36.7822034,-1.2876804,36.7802778,920,1032,116,1097
16852,25289,3229,3,Personal,24,3,39109,24,3,39233,24,3,40297,24,3,40475,24,3,41857,10,23.25888921888938,-1.3068448,36.8348641,-1.2561231,36.7940997,130,1382,124,1242
16853,4744,190,3,Business,3,1,45599,3,1,45898,3,1,48081,3,1,48752,3,1,49504,5,23.3,-1.3270347,36.8667362,-1.3390024,36.8746657,126,752,299,2854
16854,14057,3283,3,Business,28,6,51999,28,6,52751,28,6,53031,28,6,53561,28,6,55443,20,24.8,-1.2628473,36.781805,-1.293515,36.897607,101,1882,752,810
16855,20201,1499,2,Personal,24,4,35169,24,4,35195,24,4,35484,24,4,35857,24,4,37037,7,16.8,-1.2606445,36.8185586,-1.294904,36.814658,103,1180,26,662
16856,11897,1869,1,Personal,9,3,52849,9,3,53193,9,3,54946,9,3,55086,9,3,56312,6,23.5,-1.2976314,36.777256,-1.2778976,36.8166591,101,1226,344,1893
16857,24285,18,3,Personal,25,5,55267,25,5,55313,25,5,55605,25,5,56273,25,5,58320,11,23.3,-1.2960302,36.7711317,-1.355845,36.7088261,478,2047,46,960
16858,2815,432,3,Business,24,5,47311,24,5,47644,24,5,48319,24,5,48954,24,5,52744,22,23.1,-1.3562374,36.9042954,-1.3012008,36.764868,205,3790,333,1310
16859,21705,3560,3,Business,7,3,45895,7,3,49257,7,3,50025,7,3,50414,7,3,52321,8,28.4,-1.3014461,36.7661381,-1.279395,36.825364,260,1907,3362,1157
16860,2911,3584,2,Personal,14,5,43160,14,5,43196,14,5,44013,14,5,44546,14,5,45974,7,24.5,-1.3172395,36.839269,-1.299542,36.7911201,810,1428,36,1350
16861,12125,3291,3,Business,22,6,47903,22,6,47925,22,6,48550,22,6,48635,22,6,49384,4,21.1,-1.265715,36.823815,-1.2600926,36.8088685,103,749,22,710
16862,4433,2152,2,Personal,10,4,46672,10,4,46780,10,4,46830,10,4,47642,10,4,49116,7,23.25888921888938,-1.2718504,36.8246277,-1.2684894,36.780451,777,1474,108,862
16863,19498,1346,3,Business,18,1,57142,18,1,57175,18,1,58207,18,1,58651,18,1,59208,2,29.7,-1.3035494,36.7914336,-1.2917868,36.7872675,76,557,33,1476
16864,26385,640,3,Business,24,3,36048,24,3,36056,24,3,36362,24,3,37084,24,3,39798,21,17.1,-1.304033,36.7848695,-1.207546,36.7913976,578,2714,8,1028
16865,151,393,3,Business,5,1,30030,5,1,30111,5,1,31619,5,1,31987,5,1,34086,14,18.4,-1.3177547,36.8303703,-1.306378,36.7519845,208,2099,81,1876
16866,26527,2701,3,Business,31,4,48365,31,4,48951,31,4,51641,31,4,51937,31,4,52753,10,23.1,-1.279395,36.825364,-1.2478187,36.8844611,589,816,586,2986
16867,26324,3439,3,Business,24,5,36480,24,5,36593,24,5,38878,24,5,39192,24,5,40574,11,21.3,-1.2393157,36.7668877,-1.2466809,36.8237453,689,1382,113,2599
16868,20474,1544,3,Business,10,5,56504,10,5,56890,10,5,58223,10,5,60957,10,5,62348,3,23.25888921888938,-1.2873232,36.7658572,-1.291692,36.7528145,567,1391,386,4067
16869,1812,598,1,Business,20,1,57837,20,1,58040,20,1,58477,20,1,58711,20,1,59166,2,21.6,-1.2536797,36.7995085,-1.255392,36.792539,882,455,203,671
16870,14574,3091,3,Business,5,3,42883,5,3,48724,5,3,49827,5,3,50363,5,3,52977,19,25.1,-1.2859912,36.8756811,-1.3012008,36.764868,510,2614,5841,1639
16871,18169,3291,3,Business,14,3,46432,14,3,46801,14,3,47226,14,3,48135,14,3,48637,5,24.4,-1.2628473,36.781805,-1.2600926,36.8088685,131,502,369,1334
16872,21126,909,3,Business,30,5,48520,30,5,50871,30,5,51529,30,5,51589,30,5,54289,8,24.8,-1.225322,36.80855,-1.259697,36.800802,447,2700,2351,718
16873,21528,322,3,Business,14,5,53103,14,5,53110,14,5,55113,14,5,55685,14,5,58046,15,27.1,-1.2452664,36.8028541,-1.3231725,36.8640177,844,2361,7,2575
16874,28013,2150,3,Business,13,2,33959,13,2,33970,13,2,34143,13,2,34759,13,2,35822,12,19.8,-1.331619,36.847976,-1.344446,36.756597,439,1063,11,789
16875,25554,84,3,Business,15,5,55416,15,5,55536,15,5,57185,15,5,57494,15,5,59791,19,28.2,-1.2551895,36.7822034,-1.2860183,36.8975338,547,2297,120,1958
16876,7539,1934,2,Personal,15,1,59246,15,1,59288,15,1,59698,15,1,61114,15,1,61953,7,23.25888921888938,-1.264621,36.778904,-1.2563576,36.7881585,754,839,42,1826
16877,16720,2304,1,Personal,21,5,63351,21,5,63397,21,5,64672,21,5,65647,21,5,67478,14,25.0,-1.2946769,36.7501951,-1.3549418,36.7280528,268,1831,46,2250
16878,18528,20,3,Business,20,5,58085,20,5,59264,20,5,60765,20,5,62142,20,5,64565,13,20.2,-1.3346931,36.8661911,-1.2628638,36.8070399,808,2423,1179,2878
16879,6653,238,3,Business,27,3,31082,27,3,31110,27,3,31255,27,3,31886,27,3,32317,4,21.5,-1.3077869,36.8443207,-1.3004062,36.829741,448,431,28,776
16880,22988,2933,2,Personal,19,4,55900,19,4,55955,19,4,56235,19,4,56554,19,4,57930,9,20.3,-1.3052672,36.7538539,-1.2721028,36.7953485,412,1376,55,599
16881,3633,868,3,Business,25,1,61686,25,1,61739,25,1,63213,25,1,63327,25,1,64682,4,28.5,-1.265715,36.823815,-1.2783849,36.8163445,118,1355,53,1588
16882,18095,3264,3,Business,9,5,38544,9,5,38572,9,5,39174,9,5,39252,9,5,40170,9,25.9,-1.2551895,36.7822034,-1.2962618,36.7929334,623,918,28,680
16883,1275,2030,3,Business,4,5,40972,4,5,41067,4,5,42897,4,5,43109,4,5,46959,2,17.3,-1.2508229,36.7895263,-1.2601197,36.7985271,916,3850,95,2042
16884,18939,2523,3,Business,19,2,34602,19,2,34610,19,2,34651,19,2,34905,19,2,35501,3,23.25888921888938,-1.2551895,36.7822034,-1.2676026,36.8103629,523,596,8,295
16885,19388,246,3,Business,30,1,63539,30,1,63583,30,1,66143,30,1,66636,30,1,67621,4,16.2,-1.2332902,36.7971244,-1.2584143,36.8048002,140,985,44,3053
16886,27762,2828,1,Business,16,4,39172,16,4,39272,16,4,39761,16,4,41596,16,4,43094,9,14.7,-1.3044267,36.8264567,-1.2615888,36.7928732,848,1498,100,2324
16887,20080,845,3,Business,29,5,58840,29,5,58851,29,5,59797,29,5,60054,29,5,61363,3,20.3,-1.2694073,36.7989138,-1.2697141,36.7981777,281,1309,11,1203
16888,9366,2789,3,Business,22,3,52754,22,3,54327,22,3,54716,22,3,54895,22,3,55924,7,24.2,-1.304735,36.7846054,-1.2764851,36.8007126,177,1029,1573,568
16889,12581,393,3,Business,4,1,30587,4,1,30933,4,1,31453,4,1,32676,4,1,33841,11,21.7,-1.3167113,36.8301563,-1.2638185,36.7930057,154,1165,346,1743
16890,15599,2112,3,Business,29,5,47298,29,5,48034,29,5,48202,29,5,48828,29,5,49684,11,21.3,-1.2765736,36.8513646,-1.2156006,36.8916865,549,856,736,794
16891,9328,633,3,Business,22,5,55376,22,5,55862,22,5,58660,22,5,58951,22,5,59557,4,30.8,-1.3077869,36.8443207,-1.3004062,36.829741,682,606,486,3089
16892,14580,393,3,Business,1,5,51886,1,5,51908,1,5,51915,1,5,54739,1,5,54741,14,28.3,-1.3167113,36.8301563,-1.306378,36.7519845,239,2,22,2831
16893,25448,3565,3,Business,3,7,39399,3,7,39410,3,7,39783,3,7,39929,3,7,41896,18,27.8,-1.2844665,36.7866113,-1.207546,36.7913976,368,1967,11,519
16894,27007,393,3,Business,1,5,32162,1,5,33491,1,5,33582,1,5,36482,1,5,36485,11,23.0,-1.3167113,36.8301563,-1.2638185,36.7930057,39,3,1329,2991
16895,24892,2360,3,Business,5,5,55956,5,5,56000,5,5,56619,5,5,57247,5,5,58165,4,27.4,-1.2708857,36.8135766,-1.2551895,36.7822034,383,918,44,1247
16896,13837,3147,3,Business,14,5,44228,14,5,44239,14,5,45005,14,5,45419,14,5,47231,17,24.5,-1.3472066,36.7692638,-1.2551895,36.7822034,882,1812,11,1180
16897,7825,3728,2,Personal,3,4,38270,3,4,38287,3,4,39477,3,4,39778,3,4,41883,5,22.0,-1.2839026,36.80893,-1.2661264,36.8030359,753,2105,17,1491
16898,10541,3496,3,Business,17,4,54317,17,4,55947,17,4,56290,17,4,56653,17,4,58463,5,24.1,-1.2850694,36.8236625,-1.3016417,36.8271679,949,1810,1630,706
16899,15979,2987,3,Business,10,5,47090,10,5,47121,10,5,48138,10,5,48227,10,5,49374,7,19.4,-1.270212,36.8210877,-1.3043821,36.7840586,541,1147,31,1106
16900,418,1792,3,Business,19,1,36559,19,1,36610,19,1,37255,19,1,37421,19,1,39413,20,19.4,-1.2809121,36.7852524,-1.3103985,36.9114173,439,1992,51,811
16901,23275,3359,3,Business,27,2,36701,27,2,40422,27,2,40800,27,2,41082,27,2,42255,8,23.8,-1.2551895,36.7822034,-1.3044313,36.818504,379,1173,3721,660
16902,14905,393,3,Business,15,5,31854,15,5,31868,15,5,31872,15,5,32807,15,5,33357,4,19.0,-1.3167113,36.8301563,-1.3004062,36.829741,809,550,14,939
16903,2356,3439,3,Business,14,5,37882,14,5,37882,14,5,40000,14,5,40911,14,5,42480,9,21.8,-1.2854174,36.7951152,-1.2393157,36.7668877,709,1569,0,3029
16904,7317,3669,3,Business,15,6,42018,15,6,42598,15,6,43349,15,6,44478,15,6,46232,10,22.1,-1.2527958,36.8003131,-1.2429937,36.8754167,477,1754,580,1880
16905,17401,2657,3,Personal,28,2,39953,28,2,40028,28,2,40318,28,2,40683,28,2,42158,11,21.3,-1.2752846,36.8027022,-1.311818,36.8638544,778,1475,75,655
16906,13649,346,3,Business,13,4,33041,13,4,33193,13,4,33952,13,4,34689,13,4,35130,1,18.4,-1.28878,36.8168312,-1.2795827,36.8197262,698,441,152,1496
16907,28110,2701,3,Business,24,4,53409,24,4,53627,24,4,54337,24,4,54432,24,4,54853,1,22.6,-1.279395,36.825364,-1.2866012,36.8195691,79,421,218,805
16908,9922,1336,3,Business,13,3,42712,13,3,42724,13,3,43202,13,3,44666,13,3,45898,8,24.7,-1.2615888,36.7928732,-1.2885029,36.825605,462,1232,12,1942
16909,13960,3647,3,Business,26,2,54307,26,2,54462,26,2,55590,26,2,56197,26,2,57384,6,31.0,-1.272639,36.794723,-1.2944363,36.7983424,76,1187,155,1735
16910,23981,53,3,Business,26,5,46475,26,5,46498,26,5,47716,26,5,49483,26,5,51085,11,23.25888921888938,-1.2991441,36.7528804,-1.2770708,36.8231093,855,1602,23,2985
16911,307,1271,3,Business,9,3,44221,9,3,44771,9,3,46421,9,3,46585,9,3,50643,22,25.5,-1.3244885,36.897792,-1.3107918,36.761794,420,4058,550,1814
16912,9482,677,3,Business,10,3,47214,10,3,47249,10,3,47574,10,3,47774,10,3,49621,20,27.9,-1.2283403,36.8822756,-1.3014461,36.7661381,299,1847,35,525
16913,23810,517,3,Business,12,4,35248,12,4,35272,12,4,35306,12,4,35761,12,4,37945,14,16.2,-1.3177547,36.8303703,-1.306378,36.7519845,18,2184,24,489
16914,23806,3291,3,Business,28,2,50824,28,2,50837,28,2,51773,28,2,52214,28,2,54358,17,23.6,-1.3188359,36.7038526,-1.2600926,36.8088685,524,2144,13,1377
16915,14837,2982,3,Business,4,1,47314,4,1,47383,4,1,50216,4,1,51181,4,1,53693,18,23.25888921888938,-1.300921,36.828195,-1.177202,36.8351183,268,2512,69,3798
16916,26133,111,3,Business,18,4,41248,18,4,41329,18,4,41766,18,4,42066,18,4,43649,9,23.25888921888938,-1.2551895,36.7822034,-1.281999,36.826887,576,1583,81,737
16917,12109,2350,1,Personal,18,3,40743,18,3,40761,18,3,41000,18,3,41616,18,3,42062,3,19.8,-1.2901786,36.824294,-1.2922257,36.802759,583,446,18,855
16918,3684,2587,3,Business,5,3,39551,5,3,39605,5,3,40999,5,3,42622,5,3,43710,10,22.5,-1.225322,36.80855,-1.28878,36.8168312,101,1088,54,3017
16919,15518,53,3,Business,8,3,47266,8,3,47339,8,3,47507,8,3,48155,8,3,49629,14,23.25888921888938,-1.2770708,36.8231093,-1.219817,36.903273,276,1474,73,816
16920,2929,516,3,Business,16,4,43355,16,4,43365,16,4,43482,16,4,44422,16,4,47031,19,23.25888921888938,-1.2551895,36.7822034,-1.2824534,36.9118791,411,2609,10,1057
16921,22945,3420,3,Business,23,6,37074,23,6,37146,23,6,37783,23,6,38043,23,6,38973,6,26.2,-1.3046007,36.8211743,-1.265981,36.7936121,459,930,72,897
16922,21108,975,1,Personal,18,4,33263,18,4,33507,18,4,34005,18,4,34228,18,4,35196,3,20.6,-1.267452,36.806015,-1.2604326,36.8063723,453,968,244,721
16923,21013,867,3,Business,22,5,54115,22,5,54137,22,5,54724,22,5,55118,22,5,56095,9,27.3,-1.2638185,36.7930057,-1.2991441,36.7528804,785,977,22,981
16924,13218,186,3,Business,7,5,56814,7,5,58396,7,5,58399,7,5,59541,7,5,61456,4,21.4,-1.2571472,36.7950633,-1.2825816,36.8092346,19,1915,1582,1145
16925,18872,186,3,Business,5,2,53472,5,2,54477,5,2,55766,5,2,56182,5,2,58719,23,23.25888921888938,-1.3700383,36.9190174,-1.2571472,36.7950633,883,2537,1005,1705
16926,8066,2330,3,Business,21,1,42969,21,1,42992,21,1,43850,21,1,43968,21,1,45011,9,25.5,-1.2642903,36.8002137,-1.2326041,36.8009029,611,1043,23,976
16927,25594,1899,3,Business,24,5,50096,24,5,50133,24,5,50618,24,5,51253,24,5,52108,10,23.3,-1.2783849,36.8163445,-1.331619,36.847976,857,855,37,1120
16928,25493,733,3,Business,9,5,44662,9,5,44685,9,5,46091,9,5,47917,9,5,48669,15,25.6,-1.2551895,36.7822034,-1.214071,36.7985052,811,752,23,3232
16929,1514,1428,3,Personal,13,3,28711,13,3,28756,13,3,31427,13,3,32219,13,3,33491,7,17.5,-1.300106,36.7584546,-1.3222617,36.7164539,774,1272,45,3463
16930,4437,1245,3,Business,13,2,52458,13,2,53462,13,2,53969,13,2,56136,13,2,58302,8,26.1,-1.300921,36.828195,-1.282937,36.7816984,829,2166,1004,2674
16931,21167,733,3,Business,6,4,54861,6,4,54917,6,4,54994,6,4,55272,6,4,58926,20,21.5,-1.2551895,36.7822034,-1.3185307,36.9001089,709,3654,56,355
16932,20223,265,3,Business,2,5,56501,2,5,56571,2,5,57232,2,5,57453,2,5,60094,18,25.3,-1.300921,36.828195,-1.3117864,36.6973045,890,2641,70,882
16933,17104,3630,2,Personal,29,2,63419,29,2,63457,29,2,64356,29,2,65356,29,2,67518,14,22.2,-1.2886923,36.8241519,-1.214328,36.7911903,478,2162,38,1899
16934,4692,3098,3,Business,29,1,33845,29,1,33909,29,1,34582,29,1,34804,29,1,35880,7,23.25888921888938,-1.2689186,36.8001681,-1.2963097,36.7688221,306,1076,64,895
16935,2507,2700,3,Business,17,5,61011,17,5,61747,17,5,62654,17,5,63158,17,5,64018,3,19.1,-1.293973,36.80169,-1.2867483,36.8196599,79,860,736,1411
16936,9526,1051,3,Business,9,1,45987,9,1,46035,9,1,46570,9,1,46814,9,1,49173,21,20.4,-1.2963097,36.7688221,-1.3106599,36.9179186,749,2359,48,779
16937,25060,1774,1,Personal,27,4,39467,27,4,39501,27,4,40187,27,4,40796,27,4,42286,17,23.0,-1.2890635,36.8318522,-1.3700383,36.9190174,336,1490,34,1295
16938,18049,1546,3,Business,3,3,32146,3,3,32303,3,3,32976,3,3,33411,3,3,35808,10,21.2,-1.2649471,36.7453303,-1.2684319,36.8165853,269,2397,157,1108
16939,15404,2627,3,Business,24,4,41864,24,4,41874,24,4,42450,24,4,45583,24,4,46704,15,24.7,-1.2283403,36.8822756,-1.2571472,36.7950633,75,1121,10,3709
16940,6054,3080,3,Business,5,3,37875,5,3,38405,5,3,38667,5,3,38963,5,3,39647,4,22.5,-1.2551895,36.7822034,-1.2617028,36.7983849,436,684,530,558
16941,13614,1787,3,Business,5,2,49171,5,2,49203,5,2,49942,5,2,50092,5,2,52476,15,23.25888921888938,-1.2285835,36.8826468,-1.2551895,36.7822034,959,2384,32,889
16942,24113,3599,3,Business,14,2,45439,14,2,49743,14,2,50319,14,2,51371,14,2,51609,4,23.25888921888938,-1.3302996,36.8707935,-1.3295558,36.8390471,218,238,4304,1628
16943,22427,469,3,Personal,18,5,45467,18,5,51787,18,5,54127,18,5,54233,18,5,56075,6,24.6,-1.2888627,36.8416584,-1.3090663,36.8136865,192,1842,6320,2446
16944,28109,53,3,Business,14,1,36402,14,1,36490,14,1,39190,14,1,39936,14,1,41104,5,23.5,-1.3004062,36.829741,-1.2770708,36.8231093,725,1168,88,3446
16945,27746,186,3,Business,31,2,35504,31,2,36434,31,2,37389,31,2,37529,31,2,39940,24,16.8,-1.3700383,36.9190174,-1.2571472,36.7950633,65,2411,930,1095
16946,13124,1726,1,Personal,23,3,42908,23,3,42933,23,3,43078,23,3,43547,23,3,44372,5,22.0,-1.3007534,36.7964576,-1.2787849,36.8194705,698,825,25,614
16947,24209,3355,3,Business,3,5,52330,3,5,52629,3,5,53780,3,5,54523,3,5,55643,6,25.0,-1.2765736,36.8513646,-1.3052491,36.8223899,754,1120,299,1894
16948,26146,1329,3,Business,30,2,53573,30,2,58073,30,2,59015,30,2,59210,30,2,59974,3,23.25888921888938,-1.273056,36.811298,-1.2546732,36.8086796,953,764,4500,1137
16949,4774,393,3,Business,16,3,33939,16,3,33961,16,3,33969,16,3,35166,16,3,37643,14,19.8,-1.3177547,36.8303703,-1.306378,36.7519845,702,2477,22,1205
16950,11798,3404,3,Business,29,6,48597,29,6,48659,29,6,49071,29,6,49357,29,6,49906,2,26.7,-1.2882184,36.826346,-1.279395,36.825364,237,549,62,698
16951,13418,1245,3,Business,10,5,48324,10,5,48652,10,5,49188,10,5,51289,10,5,53374,17,23.25888921888938,-1.300921,36.828195,-1.3198615,36.7110323,943,2085,328,2637
16952,24298,1346,3,Business,13,5,44636,13,5,44659,13,5,45580,13,5,45840,13,5,48253,20,23.25888921888938,-1.299813,36.7871392,-1.3700383,36.9190174,844,2413,23,1181
16953,13448,1974,1,Personal,5,5,40666,5,5,40758,5,5,41490,5,5,42008,5,5,43242,6,23.6,-1.2942764,36.7969749,-1.2715686,36.8023526,722,1234,92,1250
16954,1255,3491,3,Business,25,1,59918,25,1,60593,25,1,61374,25,1,61947,25,1,64565,13,27.7,-1.2326041,36.8009029,-1.2283403,36.8822756,953,2618,675,1354
16955,17123,1990,3,Business,31,5,57908,31,5,58212,31,5,60554,31,5,61306,31,5,66009,20,23.5,-1.329449,36.890451,-1.275442,36.7660207,25,4703,304,3094
16956,18777,3757,3,Personal,8,1,44541,8,1,44558,8,1,44960,8,1,46883,8,1,47945,9,27.7,-1.2655381,36.8354648,-1.3173869,36.8112044,576,1062,17,2325
16957,26587,186,3,Business,18,4,49703,18,4,50168,18,4,51312,18,4,51562,18,4,55681,23,27.0,-1.3700383,36.9190174,-1.2571472,36.7950633,612,4119,465,1394
16958,21761,2349,3,Business,4,5,39451,4,5,39482,4,5,41206,4,5,41379,4,5,42433,4,17.2,-1.2784495,36.7981729,-1.2613768,36.8019418,932,1054,31,1897
16959,13168,2956,3,Business,3,1,55935,3,1,58615,3,1,59493,3,1,59974,3,1,62013,14,22.3,-1.207546,36.7913976,-1.2584143,36.8048002,279,2039,2680,1359
16960,17313,3647,3,Business,5,5,54026,5,5,54100,5,5,54635,5,5,55211,5,5,56354,7,27.6,-1.272639,36.794723,-1.3004844,36.7704915,99,1143,74,1111
16961,11495,186,3,Business,7,3,54723,7,3,54768,7,3,55396,7,3,55680,7,3,58795,23,28.2,-1.3700383,36.9190174,-1.2571472,36.7950633,208,3115,45,912
16962,262,2200,3,Business,29,5,35728,29,5,35869,29,5,37666,29,5,40289,29,5,42413,12,26.7,-1.233018,36.8004477,-1.290894,36.822971,177,2124,141,4420
16963,23022,3295,3,Business,23,4,43244,23,4,43295,23,4,43902,23,4,45225,23,4,47065,12,23.2,-1.2571472,36.7950633,-1.31553,36.863732,131,1840,51,1930
16964,1438,246,3,Business,10,4,38805,10,4,38848,10,4,40315,10,4,40766,10,4,41530,3,23.25888921888938,-1.2584143,36.8048002,-1.255956,36.789867,188,764,43,1918
16965,25691,3688,3,Business,3,3,55723,3,3,55812,3,3,58287,3,3,58390,3,3,59755,10,28.2,-1.2285835,36.8826468,-1.2736466,36.8164042,76,1365,89,2578
16966,20469,478,3,Business,8,5,40645,8,5,40718,8,5,41163,8,5,41572,8,5,43715,13,28.5,-1.2551895,36.7822034,-1.3164474,36.8575861,131,2143,73,854
16967,7938,3365,2,Personal,10,5,57902,10,5,57972,10,5,59279,10,5,62129,10,5,63482,3,20.9,-1.2816136,36.8328627,-1.2860198,36.8176562,229,1353,70,4157
16968,19260,190,3,Business,2,4,51714,2,4,51758,2,4,52281,2,4,52796,2,4,53191,6,23.25888921888938,-1.3275885,36.8621552,-1.3270347,36.8667362,205,395,44,1038
16969,594,3647,3,Business,19,1,62026,19,1,62042,19,1,62549,19,1,62936,19,1,63492,3,23.8,-1.272639,36.794723,-1.272798,36.8124195,79,556,16,894
16970,7671,2828,3,Business,14,4,50228,14,4,50911,14,4,50973,14,4,52354,14,4,53976,10,27.6,-1.2615888,36.7928732,-1.2343087,36.84749,576,1622,683,1443
16971,11241,867,3,Business,3,4,47801,3,4,47897,3,4,48550,3,4,48613,3,4,49931,11,23.7,-1.2991441,36.7528804,-1.2996533,36.8292629,518,1318,96,716
16972,27211,2227,3,Personal,9,3,32854,9,3,32931,9,3,33680,9,3,33797,9,3,34932,6,20.2,-1.2541275,36.8263055,-1.2741728,36.7969108,332,1135,77,866
16973,26127,835,3,Business,14,2,57354,14,2,57549,14,2,58273,14,2,60110,14,2,61320,15,23.25888921888938,-1.3002926,36.8668523,-1.3700383,36.9190174,411,1210,195,2561
16974,6018,2102,3,Business,29,1,55941,29,1,56001,29,1,56893,29,1,56963,29,1,59026,14,23.25888921888938,-1.3250048,36.8697188,-1.2613768,36.8019418,863,2063,60,962
16975,11233,1304,3,Business,12,2,35899,12,2,35960,12,2,36991,12,2,37334,12,2,40375,13,16.0,-1.2551895,36.7822034,-1.3318059,36.8359596,844,3041,61,1374
16976,25109,1237,1,Personal,17,3,27366,17,3,27373,17,3,28078,17,3,28687,17,3,29022,4,21.1,-1.2812305,36.7791109,-1.2741728,36.7969108,829,335,7,1314
16977,2314,1329,3,Business,14,5,57482,14,5,57778,14,5,58679,14,5,58827,14,5,60296,4,23.6,-1.273056,36.811298,-1.2560874,36.7931031,547,1469,296,1049
16978,19848,1280,3,Business,31,5,59334,31,5,59796,31,5,60899,31,5,61015,31,5,62890,8,23.9,-1.2551895,36.7822034,-1.2993556,36.8146776,233,1875,462,1219
16979,5757,265,3,Business,29,5,31216,29,5,31259,29,5,32000,29,5,32724,29,5,34107,13,20.8,-1.300921,36.828195,-1.3195936,36.9161697,206,1383,43,1465
16980,6067,2899,3,Personal,23,2,49327,23,2,49471,23,2,50493,23,2,50610,23,2,51402,5,23.25888921888938,-1.298762,36.7636456,-1.285355,36.795287,641,792,144,1139
16981,10807,1245,3,Business,27,3,53738,27,3,53759,27,3,53943,27,3,54339,27,3,55620,6,29.4,-1.3198615,36.7110323,-1.3532484,36.7249576,519,1281,21,580
16982,19456,1209,3,Business,12,5,46798,12,5,46821,12,5,46829,12,5,47624,12,5,48513,9,26.6,-1.2638185,36.7930057,-1.3004062,36.829741,349,889,23,803
16983,24321,810,3,Personal,26,3,53884,26,3,53900,26,3,54068,26,3,55490,26,3,56173,6,27.2,-1.2704561,36.7688456,-1.2833534,36.8165865,82,683,16,1590
16984,23154,3398,3,Business,12,3,65230,12,3,65256,12,3,66668,12,3,66828,12,3,69064,19,24.4,-1.3052491,36.8223899,-1.3169591,36.7000029,328,2236,26,1572
16985,6411,2587,3,Business,1,1,45771,1,1,45798,1,1,45821,1,1,46781,1,1,49510,9,24.0,-1.28878,36.8168312,-1.2413316,36.8785525,656,2729,27,983
16986,18447,1500,3,Business,18,4,45121,18,4,45167,18,4,46371,18,4,46947,18,4,48521,11,23.25888921888938,-1.3228003,36.8306435,-1.2638185,36.7930057,641,1574,46,1780
16987,16597,3149,3,Business,16,4,42728,16,4,42766,16,4,42911,16,4,44280,16,4,44799,5,23.25888921888938,-1.3004062,36.829741,-1.3167113,36.8301563,953,519,38,1514
16988,24844,3283,3,Business,6,4,47417,6,4,47446,6,4,47461,6,4,48376,6,4,49138,6,19.5,-1.2663631,36.8163329,-1.2628473,36.781805,855,762,29,930
16989,15199,393,3,Business,20,1,35991,20,1,36134,20,1,36479,20,1,37468,20,1,39890,7,19.2,-1.3167113,36.8301563,-1.3083266,36.8494756,143,2422,143,1334
16990,27812,265,3,Business,4,1,41371,4,1,41483,4,1,43097,4,1,43506,4,1,44899,12,26.4,-1.329285,36.8867853,-1.300921,36.828195,0,1393,112,2023
16991,8279,669,1,Personal,3,3,39244,3,3,40751,3,3,41139,3,3,41959,3,3,42663,6,23.8,-1.2824911,36.8218042,-1.2971892,36.7814176,88,704,1507,1208
16992,15732,2241,1,Personal,14,6,41378,14,6,41384,14,6,41832,14,6,42226,14,6,44656,16,17.7,-1.2815529,36.8308217,-1.255513,36.752422,629,2430,6,842
16993,20498,346,3,Business,12,2,46577,12,2,46762,12,2,47321,12,2,47467,12,2,47469,4,24.6,-1.28878,36.8168312,-1.3033063,36.8117921,903,2,185,705
16994,19680,759,1,Personal,4,5,53078,4,5,53285,4,5,54015,4,5,54370,4,5,57793,13,24.0,-1.2736771,36.8123141,-1.303217,36.731467,196,3423,207,1085
16995,11709,3265,1,Personal,25,6,39675,25,6,39683,25,6,40542,25,6,40989,25,6,42475,14,23.25888921888938,-1.322999,36.7832633,-1.2529072,36.8525066,216,1486,8,1306
16996,11642,3434,3,Business,18,2,32618,18,2,32643,18,2,35574,18,2,36198,18,2,38056,17,19.8,-1.2963097,36.7688221,-1.2482465,36.8889062,649,1858,25,3555
16997,5693,905,1,Personal,21,2,32711,21,2,32731,21,2,35205,21,2,35584,21,2,36656,13,15.5,-1.2850644,36.8343657,-1.2119232,36.8996459,208,1072,20,2853
16998,22366,2008,3,Business,24,5,43908,24,5,44017,24,5,44926,24,5,46831,24,5,46840,6,21.6,-1.2508229,36.7895263,-1.27948,36.8304448,119,9,109,2814
16999,1040,3135,3,Personal,12,5,42254,12,5,42450,12,5,42476,12,5,44194,12,5,45007,12,24.3,-1.2756364,36.8535485,-1.277585,36.77145,179,813,196,1744
17000,25317,53,3,Business,3,1,51352,3,1,52114,3,1,52403,3,1,52835,3,1,54148,5,23.1,-1.2770708,36.8231093,-1.3004062,36.829741,158,1313,762,721
17001,17216,2900,3,Business,3,3,57213,3,3,57345,3,3,57978,3,3,58222,3,3,59296,10,26.6,-1.2963097,36.7688221,-1.304969,36.846623,216,1074,132,877
17002,17646,633,3,Business,10,4,26444,10,4,26460,10,4,27872,10,4,28078,10,4,29759,11,19.2,-1.2991441,36.7528804,-1.3004062,36.829741,523,1681,16,1618
17003,10969,1245,3,Business,15,5,46197,15,5,47853,15,5,50543,15,5,51891,15,5,55549,21,27.8,-1.2857764,36.8236622,-1.3198615,36.7110323,332,3658,1656,4038
17004,17618,1461,2,Personal,17,7,41817,17,7,43890,17,7,44401,17,7,44743,17,7,44986,2,15.7,-1.2720769,36.8180604,-1.2660631,36.8343554,727,243,2073,853
17005,24124,2154,3,Business,31,3,51379,31,3,51801,31,3,53160,31,3,54064,31,3,55494,5,27.2,-1.279395,36.825364,-1.2765736,36.8513646,906,1430,422,2263
17006,14035,3201,3,Business,5,2,30527,5,2,30640,5,2,31401,5,2,32262,5,2,32986,6,20.9,-1.290894,36.822971,-1.2584143,36.8048002,156,724,113,1622
17007,22340,1500,3,Business,6,4,39714,6,4,40017,6,4,40650,6,4,41303,6,4,42419,8,23.9,-1.29508,36.796863,-1.2574219,36.7927073,523,1116,303,1286
17008,14034,3060,3,Business,6,3,33648,6,3,33840,6,3,34382,6,3,34451,6,3,35500,4,16.7,-1.269671,36.821544,-1.2513591,36.7947674,175,1049,192,611
17009,18215,3635,1,Business,7,5,57391,7,5,57399,7,5,57418,7,5,57708,7,5,59181,7,24.7,-1.2615888,36.7928732,-1.295156,36.8094306,848,1473,8,309
17010,27871,3434,3,Business,30,4,44559,30,4,44571,30,4,44603,30,4,44932,30,4,47474,20,23.25888921888938,-1.2963097,36.7688221,-1.3244885,36.897792,958,2542,12,361
17011,19091,475,3,Business,8,5,45018,8,5,45122,8,5,45709,8,5,45965,8,5,47866,8,24.2,-1.2551895,36.7822034,-1.2925919,36.8170577,338,1901,104,843
17012,22159,1329,3,Business,29,5,63604,29,5,64079,29,5,64554,29,5,64943,29,5,65557,4,28.0,-1.273056,36.811298,-1.2829592,36.8046174,291,614,475,864
17013,8940,3599,3,Business,2,4,43155,2,4,43195,2,4,44133,2,4,44746,2,4,45989,12,23.25888921888938,-1.3302996,36.8707935,-1.3713751,36.934862,461,1243,40,1551
17014,8986,535,3,Business,11,6,39069,11,6,41361,11,6,41638,11,6,46397,11,6,49948,18,23.25888921888938,-1.2549259,36.7919494,-1.2715944,36.9114173,778,3551,2292,5036
17015,27618,2989,3,Business,6,2,58787,6,2,60060,6,2,60908,6,2,61040,6,2,62363,10,23.25888921888938,-1.3165542,36.700067,-1.3472066,36.7692638,747,1323,1273,980
17016,5078,867,3,Business,15,5,40383,15,5,40434,15,5,40478,15,5,42385,15,5,44206,10,26.0,-1.2996533,36.8292629,-1.2991441,36.7528804,154,1821,51,1951
17017,5490,393,3,Business,9,2,29638,9,2,29647,9,2,29653,9,2,33114,9,2,35548,14,17.4,-1.3177547,36.8303703,-1.306378,36.7519845,702,2434,9,3467
17018,5427,635,3,Business,28,1,39379,28,1,39408,28,1,40074,28,1,40450,28,1,41003,3,23.9,-1.2764099,36.8208451,-1.2602337,36.7990548,379,553,29,1042
17019,21002,1569,2,Personal,19,7,49126,19,7,49137,19,7,50201,19,7,50916,19,7,55222,17,21.2,-1.2724556,36.7931938,-1.1934853,36.8448931,727,4306,11,1779
17020,14107,111,3,Business,13,4,33933,13,4,33990,13,4,34495,13,4,34648,13,4,36118,9,18.7,-1.2551895,36.7822034,-1.2879222,36.7747099,259,1470,57,658
17021,2303,393,3,Business,17,5,56358,17,5,56602,17,5,58316,17,5,59424,17,5,60933,11,23.25888921888938,-1.3167113,36.8301563,-1.2638185,36.7930057,85,1509,244,2822
17022,7888,2030,3,Business,23,2,35340,23,2,35874,23,2,36968,23,2,38311,23,2,38878,2,23.25888921888938,-1.3047482,36.7849672,-1.2963097,36.7688221,933,567,534,2437
17023,18770,867,3,Business,10,1,45222,10,1,45535,10,1,46085,10,1,47089,10,1,49327,13,18.3,-1.3228003,36.8306435,-1.2991441,36.7528804,155,2238,313,1554
17024,17600,633,3,Business,5,2,56600,5,2,56676,5,2,57045,5,2,57336,5,2,58426,9,23.25888921888938,-1.2638185,36.7930057,-1.3004062,36.829741,154,1090,76,660
17025,23685,635,3,Business,1,1,52172,1,1,52525,1,1,54093,1,1,54605,1,1,56519,8,23.25888921888938,-1.2780878,36.8469436,-1.2602337,36.7990548,118,1914,353,2080
17026,14895,2982,3,Business,9,6,39510,9,6,39531,9,6,39632,9,6,41642,9,6,45002,18,24.8,-1.300921,36.828195,-1.177202,36.8351183,258,3360,21,2111
17027,20341,448,2,Personal,26,3,26097,26,3,26560,26,3,27025,26,3,27464,26,3,27978,4,19.2,-1.2893745,36.8002562,-1.3075173,36.7845652,722,514,463,904
17028,12039,867,3,Business,9,3,31366,9,3,35501,9,3,35964,9,3,37582,9,3,39180,10,20.3,-1.2996533,36.8292629,-1.2991441,36.7528804,496,1598,4135,2081
17029,22258,1796,3,Business,29,5,39135,29,5,39172,29,5,39386,29,5,39667,29,5,41162,15,26.6,-1.2628473,36.781805,-1.331619,36.847976,854,1495,37,495
17030,20673,78,1,Personal,9,1,69189,9,1,69205,9,1,69226,9,1,69606,9,1,70320,6,20.6,-1.2765492,36.7669809,-1.2705336,36.7943509,334,714,16,401
17031,25497,3560,3,Business,2,2,48440,2,2,48742,2,2,49956,2,2,50848,2,2,52710,11,29.5,-1.225322,36.80855,-1.279395,36.825364,953,1862,302,2106
17032,25581,393,3,Business,19,2,35150,19,2,35244,19,2,36263,19,2,36841,19,2,38706,11,23.25888921888938,-1.3167113,36.8301563,-1.2638185,36.7930057,194,1865,94,1597
17033,8549,1471,3,Business,10,1,47256,10,1,47324,10,1,47972,10,1,48520,10,1,50087,15,18.6,-1.2551895,36.7822034,-1.2238103,36.8772588,894,1567,68,1196
17034,10789,1565,1,Personal,13,1,58751,13,1,58764,13,1,58867,13,1,59870,13,1,61183,10,19.2,-1.2915969,36.8237639,-1.2982544,36.7500835,942,1313,13,1106
17035,8621,867,3,Business,14,5,41555,14,5,41586,14,5,41798,14,5,41932,14,5,43337,10,22.1,-1.2996533,36.8292629,-1.2991441,36.7528804,211,1405,31,346
17036,19536,1209,3,Business,30,2,29525,30,2,29560,30,2,30227,30,2,30558,30,2,33059,9,23.25888921888938,-1.2574219,36.7927073,-1.3004062,36.829741,99,2501,35,998
17037,24704,2132,3,Business,14,1,42434,14,1,43389,14,1,45516,14,1,46957,14,1,49214,11,23.3,-1.2384056,36.8718698,-1.3095309,36.8658586,332,2257,955,3568
17038,18086,928,3,Business,14,3,58060,14,3,58079,14,3,58715,14,3,59281,14,3,60449,2,25.7,-1.2551895,36.7822034,-1.262212,36.7886506,738,1168,19,1202
17039,4500,2195,3,Business,11,4,53514,11,4,53585,11,4,55868,11,4,57302,11,4,58330,6,26.9,-1.2296618,36.8438272,-1.228911,36.881876,8,1028,71,3717
17040,6451,238,3,Business,29,4,34739,29,4,34804,29,4,34813,29,4,35202,29,4,35224,4,18.5,-1.3080092,36.8284543,-1.3077869,36.8443207,848,22,65,398
17041,12885,237,3,Business,25,4,30648,25,4,30712,25,4,30915,25,4,31357,25,4,32866,8,16.4,-1.2551895,36.7822034,-1.2857671,36.7875614,125,1509,64,645
17042,17590,60,3,Business,15,3,35597,15,3,35607,15,3,35993,15,3,36569,15,3,38090,14,23.25888921888938,-1.2628473,36.781805,-1.2296618,36.8438272,3,1521,10,962
17043,592,778,3,Business,26,2,48742,26,2,48757,26,2,49656,26,2,50683,26,2,51624,10,29.5,-1.304127,36.805743,-1.2535486,36.7933541,322,941,15,1926
17044,26973,2245,3,Personal,18,5,52208,18,5,52265,18,5,55790,18,5,56234,18,5,59902,23,24.6,-1.2866269,36.8246368,-1.3510653,36.6665115,543,3668,57,3969
17045,5696,265,3,Business,10,5,42674,10,5,42690,10,5,42703,10,5,43836,10,5,44563,3,19.1,-1.300921,36.828195,-1.2983805,36.8198439,179,727,16,1146
17046,13412,2767,3,Business,13,4,49842,13,4,50278,13,4,51853,13,4,54637,13,4,57025,11,22.5,-1.3076234,36.8393399,-1.257773,36.795486,511,2388,436,4359
17047,27668,1341,3,Business,30,6,38548,30,6,38572,30,6,39221,30,6,39849,30,6,41766,19,26.8,-1.228911,36.881876,-1.331619,36.847976,75,1917,24,1277
17048,661,2987,3,Business,22,4,45445,22,4,45538,22,4,46027,22,4,46100,22,4,47805,15,22.4,-1.270212,36.8210877,-1.3284365,36.8970679,359,1705,93,562
17049,7922,2200,3,Business,13,3,50541,13,3,50781,13,3,51698,13,3,52226,13,3,53731,6,29.2,-1.2527958,36.8003131,-1.290894,36.822971,223,1505,240,1445
17050,21830,1261,1,Personal,19,5,30164,19,5,30181,19,5,30639,19,5,30752,19,5,36205,18,20.1,-1.2669736,36.8040985,-1.3232074,36.8913668,108,5453,17,571
17051,22221,633,3,Business,12,2,37824,12,2,37928,12,2,38730,12,2,39164,12,2,40520,9,28.3,-1.2638185,36.7930057,-1.3004062,36.829741,448,1356,104,1236
17052,5726,53,3,Business,28,4,34753,28,4,35242,28,4,35833,28,4,37772,28,4,39786,8,22.6,-1.3167113,36.8301563,-1.2770708,36.8231093,590,2014,489,2530
17053,1911,3688,3,Business,6,4,53325,6,4,53531,6,4,55575,6,4,55682,6,4,56607,6,23.25888921888938,-1.2736466,36.8164042,-1.2551895,36.7822034,857,925,206,2151
17054,10112,2008,3,Business,10,3,41171,10,3,41536,10,3,43692,10,3,44237,10,3,46226,6,28.0,-1.2508229,36.7895263,-1.2788257,36.82877,76,1989,365,2701
17055,20466,2587,3,Business,17,3,38179,17,3,38221,17,3,38789,17,3,38906,17,3,39977,6,25.2,-1.28878,36.8168312,-1.2808667,36.7883545,857,1071,42,685
17056,1029,2904,3,Personal,1,1,57214,1,1,57288,1,1,57372,1,1,58465,1,1,59647,5,25.7,-1.2970896,36.7771786,-1.3030678,36.7554371,519,1182,74,1177
17057,2438,3217,3,Business,25,3,37249,25,3,38004,25,3,39255,25,3,39891,25,3,40703,4,23.25888921888938,-1.22556,36.80813,-1.214328,36.7911903,208,812,755,1887
17058,26007,760,3,Business,19,2,56206,19,2,56243,19,2,57028,19,2,57148,19,2,58358,4,29.3,-1.2886303,36.8026947,-1.282937,36.7816984,362,1210,37,905
17059,26069,2587,3,Business,24,3,40601,24,3,40773,24,3,41291,24,3,41923,24,3,43769,6,19.9,-1.2551895,36.7822034,-1.28878,36.8168312,268,1846,172,1150
17060,3961,633,3,Business,25,1,46525,25,1,46535,25,1,47374,25,1,47948,25,1,48558,4,27.1,-1.3077869,36.8443207,-1.3004062,36.829741,910,610,10,1413
17061,10899,2518,3,Personal,20,4,51424,20,4,51473,20,4,52875,20,4,53255,20,4,54006,5,25.4,-1.2990731,36.8488058,-1.3246455,36.8754415,26,751,49,1782
17062,9726,1469,3,Business,1,5,42220,1,5,42277,1,5,43051,1,5,44245,1,5,45373,4,28.4,-1.2698515,36.7831618,-1.2749245,36.8069557,576,1128,57,1968
17063,21605,3175,3,Business,24,4,33321,24,4,33335,24,4,33937,24,4,34428,24,4,34886,4,16.9,-1.2562797,36.8075858,-1.2612417,36.7958868,116,458,14,1093
17064,1148,767,1,Personal,25,5,32807,25,5,32951,25,5,34222,25,5,34514,25,5,36571,9,17.0,-1.2657709,36.7305746,-1.2773014,36.7773015,412,2057,144,1563
17065,97,733,3,Business,8,4,36709,8,4,36718,8,4,36991,8,4,37951,8,4,39509,4,26.1,-1.2551895,36.7822034,-1.2662728,36.8151265,620,1558,9,1233
17066,11245,3283,3,Business,25,1,58899,25,1,58918,25,1,59301,25,1,60162,25,1,61399,5,28.3,-1.2600926,36.8088685,-1.2628473,36.781805,118,1237,19,1244
17067,20210,909,3,Business,27,5,40148,27,5,40192,27,5,41217,27,5,41845,27,5,42854,3,22.5,-1.225322,36.80855,-1.2324936,36.8224146,281,1009,44,1653
17068,22620,2094,2,Personal,22,2,52268,22,2,52374,22,2,53653,22,2,54310,22,2,56087,8,21.2,-1.2922364,36.7895538,-1.2884996,36.7422252,116,1777,106,1936
17069,10655,2457,3,Business,26,5,42723,26,5,46826,26,5,46973,26,5,47232,26,5,48740,6,23.25888921888938,-1.2551895,36.7822034,-1.2884146,36.8107668,380,1508,4103,406
17070,25860,1281,3,Business,31,5,32147,31,5,32159,31,5,33064,31,5,33209,31,5,35634,9,14.7,-1.2707742,36.7578609,-1.2854453,36.8188363,88,2425,12,1050
17071,2091,2457,3,Business,10,2,31105,10,2,32363,10,2,34134,10,2,35391,10,2,37057,7,16.1,-1.2551895,36.7822034,-1.289498,36.818878,101,1666,1258,3028
17072,17174,238,3,Business,22,3,54223,22,3,55384,22,3,56135,22,3,57521,22,3,58115,3,24.2,-1.3077869,36.8443207,-1.3166812,36.8594608,2,594,1161,2137
17073,17676,111,3,Business,9,5,51697,9,5,52696,9,5,54004,9,5,57115,9,5,60344,9,26.0,-1.2551895,36.7822034,-1.3001735,36.8042049,303,3229,999,4419
17074,14749,71,3,Business,18,2,29427,18,2,30566,18,2,32089,18,2,32937,18,2,34646,11,19.7,-1.225322,36.80855,-1.281754,36.8324229,101,1709,1139,2371
17075,5455,2150,3,Business,7,4,57515,7,4,57536,7,4,58108,7,4,58451,7,4,59622,14,31.1,-1.3313643,36.8577422,-1.344446,36.756597,675,1171,21,915
17076,17669,1724,3,Business,5,3,38530,5,3,41129,5,3,41824,5,3,41952,5,3,44233,9,22.4,-1.2551895,36.7822034,-1.303105,36.819135,382,2281,2599,823
17077,23448,295,3,Business,1,1,49498,1,1,50362,1,1,50377,1,1,50763,1,1,50770,2,23.25888921888938,-1.286925,36.821916,-1.2878973,36.8225054,571,7,864,401
17078,15493,868,3,Business,15,6,39262,15,6,39273,15,6,39278,15,6,39776,15,6,40328,7,19.4,-1.2628473,36.781805,-1.2663631,36.8163329,564,552,11,503
17079,21130,909,3,Business,8,1,53535,8,1,53586,8,1,54751,8,1,55251,8,1,56504,8,29.4,-1.225322,36.80855,-1.2571472,36.7950633,547,1253,51,1665
17080,10645,1673,2,Personal,14,5,55182,14,5,55237,14,5,56061,14,5,56936,14,5,58082,7,27.0,-1.261395,36.8263891,-1.2859609,36.7852628,427,1146,55,1699
17081,2177,2828,3,Business,13,4,57635,13,4,58193,13,4,59235,13,4,59860,13,4,60375,3,22.1,-1.2685707,36.8064961,-1.2615888,36.7928732,829,515,558,1667
17082,19632,3149,3,Business,7,3,54818,7,3,54956,7,3,54969,7,3,56244,7,3,56260,6,28.4,-1.3004062,36.829741,-1.3177547,36.8303703,98,16,138,1288
17083,20242,2330,3,Business,6,1,54074,6,1,54401,6,1,55068,6,1,55274,6,1,56406,9,23.25888921888938,-1.3015197,36.7658456,-1.2645318,36.7981775,678,1132,327,873
17084,13146,733,3,Business,18,4,46077,18,4,46090,18,4,46272,18,4,46927,18,4,48015,10,25.5,-1.2551895,36.7822034,-1.3031971,36.7863146,932,1088,13,837
17085,20020,3199,1,Personal,31,2,59331,31,2,59367,31,2,59767,31,2,59879,31,2,61194,7,19.9,-1.2630978,36.7832596,-1.2994194,36.7647917,519,1315,36,512
17086,5085,1825,1,Personal,3,4,31739,3,4,31840,3,4,33078,3,4,34694,3,4,36402,8,17.3,-1.3015998,36.8764939,-1.3055221,36.8216764,753,1708,101,2854
17087,4108,3647,3,Business,20,1,57222,20,1,57290,20,1,58458,20,1,58606,20,1,62179,4,21.4,-1.272639,36.794723,-1.2569503,36.7834728,415,3573,68,1316
17088,10878,1990,3,Business,4,4,35921,4,4,35977,4,4,36495,4,4,37444,4,4,39919,10,21.6,-1.286341,36.8172393,-1.275442,36.7660207,119,2475,56,1467
17089,26629,516,3,Business,23,5,49645,23,5,49813,23,5,51013,23,5,51180,23,5,52249,10,26.5,-1.2551895,36.7822034,-1.2982347,36.7606361,933,1069,168,1367
17090,19161,1729,1,Personal,7,2,51615,7,2,51641,7,2,52555,7,2,52646,7,2,54034,6,24.7,-1.2873152,36.8246342,-1.3235941,36.8237885,857,1388,26,1005
17091,15067,265,3,Business,12,4,44372,12,4,44384,12,4,44394,12,4,45327,12,4,46732,10,18.7,-1.300921,36.828195,-1.2911739,36.7614223,806,1405,12,943
17092,12186,2763,3,Business,4,2,35825,4,2,35861,4,2,36100,4,2,36338,4,2,37027,3,16.7,-1.2551895,36.7822034,-1.2644742,36.8083457,211,689,36,477
17093,5771,867,3,Business,28,3,56345,28,3,56359,28,3,56366,28,3,56487,28,3,58042,11,23.25888921888938,-1.306378,36.7519845,-1.2996533,36.8292629,854,1555,14,128
17094,15466,3446,1,Personal,4,4,29885,4,4,29921,4,4,31046,4,4,31296,4,4,35182,23,18.5,-1.3186522,36.7699884,-1.2166078,36.882501,847,3886,36,1375
17095,17376,2175,3,Business,13,2,43457,13,2,46682,13,2,47787,13,2,48265,13,2,50962,8,22.1,-1.2551895,36.7822034,-1.2950408,36.8098172,436,2697,3225,1583
17096,698,1500,3,Business,8,5,41819,8,5,42082,8,5,43354,8,5,44446,8,5,44894,6,28.4,-1.2770708,36.8231093,-1.2638185,36.7930057,119,448,263,2364
17097,24660,393,3,Business,13,3,34256,13,3,40144,13,3,40780,13,3,45905,13,3,46000,10,19.9,-1.3177547,36.8303703,-1.2574219,36.7927073,333,95,5888,5761
17098,11966,3291,3,Business,24,2,37690,24,2,37700,24,2,37932,24,2,38603,24,2,39143,2,17.2,-1.266837,36.799249,-1.2600926,36.8088685,116,540,10,903
17099,14999,393,3,Business,11,1,37089,11,1,37098,11,1,37103,11,1,39279,11,1,39302,11,26.6,-1.3167113,36.8301563,-1.2638185,36.7930057,39,23,9,2181
17100,18135,1642,3,Business,25,1,50240,25,1,51134,25,1,52050,25,1,52200,25,1,53008,5,29.9,-1.2808159,36.8160545,-1.2728069,36.7962362,910,808,894,1066
17101,7756,2691,3,Business,10,4,41211,10,4,41419,10,4,41859,10,4,42586,10,4,43722,8,24.6,-1.2551895,36.7822034,-1.2857671,36.7875614,319,1136,208,1167
17102,22978,3647,3,Business,12,5,35022,12,5,35060,12,5,35641,12,5,36024,12,5,36531,4,21.6,-1.2628638,36.8070399,-1.272639,36.794723,607,507,38,964
17103,4469,1244,3,Business,7,1,45728,7,1,45743,7,1,46042,7,1,46567,7,1,47436,8,25.0,-1.272828,36.816608,-1.303596,36.778378,655,869,15,824
17104,17145,1502,3,Business,4,1,56792,4,1,56808,4,1,57401,4,1,58304,4,1,61023,19,23.25888921888938,-1.3014461,36.7661381,-1.2232123,36.8932547,148,2719,16,1496
17105,15154,1126,1,Personal,19,5,38856,19,5,38899,19,5,39543,19,5,39813,19,5,41822,16,25.1,-1.2309779,36.8565814,-1.2979634,36.7719936,812,2009,43,914
17106,13932,3063,2,Personal,3,2,59605,3,2,60170,3,2,60525,3,2,60650,3,2,61464,5,18.5,-1.2926094,36.7904435,-1.31471,36.8110941,312,814,565,480
17107,6749,3420,3,Business,6,3,35141,6,3,36134,6,3,36605,6,3,36752,6,3,37531,6,16.1,-1.3046007,36.8211743,-1.265981,36.7936121,852,779,993,618
17108,1892,1469,3,Business,21,4,53203,21,4,53227,21,4,53309,21,4,54051,21,4,55371,7,31.2,-1.2551895,36.7822034,-1.2989934,36.8136694,764,1320,24,824
17109,535,3647,3,Business,8,3,44926,8,3,44988,8,3,46177,8,3,46250,8,3,46784,5,23.25888921888938,-1.2748221,36.7817865,-1.272639,36.794723,854,534,62,1262
17110,17387,516,3,Business,30,4,47514,30,4,47817,30,4,48253,30,4,48659,30,4,49868,8,23.25888921888938,-1.2896399,36.8124498,-1.2551895,36.7822034,372,1209,303,842
17111,25028,1073,3,Business,22,5,55510,22,5,55588,22,5,56209,22,5,56336,22,5,56708,4,27.3,-1.2561964,36.7885001,-1.259697,36.800664,875,372,78,748
17112,20601,2701,3,Business,17,4,33912,17,4,34668,17,4,37084,17,4,37468,17,4,39251,12,23.25888921888938,-1.225322,36.80855,-1.2765736,36.8513646,870,1783,756,2800
17113,21810,3492,3,Business,4,2,47519,4,2,47604,4,2,47919,4,2,48187,4,2,50245,7,20.6,-1.299207,36.8414337,-1.2764851,36.8007126,2,2058,85,583
17114,14816,3222,3,Business,8,1,43735,8,1,43764,8,1,43788,8,1,44698,8,1,44861,4,24.4,-1.2551895,36.7822034,-1.2697141,36.7981777,179,163,29,934
17115,20620,3434,3,Business,20,1,55527,20,1,55629,20,1,57526,20,1,57656,20,1,59066,10,21.5,-1.304969,36.846623,-1.2963097,36.7688221,249,1410,102,2027
17116,20726,1282,1,Personal,23,7,53551,23,7,53567,23,7,54238,23,7,54528,23,7,59772,22,26.4,-1.2905113,36.7591138,-1.2711571,36.9017288,465,5244,16,961
17117,21151,2987,3,Business,6,3,43728,6,3,44518,6,3,45420,6,3,45535,6,3,46421,10,19.8,-1.270212,36.8210877,-1.2297202,36.8745508,103,886,790,1017
17118,1215,2130,3,Personal,4,2,32332,4,2,32406,4,2,34950,4,2,35579,4,2,38088,12,16.7,-1.2310607,36.8035776,-1.2533491,36.8615911,564,2509,74,3173
17119,25986,3773,3,Personal,30,4,44341,30,4,44358,30,4,44375,30,4,45111,30,4,46140,9,20.4,-1.2962832,36.7849683,-1.270701,36.8378757,207,1029,17,753
17120,26707,1244,3,Business,1,5,54374,1,5,54839,1,5,55455,1,5,56167,1,5,58403,11,32.1,-1.331619,36.847976,-1.303596,36.778378,332,2236,465,1328
17121,18905,3383,1,Personal,6,6,53288,6,6,53320,6,6,53874,6,6,54070,6,6,55506,6,27.8,-1.2586742,36.8016438,-1.2848844,36.7893911,407,1436,32,750
17122,843,3547,3,Business,20,3,57559,20,3,57644,20,3,58260,20,3,60233,20,3,62449,18,27.4,-1.3189252,36.8617269,-1.2856319,36.7672998,483,2216,85,2589
17123,4218,2565,3,Personal,17,3,37060,17,3,37088,17,3,37092,17,3,37928,17,3,39236,13,25.2,-1.2975066,36.7689423,-1.330608,36.677485,874,1308,28,840
17124,7309,1695,1,Personal,16,2,37424,16,2,37433,16,2,37642,16,2,37812,16,2,38768,8,23.25888921888938,-1.257309,36.8060084,-1.2793831,36.7617573,453,956,9,379
17125,20327,1376,2,Personal,12,4,63774,12,4,63790,12,4,65183,12,4,65869,12,4,67317,13,20.5,-1.2798711,36.8207118,-1.26566,36.72291,806,1448,16,2079
17126,22166,393,3,Business,25,2,30865,25,2,32743,25,2,33657,25,2,34262,25,2,35738,10,17.9,-1.3177547,36.8303703,-1.2574219,36.7927073,731,1476,1878,1519
17127,5856,2026,3,Business,17,3,68813,17,3,68835,17,3,69645,17,3,72558,17,3,72564,12,23.25888921888938,-1.2584143,36.8048002,-1.3094481,36.8652486,119,6,22,3723
17128,20688,553,3,Business,9,2,54345,9,2,54365,9,2,54371,9,2,56837,9,2,58200,17,22.5,-1.218376,36.8821822,-1.2551895,36.7822034,813,1363,20,2472
17129,22985,1637,3,Business,7,3,54665,7,3,54678,7,3,54695,7,3,55308,7,3,55321,3,28.1,-1.2615888,36.7928732,-1.2657464,36.7801144,517,13,13,630
17130,27868,1329,3,Business,4,6,48558,4,6,48600,4,6,49330,4,6,49436,4,6,51377,8,23.25888921888938,-1.273056,36.811298,-1.3178939,36.8348835,815,1941,42,836
17131,6508,2907,2,Personal,7,5,37785,7,5,38010,7,5,40240,7,5,40532,7,5,41493,8,25.6,-1.2672426,36.7884223,-1.2934278,36.7930583,820,961,225,2522
17132,4669,1687,1,Business,18,4,31814,18,4,31932,18,4,32607,18,4,33047,18,4,34353,9,20.8,-1.2626574,36.8014034,-1.31861,36.8113967,754,1306,118,1115
17133,16750,2227,3,Personal,19,2,37678,19,2,38813,19,2,40526,19,2,40643,19,2,43361,10,23.25888921888938,-1.3039695,36.7838267,-1.2541275,36.8263055,354,2718,1135,1830
17134,14169,60,3,Business,19,2,51280,19,2,51331,19,2,51751,19,2,52560,19,2,53033,6,29.5,-1.228911,36.881876,-1.2296618,36.8438272,75,473,51,1229
17135,1037,1363,3,Business,18,6,34079,18,6,34168,18,6,36212,18,6,36308,18,6,37123,8,23.25888921888938,-1.3004062,36.829741,-1.2574219,36.7927073,448,815,89,2140
17136,20492,3491,3,Business,9,3,33510,9,3,33603,9,3,34562,9,3,36611,9,3,38193,11,20.1,-1.2781939,36.8191922,-1.2283403,36.8822756,72,1582,93,3008
17137,13435,3669,3,Business,7,4,48680,7,4,48696,7,4,49098,7,4,49409,7,4,50201,3,27.7,-1.2615888,36.7928732,-1.2641662,36.8136393,708,792,16,713
17138,3689,419,3,Business,27,5,43081,27,5,43180,27,5,43227,27,5,44674,27,5,46154,14,22.4,-1.2571472,36.7950633,-1.2238103,36.8772588,536,1480,99,1494
17139,8472,1329,3,Business,27,3,62007,27,3,62077,27,3,63531,27,3,63828,27,3,65937,7,27.6,-1.273056,36.811298,-1.276616,36.766094,907,2109,70,1751
17140,988,2174,3,Business,13,4,50966,13,4,50975,13,4,51678,13,4,52761,13,4,53467,10,26.6,-1.2482781,36.884092,-1.2782261,36.8225009,82,706,9,1786
17141,13300,2904,3,Personal,2,6,45487,2,6,45523,2,6,46287,2,6,47328,2,6,48135,7,23.9,-1.2590031,36.8078168,-1.2970896,36.7771786,100,807,36,1805
17142,12458,1329,3,Business,10,1,39502,10,1,39534,10,1,40777,10,1,40881,10,1,41540,3,23.4,-1.273056,36.811298,-1.2646084,36.8028645,407,659,32,1347
17143,16823,3686,3,Business,31,4,35019,31,4,35066,31,4,35171,31,4,35584,31,4,37144,9,20.6,-1.2551895,36.7822034,-1.2875983,36.7901566,518,1560,47,518
17144,26307,1402,3,Business,6,4,34081,6,4,34219,6,4,36064,6,4,36155,6,4,37243,5,16.0,-1.3140622,36.8162463,-1.2813012,36.8323962,582,1088,138,1936
17145,9850,435,3,Business,29,3,53319,29,3,53319,29,3,53367,29,3,55013,29,3,56368,15,21.0,-1.300921,36.828195,-1.242265,36.8808728,521,1355,0,1694
17146,8809,3283,3,Business,3,1,40684,3,1,40726,3,1,42580,3,1,43145,3,1,44280,13,21.5,-1.331619,36.847976,-1.2628473,36.781805,567,1135,42,2419
17147,24641,3264,3,Business,12,5,53285,12,5,53383,12,5,55072,12,5,55158,12,5,56466,9,23.25888921888938,-1.2551895,36.7822034,-1.3080696,36.8237191,99,1308,98,1775
17148,7782,2653,1,Personal,26,3,43471,26,3,43488,26,3,44180,26,3,44909,26,3,46319,5,24.1,-1.2867717,36.7735237,-1.2985749,36.8088,565,1410,17,1421
17149,5852,954,1,Personal,26,6,57279,26,6,57294,26,6,58295,26,6,58510,26,6,62340,23,24.1,-1.2389425,36.8775718,-1.3296591,36.7572949,479,3830,15,1216
17150,19582,2113,3,Personal,13,1,38938,13,1,38983,13,1,40251,13,1,40769,13,1,41819,12,17.4,-1.2624632,36.8405321,-1.275442,36.7660207,174,1050,45,1786
17151,22063,254,2,Personal,13,6,37624,13,6,37641,13,6,38216,13,6,39131,13,6,40491,12,25.2,-1.3080354,36.8531473,-1.2524976,36.8062935,662,1360,17,1490
17152,6069,2677,3,Business,15,5,34466,15,5,34505,15,5,35387,15,5,36307,15,5,40439,14,19.1,-1.3228003,36.8306435,-1.2991441,36.7528804,300,4132,39,1802
17153,13078,517,3,Business,28,5,31415,28,5,31428,28,5,31440,28,5,32704,28,5,32710,11,19.5,-1.3167113,36.8301563,-1.2574219,36.7927073,39,6,13,1276
17154,19179,2154,3,Business,13,2,55933,13,2,55960,13,2,56735,13,2,57017,13,2,58238,11,26.4,-1.2283403,36.8822756,-1.2765736,36.8513646,191,1221,27,1057
17155,20442,1557,3,Business,26,4,49540,26,4,49585,26,4,50377,26,4,50674,26,4,51711,11,22.1,-1.3147074,36.811722,-1.2551895,36.7822034,629,1037,45,1089
17156,12301,3291,3,Business,3,5,51631,3,5,51795,3,5,52458,3,5,52854,3,5,53460,2,23.25888921888938,-1.266837,36.799249,-1.2600926,36.8088685,745,606,164,1059
17157,14653,141,3,Personal,12,2,57789,12,2,57919,12,2,59713,12,2,61814,12,2,66254,13,26.6,-1.2871938,36.8195031,-1.2658003,36.8983864,332,4440,130,3895
17158,15368,57,2,Personal,28,6,25198,28,6,25252,28,6,26450,28,6,27342,28,6,28649,6,17.3,-1.284879,36.8245971,-1.2999579,36.7990742,399,1307,54,2090
17159,2206,391,3,Business,12,1,34883,12,1,35717,12,1,36505,12,1,36657,12,1,38137,14,19.4,-1.2857574,36.8295667,-1.3370583,36.8846253,276,1480,834,940
17160,19468,1402,3,Business,14,2,56882,14,2,57077,14,2,58034,14,2,58826,14,2,61956,12,23.25888921888938,-1.2813012,36.8323962,-1.3091733,36.74081,247,3130,195,1749
17161,7043,598,2,Business,12,5,43334,12,5,43364,12,5,44048,12,5,44986,12,5,47271,19,24.5,-1.2138373,36.7998572,-1.2890254,36.7990753,45,2285,30,1622
17162,16307,2044,1,Personal,24,4,30657,24,4,32344,24,4,33531,24,4,33816,24,4,34661,5,17.1,-1.284367,36.824186,-1.2517392,36.8249608,103,845,1687,1472
17163,828,1329,3,Business,6,4,49562,6,4,49655,6,4,50677,6,4,50787,6,4,51504,3,21.2,-1.273056,36.811298,-1.2702333,36.80065,579,717,93,1132
17164,21912,295,3,Business,8,5,42366,8,5,43692,8,5,44292,8,5,44606,8,5,45830,8,28.5,-1.2967108,36.7871135,-1.261307,36.809549,583,1224,1326,914
17165,26268,2701,3,Business,11,2,50254,11,2,50418,11,2,51116,11,2,51458,11,2,53733,6,21.1,-1.279395,36.825364,-1.2765736,36.8513646,868,2275,164,1040
17166,7708,1363,3,Business,5,2,32984,5,2,33049,5,2,33256,5,2,33377,5,2,34320,11,20.8,-1.3004062,36.829741,-1.3302099,36.8898999,136,943,65,328
17167,77,2271,3,Business,4,1,59094,4,1,59148,4,1,59526,4,1,60141,4,1,64509,14,26.2,-1.272828,36.816608,-1.293515,36.897607,404,4368,54,993
17168,21904,248,3,Business,21,2,58241,21,2,58314,21,2,59009,21,2,59137,21,2,59651,2,24.9,-1.3050379,36.7943452,-1.304735,36.7846054,576,514,73,823
17169,2748,1549,1,Personal,26,4,47483,26,4,47494,26,4,48382,26,4,49036,26,4,50322,15,21.9,-1.3223345,36.7195749,-1.3214562,36.8100828,648,1286,11,1542
17170,14989,466,3,Personal,14,1,43032,14,1,43044,14,1,43231,14,1,43428,14,1,44651,9,23.3,-1.2768326,36.8073804,-1.2310607,36.8035776,764,1223,12,384
17171,17189,3590,3,Business,9,3,34533,9,3,34692,9,3,35345,9,3,35829,9,3,37783,3,20.3,-1.266294,36.8057971,-1.2881035,36.8142095,88,1954,159,1137
17172,1160,733,3,Business,30,2,39889,30,2,40204,30,2,40341,30,2,41047,30,2,43201,9,23.25888921888938,-1.2551895,36.7822034,-1.3031971,36.7863146,686,2154,315,843
17173,4285,1384,3,Business,13,1,52377,13,1,52471,13,1,53163,13,1,53579,13,1,55087,20,23.25888921888938,-1.2517448,36.7924971,-1.206074,36.924713,484,1508,94,1108
17174,3488,3201,3,Business,24,3,34856,24,3,34864,24,3,35663,24,3,36132,24,3,36872,5,17.1,-1.2584143,36.8048002,-1.255956,36.772901,620,740,8,1268
17175,12540,1880,3,Business,16,4,42987,16,4,44551,16,4,45113,16,4,45575,16,4,46138,2,23.25888921888938,-1.2571472,36.7950633,-1.2706941,36.8132766,675,563,1564,1024
17176,26143,2896,3,Business,27,6,32525,27,6,32550,27,6,32892,27,6,33438,27,6,34517,6,23.25888921888938,-1.3201407,36.8540433,-1.3338005,36.863026,263,1079,25,888
17177,3551,3502,2,Personal,22,5,56663,22,5,56713,22,5,57012,22,5,58534,22,5,60797,10,23.25888921888938,-1.2930931,36.7559267,-1.2893884,36.828207,846,2263,50,1821
17178,2665,3669,3,Business,17,4,40246,17,4,40287,17,4,40669,17,4,41908,17,4,43622,3,25.4,-1.2590837,36.804902,-1.2615888,36.7928732,167,1714,41,1621
17179,27803,3295,3,Business,22,3,56862,22,3,56880,22,3,57272,22,3,58207,22,3,59367,13,25.9,-1.2571472,36.7950633,-1.3226302,36.8719901,789,1160,18,1327
17180,16635,2360,3,Business,10,5,44502,10,5,44520,10,5,44542,10,5,45088,10,5,45754,5,23.25888921888938,-1.2551895,36.7822034,-1.2700552,36.817067,576,666,18,568
17181,9270,2801,3,Business,5,2,54177,5,2,54221,5,2,54248,5,2,56314,5,2,57307,8,23.25888921888938,-1.2595422,36.7871178,-1.2987276,36.8176337,876,993,44,2093
17182,13503,2829,3,Business,13,1,51980,13,1,52020,13,1,53162,13,1,53806,13,1,56561,21,23.25888921888938,-1.2571472,36.7950633,-1.3562374,36.9042954,205,2755,40,1786
17183,16808,136,3,Business,16,5,55540,16,5,59174,16,5,60585,16,5,60732,16,5,63927,22,26.2,-1.3326173,36.7146233,-1.2372853,36.7611857,40,3195,3634,1558
17184,1365,3264,3,Business,21,1,52427,21,1,52510,21,1,52825,21,1,53144,21,1,55087,16,27.6,-1.2551895,36.7822034,-1.2778747,36.8831829,670,1943,83,634
17185,10200,2956,3,Business,11,1,32826,11,1,32849,11,1,34324,11,1,34522,11,1,35681,9,21.0,-1.3014461,36.7661381,-1.2584143,36.8048002,576,1159,23,1673
17186,1132,2279,3,Business,10,3,49811,10,3,50128,10,3,50965,10,3,53376,10,3,53558,7,30.6,-1.2897368,36.8226783,-1.2551895,36.7822034,61,182,317,3248
17187,12660,1038,1,Business,10,2,30516,10,2,30542,10,2,31304,10,2,31372,10,2,33842,16,16.5,-1.3099145,36.8022774,-1.3123977,36.902807,45,2470,26,830
17188,27789,2207,3,Business,26,5,31559,26,5,34023,26,5,35251,26,5,35658,26,5,35918,2,23.25888921888938,-1.2679971,36.8088937,-1.2768326,36.8073804,770,260,2464,1635
17189,24224,1363,3,Business,6,2,53893,6,2,55308,6,2,55452,6,2,56250,6,2,57282,8,27.7,-1.3004062,36.829741,-1.2574219,36.7927073,188,1032,1415,942
17190,22326,3517,3,Business,20,3,34361,20,3,34386,20,3,37496,20,3,41128,20,3,42407,15,27.2,-1.300921,36.828195,-1.3882008,36.7699445,817,1279,25,6742
17191,6950,1271,3,Business,4,2,48663,4,2,49347,4,2,50106,4,2,50492,4,2,54015,24,23.8,-1.3244885,36.897792,-1.2821825,36.7588985,829,3523,684,1145
17192,11929,552,3,Business,31,5,40802,31,5,40903,31,5,41887,31,5,42838,31,5,46510,18,21.8,-1.279395,36.825364,-1.3562374,36.9042954,582,3672,101,1935
17193,11891,1724,3,Business,11,4,41572,11,4,41592,11,4,41651,11,4,42258,11,4,43634,8,25.6,-1.2551895,36.7822034,-1.2941648,36.7977315,698,1376,20,666
17194,17651,393,3,Business,28,4,36528,28,4,36591,28,4,37387,28,4,39017,28,4,41517,11,28.2,-1.3167113,36.8301563,-1.2638185,36.7930057,154,2500,63,2426
17195,14432,1341,3,Business,9,4,56082,9,4,57161,9,4,57408,9,4,57778,9,4,59148,15,23.25888921888938,-1.2628473,36.781805,-1.331619,36.847976,411,1370,1079,617
17196,9042,136,3,Business,20,4,51765,20,4,51839,20,4,53477,20,4,54270,20,4,58894,16,28.1,-1.3326173,36.7146233,-1.3233496,36.8139159,565,4624,74,2431
17197,20980,2041,1,Business,12,3,42419,12,3,42521,12,3,43594,12,3,44557,12,3,45460,4,23.0,-1.290894,36.822971,-1.2690931,36.8065779,726,903,102,2036
17198,348,3283,3,Business,5,2,33305,5,2,34003,5,2,37360,5,2,37901,5,2,40455,19,21.2,-1.293515,36.897607,-1.2628473,36.781805,699,2554,698,3898
17199,21170,3291,3,Business,27,1,36612,27,1,36722,27,1,37388,27,1,37761,27,1,39046,11,17.9,-1.303596,36.778378,-1.2600926,36.8088685,826,1285,110,1039
17200,16929,1329,3,Business,16,6,43329,16,6,43374,16,6,43940,16,6,44297,16,6,45484,19,25.8,-1.273056,36.811298,-1.1933233,36.9354943,865,1187,45,923
17201,5372,2212,3,Business,27,5,39034,27,5,39042,27,5,39581,27,5,39725,27,5,40301,5,22.4,-1.2646084,36.8028645,-1.255956,36.772901,415,576,8,683
17202,9473,2854,3,Business,30,3,46900,30,3,49110,30,3,50070,30,3,51320,30,3,53102,15,24.9,-1.2287314,36.8367354,-1.2963097,36.7688221,752,1782,2210,2210
17203,23861,1162,3,Business,20,1,31627,20,1,31651,20,1,32194,20,1,32474,20,1,33611,10,18.9,-1.312261,36.794658,-1.264788,36.7883897,68,1137,24,823
17204,15458,1073,3,Business,9,3,33503,9,3,33572,9,3,33907,9,3,34214,9,3,35917,17,20.0,-1.2563576,36.7881585,-1.22386,36.8887256,45,1703,69,642
17205,3997,3686,3,Business,27,2,53024,27,2,53252,27,2,53994,27,2,54294,27,2,55689,8,25.8,-1.2551895,36.7822034,-1.287428,36.7800821,958,1395,228,1042
17206,5662,635,3,Business,22,3,35128,22,3,36092,22,3,37822,22,3,38390,22,3,42635,28,23.3,-1.2847613,36.967084,-1.2602337,36.7990548,730,4245,964,2298
17207,10180,265,3,Business,23,2,39017,23,2,39026,23,2,39726,23,2,40164,23,2,41290,4,23.25888921888938,-1.321846,36.82826,-1.300921,36.828195,349,1126,9,1138
17208,2830,2601,3,Personal,2,2,56409,2,2,61586,2,2,64247,2,2,64951,2,2,65873,6,23.4,-1.261137,36.7285138,-1.2812549,36.7236622,565,922,5177,3365
17209,15435,136,3,Business,8,3,32584,8,3,32640,8,3,33007,8,3,33096,8,3,36888,18,23.25888921888938,-1.3254522,36.7216584,-1.2461647,36.7902361,65,3792,56,456
17210,23696,2601,3,Personal,16,3,33810,16,3,33818,16,3,33915,16,3,34085,16,3,34442,2,19.4,-1.2963097,36.7688221,-1.3014461,36.7661381,425,357,8,267
17211,9513,2523,3,Business,26,2,52952,26,2,53027,26,2,53839,26,2,53981,26,2,55352,3,31.2,-1.2551895,36.7822034,-1.2514315,36.7918586,318,1371,75,954
17212,10578,1017,3,Business,14,2,33293,14,2,33317,14,2,33545,14,2,33668,14,2,34154,3,15.6,-1.2551895,36.7822034,-1.259382,36.807205,726,486,24,351
17213,11562,2154,3,Business,2,5,48884,2,5,50889,2,5,51218,2,5,54024,2,5,56349,5,25.3,-1.290894,36.822971,-1.2765736,36.8513646,320,2325,2005,3135
17214,16050,136,3,Business,22,2,46842,22,2,47136,22,2,49053,22,2,49555,22,2,54459,3,25.4,-1.2965045,36.7913036,-1.290641,36.812941,847,4904,294,2419
17215,21935,2454,3,Business,29,5,54504,29,5,54570,29,5,55633,29,5,56059,29,5,57921,8,28.8,-1.2570328,36.7869744,-1.2993231,36.7753372,829,1862,66,1489
17216,1376,3674,3,Business,25,1,51038,25,1,51653,25,1,53044,25,1,53178,25,1,54911,7,30.2,-1.2551895,36.7822034,-1.2880883,36.8227336,709,1733,615,1525
17217,26292,3561,3,Personal,12,2,46807,12,2,46822,12,2,47345,12,2,47582,12,2,49368,15,28.3,-1.2658315,36.809049,-1.3242107,36.7212891,885,1786,15,760
17218,1475,3688,3,Business,21,5,45932,21,5,47063,21,5,47708,21,5,47892,21,5,49916,9,22.8,-1.2551895,36.7822034,-1.3001735,36.8042049,548,2024,1131,829
17219,17061,1207,3,Business,17,6,47172,17,6,48202,17,6,48221,17,6,48730,17,6,49796,14,23.9,-1.2629666,36.8068369,-1.207546,36.7913976,541,1066,1030,528
17220,1525,2423,3,Business,18,1,37808,18,1,38040,18,1,38327,18,1,38489,18,1,41510,14,23.25888921888938,-1.2551895,36.7822034,-1.329568,36.8520825,322,3021,232,449
17221,1900,867,3,Business,26,5,49669,26,5,49745,26,5,51377,26,5,53636,26,5,55346,10,23.25888921888938,-1.2996533,36.8292629,-1.2991441,36.7528804,328,1710,76,3891
17222,20035,409,3,Personal,1,5,59488,1,5,64184,1,5,65113,1,5,67163,1,5,68574,11,30.2,-1.2539849,36.8247209,-1.304735,36.7846054,427,1411,4696,2979
17223,10828,661,3,Business,25,3,53454,25,3,53479,25,3,54020,25,3,55818,25,3,56863,4,17.7,-1.2950044,36.7512209,-1.2963097,36.7688221,140,1045,25,2339
17224,5051,3264,3,Business,4,2,51337,4,2,51494,4,2,52168,4,2,52302,4,2,52978,3,22.5,-1.2551895,36.7822034,-1.259919,36.808244,921,676,157,808
17225,23063,2277,3,Business,8,4,32898,8,4,32946,8,4,33379,8,4,33983,8,4,35017,7,20.4,-1.303637,36.8161168,-1.2934657,36.7644731,726,1034,48,1037
17226,25301,1500,3,Business,18,1,40561,18,1,40572,18,1,40575,18,1,41163,18,1,42952,10,26.9,-1.2991441,36.7528804,-1.2638185,36.7930057,576,1789,11,591
17227,2881,3599,3,Business,31,3,33549,31,3,34474,31,3,36467,31,3,38970,31,3,40307,15,24.8,-1.3302996,36.8707935,-1.2520942,36.7915863,179,1337,925,4496
17228,12305,1192,1,Personal,13,5,48057,13,5,48227,13,5,50678,13,5,51112,13,5,53477,6,19.1,-1.2857521,36.8277457,-1.2941024,36.79578,313,2365,170,2885
17229,14141,430,3,Business,4,6,40045,4,6,40077,4,6,43574,4,6,43921,4,6,46873,18,19.9,-1.3321944,36.8892329,-1.2611667,36.8056908,700,2952,32,3844
17230,11566,835,3,Business,4,4,32992,4,4,34039,4,4,36578,4,4,37971,4,4,40647,21,25.5,-1.3700383,36.9190174,-1.2917868,36.7872675,883,2676,1047,3932
17231,4210,1812,1,Personal,14,5,48873,14,5,48918,14,5,49201,14,5,49700,14,5,50798,5,27.1,-1.2560455,36.7800867,-1.2804664,36.7701111,770,1098,45,782
17232,16526,1297,2,Personal,18,4,67140,18,4,67151,18,4,67285,18,4,68224,18,4,68918,7,23.5,-1.2649605,36.7981777,-1.2983805,36.8198439,266,694,11,1073
17233,13106,1209,3,Business,27,1,56108,27,1,56213,27,1,56531,27,1,57971,27,1,58549,4,23.2,-1.3228003,36.8306435,-1.3004062,36.829741,817,578,105,1758
17234,7011,3613,3,Business,18,4,51147,18,4,51217,18,4,52499,18,4,53253,18,4,54507,7,27.0,-1.2730868,36.7706594,-1.298529,36.816482,213,1254,70,2036
17235,25991,2257,3,Personal,16,4,52693,16,4,52795,16,4,55094,16,4,55354,16,4,56523,6,19.1,-1.2624924,36.7961688,-1.2755629,36.8131522,857,1169,102,2559
17236,25330,1342,3,Business,17,3,45336,17,3,45591,17,3,46424,17,3,46879,17,3,48164,10,25.6,-1.263194,36.797624,-1.3025826,36.7670807,937,1285,255,1288
17237,17615,580,1,Personal,8,2,43011,8,2,43955,8,2,46010,8,2,46976,8,2,49426,17,21.2,-1.2161475,36.8828534,-1.2972307,36.8139073,620,2450,944,3021
17238,1518,3355,3,Business,17,1,50659,17,1,52626,17,1,53070,17,1,53404,17,1,54626,6,24.8,-1.3052491,36.8223899,-1.2980272,36.7832507,518,1222,1967,778
17239,26835,3510,1,Business,4,3,37593,4,3,37745,4,3,38065,4,3,38464,4,3,39082,3,17.1,-1.2646579,36.8253211,-1.265715,36.808525,531,618,152,719
17240,20489,3149,3,Business,15,4,54294,15,4,55500,15,4,55555,15,4,57719,15,4,57725,6,27.7,-1.3004062,36.829741,-1.3177547,36.8303703,623,6,1206,2219
17241,13083,2978,3,Business,24,5,31685,24,5,31691,24,5,32907,24,5,33146,24,5,35031,22,15.8,-1.2551895,36.7822034,-1.3076278,36.9158578,865,1885,6,1455
17242,14267,3560,3,Business,23,6,57303,23,6,57750,23,6,58200,23,6,58294,23,6,59260,8,23.25888921888938,-1.279395,36.825364,-1.3270716,36.8406371,202,966,447,544
17243,17023,1115,2,Personal,19,4,44153,19,4,44238,19,4,44896,19,4,45141,19,4,45824,5,20.0,-1.2848216,36.8097316,-1.2875842,36.7799696,648,683,85,903
17244,3719,1482,3,Business,13,3,43139,13,3,43167,13,3,43171,13,3,43425,13,3,45323,24,25.0,-1.338579,36.8963038,-1.22589,36.7822548,886,1898,28,258
17245,7174,3647,3,Business,13,2,38226,13,2,38401,13,2,41310,13,2,41519,13,2,47448,10,22.5,-1.272639,36.794723,-1.3108783,36.8392726,112,5929,175,3118
17246,17843,3283,3,Business,14,2,45273,14,2,45318,14,2,45912,14,2,46588,14,2,47337,5,23.25888921888938,-1.2600926,36.8088685,-1.2628473,36.781805,959,749,45,1270
17247,1650,3515,1,Personal,13,4,38667,13,4,39048,13,4,40081,13,4,40571,13,4,42689,6,23.3,-1.2946696,36.8516587,-1.3053865,36.8917332,189,2118,381,1523
17248,26604,1402,3,Business,16,2,52523,16,2,52631,16,2,53201,16,2,53678,16,2,54262,1,23.25888921888938,-1.2793686,36.8259233,-1.2813012,36.8323962,404,584,108,1047
17249,25611,868,3,Business,28,4,50338,28,4,50352,28,4,52041,28,4,52239,28,4,54299,6,27.3,-1.307143,36.825009,-1.265715,36.823815,787,2060,14,1887
17250,17534,1342,3,Business,16,2,39263,16,2,39324,16,2,42364,16,2,46668,16,2,49865,9,23.6,-1.28878,36.8168312,-1.3025826,36.7670807,303,3197,61,7344
17251,13665,640,3,Business,25,1,33587,25,1,33692,25,1,34691,25,1,36652,25,1,37368,3,20.9,-1.2969741,36.7856612,-1.2878914,36.7728222,678,716,105,2960
17252,13380,2330,3,Business,30,4,56074,30,4,56133,30,4,57005,30,4,57238,30,4,59463,15,23.25888921888938,-1.2642903,36.8002137,-1.2524916,36.8656196,329,2225,59,1105
17253,16427,42,3,Business,8,4,49896,8,4,49925,8,4,50289,8,4,50964,8,4,51384,5,27.1,-1.2564152,36.7792803,-1.2705336,36.7943509,56,420,29,1039
17254,4272,1245,3,Business,11,4,44201,11,4,44216,11,4,44345,11,4,47519,11,4,48371,15,25.8,-1.300921,36.828195,-1.2174265,36.8122001,436,852,15,3303
17255,18418,2695,1,Personal,5,5,39176,5,5,40522,5,5,41547,5,5,41808,5,5,42712,6,23.8,-1.2997169,36.7486486,-1.2809264,36.7842675,565,904,1346,1286
17256,5105,3222,3,Business,13,4,52900,13,4,52973,13,4,54300,13,4,54393,13,4,57100,13,22.3,-1.2551895,36.7822034,-1.3069686,36.8596454,108,2707,73,1420
17257,6504,2523,3,Business,25,4,45626,25,4,45659,25,4,46784,25,4,46977,25,4,49524,23,20.2,-1.2551895,36.7822034,-1.3447079,36.91105,541,2547,33,1318
17258,10404,3355,3,Business,14,2,48309,14,2,48399,14,2,48868,14,2,49088,14,2,50068,3,24.0,-1.3052491,36.8223899,-1.291768,36.8297208,857,980,90,689
17259,1614,1882,3,Business,10,4,43933,10,4,43947,10,4,44037,10,4,45121,10,4,50241,18,24.8,-1.2628638,36.8070399,-1.3499321,36.9047554,447,5120,14,1174
17260,4220,3091,3,Business,29,3,41586,29,3,41653,29,3,41962,29,3,42176,29,3,42529,2,23.25888921888938,-1.279395,36.825364,-1.290894,36.822971,276,353,67,523
17261,12401,1244,3,Business,23,6,47992,23,6,48186,23,6,48818,23,6,50932,23,6,50937,11,23.25888921888938,-1.331619,36.847976,-1.303596,36.778378,459,5,194,2746
17262,14117,2532,3,Business,21,4,53009,21,4,53360,21,4,54480,21,4,54715,21,4,56689,7,26.2,-1.2551895,36.7822034,-1.2898179,36.8270849,831,1974,351,1355
17263,6312,2677,3,Business,18,4,55498,18,4,55530,18,4,56500,18,4,57450,18,4,60239,10,23.25888921888938,-1.3004062,36.829741,-1.2991441,36.7528804,438,2789,32,1920
17264,21417,3586,3,Business,9,3,59592,9,3,59630,9,3,60069,9,3,60307,9,3,61578,8,24.5,-1.275442,36.7660207,-1.2760462,36.8074697,205,1271,38,677
17265,27914,1037,2,Personal,11,3,57898,11,3,58109,11,3,59218,11,3,59532,11,3,60646,5,19.8,-1.2596651,36.8086697,-1.2873708,36.814908,752,1114,211,1423
17266,12959,1244,3,Business,20,3,36798,20,3,36810,20,3,38149,20,3,39430,20,3,41138,18,27.3,-1.293515,36.897607,-1.303596,36.778378,377,1708,12,2620
17267,25488,1405,3,Business,17,4,35581,17,4,35672,17,4,35851,17,4,37699,17,4,39034,9,23.25888921888938,-1.3194518,36.869396,-1.3478563,36.8935824,178,1335,91,2027
17268,8669,1553,1,Personal,6,5,39257,6,5,41018,6,5,41793,6,5,42068,6,5,43179,8,20.5,-1.2343087,36.84749,-1.2813544,36.8203521,726,1111,1761,1050
17269,6740,1500,3,Business,19,2,36477,19,2,36489,19,2,36495,19,2,38024,19,2,38148,8,27.4,-1.3004062,36.829741,-1.2638185,36.7930057,403,124,12,1535
17270,23606,20,3,Business,20,2,56472,20,2,57408,20,2,59539,20,2,59983,20,2,62008,27,24.0,-1.413547,36.9550764,-1.2628638,36.8070399,222,2025,936,2575
17271,6080,393,3,Business,10,3,31165,10,3,31210,10,3,31216,10,3,34159,10,3,34169,11,21.8,-1.3167113,36.8301563,-1.2638185,36.7930057,239,10,45,2949
17272,8069,1177,1,Personal,19,2,46598,19,2,46614,19,2,47986,19,2,48416,19,2,50841,8,23.25888921888938,-1.2915307,36.7905865,-1.3017794,36.8240888,202,2425,16,1802
17273,24469,53,3,Business,25,1,51358,25,1,51436,25,1,52260,25,1,52524,25,1,53469,5,29.9,-1.2770708,36.8231093,-1.29508,36.796863,855,945,78,1088
17274,17920,421,3,Business,18,2,49656,18,2,49673,18,2,50512,18,2,52294,18,2,54872,28,25.4,-1.2975066,36.7689423,-1.1612808,36.9563278,607,2578,17,2621
17275,2580,1209,3,Business,24,3,39949,24,3,40049,24,3,40437,24,3,40598,24,3,43280,16,23.25888921888938,-1.3004062,36.829741,-1.3871626,36.7705016,504,2682,100,549
17276,4247,1075,3,Business,1,5,56006,1,5,56079,1,5,56512,1,5,56837,1,5,58138,9,28.4,-1.2527958,36.8003131,-1.2934638,36.7668028,315,1301,73,758
17277,12030,193,3,Personal,21,5,55519,21,5,55547,21,5,56176,21,5,56489,21,5,59038,21,24.8,-1.3632162,36.9108253,-1.2615584,36.8149506,205,2549,28,942
17278,26301,3698,3,Business,22,3,38762,22,3,38796,22,3,39223,22,3,40472,22,3,42019,17,23.3,-1.2285995,36.9012372,-1.3244885,36.897792,291,1547,34,1676
17279,21433,3434,3,Business,25,2,45543,25,2,45572,25,2,46397,25,2,46770,25,2,49829,22,23.9,-1.2729121,36.8325402,-1.1612808,36.9563278,96,3059,29,1198
17280,27546,1384,3,Business,15,3,39822,15,3,39839,15,3,40063,15,3,40325,15,3,42512,14,23.25888921888938,-1.2517448,36.7924971,-1.3022584,36.7343665,959,2187,17,486
17281,21543,3727,3,Business,18,1,51784,18,1,51797,18,1,52404,18,1,52639,18,1,53846,8,30.9,-1.2963097,36.7688221,-1.2600616,36.7870182,952,1207,13,842
17282,17062,496,3,Business,26,2,39686,26,2,39718,26,2,39958,26,2,40149,26,2,41278,8,27.4,-1.2551895,36.7822034,-1.3007402,36.8108766,634,1129,32,431
17283,7199,1205,3,Business,20,3,45035,20,3,45074,20,3,45496,20,3,45918,20,3,46997,7,27.3,-1.2973188,36.7895013,-1.2495931,36.8065087,829,1079,39,844
17284,6386,2464,3,Business,3,1,53362,3,1,54910,3,1,55956,3,1,56069,3,1,59031,13,23.0,-1.279395,36.825364,-1.2715944,36.9114173,709,2962,1548,1159
17285,5301,2174,3,Business,19,2,37575,19,2,38699,19,2,40465,19,2,40595,19,2,43268,15,26.4,-1.2482781,36.884092,-1.214071,36.7985052,152,2673,1124,1896
17286,21034,187,3,Business,1,6,56243,1,6,57673,1,6,58278,1,6,59330,1,6,60582,8,21.8,-1.3014461,36.7661381,-1.3169591,36.7000029,267,1252,1430,1657
17287,25529,3291,3,Business,4,4,54237,4,4,54293,4,4,54935,4,4,56167,4,4,57607,9,27.4,-1.307143,36.825009,-1.2600926,36.8088685,166,1440,56,1874
17288,9460,3599,3,Business,3,1,49575,3,1,49575,3,1,50832,3,1,53627,3,1,57292,18,23.2,-1.3302996,36.8707935,-1.2707623,36.7581285,772,3665,0,4052
17289,1447,3291,3,Business,28,2,32258,28,2,32608,28,2,33044,28,2,33372,28,2,34036,4,18.5,-1.265715,36.823815,-1.2600926,36.8088685,715,664,350,764
17290,22834,3291,3,Business,31,1,47542,31,1,47667,31,1,48131,31,1,48471,31,1,49256,4,21.1,-1.272828,36.816608,-1.2600926,36.8088685,362,785,125,804
17291,4924,3320,3,Business,26,5,38435,26,5,39954,26,5,40075,26,5,40320,26,5,41848,8,23.25888921888938,-1.3080092,36.8284543,-1.271823,36.789215,866,1528,1519,366
17292,10142,1334,2,Personal,30,4,41417,30,4,42602,30,4,43227,30,4,43454,30,4,44170,6,20.2,-1.3086326,36.8080886,-1.304033,36.7848695,848,716,1185,852
17293,22653,3222,3,Business,13,2,44443,13,2,45213,13,2,47187,13,2,47348,13,2,48433,10,22.2,-1.2551895,36.7822034,-1.2287282,36.8115304,578,1085,770,2135
17294,3390,393,3,Business,25,4,45860,25,4,48288,25,4,48505,25,4,49365,25,4,49997,4,23.25888921888938,-1.3167113,36.8301563,-1.3004062,36.829741,211,632,2428,1077
17295,5174,3434,3,Business,20,1,47401,20,1,47443,20,1,47866,20,1,48051,20,1,51473,28,20.2,-1.2963097,36.7688221,-1.1612808,36.9563278,334,3422,42,608
17296,17284,635,3,Business,26,3,53144,26,3,53262,26,3,54057,26,3,55366,26,3,56603,7,27.1,-1.3016417,36.8271679,-1.2618264,36.8141179,402,1237,118,2104
17297,27921,475,3,Business,30,3,44064,30,3,44227,30,3,45265,30,3,45585,30,3,47870,28,22.7,-1.3632162,36.9108253,-1.3339943,36.7263409,95,2285,163,1358
17298,726,1081,3,Business,6,3,44564,6,3,44592,6,3,46973,6,3,47413,6,3,49877,21,22.5,-1.2860183,36.8975338,-1.3025826,36.7670807,377,2464,28,2821
17299,13534,1679,1,Personal,31,5,56171,31,5,56230,31,5,58851,31,5,58993,31,5,60644,13,20.2,-1.2629666,36.8068369,-1.3291184,36.7892374,857,1651,59,2763
17300,17910,3641,3,Business,8,3,49777,8,3,49803,8,3,49925,8,3,50823,8,3,53998,18,23.25888921888938,-1.2551895,36.7822034,-1.276292,36.90082,952,3175,26,1020
17301,24031,3688,3,Business,11,1,52098,11,1,52136,11,1,52848,11,1,53433,11,1,56443,15,28.0,-1.3194518,36.869396,-1.2551895,36.7822034,510,3010,38,1297
17302,9549,3450,3,Business,28,2,30053,28,2,30125,28,2,32519,28,2,32808,28,2,34269,6,18.6,-1.2551895,36.7822034,-1.2834816,36.8219031,92,1461,72,2683
17303,17463,984,1,Personal,12,6,39624,12,6,39641,12,6,39856,12,6,40820,12,6,42898,18,23.0,-1.2976971,36.7911336,-1.2119232,36.8996459,390,2078,17,1179
17304,27439,3216,2,Personal,28,5,26475,28,5,26495,28,5,26980,28,5,27434,28,5,28511,6,20.6,-1.301093,36.7790314,-1.3175119,36.8058513,722,1077,20,939
17305,322,136,3,Business,14,5,54183,14,5,54733,14,5,55371,14,5,55642,14,5,59089,14,27.3,-1.3326173,36.7146233,-1.2896399,36.8124498,312,3447,550,909
17306,12187,3331,3,Business,14,4,52743,14,4,52815,14,4,53510,14,4,53817,14,4,54795,4,28.1,-1.2551895,36.7822034,-1.2668454,36.7940642,290,978,72,1002
17307,13326,868,3,Business,20,2,35003,20,2,35190,20,2,35865,20,2,36521,20,2,37319,5,19.0,-1.2600926,36.8088685,-1.265715,36.823815,178,798,187,1331
17308,21895,1075,3,Business,6,1,59080,6,1,59114,6,1,59417,6,1,60241,6,1,62796,20,23.25888921888938,-1.3562374,36.9042954,-1.2527958,36.8003131,709,2555,34,1127
17309,1420,286,3,Business,27,3,57887,27,3,59012,27,3,59186,27,3,59540,27,3,61327,8,23.25888921888938,-1.2962967,36.8020231,-1.2551895,36.7822034,268,1787,1125,528
17310,22707,2285,3,Personal,14,5,40017,14,5,40093,14,5,41257,14,5,41352,14,5,43051,15,22.1,-1.351453,36.899315,-1.2950041,36.8143583,955,1699,76,1259
17311,4764,2212,3,Business,2,4,51081,2,4,51103,2,4,51746,2,4,52424,2,4,53733,4,26.0,-1.2646084,36.8028645,-1.255956,36.772901,520,1309,22,1321
17312,2776,2956,3,Business,20,3,43015,20,3,43079,20,3,43429,20,3,44246,20,3,44939,6,26.3,-1.290894,36.822971,-1.2584143,36.8048002,764,693,64,1167
17313,20904,914,3,Business,4,1,42827,4,1,42861,4,1,45406,4,1,45613,4,1,47173,11,25.8,-1.3053578,36.8607913,-1.2670213,36.7994482,206,1560,34,2752
17314,15497,887,3,Personal,22,5,32084,22,5,34989,22,5,35975,22,5,36084,22,5,37307,8,16.1,-1.311706,36.802841,-1.2574088,36.799712,65,1223,2905,1095
17315,12355,868,3,Business,6,4,50711,6,4,52143,6,4,52423,6,4,52753,6,4,53621,5,23.25888921888938,-1.2600926,36.8088685,-1.265715,36.823815,685,868,1432,610
17316,11857,286,3,Business,23,5,67570,23,5,69045,23,5,69875,23,5,71147,23,5,72487,8,20.4,-1.2962967,36.8020231,-1.2551895,36.7822034,19,1340,1475,2102
17317,8252,1397,3,Business,12,2,56608,12,2,57301,12,2,58576,12,2,58704,12,2,61257,13,26.9,-1.2616841,36.801999,-1.2630542,36.7081754,862,2553,693,1403
17318,18357,1162,3,Business,6,4,34213,6,4,34781,6,4,35302,6,4,35498,6,4,36866,9,18.7,-1.312261,36.794658,-1.2626954,36.8273738,345,1368,568,717
17319,12061,510,3,Business,18,2,47998,18,2,48474,18,2,48742,18,2,49024,18,2,50747,16,25.7,-1.2584143,36.8048002,-1.2860183,36.8975338,932,1723,476,550
17320,11471,1719,3,Business,10,5,46594,10,5,46688,10,5,47206,10,5,47480,10,5,47856,2,23.25888921888938,-1.2969741,36.7856612,-1.3039706,36.7688174,256,376,94,792
17321,10999,826,3,Personal,20,1,33034,20,1,33599,20,1,34241,20,1,34523,20,1,35109,3,14.1,-1.2945041,36.8151527,-1.298744,36.8178237,338,586,565,924
17322,12854,2216,3,Business,12,2,33517,12,2,33534,12,2,33833,12,2,35053,12,2,39048,19,20.9,-1.2551895,36.7822034,-1.3253022,36.8803995,690,3995,17,1519
17323,4088,1245,3,Business,22,2,49386,22,2,50346,22,2,52998,22,2,53565,22,2,55749,14,25.4,-1.3882008,36.7699445,-1.3198615,36.7110323,379,2184,960,3219
17324,21035,309,3,Business,28,2,33682,28,2,33700,28,2,33715,28,2,34348,28,2,36712,17,18.5,-1.2156006,36.8916865,-1.3038408,36.818713,266,2364,18,648
17325,7175,410,1,Personal,17,1,60278,17,1,60667,17,1,61114,17,1,61998,17,1,65933,18,25.6,-1.1917753,36.9211989,-1.2361443,36.8108518,447,3935,389,1331
17326,7050,3222,3,Business,19,3,45287,19,3,45435,19,3,47721,19,3,48056,19,3,49653,5,22.0,-1.2551895,36.7822034,-1.2731645,36.7900343,399,1597,148,2621
17327,25162,2249,3,Business,28,3,36763,28,3,36775,28,3,37197,28,3,37338,28,3,39480,15,20.4,-1.2375831,36.79785858,-1.3030661,36.7512784,575,2142,12,563
17328,7111,1926,3,Business,30,6,45211,30,6,45226,30,6,45629,30,6,46427,30,6,47047,4,22.0,-1.304221,36.884308,-1.3050321,36.8843246,397,620,15,1201
17329,266,1502,3,Business,31,1,38055,31,1,38070,31,1,39187,31,1,40283,31,1,40300,5,21.2,-1.2283403,36.8822756,-1.2232123,36.8932547,812,17,15,2213
17330,27123,2423,3,Business,21,4,43586,21,4,43598,21,4,43785,21,4,44309,21,4,47775,10,28.0,-1.2551895,36.7822034,-1.3126476,36.831455,349,3466,12,711
17331,8123,2587,3,Business,7,7,37341,7,7,37365,7,7,37782,7,7,39062,7,7,39358,2,25.4,-1.290894,36.822971,-1.28878,36.8168312,532,296,24,1697
17332,11699,3647,3,Business,21,5,50857,21,5,50919,21,5,51326,21,5,51671,21,5,54621,20,24.6,-1.272639,36.794723,-1.2162985,36.9065105,866,2950,62,752
17333,14593,3647,3,Business,3,3,61043,3,3,61112,3,3,62988,3,3,63418,3,3,66478,3,27.6,-1.272639,36.794723,-1.272798,36.8124195,690,3060,69,2306
17334,13283,20,3,Business,20,2,59434,20,2,60204,20,2,61081,20,2,61403,20,2,64290,13,24.0,-1.2628638,36.8070399,-1.3343129,36.8637112,38,2887,770,1199
17335,17355,633,3,Business,7,4,29943,7,4,29972,7,4,30217,7,4,30903,7,4,31317,4,23.25888921888938,-1.3077869,36.8443207,-1.3004062,36.829741,329,414,29,931
17336,22253,391,3,Business,19,2,51295,19,2,51344,19,2,52377,19,2,52545,19,2,54717,11,30.2,-1.2867454,36.8259017,-1.2134633,36.8166402,660,2172,49,1201
17337,26267,2931,3,Business,15,3,52877,15,3,53198,15,3,54227,15,3,54863,15,3,56243,7,25.7,-1.2802803,36.8271747,-1.2452664,36.8028541,907,1380,321,1665
17338,24500,2633,1,Personal,19,6,50618,19,6,50648,19,6,51279,19,6,51550,19,6,52903,14,24.2,-1.2916556,36.8852415,-1.2944292,36.7793569,633,1353,30,902
17339,27362,635,3,Business,24,4,44201,24,4,44723,24,4,47356,24,4,47993,24,4,48463,3,21.0,-1.2777924,36.8231577,-1.26639,36.834883,844,470,522,3270
17340,9440,761,3,Business,22,3,46691,22,3,46700,22,3,47125,22,3,47676,22,3,52237,23,23.0,-1.2693102,36.7981777,-1.2927239,36.946421,676,4561,9,976
17341,25926,909,3,Business,21,3,40286,21,3,40768,21,3,43527,21,3,43714,21,3,45065,10,22.0,-1.225322,36.80855,-1.1785179,36.7557799,829,1351,482,2946
17342,2354,391,3,Business,6,1,51215,6,1,51313,6,1,51492,6,1,51925,6,1,52682,5,23.25888921888938,-1.2602337,36.7990548,-1.2784063,36.8222933,953,757,98,612
17343,4592,1880,3,Business,25,5,55172,25,5,55213,25,5,55321,25,5,56296,25,5,57361,6,23.6,-1.2579304,36.8019667,-1.2809498,36.8252309,379,1065,41,1083
17344,18752,2523,3,Business,4,5,45947,4,5,45975,4,5,47263,4,5,47433,4,5,51254,26,17.4,-1.2516167,36.8678844,-1.3117864,36.6973045,457,3821,28,1458
17345,27562,3030,3,Business,4,3,43214,4,3,43235,4,3,43495,4,3,44052,4,3,45010,5,17.0,-1.3004846,36.7901591,-1.2866012,36.8195691,726,958,21,817
17346,11995,1687,3,Business,22,2,56226,22,2,56303,22,2,58609,22,2,58903,22,2,62689,9,25.5,-1.3011535,36.8437979,-1.2729802,36.793734,26,3786,77,2600
17347,20318,3246,1,Business,16,2,31611,16,2,31636,16,2,34373,16,2,34605,16,2,37028,16,23.25888921888938,-1.3165542,36.700067,-1.2615888,36.7928732,565,2423,25,2969
17348,9997,2066,3,Business,28,4,36500,28,4,37856,28,4,38024,28,4,38538,28,4,40258,7,28.0,-1.3210189,36.8410551,-1.2865958,36.8244585,101,1720,1356,682
17349,21664,700,3,Business,7,1,58646,7,1,58687,7,1,59309,7,1,59598,7,1,61300,11,24.2,-1.323135,36.833139,-1.3014461,36.7661381,779,1702,41,911
17350,13248,3686,3,Business,17,2,38293,17,2,38303,17,2,38586,17,2,39424,17,2,40399,8,19.2,-1.2551895,36.7822034,-1.2898354,36.7872703,752,975,10,1121
17351,10458,1781,3,Business,3,5,36215,3,5,36226,3,5,36267,3,5,36815,3,5,38705,11,17.6,-1.2571472,36.7950633,-1.2271875,36.8522471,105,1890,11,589
17352,10057,3326,3,Business,12,2,52925,12,2,52981,12,2,53927,12,2,54501,12,2,56265,8,27.1,-1.2551895,36.7822034,-1.2977387,36.8031447,315,1764,56,1520
17353,12491,2174,3,Business,12,5,44112,12,5,44327,12,5,44359,12,5,45236,12,5,46583,16,24.6,-1.2482781,36.884092,-1.2108864,36.7807022,307,1347,215,909
17354,7629,111,3,Business,9,2,52600,9,2,53121,9,2,53555,9,2,53628,9,2,55224,9,30.7,-1.2551895,36.7822034,-1.3123782,36.8181528,505,1596,521,507
17355,2489,2212,3,Business,5,1,53684,5,1,53984,5,1,55166,5,1,55309,5,1,56842,7,26.2,-1.2571472,36.7950633,-1.2941585,36.7947375,112,1533,300,1325
17356,27236,238,3,Business,12,5,34893,12,5,34988,12,5,34992,12,5,36824,12,5,37340,4,21.8,-1.3004062,36.829741,-1.3077869,36.8443207,239,516,95,1836
17357,17861,3115,3,Business,16,2,51579,16,2,51679,16,2,52909,16,2,54048,16,2,55795,9,27.6,-1.2739208,36.8310153,-1.2963097,36.7688221,518,1747,100,2369
17358,11496,1927,3,Business,28,2,53681,28,2,53910,28,2,54624,28,2,56698,28,2,58376,12,23.5,-1.28878,36.8168312,-1.3472066,36.7692638,158,1678,229,2788
17359,12758,1926,3,Business,11,5,58490,11,5,60063,11,5,61511,11,5,61849,11,5,63570,6,20.3,-1.2897368,36.8226783,-1.3036637,36.7853135,929,1721,1573,1786
17360,17219,3291,3,Business,29,3,47437,29,3,47472,29,3,48277,29,3,49790,29,3,49795,12,20.9,-1.228911,36.881876,-1.2600926,36.8088685,788,5,35,2318
17361,1102,2008,3,Business,8,1,56368,8,1,56600,8,1,57644,8,1,57965,8,1,59419,8,29.8,-1.2508229,36.7895263,-1.2935303,36.7988142,660,1454,232,1365
17362,15110,1447,2,Personal,13,4,69209,13,4,69245,13,4,70675,13,4,70941,13,4,72444,17,20.0,-1.2838392,36.8842742,-1.299947,36.7685447,179,1503,36,1696
17363,6201,3291,3,Business,23,3,54846,23,3,54889,23,3,55424,23,3,56708,23,3,58041,11,27.3,-1.303596,36.778378,-1.2600926,36.8088685,219,1333,43,1819
17364,17250,437,3,Business,29,4,41972,29,4,42177,29,4,42423,29,4,42808,29,4,44738,7,21.5,-1.2551895,36.7822034,-1.2822909,36.8193456,510,1930,205,631
17365,16449,1780,1,Personal,5,3,46223,5,3,46246,5,3,46672,5,3,47185,5,3,51785,15,22.1,-1.206696,36.847709,-1.2956951,36.8129242,882,4600,23,939
17366,20965,3372,3,Business,29,7,63456,29,7,63468,29,7,64779,29,7,64874,29,7,68126,26,15.4,-1.214328,36.7911903,-1.3169591,36.7000029,208,3252,12,1406
17367,7485,265,3,Business,21,1,41973,21,1,42889,21,1,45059,21,1,45935,21,1,47062,10,25.7,-1.341891,36.761269,-1.300921,36.828195,576,1127,916,3046
17368,5072,1990,3,Business,20,1,51394,20,1,51719,20,1,51800,20,1,53887,20,1,57342,9,23.25888921888938,-1.2854453,36.8188363,-1.275442,36.7660207,564,3455,325,2168
17369,3615,640,3,Business,24,1,52243,24,1,52260,24,1,52472,24,1,52924,24,1,54514,3,23.25888921888938,-1.304033,36.7848695,-1.2945106,36.7728398,312,1590,17,664
17370,4697,2327,1,Personal,9,1,46337,9,1,46968,9,1,48531,9,1,51021,9,1,51446,2,21.2,-1.3106677,36.8233137,-1.3004062,36.829741,939,425,631,4053
17371,16741,1724,3,Business,7,3,33614,7,3,34389,7,3,36372,7,3,36962,7,3,39133,8,23.25888921888938,-1.2551895,36.7822034,-1.3037387,36.8175661,206,2171,775,2573
17372,6093,2587,3,Business,12,1,53864,12,1,56337,12,1,56375,12,1,56814,12,1,57704,3,26.9,-1.28878,36.8168312,-1.2896399,36.8124498,101,890,2473,477
17373,4473,391,3,Business,14,3,34082,14,3,35055,14,3,36143,14,3,38762,14,3,40409,22,24.5,-1.2847613,36.967084,-1.2867454,36.8259017,813,1647,973,3707
17374,12721,3517,3,Business,19,6,38696,19,6,38726,19,6,39639,19,6,43790,19,6,45728,15,25.4,-1.300921,36.828195,-1.3882008,36.7699445,654,1938,30,5064
17375,19564,635,3,Business,11,1,50929,11,1,51164,11,1,51523,11,1,51732,11,1,52223,4,28.7,-1.2599563,36.7993439,-1.2731645,36.7900343,52,491,235,568
17376,19832,2330,3,Business,21,4,37897,21,4,37934,21,4,38441,21,4,38809,21,4,39642,5,25.2,-1.2642903,36.8002137,-1.2545163,36.8243717,547,833,37,875
17377,13021,3201,3,Business,19,2,48127,19,2,48660,19,2,49060,19,2,49573,19,2,51539,17,29.4,-1.3463042,36.768164,-1.2584143,36.8048002,338,1966,533,913
17378,20942,2069,3,Business,29,4,46212,29,4,46269,29,4,46793,29,4,48035,29,4,49536,12,21.6,-1.2600926,36.8088685,-1.228911,36.881876,646,1501,57,1766
17379,11264,3291,3,Business,20,2,44916,20,2,45557,20,2,46166,20,2,46730,20,2,48076,12,19.6,-1.228911,36.881876,-1.2600926,36.8088685,31,1346,641,1173
17380,27685,3283,3,Business,4,5,39072,4,5,39367,4,5,39763,4,5,40072,4,5,41204,6,17.5,-1.272828,36.816608,-1.2628473,36.781805,489,1132,295,705
17381,16536,2335,3,Business,24,4,30744,24,4,30796,24,4,31335,24,4,31843,24,4,33916,21,16.9,-1.2553615,36.7895376,-1.3632162,36.9108253,40,2073,52,1047
17382,2610,2069,3,Business,29,2,38168,29,2,38299,29,2,39082,29,2,40371,29,2,41457,9,23.7,-1.265715,36.823815,-1.228911,36.881876,332,1086,131,2072
17383,9874,2200,3,Business,24,3,60494,24,3,63141,24,3,63168,24,3,64249,24,3,65850,8,18.5,-1.3014461,36.7661381,-1.290894,36.822971,927,1601,2647,1108
17384,21591,2509,3,Business,4,1,41111,4,1,41120,4,1,41137,4,1,42169,4,1,44656,20,25.4,-1.2571472,36.7950633,-1.3700383,36.9190174,647,2487,9,1049
17385,11734,1207,3,Business,14,4,36647,14,4,36764,14,4,38189,14,4,38766,14,4,39673,7,23.5,-1.2745321,36.765088,-1.2629666,36.8068369,101,907,117,2002
17386,10198,53,3,Business,10,5,34204,10,5,34503,10,5,34921,10,5,35321,10,5,36081,7,23.25888921888938,-1.2638185,36.7930057,-1.2770708,36.8231093,768,760,299,818
17387,9378,1927,3,Business,13,3,51412,13,3,51536,13,3,51846,13,3,52393,13,3,55902,12,29.0,-1.3472066,36.7692638,-1.2811503,36.8235884,317,3509,124,857
17388,17337,1244,3,Business,4,1,50388,4,1,51772,4,1,51941,4,1,52038,4,1,53976,8,28.6,-1.272828,36.816608,-1.303596,36.778378,605,1938,1384,266
17389,14500,635,3,Business,8,5,39008,8,5,39634,8,5,41251,8,5,41676,8,5,43861,7,28.6,-1.2602337,36.7990548,-1.3081376,36.8329772,309,2185,626,2042
17390,13753,633,3,Business,27,3,53197,27,3,53337,27,3,54036,27,3,55190,27,3,56412,9,29.3,-1.2638185,36.7930057,-1.3004062,36.829741,448,1222,140,1853
17391,9957,3222,3,Business,6,1,55251,6,1,55475,6,1,56065,6,1,56224,6,1,57795,8,23.25888921888938,-1.2551895,36.7822034,-1.295156,36.8094306,853,1571,224,749
17392,19568,3651,3,Business,28,1,58169,28,1,58330,28,1,59310,28,1,59908,28,1,62485,15,22.6,-1.2579304,36.8019667,-1.3310785,36.8933109,216,2577,161,1578
17393,3423,3686,3,Business,24,4,43365,24,4,43403,24,4,43779,24,4,44143,24,4,46204,6,24.3,-1.2551895,36.7822034,-1.2729292,36.7679079,755,2061,38,740
17394,11714,868,3,Business,3,3,55238,3,3,55274,3,3,55724,3,3,56410,3,3,57297,5,27.0,-1.2600926,36.8088685,-1.265715,36.823815,65,887,36,1136
17395,13040,3283,3,Business,4,4,54926,4,4,55080,4,4,55497,4,4,56746,4,4,57866,7,27.5,-1.303596,36.778378,-1.2628473,36.781805,484,1120,154,1666
17396,16647,2454,3,Business,1,5,55271,1,5,55292,1,5,56753,1,5,58461,1,5,59168,4,28.3,-1.2921436,36.7757259,-1.3031439,36.805133,427,707,21,3169
17397,8232,2579,3,Business,22,4,39074,22,4,39125,22,4,40698,22,4,41247,22,4,42002,7,22.4,-1.287428,36.7800821,-1.2592947,36.7698085,345,755,51,2122
17398,3680,970,3,Business,9,1,41920,9,1,42857,9,1,44247,9,1,44732,9,1,45580,8,20.2,-1.2551895,36.7822034,-1.2377323,36.8059983,101,848,937,1875
17399,13217,3177,3,Business,15,4,47402,15,4,47699,15,4,48537,15,4,48902,15,4,52865,20,27.7,-1.301953,36.788458,-1.2617477,36.6701414,558,3963,297,1203
17400,12889,3434,3,Business,17,5,38068,17,5,38118,17,5,40286,17,5,40759,17,5,44544,11,23.25888921888938,-1.3053135,36.8605848,-1.2417321,36.8886277,668,3785,50,2641
17401,14669,1484,3,Business,17,4,45614,17,4,45645,17,4,45991,17,4,46233,17,4,46513,4,25.4,-1.2551895,36.7822034,-1.2617028,36.7983849,881,280,31,588
17402,27094,2066,3,Business,10,4,30308,10,4,30361,10,4,31795,10,4,32565,10,4,34316,10,19.3,-1.3210189,36.8410551,-1.279529,36.8828522,436,1751,53,2204
17403,15100,3149,3,Business,25,4,48160,25,4,48217,25,4,48448,25,4,49237,25,4,49706,5,23.25888921888938,-1.3004062,36.829741,-1.3167113,36.8301563,877,469,57,1020
17404,24425,60,3,Business,7,2,35131,7,2,35225,7,2,36609,7,2,37351,7,2,38823,10,23.25888921888938,-1.2600926,36.8088685,-1.22978,36.836215,147,1472,94,2126
17405,28171,516,3,Business,29,2,41213,29,2,41330,29,2,41740,29,2,42869,29,2,43717,7,23.3,-1.2571472,36.7950633,-1.2843046,36.7746132,279,848,117,1539
17406,1318,635,3,Business,5,2,40424,5,2,40449,5,2,40634,5,2,41132,5,2,42066,4,25.4,-1.2602337,36.7990548,-1.277261,36.790856,727,934,25,683
17407,5141,1131,3,Business,29,1,46721,29,1,46754,29,1,47541,29,1,47665,29,1,49738,18,23.25888921888938,-1.207546,36.7913976,-1.2842308,36.7886575,878,2073,33,911
17408,24069,1527,3,Business,13,1,48715,13,1,48877,13,1,49566,13,1,49951,13,1,50610,4,23.25888921888938,-1.3077869,36.8443207,-1.3004062,36.829741,435,659,162,1074
17409,27329,60,3,Business,26,5,35836,26,5,35848,26,5,38072,26,5,38540,26,5,39297,7,23.25888921888938,-1.228911,36.881876,-1.22978,36.836215,952,757,12,2692
17410,20836,1500,3,Business,17,4,45741,17,4,45764,17,4,45778,17,4,47694,17,4,48689,8,25.4,-1.3004062,36.829741,-1.2574219,36.7927073,518,995,23,1930
17411,3456,3470,3,Business,5,2,54518,5,2,54545,5,2,55187,5,2,56184,5,2,56685,1,23.25888921888938,-1.28878,36.8168312,-1.2791714,36.8255997,942,501,27,1639
17412,12628,2492,3,Personal,5,2,48418,5,2,48480,5,2,49481,5,2,50054,5,2,50912,3,23.25888921888938,-1.2778447,36.8307214,-1.2869955,36.8202749,812,858,62,1574
17413,15273,535,3,Business,30,4,54693,30,4,54721,30,4,54916,30,4,58105,30,4,58173,17,23.25888921888938,-1.2615888,36.7928732,-1.2491258,36.6894253,576,68,28,3384
17414,25387,1568,3,Business,14,5,39202,14,5,39221,14,5,39737,14,5,40379,14,5,41418,7,24.4,-1.2897368,36.8226783,-1.2571472,36.7950633,726,1039,19,1158
17415,26477,1771,1,Personal,13,3,59711,13,3,62019,13,3,63154,13,3,63419,13,3,64221,4,22.0,-1.2418469,36.8880358,-1.2297202,36.8745508,851,802,2308,1400
17416,2993,60,3,Business,4,5,34805,4,5,34815,4,5,35152,4,5,38020,4,5,38496,6,17.3,-1.228911,36.881876,-1.22978,36.836215,445,476,10,3205
17417,1293,599,1,Personal,18,3,57539,18,3,57616,18,3,58093,18,3,59487,18,3,61349,4,20.5,-1.3005593,36.8359298,-1.3200277,36.8206816,939,1862,77,1871
17418,18437,3686,3,Business,26,2,55268,26,2,55317,26,2,55583,26,2,56031,26,2,56730,4,31.2,-1.2551895,36.7822034,-1.2617028,36.7983849,652,699,49,714
17419,18071,2066,3,Business,4,2,41850,4,2,41888,4,2,42440,4,2,42744,4,2,43902,12,19.0,-1.316961,36.820337,-1.2592947,36.7698085,88,1158,38,856
17420,4238,749,1,Personal,2,1,39339,2,1,39419,2,1,39535,2,1,39951,2,1,43215,5,19.1,-1.296613,36.819823,-1.2807268,36.7866659,726,3264,80,532
17421,24880,393,3,Business,14,5,36759,14,5,36769,14,5,36858,14,5,37677,14,5,39323,11,17.3,-1.3228003,36.8306435,-1.2638185,36.7930057,35,1646,10,908
17422,8596,3211,1,Personal,21,1,51959,21,1,53646,21,1,55393,21,1,55469,21,1,58472,5,21.8,-1.2844551,36.8251752,-1.2983462,36.8139996,844,3003,1687,1823
17423,9531,3283,3,Business,22,5,43955,22,5,44110,22,5,44657,22,5,45003,22,5,47487,7,28.3,-1.303596,36.778378,-1.2628473,36.781805,306,2484,155,893
17424,8048,2956,3,Business,25,5,37916,25,5,39400,25,5,39409,25,5,43680,25,5,46219,15,21.0,-1.3562374,36.9042954,-1.290894,36.822971,100,2539,1484,4280
17425,4718,2595,3,Personal,20,1,43236,20,1,43339,20,1,44288,20,1,44824,20,1,45535,10,20.4,-1.2656922,36.8136944,-1.2478187,36.8844611,207,711,103,1485
17426,1927,2150,3,Business,13,4,34127,13,4,34159,13,4,35704,13,4,36299,13,4,38583,22,18.4,-1.2296618,36.8438272,-1.344446,36.756597,427,2284,32,2140
17427,21069,1880,3,Business,9,4,44458,9,4,44494,9,4,44600,9,4,45727,9,4,47625,12,23.25888921888938,-1.2571472,36.7950633,-1.3167553,36.869485,925,1898,36,1233
17428,6437,1880,3,Business,8,2,44909,8,2,44972,8,2,45179,8,2,46322,8,2,48010,12,23.2,-1.2571472,36.7950633,-1.31553,36.863732,937,1688,63,1350
17429,15443,3647,3,Business,15,3,54990,15,3,55005,15,3,55618,15,3,56021,15,3,57893,10,25.8,-1.272639,36.794723,-1.3251584,36.8199384,576,1872,15,1016
17430,2612,3095,3,Personal,22,2,46654,22,2,46752,22,2,49983,22,2,51311,22,2,53464,12,25.6,-1.3294531,36.8614019,-1.30157,36.7871,520,2153,98,4559
17431,22731,393,3,Business,26,2,42871,26,2,42891,26,2,42897,26,2,43584,26,2,44010,4,26.0,-1.3167113,36.8301563,-1.3004062,36.829741,15,426,20,693
17432,8721,435,3,Business,7,5,40786,7,5,41123,7,5,42273,7,5,42900,7,5,44367,6,23.25888921888938,-1.2997385,36.8019529,-1.300921,36.828195,133,1467,337,1777
17433,17415,2277,3,Business,13,2,44899,13,2,45047,13,2,45347,13,2,46707,13,2,47890,8,22.1,-1.2389425,36.8775718,-1.2915328,36.8632896,237,1183,148,1660
17434,6770,3318,3,Business,24,3,34411,24,3,35309,24,3,35769,24,3,36014,24,3,39089,21,23.25888921888938,-1.4226525,36.9530825,-1.3004062,36.829741,498,3075,898,705
17435,25667,2523,3,Business,3,5,32657,3,5,32694,3,5,33509,3,5,33593,3,5,35382,9,23.25888921888938,-1.2551895,36.7822034,-1.3025667,36.7803495,876,1789,37,899
17436,4228,868,3,Business,13,4,38549,13,4,38549,13,4,39093,13,4,40447,13,4,40674,6,22.1,-1.307143,36.825009,-1.2663631,36.8163329,864,227,0,1898
17437,14854,3017,3,Business,7,5,66290,7,5,66379,7,5,66812,7,5,67170,7,5,68289,5,22.3,-1.2993231,36.7753372,-1.269974,36.7753728,86,1119,89,791
17438,10256,3635,3,Business,8,4,52791,8,4,52855,8,4,54300,8,4,54927,8,4,55206,2,27.3,-1.2615888,36.7928732,-1.2669099,36.7977433,881,279,64,2072
17439,7298,2330,3,Business,21,4,65380,21,4,65418,21,4,65846,21,4,65983,21,4,68169,7,23.25888921888938,-1.2642903,36.8002137,-1.2873232,36.7658572,354,2186,38,565
17440,19999,3355,3,Business,23,2,49214,23,2,49223,23,2,50033,23,2,50137,23,2,50709,2,19.1,-1.3052491,36.8223899,-1.2983805,36.8198439,612,572,9,914
17441,20266,142,3,Business,18,2,53795,18,2,55142,18,2,55601,18,2,56182,18,2,57316,3,25.8,-1.2963097,36.7688221,-1.3026886,36.752225,829,1134,1347,1040
17442,23089,1724,3,Business,25,4,34287,25,4,34405,25,4,35045,25,4,35138,25,4,36673,10,23.25888921888938,-1.3122786,36.8098477,-1.2551895,36.7822034,709,1535,118,733
17443,3340,2457,3,Business,26,5,58691,26,5,63529,26,5,64026,26,5,64461,26,5,65756,6,23.25888921888938,-1.2551895,36.7822034,-1.285763,36.82412,521,1295,4838,932
17444,1926,2190,3,Business,13,3,38417,13,3,38470,13,3,39281,13,3,40010,13,3,42542,13,23.25888921888938,-1.301953,36.788458,-1.3430735,36.7105064,332,2532,53,1540
17445,10835,265,3,Business,10,4,46760,10,4,47767,10,4,48445,10,4,49242,10,4,51044,12,25.1,-1.300921,36.828195,-1.2503017,36.8624317,237,1802,1007,1475
17446,15047,1705,3,Business,28,1,46676,28,1,46684,28,1,46910,28,1,47500,28,1,50964,28,23.5,-1.2551895,36.7822034,-1.1429062,36.9300994,623,3464,8,816
17447,9279,3560,3,Business,16,1,60650,16,1,60663,16,1,61776,16,1,62010,16,1,62671,2,23.25888921888938,-1.2812845,36.8327127,-1.279395,36.825364,670,661,13,1347
17448,27407,3264,3,Business,11,4,40233,11,4,40256,11,4,40473,11,4,40862,11,4,40895,3,25.8,-1.2551895,36.7822034,-1.2642665,36.7788286,698,33,23,606
17449,15814,3331,3,Business,7,1,36278,7,1,36328,7,1,37247,7,1,38520,7,1,41665,7,24.9,-1.2551895,36.7822034,-1.2897289,36.8271257,247,3145,50,2192
17450,15482,499,3,Personal,16,2,63355,16,2,63392,16,2,63980,16,2,64273,16,2,65976,11,25.3,-1.2652809,36.8080659,-1.3196809,36.8410572,648,1703,37,881
17451,3165,3080,3,Business,27,2,34798,27,2,35448,27,2,36109,27,2,36737,27,2,38456,15,18.7,-1.2551895,36.7822034,-1.3231725,36.8640177,81,1719,650,1289
17452,3626,2866,3,Business,5,1,58637,5,1,59370,5,1,59376,5,1,60186,5,1,60777,3,24.2,-1.2551895,36.7822034,-1.255081,36.802335,107,591,733,816
17453,25133,2308,3,Business,18,4,37525,18,4,37721,18,4,37743,18,4,39481,18,4,40788,10,25.3,-1.295324,36.839629,-1.2963097,36.7688221,179,1307,196,1760
17454,6289,1685,1,Personal,30,4,53769,30,4,53917,30,4,56140,30,4,56886,30,4,59331,5,20.8,-1.2802477,36.8141141,-1.2857671,36.7875614,268,2445,148,2969
17455,4890,3404,3,Business,21,5,56953,21,5,56974,21,5,58148,21,5,60122,21,5,60420,1,23.2,-1.2571472,36.7950633,-1.2584143,36.8048002,909,298,21,3148
17456,8212,627,3,Business,6,1,54916,6,1,54974,6,1,56038,6,1,56229,6,1,58567,18,23.25888921888938,-1.2551895,36.7822034,-1.3491472,36.7599788,770,2338,58,1255
17457,8786,1178,3,Business,19,1,53345,19,1,53491,19,1,54030,19,1,54331,19,1,55323,9,25.0,-1.2868515,36.7844247,-1.2401893,36.7961714,649,992,146,840
17458,6261,635,3,Business,5,5,51913,5,5,51959,5,5,52111,5,5,53461,5,5,54557,8,27.8,-1.300921,36.828195,-1.2602337,36.7990548,343,1096,46,1502
17459,1561,2700,3,Business,17,5,56296,17,5,56536,17,5,57161,17,5,57560,17,5,59027,10,20.3,-1.2343087,36.84749,-1.2845835,36.8079121,96,1467,240,1024
17460,6884,41,2,Personal,11,1,50168,11,1,51741,11,1,52696,11,1,53429,11,1,54454,5,23.4,-1.30004,36.83539,-1.2856827,36.8211379,844,1025,1573,1688
17461,16110,3647,3,Business,3,4,51054,3,4,51240,3,4,51705,3,4,51879,3,4,53041,8,26.0,-1.272639,36.794723,-1.2981102,36.8293513,434,1162,186,639
17462,18553,3686,3,Business,28,4,36968,28,4,36990,28,4,37932,28,4,38856,28,4,41936,22,27.9,-1.2551895,36.7822034,-1.333148,36.922453,26,3080,22,1866
17463,4929,2454,3,Business,18,4,56336,18,4,56348,18,4,57917,18,4,58721,18,4,63483,12,23.25888921888938,-1.2341294,36.8065148,-1.2941413,36.7958937,815,4762,12,2373
17464,6551,2509,3,Business,25,2,58777,25,2,58801,25,2,59125,25,2,59503,25,2,60761,8,27.2,-1.305399,36.8221849,-1.2571472,36.7950633,612,1258,24,702
17465,14529,1721,3,Business,30,2,44098,30,2,47264,30,2,47566,30,2,47866,30,2,48632,4,23.25888921888938,-1.2551895,36.7822034,-1.2744463,36.8132178,709,766,3166,602
17466,17765,3404,3,Business,2,5,51722,2,5,57153,2,5,57517,2,5,57577,2,5,59249,11,25.0,-1.279395,36.825364,-1.3104734,36.7363698,878,1672,5431,424
17467,10410,1179,3,Business,24,3,52143,24,3,53109,24,3,54521,24,3,54921,24,3,57691,21,18.5,-1.3700383,36.9190174,-1.2917868,36.7872675,675,2770,966,1812
17468,27358,1993,2,Personal,23,4,33496,23,4,33579,23,4,34543,23,4,34770,23,4,35671,5,15.7,-1.2900727,36.7890059,-1.2871938,36.8195031,425,901,83,1191
17469,9587,2763,3,Business,12,2,43937,12,2,43982,12,2,44441,12,2,44655,12,2,45488,8,24.3,-1.2551895,36.7822034,-1.2934638,36.7668028,345,833,45,673
17470,9548,2448,2,Personal,9,3,43901,9,3,43983,9,3,45031,9,3,45508,9,3,46619,4,21.3,-1.302922,36.816383,-1.2814031,36.8201647,207,1111,82,1525
17471,25349,3149,3,Business,7,2,41705,7,2,41716,7,2,41887,7,2,42311,7,2,44432,11,23.25888921888938,-1.3167113,36.8301563,-1.2520537,36.8300678,155,2121,11,595
17472,14087,3331,3,Business,16,4,57112,16,4,57149,16,4,57524,16,4,57637,16,4,58805,7,19.0,-1.2551895,36.7822034,-1.2941988,36.8148746,415,1168,37,488
17473,21057,1850,3,Business,3,3,36649,3,3,36723,3,3,37891,3,3,39510,3,3,39736,6,27.3,-1.3173869,36.8112044,-1.2816664,36.8226716,507,226,74,2787
17474,23144,3635,1,Business,11,4,38623,11,4,38632,11,4,39040,11,4,40191,11,4,42015,17,23.7,-1.2156006,36.8916865,-1.2615888,36.7928732,704,1824,9,1559
17475,10845,496,3,Business,27,1,39626,27,1,39649,27,1,39652,27,1,39998,27,1,40593,4,20.8,-1.2551895,36.7822034,-1.2662728,36.8151265,576,595,23,349
17476,4005,3555,2,Personal,11,4,53967,11,4,53988,11,4,54482,11,4,54985,11,4,55595,4,26.7,-1.2619538,36.8087637,-1.2587023,36.7898488,932,610,21,997
17477,14302,633,3,Business,19,2,56111,19,2,56401,19,2,57297,19,2,57593,19,2,58583,4,29.2,-1.2770708,36.8231093,-1.3004062,36.829741,448,990,290,1192
17478,17543,633,3,Business,26,1,40220,26,1,42681,26,1,42797,26,1,43277,26,1,44213,9,22.8,-1.2574219,36.7927073,-1.3004062,36.829741,878,936,2461,596
17479,16548,1642,3,Business,8,1,40269,8,1,40525,8,1,41103,8,1,41627,8,1,42645,5,27.9,-1.2728069,36.7962362,-1.288269,36.8182753,291,1018,256,1102
17480,10799,2502,2,Personal,27,5,49849,27,5,49854,27,5,50654,27,5,50943,27,5,51987,6,23.9,-1.2651218,36.8228765,-1.2559294,36.788465,754,1044,5,1089
17481,17114,248,3,Business,20,3,54820,20,3,54843,20,3,55340,20,3,55477,20,3,56701,10,28.5,-1.304735,36.7846054,-1.2656051,36.7826654,123,1224,23,634
17482,7876,1484,3,Business,2,5,39987,2,5,40068,2,5,40455,2,5,41115,2,5,43679,12,23.3,-1.2571472,36.7950633,-1.3083777,36.8590077,199,2564,81,1047
17483,959,3557,3,Business,18,4,46999,18,4,47096,18,4,47135,18,4,47661,18,4,48386,4,25.3,-1.2857524,36.8196806,-1.2546732,36.8086796,875,725,97,565
17484,21047,2116,3,Business,23,3,38482,23,3,38688,23,3,39962,23,3,42292,23,3,43678,15,23.25888921888938,-1.1896438,36.9126935,-1.2271998,36.8084905,857,1386,206,3604
17485,25005,2956,3,Business,13,1,44125,13,1,44160,13,1,44325,13,1,44524,13,1,45260,4,23.25888921888938,-1.2584143,36.8048002,-1.2635051,36.7829162,931,736,35,364
17486,4105,747,3,Personal,23,4,49227,23,4,49252,23,4,49643,23,4,49721,23,4,50090,3,20.7,-1.2925236,36.7795556,-1.2998882,36.7895711,64,369,25,469
17487,11736,3687,1,Personal,15,3,42338,15,3,43072,15,3,44116,15,3,44808,15,3,46313,10,18.1,-1.289498,36.818878,-1.3074581,36.7434,726,1505,734,1736
17488,5863,306,1,Personal,13,5,53180,13,5,53261,13,5,54373,13,5,54621,13,5,57350,11,19.2,-1.3157973,36.815148,-1.2473038,36.7884707,427,2729,81,1360
17489,11473,1471,3,Business,18,2,41978,18,2,41997,18,2,44305,18,2,45221,18,2,48704,23,23.25888921888938,-1.2551895,36.7822034,-1.3374736,36.9207076,222,3483,19,3224
17490,2613,2349,3,Business,27,1,34846,27,1,34932,27,1,35926,27,1,36286,27,1,37655,12,18.1,-1.2784229,36.791051,-1.311687,36.866857,438,1369,86,1354
17491,18415,3517,3,Business,28,2,56830,28,2,56856,28,2,56875,28,2,60027,28,2,60668,15,21.6,-1.300921,36.828195,-1.3882008,36.7699445,137,641,26,3171
17492,26893,1280,3,Business,3,4,40575,3,4,40589,3,4,42438,3,4,43460,3,4,46056,19,22.0,-1.2927792,36.9053492,-1.2551856,36.7822492,900,2596,14,2871
17493,7360,3641,3,Business,17,3,48672,17,3,48836,17,3,49570,17,3,49954,17,3,51314,12,28.3,-1.2551895,36.7822034,-1.3276043,36.836922,565,1360,164,1118
17494,3570,733,3,Business,1,5,62303,1,5,62380,1,5,63369,1,5,63771,1,5,66030,13,26.4,-1.2551895,36.7822034,-1.3257473,36.8592068,953,2259,77,1391
17495,3237,1346,3,Business,29,3,52310,29,3,52431,29,3,54098,29,3,54281,29,3,57789,20,21.3,-1.2917868,36.7872675,-1.3700383,36.9190174,177,3508,121,1850
17496,19604,302,3,Business,28,2,66665,28,2,66727,28,2,67748,28,2,68107,28,2,68204,2,18.0,-1.2649605,36.7981777,-1.2544458,36.7897277,40,97,62,1380
17497,17109,393,3,Business,28,2,32593,28,2,32637,28,2,34568,28,2,34972,28,2,37254,14,18.9,-1.3228003,36.8306435,-1.2991441,36.7528804,168,2282,44,2335
17498,13095,3255,1,Personal,28,5,38169,28,5,38472,28,5,39446,28,5,40103,28,5,41171,6,25.0,-1.2662974,36.836278,-1.273854,36.8003368,795,1068,303,1631
17499,27165,718,3,Business,6,4,57757,6,4,57793,6,4,58378,6,4,58526,6,4,62569,19,23.25888921888938,-1.2551895,36.7822034,-1.3325582,36.7406697,925,4043,36,733
17500,8863,3647,3,Business,28,3,43103,28,3,43146,28,3,43398,28,3,43868,28,3,44599,5,23.25888921888938,-1.2962618,36.7929334,-1.272639,36.794723,914,731,43,722
17501,22724,3283,3,Business,22,5,36415,22,5,36453,22,5,36725,22,5,37579,22,5,38472,5,16.3,-1.2600926,36.8088685,-1.2628473,36.781805,116,893,38,1126
17502,16855,868,3,Business,20,3,38273,20,3,38865,20,3,39507,20,3,40426,20,3,41088,10,20.3,-1.228911,36.881876,-1.265715,36.823815,222,662,592,1561
17503,18871,2044,1,Personal,13,7,53316,13,7,53408,13,7,54625,13,7,55133,13,7,55942,6,25.9,-1.2559556,36.7729094,-1.2517392,36.8249608,103,809,92,1725
17504,8460,3516,3,Business,3,1,34674,3,1,34721,3,1,35136,3,1,35338,3,1,36580,3,18.2,-1.3039706,36.7688174,-1.295908,36.791433,362,1242,47,617
17505,13805,393,3,Business,13,4,32172,13,4,36020,13,4,36031,13,4,38562,13,4,38565,4,21.8,-1.3167113,36.8301563,-1.3004062,36.829741,619,3,3848,2542
17506,1364,2330,3,Business,12,1,65540,12,1,65554,12,1,65637,12,1,66796,12,1,68493,9,24.0,-1.2642903,36.8002137,-1.3015197,36.7658456,45,1697,14,1242
17507,2596,3381,3,Business,19,1,35630,19,1,40877,19,1,42044,19,1,42708,19,1,43759,8,24.9,-1.255956,36.772901,-1.279662,36.814902,612,1051,5247,1831
17508,11283,2439,3,Business,20,3,50218,20,3,50594,20,3,51883,20,3,52530,20,3,53631,7,29.4,-1.2325706,36.8083923,-1.2534301,36.8000983,245,1101,376,1936
17509,58,2154,3,Business,16,2,47235,16,2,47256,16,2,48161,16,2,48739,16,2,50265,11,23.25888921888938,-1.2156006,36.8916865,-1.2765736,36.8513646,660,1526,21,1483
17510,12087,393,3,Business,2,6,44321,2,6,44330,2,6,44338,2,6,45851,2,6,45853,4,27.7,-1.3167113,36.8301563,-1.3004062,36.829741,10,2,9,1521
17511,19721,1075,3,Business,7,2,39519,7,2,39547,7,2,40184,7,2,41220,7,2,42387,5,23.25888921888938,-1.279395,36.825364,-1.2527958,36.8003131,341,1167,28,1673
17512,16961,3283,3,Business,11,2,46801,11,2,47983,11,2,48210,11,2,48553,11,2,52395,13,19.4,-1.2296618,36.8438272,-1.2628473,36.781805,456,3842,1182,570
17513,14831,63,2,Personal,18,5,46128,18,5,46219,18,5,46702,18,5,47628,18,5,49384,11,21.3,-1.3004846,36.7901591,-1.2477887,36.7960085,390,1756,91,1409
17514,3909,2908,3,Personal,17,5,55675,17,5,55707,17,5,56034,17,5,57020,17,5,58419,6,20.4,-1.2902869,36.8085396,-1.2929747,36.7646358,241,1399,32,1313
17515,27168,1687,3,Business,30,3,48796,30,3,48869,30,3,49083,30,3,49184,30,3,51023,7,29.0,-1.28164,36.816867,-1.3197323,36.8120386,85,1839,73,315
17516,2809,402,3,Business,27,1,46045,27,1,46084,27,1,46582,27,1,46650,27,1,47557,3,21.0,-1.2527958,36.8003131,-1.2551895,36.7822034,341,907,39,566
17517,7359,14,2,Personal,14,4,30348,14,4,31459,14,4,31850,14,4,32258,14,4,33455,3,15.7,-1.3154433,36.806386,-1.3070122,36.8287218,635,1197,1111,799
17518,20455,1205,3,Business,13,3,51012,13,3,51292,13,3,53192,13,3,53579,13,3,55411,10,27.0,-1.2586964,36.7750085,-1.2402231,36.7652808,936,1832,280,2287
17519,2347,1578,3,Business,6,3,45754,6,3,45797,6,3,46466,6,3,46783,6,3,49245,12,22.5,-1.2865597,36.8237743,-1.2859912,36.8756811,557,2462,43,986
17520,20383,3718,3,Business,9,2,53291,9,2,53302,9,2,53757,9,2,54177,9,2,54629,1,22.7,-1.2650027,36.8126242,-1.2675613,36.8133001,620,452,11,875
17521,10266,2457,3,Business,26,5,42275,26,5,46714,26,5,47230,26,5,47521,26,5,50549,7,23.25888921888938,-1.2551895,36.7822034,-1.289498,36.818878,849,3028,4439,807
17522,2287,2854,3,Business,6,3,55034,6,3,56494,6,3,57992,6,3,58200,6,3,59380,7,22.0,-1.2868868,36.8145777,-1.2963097,36.7688221,846,1180,1460,1706
17523,23925,3560,3,Business,5,5,35151,5,5,37160,5,5,37346,5,5,38189,5,5,38595,2,24.0,-1.2793686,36.8259233,-1.2848174,36.826163,648,406,2009,1029
17524,10019,1500,3,Business,22,5,42563,22,5,42773,22,5,45181,22,5,45319,22,5,46091,6,23.25888921888938,-1.2770708,36.8231093,-1.2638185,36.7930057,154,772,210,2546
17525,22360,1245,3,Business,31,5,35418,31,5,35950,31,5,36871,31,5,38025,31,5,40120,23,21.9,-1.300921,36.828195,-1.3434862,36.6895464,712,2095,532,2075
17526,17684,893,3,Business,24,3,43266,24,3,43920,24,3,44919,24,3,45439,24,3,46885,5,19.8,-1.2663194,36.809901,-1.2872899,36.820434,477,1446,654,1519
17527,28207,2423,3,Business,22,5,45372,22,5,45463,22,5,46553,22,5,46904,22,5,47753,8,23.25888921888938,-1.2551895,36.7822034,-1.2967702,36.8040381,205,849,91,1441
17528,24539,567,3,Business,27,4,56327,27,4,56400,27,4,56915,27,4,57587,27,4,58716,6,25.1,-1.2633494,36.7959696,-1.2963097,36.7688221,932,1129,73,1187
17529,26209,3647,3,Business,14,4,60256,14,4,60419,14,4,60977,14,4,61224,14,4,63839,4,26.2,-1.272639,36.794723,-1.2886303,36.8026947,953,2615,163,805
17530,5357,345,3,Business,6,3,38483,6,3,39133,6,3,40418,6,3,41034,6,3,43667,24,19.8,-1.3632162,36.9108253,-1.2579304,36.8019667,543,2633,650,1901
17531,19006,1329,3,Business,6,4,55319,6,4,55422,6,4,55920,6,4,56035,6,4,57222,13,21.3,-1.273056,36.811298,-1.2186819,36.892153,481,1187,103,613
17532,15064,3127,3,Business,7,5,68498,7,5,69097,7,5,70514,7,5,70865,7,5,71825,6,17.5,-1.3016281,36.8055215,-1.260997,36.8097857,19,960,599,1768
17533,7498,1329,3,Business,20,2,39224,20,2,46351,20,2,47709,20,2,47782,20,2,48909,7,19.9,-1.273056,36.811298,-1.3006167,36.792557,268,1127,7127,1431
17534,15139,1798,3,Business,29,4,48733,29,4,48782,29,4,49238,29,4,49563,29,4,50695,6,25.0,-1.2615888,36.7928732,-1.2860152,36.826003,330,1132,49,781
17535,26167,1927,3,Business,6,6,42078,6,6,42085,6,6,42115,6,6,43422,6,6,44655,12,24.1,-1.290894,36.822971,-1.3463042,36.768164,74,1233,7,1337
17536,20990,435,3,Business,22,3,40035,22,3,40092,22,3,40840,22,3,41296,22,3,44594,12,23.3,-1.2637139,36.7656548,-1.300921,36.828195,269,3298,57,1204
17537,26994,2454,3,Business,17,4,54905,17,4,55690,17,4,57079,17,4,57243,17,4,59616,10,28.0,-1.3264333,36.71071,-1.2993231,36.7753372,831,2373,785,1553
17538,22831,3635,1,Business,12,3,56403,12,3,56415,12,3,57433,12,3,58041,12,3,59822,13,26.7,-1.2095044,36.7832064,-1.2615888,36.7928732,307,1781,12,1626
17539,10138,3698,3,Business,7,5,44409,7,5,44437,7,5,44614,7,5,46104,7,5,47665,11,23.25888921888938,-1.2600932,36.8041689,-1.3108386,36.7555239,383,1561,28,1667
17540,20539,1329,3,Business,18,2,40706,18,2,41678,18,2,42545,18,2,43139,18,2,44096,4,23.25888921888938,-1.273056,36.811298,-1.2867132,36.8118433,101,957,972,1461
17541,2873,2871,1,Personal,10,5,32335,10,5,32353,10,5,32605,10,5,32893,10,5,33770,6,13.6,-1.2623805,36.7805404,-1.2772389,36.7855864,45,877,18,540
17542,12297,1460,1,Personal,4,4,26837,4,4,26869,4,4,28194,4,4,28634,4,4,32103,17,18.5,-1.200059,36.7665764,-1.285709,36.8219844,101,3469,32,1765
17543,16363,3560,3,Business,2,5,46404,2,5,47408,2,5,49284,2,5,49665,2,5,50615,2,24.9,-1.281754,36.8324229,-1.279395,36.825364,569,950,1004,2257
17544,11662,2793,1,Personal,20,4,52226,20,4,52239,20,4,52670,20,4,52869,20,4,53870,6,28.1,-1.2967108,36.7871135,-1.2866012,36.8195691,338,1001,13,630
17545,25897,3533,3,Business,29,2,40733,29,2,40769,29,2,41178,29,2,42143,29,2,44407,9,23.7,-1.2615888,36.7928732,-1.292188,36.764855,862,2264,36,1374
17546,7727,1620,3,Personal,3,3,45147,3,3,45249,3,3,46897,3,3,47574,3,3,48967,11,23.9,-1.261849,36.808254,-1.227132,36.8374277,328,1393,102,2325
17547,10345,3283,3,Business,21,4,50534,21,4,50599,21,4,51134,21,4,51358,21,4,52633,6,30.9,-1.272828,36.816608,-1.2628473,36.781805,498,1275,65,759
17548,25457,2700,3,Business,27,2,49522,27,2,49554,27,2,50209,27,2,50362,27,2,50654,3,25.8,-1.292943,36.808292,-1.295908,36.791433,322,292,32,808
17549,12316,2784,3,Business,11,1,50437,11,1,50974,11,1,52496,11,1,53906,11,1,55533,8,28.7,-1.277551,36.8273641,-1.2963097,36.7688221,448,1627,537,2932
17550,14534,3751,1,Personal,15,2,50484,15,2,50765,15,2,51177,15,2,51517,15,2,54043,7,24.3,-1.2819541,36.7888036,-1.273043,36.826355,102,2526,281,752
17551,13453,982,3,Business,7,4,38703,7,4,39563,7,4,40083,7,4,40531,7,4,44329,20,24.5,-1.2517871,36.6795716,-1.2547659,36.8236557,887,3798,860,968
17552,9988,3560,3,Business,7,4,36780,7,4,36870,7,4,37621,7,4,37873,7,4,38894,6,23.25888921888938,-1.2551895,36.7822034,-1.279395,36.825364,531,1021,90,1003
17553,6660,3496,3,Business,6,3,57471,6,3,57482,6,3,57525,6,3,57615,6,3,57622,2,22.0,-1.2903643,36.8319433,-1.300921,36.828195,927,7,11,133
17554,28,1840,1,Personal,13,3,60846,13,3,61521,13,3,61721,13,3,62494,13,3,64636,10,21.8,-1.255956,36.772901,-1.2988168,36.8198572,908,2142,675,973
17555,22645,2107,1,Personal,24,1,39412,24,1,39440,24,1,39674,24,1,40272,24,1,42067,8,22.7,-1.2972654,36.8330766,-1.2813481,36.7930933,848,1795,28,832
17556,9182,496,3,Business,25,1,27002,25,1,34629,25,1,34640,25,1,35556,25,1,36501,6,23.25888921888938,-1.2551895,36.7822034,-1.2864,36.8277,576,945,7627,927
17557,27958,496,3,Business,15,1,52904,15,1,52912,15,1,53316,15,1,53544,15,1,54830,13,23.25888921888938,-1.2551895,36.7822034,-1.3233955,36.8562944,96,1286,8,632
17558,5824,3201,3,Business,5,3,56215,5,3,56252,5,3,57695,5,3,58238,5,3,58700,3,25.1,-1.264272,36.7978791,-1.2551895,36.7822034,290,462,37,1986
17559,25206,2956,3,Business,13,3,44968,13,3,45003,13,3,45307,13,3,45587,13,3,46153,3,23.25888921888938,-1.2584143,36.8048002,-1.2551895,36.7822034,318,566,35,584
17560,24856,1687,3,Business,21,3,42987,21,3,43584,21,3,44131,21,3,44509,21,3,44866,1,21.9,-1.2962832,36.7849683,-1.2961952,36.7876396,31,357,597,925
17561,2557,2132,3,Business,29,1,36359,29,1,36373,29,1,39221,29,1,40159,29,1,43294,27,23.25888921888938,-1.2384056,36.8718698,-1.3858142,36.7641498,86,3135,14,3786
17562,7149,994,1,Personal,10,5,55897,10,5,56037,10,5,58483,10,5,59223,10,5,60745,9,21.6,-1.2854718,36.8712197,-1.286553,36.8273374,179,1522,140,3186
17563,22438,1926,3,Business,16,4,54696,16,4,54732,16,4,55901,16,4,57103,16,4,60798,13,23.25888921888938,-1.34364,36.8925345,-1.3050321,36.8843246,787,3695,36,2371
17564,10226,909,3,Business,27,1,55726,27,1,55797,27,1,56829,27,1,56986,27,1,58636,14,23.25888921888938,-1.225322,36.80855,-1.2413316,36.8785525,882,1650,71,1189
17565,14027,3643,1,Personal,4,6,47568,4,6,47606,4,6,48035,4,6,48335,4,6,50543,13,19.6,-1.2872344,36.7773949,-1.3333892,36.6923956,65,2208,38,729
17566,28012,1244,3,Business,6,6,54207,6,6,54215,6,6,54233,6,6,54355,6,6,56006,9,28.0,-1.2600926,36.8088685,-1.303596,36.778378,613,1651,8,140
17567,8136,3432,3,Business,10,3,57123,10,3,57196,10,3,58886,10,3,59375,10,3,59798,6,30.6,-1.3139898,36.8676986,-1.3299358,36.8524971,218,423,73,2179
17568,13265,2066,3,Business,16,2,57283,16,2,57333,16,2,57981,16,2,59850,16,2,62200,5,25.1,-1.316961,36.820337,-1.3007714,36.8001722,726,2350,50,2517
17569,11916,2066,3,Business,13,1,53389,13,1,53432,13,1,53707,13,1,53843,13,1,55828,9,23.25888921888938,-1.3210189,36.8410551,-1.2837549,36.8401382,233,1985,43,411
17570,65,721,2,Personal,6,5,62944,6,5,62960,6,5,63252,6,5,63636,6,5,64058,2,23.25888921888938,-1.2874192,36.7938634,-1.2979147,36.7857814,449,422,16,676
17571,14703,393,3,Business,31,3,35303,31,3,37476,31,3,38011,31,3,38914,31,3,39933,10,24.5,-1.3177547,36.8303703,-1.2574219,36.7927073,731,1019,2173,1438
17572,9186,2154,3,Business,13,4,54784,13,4,54816,13,4,55735,13,4,56011,13,4,57426,10,22.4,-1.2860183,36.8975338,-1.2765736,36.8513646,817,1415,32,1195
17573,1712,1329,3,Business,14,5,59973,14,5,60017,14,5,60473,14,5,60578,14,5,61056,3,23.1,-1.273056,36.811298,-1.2639556,36.7988094,925,478,44,561
17574,736,2112,3,Business,14,5,43544,14,5,43739,14,5,43988,14,5,46127,14,5,47225,14,24.5,-1.2927792,36.9053492,-1.2156006,36.8916865,408,1098,195,2388
17575,26482,2102,3,Business,29,2,58265,29,2,58301,29,2,59218,29,2,60773,29,2,62526,13,23.25888921888938,-1.2613768,36.8019418,-1.3323107,36.8692616,205,1753,36,2472
17576,13556,2523,3,Business,8,2,46169,8,2,46880,8,2,47370,8,2,48044,8,2,48992,5,21.5,-1.255956,36.789867,-1.269738,36.7965023,535,948,711,1164
17577,20560,496,3,Business,10,5,39823,10,5,39936,10,5,40366,10,5,40674,10,5,42911,7,23.25888921888938,-1.2551895,36.7822034,-1.2885417,36.8100523,411,2237,113,738
17578,26826,1287,3,Business,7,2,54298,7,2,54333,7,2,54423,7,2,54818,7,2,55309,3,23.25888921888938,-1.2581837,36.8017056,-1.2551895,36.7822034,520,491,35,485
17579,19724,3149,3,Business,26,6,33186,26,6,33195,26,6,33200,26,6,36593,26,6,37093,5,20.2,-1.3004062,36.829741,-1.3167113,36.8301563,15,500,9,3398
17580,18505,496,3,Business,26,3,43021,26,3,43039,26,3,43186,26,3,43459,26,3,47382,23,24.0,-1.2551895,36.7822034,-1.374163,36.913444,937,3923,18,420
17581,6183,3283,3,Business,28,4,38110,28,4,38188,28,4,39470,28,4,39998,28,4,41237,13,23.9,-1.2296618,36.8438272,-1.2628473,36.781805,590,1239,78,1810
17582,1245,867,3,Business,11,4,29242,11,4,29457,11,4,31178,11,4,33072,11,4,34663,10,22.1,-1.2996533,36.8292629,-1.2991441,36.7528804,206,1591,215,3615
17583,19859,3203,3,Business,21,4,34426,21,4,34467,21,4,35108,21,4,35864,21,4,36672,9,17.0,-1.265715,36.823815,-1.228911,36.881876,427,808,41,1397
17584,24094,1715,3,Business,30,1,48030,30,1,48051,30,1,48468,30,1,48882,30,1,51435,7,20.4,-1.2608993,36.799246,-1.300722,36.816865,882,2553,21,831
17585,796,2956,3,Business,3,5,56495,3,5,56687,3,5,58631,3,5,58779,3,5,60117,10,25.0,-1.2584143,36.8048002,-1.3014461,36.7661381,764,1338,192,2092
17586,1522,517,3,Business,6,4,31495,6,4,34981,6,4,36753,6,4,36929,6,4,39268,14,18.9,-1.3177547,36.8303703,-1.306378,36.7519845,523,2339,3486,1948
17587,27575,1769,2,Personal,6,4,49702,6,4,49728,6,4,49780,6,4,50891,6,4,53777,12,23.5,-1.2551895,36.7822034,-1.3223228,36.8532545,116,2886,26,1163
17588,7255,2200,3,Business,24,5,40693,24,5,40736,24,5,42729,24,5,44401,24,5,44409,17,21.6,-1.290894,36.822971,-1.3124537,36.925365,819,8,43,3665
17589,13243,1244,3,Business,8,2,44686,8,2,44704,8,2,44984,8,2,45887,8,2,46826,8,23.5,-1.272828,36.816608,-1.303596,36.778378,829,939,18,1183
17590,24875,3023,2,Personal,23,1,41723,23,1,41728,23,1,41875,23,1,42379,23,1,43426,7,18.4,-1.3010773,36.7752554,-1.2799394,36.8192374,88,1047,5,651
17591,24168,136,3,Business,22,5,57248,22,5,57457,22,5,57723,22,5,59726,22,5,59729,8,28.6,-1.2560874,36.7931031,-1.2965045,36.7913036,539,3,209,2269
17592,22049,237,3,Business,20,1,56436,20,1,56478,20,1,57360,20,1,60402,20,1,62575,10,23.25888921888938,-1.312942,36.8152651,-1.2551895,36.7822034,80,2173,42,3924
17593,5808,1604,3,Personal,3,5,64952,3,5,65081,3,5,66069,3,5,66608,3,5,68044,6,22.8,-1.2615584,36.8149506,-1.2670847,36.7858231,174,1436,129,1527
17594,23404,948,3,Business,28,2,36736,28,2,36774,28,2,37811,28,2,38114,28,2,38735,3,21.4,-1.2594474,36.8089122,-1.2662846,36.7970133,829,621,38,1340
17595,20315,112,2,Personal,10,4,65405,10,4,65634,10,4,67237,10,4,67478,10,4,70596,13,22.3,-1.3238699,36.8488766,-1.2827576,36.7830241,661,3118,229,1844
17596,18366,3355,3,Business,16,7,47956,16,7,48029,16,7,48790,16,7,49196,16,7,50230,7,24.2,-1.2584143,36.8048002,-1.3052491,36.8223899,725,1034,73,1167
17597,24337,2701,3,Business,4,4,39511,4,4,40519,4,4,40926,4,4,42324,4,4,42685,7,23.25888921888938,-1.2765736,36.8513646,-1.3218498,36.8615286,137,361,1008,1805
17598,12389,867,3,Business,8,1,40544,8,1,40556,8,1,40610,8,1,42410,8,1,43459,9,27.9,-1.2638185,36.7930057,-1.2991441,36.7528804,876,1049,12,1854
17599,23708,640,3,Business,14,5,35176,14,5,35207,14,5,36600,14,5,37034,14,5,37803,4,17.3,-1.304033,36.7848695,-1.2985749,36.8088,510,769,31,1827
17600,14899,633,3,Business,6,3,50733,6,3,50804,6,3,51566,6,3,52089,6,3,52815,5,27.5,-1.2770708,36.8231093,-1.3004062,36.829741,785,726,71,1285
17601,20289,246,3,Business,17,4,49702,17,4,49717,17,4,49867,17,4,50133,17,4,50860,2,28.0,-1.2527958,36.8003131,-1.2584143,36.8048002,194,727,15,416
17602,4066,2212,3,Business,8,3,40473,8,3,40514,8,3,40981,8,3,41277,8,3,43132,11,23.25888921888938,-1.2571472,36.7950633,-1.3151162,36.8569981,43,1855,41,763
17603,9019,2196,2,Personal,6,5,56051,6,5,56852,6,5,57434,6,5,58019,6,5,58734,5,22.6,-1.2668071,36.8068157,-1.2913246,36.8019522,905,715,801,1167
17604,13474,3291,3,Business,4,2,45041,4,2,45295,4,2,45321,4,2,47207,4,2,47869,4,19.4,-1.272828,36.816608,-1.2600926,36.8088685,598,662,254,1912
17605,27950,1500,3,Business,4,4,53936,4,4,53952,4,4,53972,4,4,54307,4,4,55841,9,27.3,-1.2638185,36.7930057,-1.2991441,36.7528804,349,1534,16,355
17606,9974,1405,3,Business,12,5,54503,12,5,54854,12,5,55684,12,5,56573,12,5,58388,16,26.9,-1.2805198,36.8277612,-1.3478563,36.8935824,74,1815,351,1719
17607,18955,186,3,Business,11,5,49902,11,5,49917,11,5,51028,11,5,51284,11,5,52578,14,26.2,-1.2571472,36.7950633,-1.2156006,36.8916865,512,1294,15,1367
17608,5798,2066,3,Business,13,1,42329,13,1,42329,13,1,42437,13,1,43080,13,1,44139,7,23.25888921888938,-1.3210189,36.8410551,-1.282451,36.8097806,205,1059,0,751
17609,20771,2987,3,Business,14,2,47158,14,2,47167,14,2,47171,14,2,48409,14,2,49592,10,21.7,-1.270212,36.8210877,-1.3280091,36.8524146,874,1183,9,1242
17610,20546,324,3,Personal,15,2,37839,15,2,37859,15,2,38421,15,2,38489,15,2,40026,15,24.5,-1.2653676,36.7911012,-1.332942,36.714065,85,1537,20,630
17611,5050,1146,3,Business,13,3,33375,13,3,33393,13,3,33397,13,3,34625,13,3,35488,7,17.1,-1.3167113,36.8301563,-1.3083266,36.8494756,111,863,18,1232
17612,15788,2330,3,Business,30,3,52570,30,3,52761,30,3,53842,30,3,54519,30,3,56710,12,29.1,-1.2326041,36.8009029,-1.2915247,36.8055757,513,2191,191,1758
17613,11905,3326,3,Business,6,4,50443,6,4,50462,6,4,50487,6,4,50941,6,4,51533,5,21.5,-1.2551895,36.7822034,-1.2658315,36.809049,168,592,19,479
17614,9012,1754,3,Business,10,4,47020,10,4,47117,10,4,47998,10,4,48220,10,4,50154,11,23.25888921888938,-1.312734,36.855414,-1.2860183,36.8975338,648,1934,97,1103
17615,11945,3239,3,Personal,6,4,39685,6,4,39765,6,4,42028,6,4,42691,6,4,43627,9,21.8,-1.2655332,36.8094648,-1.2969741,36.7856612,574,936,80,2926
17616,18620,3239,3,Personal,8,5,41780,8,5,41897,8,5,42127,8,5,43092,8,5,45219,10,23.25888921888938,-1.2839322,36.8292426,-1.3332749,36.8708147,846,2127,117,1195
17617,24306,1746,3,Business,23,3,34946,23,3,34960,23,3,35516,23,3,36774,23,3,38526,11,23.25888921888938,-1.3108783,36.8392726,-1.2975066,36.7689423,817,1752,14,1814
17618,2200,2271,3,Business,8,1,61230,8,1,61307,8,1,62196,8,1,63140,8,1,64629,11,28.8,-1.228911,36.881876,-1.293515,36.897607,8,1489,77,1833
17619,20067,2811,1,Personal,25,2,39305,25,2,39693,25,2,40607,25,2,41303,25,2,42034,4,23.8,-1.2848376,36.8027622,-1.284879,36.8245971,79,731,388,1610
17620,19356,1372,3,Business,9,3,29789,9,3,30384,9,3,30987,9,3,31332,9,3,32441,5,20.1,-1.2885417,36.8100523,-1.287428,36.7800821,62,1109,595,948
17621,10253,707,1,Personal,3,3,53438,3,3,53924,3,3,54589,3,3,54687,3,3,55864,5,26.7,-1.3018312,36.7817497,-1.2884799,36.8217918,847,1177,486,763
17622,18622,3521,3,Business,18,2,43996,18,2,44007,18,2,44545,18,2,45912,18,2,47198,9,22.7,-1.3201096,36.8180968,-1.2696908,36.81519,676,1286,11,1905
17623,21779,3147,3,Business,13,3,54632,13,3,54665,13,3,54891,13,3,55682,13,3,57540,17,27.4,-1.2859912,36.8756811,-1.3472066,36.7692638,890,1858,33,1017
17624,10443,3647,3,Business,7,2,57051,7,2,57099,7,2,57982,7,2,58248,7,2,62089,6,23.25888921888938,-1.272639,36.794723,-1.2976837,36.7663207,155,3841,48,1149
17625,19434,1131,3,Business,24,1,36545,24,1,36568,24,1,37540,24,1,40931,24,1,44365,15,22.4,-1.2644742,36.8083457,-1.2143387,36.7914548,101,3434,23,4363
17626,4308,1075,3,Business,23,6,36087,23,6,36244,23,6,36269,23,6,36677,23,6,37110,1,20.0,-1.2584143,36.8048002,-1.2527958,36.8003131,576,433,157,433
17627,2714,2195,3,Business,15,6,48336,15,6,48354,15,6,49100,15,6,49307,15,6,50051,6,21.4,-1.22978,36.836215,-1.228911,36.881876,8,744,18,953
17628,3905,633,3,Business,14,3,54790,14,3,56091,14,3,56800,14,3,57271,14,3,59349,12,25.5,-1.2991441,36.7528804,-1.3004062,36.829741,854,2078,1301,1180
17629,26296,2200,3,Business,27,1,45831,27,1,46262,27,1,46959,27,1,47379,27,1,49073,9,24.0,-1.3014461,36.7661381,-1.290894,36.822971,414,1694,431,1117
17630,1347,111,3,Business,14,1,35417,14,1,35539,14,1,36478,14,1,36596,14,1,38583,12,18.7,-1.255956,36.789867,-1.3093293,36.8499354,770,1987,122,1057
17631,24008,3032,3,Business,26,5,45606,26,5,45643,26,5,45881,26,5,46288,26,5,46596,2,23.25888921888938,-1.2571472,36.7950633,-1.2622145,36.8087391,578,308,37,645
17632,9499,186,3,Business,26,5,39998,26,5,40005,26,5,40158,26,5,40301,26,5,42175,23,23.25888921888938,-1.3700383,36.9190174,-1.2571472,36.7950633,62,1874,7,296
17633,26113,1500,3,Business,5,2,44041,5,2,44105,5,2,44673,5,2,46357,5,2,46444,8,25.4,-1.3004062,36.829741,-1.2638185,36.7930057,41,87,64,2252
17634,2404,2216,3,Business,31,3,46711,31,3,48196,31,3,48201,31,3,48707,31,3,49750,8,24.6,-1.2551895,36.7822034,-1.2859355,36.7843647,536,1043,1485,511
17635,4708,683,1,Personal,17,4,46064,17,4,46078,17,4,46209,17,4,49563,17,4,50642,12,23.7,-1.275931,36.8516227,-1.2105984,36.8109774,789,1079,14,3485
17636,797,2523,3,Business,26,5,51735,26,5,51813,26,5,52750,26,5,52930,26,5,54662,13,23.25888921888938,-1.2551895,36.7822034,-1.3024388,36.859699,675,1732,78,1117
17637,5830,2008,3,Business,24,5,55428,24,5,55536,24,5,57490,24,5,58296,24,5,59975,7,23.4,-1.2508229,36.7895263,-1.2798853,36.8327028,384,1679,108,2760
17638,17771,3351,2,Personal,20,5,47451,20,5,47483,20,5,47826,20,5,48246,20,5,49384,8,18.7,-1.286431,36.818411,-1.293554,36.763113,456,1138,32,763
17639,21820,2513,3,Personal,10,2,55705,10,2,55831,10,2,56899,10,2,57697,10,2,59041,5,21.3,-1.2787293,36.8256227,-1.2922364,36.7895538,268,1344,126,1866
17640,22480,60,3,Business,11,6,45373,11,6,45483,11,6,46249,11,6,47607,11,6,47609,8,23.25888921888938,-1.272828,36.816608,-1.2296618,36.8438272,953,2,110,2124
17641,15420,1550,3,Personal,20,4,31139,20,4,31189,20,4,31756,20,4,32429,20,4,33423,4,17.8,-1.280753,36.8191175,-1.2985749,36.8088,726,994,50,1240
17642,1784,2080,3,Personal,21,2,40304,21,2,40370,21,2,41004,21,2,41396,21,2,43027,9,22.6,-1.2948998,36.789164,-1.2554961,36.8020345,548,1631,66,1026
17643,629,2627,3,Business,7,5,39725,7,5,40014,7,5,42108,7,5,42232,7,5,43723,8,23.25888921888938,-1.2571472,36.7950633,-1.3090727,36.8315262,259,1491,289,2218
17644,18363,1246,3,Business,8,5,54181,8,5,54273,8,5,54886,8,5,55458,8,5,56285,8,27.1,-1.2571472,36.7950633,-1.3007534,36.7964576,62,827,92,1185
17645,824,3669,3,Business,25,1,36055,25,1,36062,25,1,36065,25,1,36345,25,1,38152,20,23.25888921888938,-1.2615888,36.7928732,-1.362319,36.743983,933,1807,7,283
17646,23692,1588,3,Business,23,5,59130,23,5,59359,23,5,59456,23,5,59934,23,5,60677,5,24.8,-1.269534,36.80697,-1.2551895,36.7822034,279,743,229,575
17647,21939,1280,3,Business,13,4,32875,13,4,32929,13,4,33825,13,4,34346,13,4,34704,3,18.5,-1.2551895,36.7822034,-1.2647688,36.775086,310,358,54,1417
17648,921,1410,3,Business,2,4,50767,2,4,50877,2,4,52628,2,4,54251,2,4,57567,20,23.25888921888938,-1.300921,36.828195,-1.2847613,36.967084,458,3316,110,3374
17649,22712,2198,1,Personal,20,4,46770,20,4,46812,20,4,48012,20,4,48105,20,4,53720,10,24.6,-1.26249,36.799715,-1.2916198,36.864443,38,5615,42,1293
17650,18076,2770,1,Personal,18,1,52233,18,1,52258,18,1,52495,18,1,52654,18,1,55502,9,17.1,-1.312469,36.815177,-1.2555718,36.8462247,676,2848,25,396
17651,725,146,3,Personal,28,5,44911,28,5,45240,28,5,46153,28,5,46505,28,5,48659,16,25.3,-1.326545,36.667483,-1.2985153,36.7876043,731,2154,329,1265
17652,4837,3647,3,Business,15,1,50830,15,1,50882,15,1,51293,15,1,51396,15,1,52552,8,23.25888921888938,-1.272639,36.794723,-1.2653185,36.8358841,434,1156,52,514
17653,23204,1209,3,Business,23,2,59169,23,2,59649,23,2,60018,23,2,60491,23,2,60985,4,23.25888921888938,-1.3077869,36.8443207,-1.3004062,36.829741,96,494,480,842
17654,11166,3599,3,Business,31,3,33442,31,3,34405,31,3,35364,31,3,37289,31,3,39720,15,19.2,-1.3302996,36.8707935,-1.2912772,36.7734495,712,2431,963,2884
17655,6716,1768,3,Personal,4,5,42161,4,5,42783,4,5,43559,4,5,44301,4,5,45007,3,17.4,-1.2750257,36.8157165,-1.2886923,36.8241519,206,706,622,1518
17656,12018,3547,3,Business,17,3,49521,17,3,49536,17,3,49545,17,3,51255,17,3,53185,21,23.25888921888938,-1.3285517,36.9018,-1.2761408,36.7710839,856,1930,15,1719
17657,25930,393,3,Business,8,5,36053,8,5,36110,8,5,36493,8,5,38114,8,5,38836,4,24.4,-1.3167113,36.8301563,-1.3004062,36.829741,206,722,57,2004
17658,4958,3283,3,Business,4,2,54138,4,2,54229,4,2,54272,4,2,55619,4,2,57601,14,22.6,-1.228911,36.881876,-1.2628473,36.781805,27,1982,91,1390
17659,1031,3698,3,Business,16,4,58693,16,4,58728,16,4,59181,16,4,59375,16,4,60623,15,23.25888921888938,-1.3244885,36.897792,-1.3188148,36.8092478,712,1248,35,647
17660,10373,1471,3,Business,13,3,48509,13,3,48563,13,3,48679,13,3,49302,13,3,50479,4,27.0,-1.2551895,36.7822034,-1.2618632,36.8100226,279,1177,54,739
17661,17286,136,3,Business,14,4,62697,14,4,63539,14,4,64093,14,4,64368,14,4,66839,17,21.3,-1.3326173,36.7146233,-1.3233496,36.8139159,101,2471,842,829
17662,19119,3507,3,Personal,20,4,42856,20,4,42882,20,4,43639,20,4,43847,20,4,44747,9,24.4,-1.2944628,36.7522739,-1.310792,36.821127,612,900,26,965
17663,24131,393,3,Business,11,1,51346,11,1,51440,11,1,51446,11,1,53722,11,1,53724,11,28.9,-1.3167113,36.8301563,-1.2638185,36.7930057,619,2,94,2282
17664,15786,383,3,Business,18,2,47174,18,2,47182,18,2,47599,18,2,48098,18,2,49147,10,23.25888921888938,-1.3749536,36.9200703,-1.3241819,36.8823428,647,1049,8,916
17665,18962,2175,3,Business,24,4,50461,24,4,50501,24,4,50523,24,4,50985,24,4,53869,19,28.5,-1.2551895,36.7822034,-1.2860183,36.8975338,651,2884,40,484
17666,11853,2739,1,Personal,20,1,62153,20,1,62197,20,1,62657,20,1,62935,20,1,65540,7,20.6,-1.2674274,36.7870827,-1.2615584,36.8149506,727,2605,44,738
17667,6221,412,3,Business,30,2,47180,30,2,48265,30,2,48588,30,2,49515,30,2,50384,3,23.25888921888938,-1.272828,36.816608,-1.266837,36.799249,461,869,1085,1250
17668,13733,2869,3,Business,24,3,30481,24,3,30811,24,3,35089,24,3,35728,24,3,38798,8,23.25888921888938,-1.3025826,36.7670807,-1.2688224,36.7944062,931,3070,330,4917
17669,8672,3573,1,Personal,25,2,41511,25,2,41645,25,2,42899,25,2,43059,25,2,45625,6,23.8,-1.2939186,36.8069693,-1.263194,36.797624,713,2566,134,1414
17670,13719,1329,3,Business,6,3,41776,6,3,41831,6,3,41871,6,3,42606,6,3,43664,5,23.25888921888938,-1.273056,36.811298,-1.2857671,36.7875614,373,1058,55,775
17671,26964,3560,3,Business,22,5,50582,22,5,50611,22,5,51683,22,5,53259,22,5,53894,8,27.4,-1.279395,36.825364,-1.2765492,36.7669809,156,635,29,2648
17672,23038,840,1,Personal,20,1,62048,20,1,62141,20,1,62951,20,1,63365,20,1,64439,3,20.3,-1.283527,36.8236512,-1.270054,36.815164,698,1074,93,1224
17673,6520,1243,1,Business,8,1,57266,8,1,57315,8,1,57642,8,1,58149,8,1,59461,10,24.9,-1.304524,36.775371,-1.2551895,36.7822034,754,1312,49,834
17674,11054,3698,3,Business,6,1,57493,6,1,57533,6,1,60801,6,1,61740,6,1,64274,26,23.25888921888938,-1.3244885,36.897792,-1.3108386,36.7555239,218,2534,40,4207
17675,18676,3550,1,Personal,14,4,41527,14,4,42082,14,4,42248,14,4,44249,14,4,46800,15,18.9,-1.2194351,36.8343591,-1.297721,36.7887912,340,2551,555,2167
17676,18544,2789,3,Business,31,4,34267,31,4,34291,31,4,34706,31,4,34928,31,4,36291,5,20.7,-1.304735,36.7846054,-1.2958383,36.8073162,468,1363,24,637
17677,9783,1410,3,Business,2,3,41387,2,3,42608,2,3,42898,2,3,48792,2,3,48800,21,23.6,-1.2847613,36.967084,-1.300921,36.828195,606,8,1221,6184
17678,3056,3560,3,Business,2,6,47935,2,6,48410,2,6,49798,2,6,50628,2,6,51497,11,31.1,-1.2283403,36.8822756,-1.279395,36.825364,812,869,475,2218
17679,6421,1787,3,Business,28,4,39414,28,4,40096,28,4,42050,28,4,42176,28,4,43277,10,28.0,-1.2285835,36.8826468,-1.2684319,36.8165853,711,1101,682,2080
17680,911,3517,3,Business,16,4,35728,16,4,35839,16,4,38310,16,4,39584,16,4,40663,14,14.6,-1.300921,36.828195,-1.3681253,36.9155298,179,1079,111,3745
17681,9738,633,3,Business,28,4,52899,28,4,52961,28,4,53164,28,4,53947,28,4,55651,12,30.2,-1.2991441,36.7528804,-1.3004062,36.829741,584,1704,62,986
17682,27160,2441,3,Business,11,5,46421,11,5,46441,11,5,47468,11,5,47564,11,5,48517,9,20.7,-1.255956,36.789867,-1.2720146,36.8278376,207,953,20,1123
17683,23671,2289,3,Business,11,5,59732,11,5,59904,11,5,60522,11,5,61305,11,5,61823,7,24.1,-1.2551895,36.7822034,-1.2936941,36.8156795,72,518,172,1401
17684,14592,2665,3,Business,13,2,55338,13,2,56010,13,2,57101,13,2,59093,13,2,59097,15,26.0,-1.3241728,36.7210093,-1.2603992,36.7878594,288,4,672,3083
17685,18733,517,3,Business,22,4,46231,22,4,46540,22,4,46550,22,4,47134,22,4,48967,10,22.8,-1.3177547,36.8303703,-1.2574219,36.7927073,619,1833,309,594
17686,16644,1280,1,Business,21,1,36952,21,1,36994,21,1,37739,21,1,40811,21,1,40975,18,20.0,-1.2626906,36.7827022,-1.2927979,36.89817,656,164,42,3817
17687,15363,1342,3,Business,27,5,31669,27,5,31703,27,5,32114,27,5,32317,27,5,33315,10,16.0,-1.2584143,36.8048002,-1.3025826,36.7670807,857,998,34,614
17688,20638,1959,1,Business,17,4,37710,17,4,38638,17,4,40845,17,4,41457,17,4,42900,13,22.6,-1.2141875,36.791039,-1.255956,36.789867,875,1443,928,2819
17689,4807,1482,3,Business,1,4,37483,1,4,37503,1,4,37581,1,4,38194,1,4,40714,20,23.25888921888938,-1.338579,36.8963038,-1.2482465,36.8889062,268,2520,20,691
17690,11876,478,3,Business,20,4,36262,20,4,36288,20,4,36549,20,4,37164,20,4,39256,15,18.7,-1.2551895,36.7822034,-1.3226302,36.8719901,870,2092,26,876
17691,8860,867,3,Business,23,6,32635,23,6,32672,23,6,32989,23,6,36778,23,6,37985,10,18.8,-1.3004062,36.829741,-1.2991441,36.7528804,284,1207,37,4106
17692,11088,60,3,Business,21,3,45584,21,3,48421,21,3,49429,21,3,49875,21,3,52439,15,23.3,-1.303596,36.778378,-1.2296618,36.8438272,596,2564,2837,1454
17693,18696,1657,1,Personal,14,5,43055,14,5,43098,14,5,43435,14,5,43973,14,5,44625,4,24.4,-1.2619756,36.800139,-1.26733,36.82368,263,652,43,875
17694,7802,2582,3,Business,18,4,47769,18,4,47782,18,4,47789,18,4,48905,18,4,50736,27,23.25888921888938,-1.2551895,36.7822034,-1.167619,36.969287,291,1831,13,1123
17695,9910,718,3,Business,13,1,51863,13,1,51874,13,1,51879,13,1,52193,13,1,53082,3,23.25888921888938,-1.2551895,36.7822034,-1.2669351,36.8058806,291,889,11,319
17696,7291,2987,3,Business,14,5,48016,14,5,48020,14,5,48066,14,5,48569,14,5,49775,12,24.4,-1.2297202,36.8819507,-1.2649605,36.7981777,584,1206,4,549
17697,9291,3222,3,Business,14,2,56390,14,2,56409,14,2,56434,14,2,56924,14,2,58271,12,23.25888921888938,-1.2551895,36.7822034,-1.3104734,36.7363698,291,1347,19,515
17698,13659,2587,3,Business,31,4,55749,31,4,55944,31,4,56369,31,4,56839,31,4,57996,5,28.8,-1.28878,36.8168312,-1.2922364,36.7895538,88,1157,195,895
17699,20418,391,3,Business,22,5,38102,22,5,38343,22,5,40481,22,5,40985,22,5,43094,5,23.25888921888938,-1.300921,36.828195,-1.2867454,36.8259017,448,2109,241,2642
17700,9263,3557,3,Business,19,2,58131,19,2,58205,19,2,58257,19,2,59763,19,2,60812,6,28.4,-1.293973,36.80169,-1.2546732,36.8086796,19,1049,74,1558
17701,3489,2044,3,Personal,14,6,62207,14,6,62228,14,6,63333,14,6,64371,14,6,65311,7,18.8,-1.2566629,36.7726397,-1.2517392,36.8249608,956,940,21,2143
17702,15942,2601,1,Personal,1,1,29671,1,1,29725,1,1,31433,1,1,31863,1,1,32293,3,18.6,-1.300334,36.7974957,-1.2963097,36.7688221,726,430,54,2138
17703,3355,2200,3,Business,25,1,40411,25,1,40572,25,1,41170,25,1,42600,25,1,43487,1,27.0,-1.2813012,36.8323962,-1.290894,36.822971,953,887,161,2028
17704,2392,2523,3,Business,11,1,45696,11,1,45710,11,1,45747,11,1,45910,11,1,47802,12,26.6,-1.2551895,36.7822034,-1.2404576,36.8683023,579,1892,14,200
17705,10692,3149,3,Business,16,6,36005,16,6,36045,16,6,36695,16,6,38328,16,6,39245,5,25.9,-1.3004062,36.829741,-1.3228003,36.8306435,448,917,40,2283
17706,21707,1329,3,Business,21,5,37000,21,5,37012,21,5,37186,21,5,37319,21,5,38129,5,19.3,-1.273056,36.811298,-1.2905055,36.778964,720,810,12,307
17707,13501,1271,3,Business,21,4,35113,21,4,35154,21,4,36086,21,4,36682,21,4,39608,15,21.7,-1.3244885,36.897792,-1.2864733,36.8239937,26,2926,41,1528
17708,10893,186,3,Business,27,2,40287,27,2,43019,27,2,43484,27,2,44878,27,2,45625,5,23.8,-1.2902869,36.8085396,-1.2571472,36.7950633,379,747,2732,1859
17709,10792,2646,2,Personal,9,1,50379,9,1,50453,9,1,50752,9,1,50852,9,1,52028,5,20.9,-1.273056,36.811298,-1.2858511,36.7946184,734,1176,74,399
17710,15975,2484,1,Business,7,4,55764,7,4,55771,7,4,56174,7,4,57786,7,4,59451,20,20.0,-1.2962832,36.7849683,-1.3700383,36.9190174,852,1665,7,2015
17711,25625,3571,3,Business,21,5,48831,21,5,48876,21,5,49728,21,5,50904,21,5,51215,2,27.1,-1.2337534,36.80858859,-1.238874,36.807889,882,311,45,2028
17712,9185,1976,3,Business,16,3,56452,16,3,56470,16,3,57066,16,3,57689,16,3,58304,6,26.9,-1.257028,36.7810435,-1.2690931,36.8065779,52,615,18,1219
17713,2251,1205,3,Business,15,2,33051,15,2,33332,15,2,33723,15,2,34253,15,2,35810,7,20.4,-1.257309,36.8060084,-1.2958383,36.8073162,101,1557,281,921
17714,8316,867,3,Business,9,2,52726,9,2,52748,9,2,52888,9,2,56043,9,2,56045,10,30.7,-1.3004062,36.829741,-1.2991441,36.7528804,206,2,22,3295
17715,28041,43,1,Personal,20,4,49840,20,4,49876,20,4,51174,20,4,51646,20,4,52425,4,27.9,-1.2816451,36.8145398,-1.2753109,36.8130185,336,779,36,1770
17716,24006,3354,3,Business,30,2,44085,30,2,44435,30,2,48255,30,2,49994,30,2,51347,3,23.25888921888938,-1.2571472,36.7950633,-1.2612111,36.7831516,547,1353,350,5559
17717,16753,393,3,Business,15,5,32250,15,5,32263,15,5,33326,15,5,34985,15,5,36567,14,19.4,-1.3167113,36.8301563,-1.306378,36.7519845,127,1582,13,2722
17718,23242,1329,3,Business,26,2,66658,26,2,66700,26,2,67101,26,2,67602,26,2,68873,6,29.4,-1.273056,36.811298,-1.288212,36.778334,907,1271,42,902
17719,1224,868,3,Business,21,2,32974,21,2,33057,21,2,33769,21,2,35600,21,2,36968,11,23.25888921888938,-1.3306113,36.8480521,-1.265715,36.823815,709,1368,83,2543
17720,1509,2217,1,Personal,5,5,42368,5,5,43611,5,5,44052,5,5,44272,5,5,45416,7,24.0,-1.2792316,36.8131524,-1.32589,36.831679,722,1144,1243,661
17721,4214,3688,3,Business,17,5,38454,17,5,38531,17,5,38814,17,5,39148,17,5,42094,15,23.25888921888938,-1.2551895,36.7822034,-1.320321,36.7195522,868,2946,77,617
17722,13746,1500,3,Business,26,5,36391,26,5,36469,26,5,36729,26,5,36829,26,5,38054,8,23.25888921888938,-1.2638185,36.7930057,-1.3018147,36.751816,119,1225,78,360
17723,6343,685,3,Business,26,5,54686,26,5,54793,26,5,55715,26,5,55917,26,5,56559,5,23.25888921888938,-1.2726506,36.7960153,-1.2876365,36.816096,291,642,107,1124
17724,11886,516,3,Business,2,4,46657,2,4,46709,2,4,46999,2,4,47125,2,4,50825,20,23.25888921888938,-1.2551895,36.7822034,-1.3195936,36.9161697,647,3700,52,416
17725,21022,2330,3,Business,29,2,51864,29,2,57513,29,2,59391,29,2,59619,29,2,63176,13,23.25888921888938,-1.2124582,36.802894,-1.293082,36.8278578,332,3557,5649,2106
17726,20419,2975,2,Personal,1,1,51176,1,1,51189,1,1,51460,1,1,51793,1,1,53047,12,25.7,-1.263964,36.7854632,-1.307241,36.8302368,905,1254,13,604
17727,1640,391,3,Business,10,3,53248,10,3,53632,10,3,55720,10,3,56074,10,3,59192,4,30.4,-1.2867454,36.8259017,-1.2760462,36.8074697,787,3118,384,2442
17728,12817,3283,3,Business,23,6,41929,23,6,41940,23,6,42087,23,6,42959,23,6,43480,5,26.5,-1.2600926,36.8088685,-1.2628473,36.781805,607,521,11,1019
17729,2193,111,3,Business,30,5,48322,30,5,48383,30,5,50424,30,5,50891,30,5,54088,13,24.8,-1.2551895,36.7822034,-1.3083777,36.8590077,279,3197,61,2508
17730,28130,2195,3,Business,12,5,36965,12,5,36999,12,5,37621,12,5,38736,12,5,39772,9,26.7,-1.265715,36.823815,-1.228911,36.881876,547,1036,34,1737
17731,13357,1976,3,Business,9,5,38118,9,5,38136,9,5,38815,9,5,38952,9,5,41614,23,25.5,-1.257028,36.7810435,-1.3103985,36.9114173,381,2662,18,816
17732,1681,1245,3,Business,23,3,36865,23,3,36901,23,3,37518,23,3,38773,23,3,40952,17,23.25888921888938,-1.300921,36.828195,-1.3204931,36.7043102,487,2179,36,1872
17733,19513,868,3,Business,28,1,42810,28,1,44889,28,1,45568,28,1,46253,28,1,47001,5,22.5,-1.2600926,36.8088685,-1.272828,36.816608,852,748,2079,1364
17734,16889,393,3,Business,15,3,57142,15,3,57200,15,3,57789,15,3,58394,15,3,60007,11,25.9,-1.3167113,36.8301563,-1.2638185,36.7930057,709,1613,58,1194
17735,26659,393,3,Business,21,4,39285,21,4,39571,21,4,39730,21,4,41431,21,4,41433,4,25.3,-1.3167113,36.8301563,-1.3004062,36.829741,39,2,286,1860
17736,24369,1399,3,Personal,3,5,50320,3,5,50369,3,5,50695,3,5,50895,3,5,51168,1,25.1,-1.2985032,36.7821448,-1.3043649,36.7816132,726,273,49,526
17737,23776,2987,3,Business,19,2,49562,19,2,49645,19,2,51120,19,2,51552,19,2,52207,4,18.3,-1.270212,36.8210877,-1.2649605,36.7981777,434,655,83,1907
17738,25813,516,3,Business,11,1,57316,11,1,57328,11,1,57592,11,1,57943,11,1,59568,9,28.1,-1.2551895,36.7822034,-1.2986123,36.8076281,925,1625,12,615
17739,18996,2000,3,Business,4,1,38828,4,1,40559,4,1,41070,4,1,41338,4,1,42191,7,26.5,-1.2551895,36.7822034,-1.2896399,36.8124498,71,853,1731,779
17740,21868,867,3,Business,10,3,30806,10,3,31060,10,3,32259,10,3,33042,10,3,35510,9,21.7,-1.2638185,36.7930057,-1.2991441,36.7528804,155,2468,254,1982
17741,24411,469,1,Personal,22,2,44930,22,2,44975,22,2,46403,22,2,47310,22,2,49106,13,19.2,-1.3264635,36.8883889,-1.3090663,36.8136865,895,1796,45,2335
17742,5407,706,3,Business,25,5,55341,25,5,55365,25,5,55884,25,5,56099,25,5,58328,15,29.4,-1.3077869,36.8443207,-1.3559093,36.9100452,436,2229,24,734
17743,18971,1927,3,Business,27,1,50935,27,1,51001,27,1,52187,27,1,53631,27,1,55384,17,23.0,-1.2859912,36.8756811,-1.3472066,36.7692638,126,1753,66,2630
17744,15946,2987,3,Business,24,3,43325,24,3,43432,24,3,43863,24,3,44033,24,3,44748,3,19.7,-1.2649605,36.7981777,-1.270212,36.8210877,107,715,107,601
17745,26049,393,3,Business,1,5,34086,1,5,34593,1,5,34598,1,5,38153,1,5,38174,14,26.6,-1.3167113,36.8301563,-1.306378,36.7519845,10,21,507,3560
17746,22806,3689,3,Business,19,1,43336,19,1,47652,19,1,48627,19,1,49057,19,1,49997,5,25.1,-1.2793686,36.8259233,-1.2527958,36.8003131,265,940,4316,1405
17747,21610,854,1,Personal,20,4,33384,20,4,33429,20,4,33439,20,4,34952,20,4,36302,14,17.8,-1.2209733,36.9045746,-1.2651643,36.8072214,886,1350,45,1523
17748,1385,2864,2,Personal,23,1,50041,23,1,50171,23,1,50673,23,1,51506,23,1,52817,6,23.25888921888938,-1.2892959,36.8378671,-1.3047132,36.8089553,844,1311,130,1335
17749,24832,2783,3,Personal,17,1,34863,17,1,34918,17,1,35696,17,1,35967,17,1,36731,4,19.1,-1.2983707,36.8008757,-1.2790232,36.7923526,375,764,55,1049
17750,15127,972,3,Business,23,5,47189,23,5,47610,23,5,48861,23,5,49103,23,5,50576,4,26.4,-1.2862033,36.8152966,-1.2768326,36.8073804,554,1473,421,1493
17751,9841,2330,3,Business,18,1,58016,18,1,58041,18,1,58241,18,1,58442,18,1,60145,9,30.6,-1.2642903,36.8002137,-1.3015197,36.7658456,952,1703,25,401
17752,14901,248,3,Business,10,3,32499,10,3,32559,10,3,33109,10,3,33643,10,3,34476,4,21.8,-1.2994772,36.804825,-1.304735,36.7846054,99,833,60,1084
17753,12217,958,3,Business,2,4,59842,2,4,59926,2,4,60728,2,4,61715,2,4,64103,18,23.25888921888938,-1.3323107,36.8692616,-1.2323371,36.864817,411,2388,84,1789
17754,16817,3493,1,Personal,7,4,47295,7,4,47750,7,4,48234,7,4,49103,7,4,51851,9,19.9,-1.3339461,36.8219129,-1.2994217,36.8009779,890,2748,455,1353
17755,5129,1469,3,Business,16,4,35538,16,4,35552,16,4,35963,16,4,36337,16,4,38260,11,23.25888921888938,-1.2551895,36.7822034,-1.2642197,36.7168247,649,1923,14,785
17756,28172,391,3,Business,25,6,31564,25,6,32541,25,6,35570,25,6,35892,25,6,39259,16,23.25888921888938,-1.3198615,36.7110323,-1.2867454,36.8259017,538,3367,977,3351
17757,17882,778,3,Business,15,1,27271,15,1,27376,15,1,27908,15,1,28055,15,1,29467,10,20.7,-1.2535486,36.7933541,-1.275931,36.8516227,107,1412,105,679
17758,2494,2330,3,Business,9,4,38715,9,4,38738,9,4,38905,9,4,40325,9,4,43719,1,23.25888921888938,-1.2642903,36.8002137,-1.2655213,36.8003795,76,3394,23,1587
17759,24397,2021,3,Business,2,2,44547,2,2,44568,2,2,44851,2,2,44970,2,2,45893,8,26.3,-1.29475,36.83421,-1.3263285,36.8926624,343,923,21,402
17760,6546,776,1,Personal,2,6,52324,2,6,52356,2,6,52370,2,6,53399,2,6,55011,8,23.9,-1.278967,36.8236745,-1.2907222,36.8843012,669,1612,32,1043
17761,15527,1559,2,Personal,27,4,50797,27,4,50819,27,4,51598,27,4,52364,27,4,54957,13,25.0,-1.3082357,36.8161482,-1.2287936,36.826979,532,2593,22,1545
17762,11564,2330,3,Business,9,4,51718,9,4,51771,9,4,52446,9,4,52789,9,4,54249,13,23.25888921888938,-1.2921463,36.8029626,-1.3192789,36.7112991,675,1460,53,1018
17763,17850,2089,3,Business,8,4,61526,8,4,62344,8,4,63775,8,4,65496,8,4,66550,12,25.6,-1.2213302,36.8494323,-1.2610722,36.8147074,200,1054,818,3152
17764,10156,868,3,Business,6,1,35022,6,1,35083,6,1,35103,6,1,36329,6,1,37260,7,23.25888921888938,-1.2628473,36.781805,-1.265715,36.823815,828,931,61,1246
17765,9617,1329,3,Business,24,5,56321,24,5,56758,24,5,57433,24,5,59015,24,5,59019,5,22.9,-1.273056,36.811298,-1.2871057,36.8226798,139,4,437,2257
17766,5377,20,3,Business,25,4,48112,25,4,48217,25,4,49455,25,4,49842,25,4,51513,5,21.0,-1.2877451,36.8157852,-1.2628638,36.8070399,662,1671,105,1625
17767,20436,2330,3,Business,28,2,55940,28,2,55978,28,2,56251,28,2,56792,28,2,58493,10,23.4,-1.2645318,36.7981775,-1.3015197,36.7658456,96,1701,38,814
17768,10215,3727,2,Business,12,4,42936,12,4,43069,12,4,44645,12,4,44729,12,4,47529,7,18.8,-1.2963097,36.7688221,-1.2875013,36.8171787,752,2800,133,1660
17769,14142,286,3,Business,7,5,40360,7,5,40382,7,5,40555,7,5,41252,7,5,45770,25,23.25888921888938,-1.2551895,36.7822034,-1.34364,36.8925345,564,4518,22,870
17770,15165,785,1,Personal,10,4,28928,10,4,31298,10,4,33984,10,4,34272,10,4,35676,9,18.5,-1.2592428,36.7894541,-1.3004846,36.7901591,101,1404,2370,2974
17771,16223,3647,3,Business,7,3,37516,7,3,37862,7,3,40694,7,3,40837,7,3,42319,7,25.0,-1.2549476,36.8269576,-1.272639,36.794723,685,1482,346,2975
17772,21532,2330,3,Business,19,2,59860,19,2,59944,19,2,60426,19,2,60660,19,2,62252,8,28.4,-1.3015197,36.7658456,-1.2649605,36.7981777,129,1592,84,716
17773,3890,517,3,Business,3,4,43908,3,4,43983,3,4,43987,3,4,44427,3,4,45310,7,23.3,-1.3167113,36.8301563,-1.3083266,36.8494756,619,883,75,444
17774,10920,3718,3,Business,4,4,54183,4,4,54411,4,4,54440,4,4,56070,4,4,56808,3,25.0,-1.2707373,36.805441,-1.2608074,36.828373,51,738,228,1659
17775,19458,893,3,Business,28,2,48048,28,2,48062,28,2,48079,28,2,50759,28,2,51980,9,23.4,-1.247957,36.879598,-1.2208123,36.8565261,669,1221,14,2697
17776,3181,1471,3,Business,7,3,40093,7,3,40159,7,3,40577,7,3,40644,7,3,41762,5,25.1,-1.2551895,36.7822034,-1.2677588,36.8169359,467,1118,66,485
17777,13820,3339,3,Business,22,5,44066,22,5,44095,22,5,44116,22,5,44358,22,5,44360,2,23.25888921888938,-1.2551895,36.7822034,-1.2566889,36.7930784,926,2,29,263
17778,5107,3468,1,Personal,10,2,52031,10,2,52221,10,2,53422,10,2,53716,10,2,55068,10,21.3,-1.3248575,36.8038345,-1.2764568,36.7939953,844,1352,190,1495
17779,17078,893,3,Business,22,3,41782,22,3,41824,22,3,43589,22,3,43975,22,3,44567,4,23.0,-1.2663194,36.809901,-1.2607622,36.8227608,484,592,42,2151
17780,18864,2340,2,Personal,13,3,33688,13,3,34149,13,3,36026,13,3,36594,13,3,38277,10,16.0,-1.2456774,36.7822414,-1.290059,36.7703475,755,1683,461,2445
17781,6031,1798,3,Business,16,5,53362,16,5,54335,16,5,55330,16,5,55472,16,5,57153,8,23.25888921888938,-1.2615888,36.7928732,-1.2882311,36.7943274,131,1681,973,1137
17782,6953,265,3,Business,4,6,32315,4,6,32329,4,6,32552,4,6,33672,4,6,34778,8,15.7,-1.2945798,36.7737755,-1.300921,36.828195,636,1106,14,1343
17783,10433,2562,1,Personal,21,6,58420,21,6,59446,21,6,60374,21,6,60637,21,6,61695,8,17.8,-1.2854718,36.8712197,-1.3299841,36.8466903,890,1058,1026,1191
17784,1704,706,3,Business,9,3,38271,9,3,38291,9,3,38307,9,3,39248,9,3,39810,4,25.3,-1.3004062,36.829741,-1.3077869,36.8443207,518,562,20,957
17785,7439,3698,3,Business,16,2,36358,16,2,36370,16,2,37308,16,2,38311,16,2,40921,28,23.25888921888938,-1.3244885,36.897792,-1.1506305,36.9643513,955,2610,12,1941
17786,20541,71,3,Business,19,1,62479,19,1,63011,19,1,63874,19,1,64980,19,1,65132,2,23.7,-1.2793686,36.8259233,-1.2891922,36.825189,237,152,532,1969
17787,6199,53,3,Business,26,6,36646,26,6,36713,26,6,36718,26,6,38247,26,6,38332,8,26.0,-1.3167113,36.8301563,-1.2770708,36.8231093,239,85,67,1534
17788,5161,391,3,Business,14,2,38208,14,2,38285,14,2,39307,14,2,40577,14,2,41487,11,23.25888921888938,-1.2867454,36.8259017,-1.2226661,36.8877816,291,910,77,2292
17789,9398,867,3,Business,1,5,53315,1,5,53339,1,5,53398,1,5,54063,1,5,55556,9,31.8,-1.2638185,36.7930057,-1.2991441,36.7528804,523,1493,24,724
17790,12832,2436,3,Business,18,4,51251,18,4,51301,18,4,51306,18,4,52025,18,4,53050,14,26.6,-1.2551895,36.7822034,-1.242902,36.870334,871,1025,50,724
17791,2161,3355,3,Business,10,4,58198,10,4,58756,10,4,60165,10,4,60763,10,4,63565,12,23.4,-1.2860183,36.8975338,-1.3052491,36.8223899,697,2802,558,2007
17792,17477,1995,3,Business,22,4,33207,22,4,41322,22,4,42639,22,4,42731,22,4,45741,7,22.6,-1.290894,36.822971,-1.2551895,36.7822034,928,3010,8115,1409
17793,26405,1932,1,Business,21,1,47526,21,1,47589,21,1,48278,21,1,48422,21,1,48748,2,19.8,-1.2867717,36.7735237,-1.2922857,36.7813274,334,326,63,833
17794,6205,3718,3,Business,11,2,42754,11,2,45834,11,2,46825,11,2,47271,11,2,48112,2,19.3,-1.2650027,36.8126242,-1.2684319,36.8165853,268,841,3080,1437
17795,26476,3599,3,Business,29,5,35742,29,5,35921,29,5,37445,29,5,39929,29,5,40614,5,26.8,-1.3302996,36.8707935,-1.3121275,36.8519202,675,685,179,4008
17796,17566,1346,3,Business,3,1,40569,3,1,40639,3,1,40653,3,1,43004,3,1,43007,20,21.3,-1.2917868,36.7872675,-1.3700383,36.9190174,855,3,70,2365
17797,23918,2174,3,Business,7,1,39275,7,1,39278,7,1,39291,7,1,41564,7,1,44361,33,24.8,-1.2482781,36.884092,-1.324878,36.7070285,12,2797,3,2286
17798,25533,3283,3,Business,11,4,44299,11,4,44326,11,4,44688,11,4,45511,11,4,47369,7,25.7,-1.303596,36.778378,-1.2628473,36.781805,154,1858,27,1185
17799,15983,2987,3,Business,30,1,42889,30,1,42899,30,1,42951,30,1,44085,30,1,44686,4,22.8,-1.270212,36.8210877,-1.260232,36.807334,408,601,10,1186
17800,19759,1402,3,Business,12,3,48977,12,3,49098,12,3,50643,12,3,51316,12,3,52704,6,21.1,-1.288924,36.831527,-1.2584143,36.8048002,36,1388,121,2218
17801,24901,830,3,Business,1,3,53949,1,3,53955,1,3,53963,1,3,55004,1,3,56087,7,24.1,-1.2584143,36.8048002,-1.271672,36.783604,777,1083,6,1049
17802,24818,3647,3,Business,24,3,55881,24,3,55928,24,3,56379,24,3,56722,24,3,59959,8,23.25888921888938,-1.272639,36.794723,-1.257537,36.843066,263,3237,47,794
17803,18866,2866,3,Business,3,4,49331,3,4,49355,3,4,49397,3,4,51321,3,4,52480,11,25.8,-1.322064,36.817157,-1.2551895,36.7822034,449,1159,24,1966
17804,2750,478,3,Business,8,5,47686,8,5,47927,8,5,48986,8,5,49302,8,5,51137,5,27.1,-1.2551895,36.7822034,-1.2760915,36.8081029,932,1835,241,1375
17805,13769,3689,3,Business,6,3,55165,6,3,55912,6,3,58170,6,3,58322,6,3,59114,3,21.6,-1.2601709,36.8002238,-1.2553615,36.7895376,881,792,747,2410
17806,25552,1589,3,Business,3,1,41568,3,1,41665,3,1,42003,3,1,42692,3,1,44376,14,21.3,-1.3014461,36.7661381,-1.225322,36.80855,205,1684,97,1027
17807,22041,2974,3,Business,27,2,33986,27,2,34828,27,2,35126,27,2,35741,27,2,37246,11,18.6,-1.287428,36.7800821,-1.3244268,36.8390322,379,1505,842,913
17808,10911,2614,1,Personal,17,5,59388,17,5,59406,17,5,59688,17,5,60130,17,5,60433,1,19.2,-1.26559,36.8027,-1.2750393,36.8151527,452,303,18,724
17809,27962,936,1,Personal,19,4,46246,19,4,46251,19,4,46256,19,4,47535,19,4,50595,14,20.4,-1.307376,36.813404,-1.2698168,36.7421898,248,3060,5,1284
17810,24604,1976,3,Business,2,4,35173,2,4,35188,2,4,35429,2,4,36111,2,4,37001,11,23.25888921888938,-1.257028,36.7810435,-1.264627,36.842259,828,890,15,923
17811,6741,3641,3,Business,15,2,56954,15,2,57180,15,2,57434,15,2,57689,15,2,59915,12,24.6,-1.2551895,36.7822034,-1.3276043,36.836922,131,2226,226,509
17812,3868,1368,3,Business,28,4,60251,28,4,60311,28,4,60337,28,4,61031,28,4,62088,5,25.5,-1.2571472,36.7950633,-1.2818812,36.8268142,330,1057,60,720
17813,462,2330,3,Business,19,2,42356,19,2,42371,19,2,43742,19,2,43827,19,2,45522,11,26.4,-1.2524916,36.8656196,-1.2642903,36.8002137,248,1695,15,1456
17814,27468,391,3,Business,20,1,33185,20,1,33259,20,1,35208,20,1,35591,20,1,37200,15,19.3,-1.3248898,36.8866867,-1.2867454,36.8259017,411,1609,74,2332
17815,10935,324,3,Personal,20,3,32867,20,3,32924,20,3,34246,20,3,34394,20,3,35795,9,23.25888921888938,-1.2823611,36.7354543,-1.332942,36.714065,205,1401,57,1470
17816,23757,1500,3,Business,10,5,37088,10,5,37101,10,5,37537,10,5,39190,10,5,40124,8,23.25888921888938,-1.3004062,36.829741,-1.2638185,36.7930057,843,934,13,2089
17817,24886,635,3,Business,13,1,36495,13,1,36508,13,1,37318,13,1,38532,13,1,40050,17,23.25888921888938,-1.177202,36.8351183,-1.2602337,36.7990548,712,1518,13,2024
17818,19768,1329,3,Business,30,2,38716,30,2,38772,30,2,39444,30,2,39675,30,2,40556,3,22.4,-1.273056,36.811298,-1.2767473,36.8095371,580,881,56,903
17819,28139,136,3,Business,5,2,35172,5,2,38254,5,2,38573,5,2,39190,5,2,39735,4,21.6,-1.3169591,36.7000029,-1.3326173,36.7146233,116,545,3082,936
17820,17065,3249,2,Personal,9,4,72816,9,4,72842,9,4,74063,9,4,74146,9,4,76006,20,18.6,-1.3168075,36.8626441,-1.2593592,36.7775322,874,1860,26,1304
17821,8662,328,1,Personal,25,5,43663,25,5,43753,25,5,44435,25,5,44905,25,5,46322,16,21.1,-1.2740396,36.7993518,-1.201875,36.8993137,517,1417,90,1152
17822,2449,3291,3,Business,8,5,39239,8,5,39269,8,5,39817,8,5,40273,8,5,41304,4,28.6,-1.272828,36.816608,-1.2600926,36.8088685,448,1031,30,1004
17823,19138,111,3,Business,26,2,51738,26,2,51757,26,2,51819,26,2,52052,26,2,56005,12,29.9,-1.2551895,36.7822034,-1.2987332,36.8463349,266,3953,19,295
17824,23846,2982,3,Business,9,3,36632,9,3,36668,9,3,37169,9,3,39232,9,3,41726,18,25.2,-1.300921,36.828195,-1.177202,36.8351183,114,2494,36,2564
17825,24216,3064,3,Business,8,5,53509,8,5,53528,8,5,53619,8,5,54158,8,5,56113,20,27.1,-1.2571472,36.7950633,-1.3700383,36.9190174,770,1955,19,630
17826,17868,708,3,Personal,1,5,48845,1,5,48904,1,5,49918,1,5,50116,1,5,51091,8,32.1,-1.2635051,36.7829162,-1.2969293,36.8027733,856,975,59,1212
17827,13080,3041,1,Personal,14,5,50120,14,5,50146,14,5,50594,14,5,51340,14,5,51839,4,27.2,-1.2550097,36.8045852,-1.2684239,36.7952462,56,499,26,1194
17828,850,393,3,Business,6,3,49031,6,3,49463,6,3,50000,6,3,50494,6,3,51599,11,27.6,-1.3167113,36.8301563,-1.2638185,36.7930057,330,1105,432,1031
17829,9698,867,3,Business,31,4,47348,31,4,47360,31,4,47368,31,4,47469,31,4,49079,15,26.4,-1.2991441,36.7528804,-1.3228003,36.8306435,518,1610,12,109
17830,13434,135,1,Personal,16,2,43324,16,2,43424,16,2,44945,16,2,45868,16,2,47704,7,23.6,-1.2912772,36.7734495,-1.2661264,36.8030359,565,1836,100,2444
17831,7738,2627,3,Business,24,4,51409,24,4,51420,24,4,51695,24,4,51868,24,4,52387,2,28.4,-1.2584143,36.8048002,-1.2571472,36.7950633,50,519,11,448
17832,13392,1304,3,Business,31,5,34613,31,5,34653,31,5,35012,31,5,35267,31,5,37186,8,23.25888921888938,-1.2551895,36.7822034,-1.3020973,36.8166312,161,1919,40,614
17833,8618,2923,1,Personal,11,3,33724,11,3,33791,11,3,37278,11,3,37849,11,3,40931,9,15.4,-1.2390407,36.7667702,-1.2549476,36.8269576,234,3082,67,4058
17834,22957,2271,3,Business,9,2,50737,9,2,50748,9,2,50965,9,2,52359,9,2,54632,12,30.8,-1.331619,36.847976,-1.293515,36.897607,306,2273,11,1611
17835,19367,375,3,Business,13,3,42815,13,3,42874,13,3,42988,13,3,43702,13,3,46045,9,23.25888921888938,-1.2551895,36.7822034,-1.3041129,36.8104939,154,2343,59,828
17836,22729,2030,3,Business,19,2,41681,19,2,41754,19,2,42648,19,2,43043,19,2,43681,3,27.4,-1.265715,36.823815,-1.2601197,36.7985271,484,638,73,1289
17837,2295,3434,1,Business,25,3,41464,25,3,47536,25,3,48200,25,3,50224,25,3,53300,30,17.8,-1.175952,36.9417,-1.2963097,36.7688221,848,3076,6072,2688
17838,21426,2330,3,Business,11,4,54809,11,4,55079,11,4,56712,11,4,56816,11,4,60673,17,26.9,-1.2854537,36.9051024,-1.2536275,36.7987932,697,3857,270,1737
17839,24491,393,3,Business,16,3,58994,16,3,59205,16,3,59210,16,3,59327,16,3,60340,4,27.2,-1.3167113,36.8301563,-1.3004062,36.829741,576,1013,211,122
17840,25557,2548,2,Business,10,3,38777,10,3,38802,10,3,38814,10,3,39744,10,3,40022,4,22.3,-1.2944266,36.787804,-1.2957616,36.7669835,865,278,25,942
17841,25983,120,1,Personal,8,2,52122,8,2,52187,8,2,53953,8,2,54072,8,2,56663,14,23.2,-1.2905033,36.8096462,-1.2927979,36.89817,654,2591,65,1885
17842,6851,393,3,Business,20,3,39325,20,3,39359,20,3,39383,20,3,40004,20,3,40602,4,26.5,-1.3167113,36.8301563,-1.3004062,36.829741,842,598,34,645
17843,9630,2587,3,Business,21,1,56110,21,1,56161,21,1,56188,21,1,57253,21,1,59156,7,27.6,-1.28878,36.8168312,-1.2551895,36.7822034,86,1903,51,1092
17844,791,3686,3,Business,9,5,56545,9,5,57877,9,5,58195,9,5,59569,9,5,60517,9,25.1,-1.2551895,36.7822034,-1.2899733,36.7908611,881,948,1332,1692
17845,12757,467,3,Business,14,2,44213,14,2,44241,14,2,44569,14,2,45480,14,2,45593,4,23.25888921888938,-1.304735,36.7846054,-1.2913246,36.8019522,678,113,28,1239
17846,9033,2777,3,Business,18,5,58121,18,5,58147,18,5,58377,18,5,58951,18,5,63574,15,27.0,-1.3024388,36.859699,-1.2551895,36.7822034,456,4623,26,804
17847,26833,635,3,Business,4,4,42041,4,4,42132,4,4,42135,4,4,44946,4,4,46005,10,25.7,-1.3079083,36.8270337,-1.2602337,36.7990548,293,1059,91,2814
17848,25283,3291,3,Business,28,4,36789,28,4,36799,28,4,36806,28,4,37957,28,4,39516,12,27.8,-1.331619,36.847976,-1.2600926,36.8088685,406,1559,10,1158
17849,17588,412,3,Business,13,5,47692,13,5,47699,13,5,48008,13,5,48465,13,5,49218,3,23.25888921888938,-1.272828,36.816608,-1.266837,36.799249,806,753,7,766
17850,11544,868,3,Business,23,2,47112,23,2,47261,23,2,47288,23,2,49106,23,2,49316,3,23.25888921888938,-1.2783849,36.8163445,-1.265715,36.823815,531,210,149,1845
17851,2966,2627,3,Business,5,5,51005,5,5,51190,5,5,51761,5,5,52111,5,5,53192,11,27.7,-1.2765736,36.8513646,-1.2571472,36.7950633,276,1081,185,921
17852,22402,1500,3,Business,28,4,39059,28,4,39071,28,4,39262,28,4,39572,28,4,41852,13,28.1,-1.2638185,36.7930057,-1.3228003,36.8306435,708,2280,12,501
17853,13761,1500,3,Business,5,2,34984,5,2,35044,5,2,35381,5,2,36341,5,2,37725,11,20.9,-1.3077869,36.8443207,-1.2638185,36.7930057,611,1384,60,1297
17854,10497,3517,3,Business,9,2,40952,9,2,41050,9,2,41838,9,2,42150,9,2,43919,19,26.9,-1.3211824,36.8683873,-1.3882008,36.7699445,715,1769,98,1100
17855,7024,426,3,Business,2,5,41161,2,5,41208,2,5,41547,2,5,42183,2,5,44331,18,23.7,-1.3323107,36.8692616,-1.2534952,36.7825215,130,2148,47,975
17856,16082,2409,3,Personal,8,3,56471,8,3,56576,8,3,57987,8,3,58321,8,3,59674,9,25.6,-1.2990731,36.8488058,-1.2775276,36.8140021,857,1353,105,1745
17857,7012,1544,3,Business,17,5,48932,17,5,48983,17,5,50583,17,5,50926,17,5,54611,18,23.25888921888938,-1.2538731,36.7850223,-1.1855066,36.8254646,198,3685,51,1943
17858,3774,3450,3,Business,10,1,58360,10,1,58380,10,1,58608,10,1,59027,10,1,61113,8,18.4,-1.2551895,36.7822034,-1.3044313,36.818504,591,2086,20,647
17859,2953,1927,3,Business,17,3,47084,17,3,47099,17,3,47569,17,3,47884,17,3,49841,18,25.5,-1.2859912,36.8756811,-1.3472066,36.7692638,620,1957,15,785
17860,4118,3647,3,Business,24,4,43430,24,4,43491,24,4,44270,24,4,44552,24,4,45691,6,24.6,-1.272639,36.794723,-1.3004846,36.7901591,269,1139,61,1061
17861,13164,3128,1,Personal,18,3,49432,18,3,50208,18,3,51071,18,3,51321,18,3,52536,6,20.6,-1.2604472,36.8365287,-1.2753109,36.8130185,212,1215,776,1113
17862,25384,3557,3,Business,15,5,55447,15,5,55546,15,5,56605,15,5,58862,15,5,60220,14,17.9,-1.207546,36.7913976,-1.2546732,36.8086796,99,1358,99,3316
17863,22201,2383,3,Business,22,4,29605,22,4,29639,22,4,30473,22,4,30649,22,4,31198,4,19.6,-1.2608993,36.799246,-1.273009,36.802807,536,549,34,1010
17864,4637,3352,3,Personal,21,4,33733,21,4,33745,21,4,34306,21,4,35163,21,4,36224,10,21.8,-1.2946939,36.8043582,-1.2533491,36.8615911,291,1061,12,1418
17865,20457,432,3,Business,24,5,29577,24,5,29640,24,5,30163,24,5,30423,24,5,31493,3,18.3,-1.3012008,36.764868,-1.2763494,36.7671783,826,1070,63,783
17866,21581,3688,3,Business,16,4,57847,16,4,57862,16,4,58256,16,4,58568,16,4,59293,4,19.1,-1.2551895,36.7822034,-1.2728058,36.8049903,882,725,15,706
17867,26390,3194,3,Business,17,1,53569,17,1,54146,17,1,54857,17,1,55139,17,1,56244,6,24.6,-1.3052491,36.8223899,-1.2854174,36.7951152,829,1105,577,993
17868,13624,1243,1,Business,4,2,51794,4,2,51833,4,2,52085,4,2,53626,4,2,54894,10,20.2,-1.304524,36.775371,-1.2551895,36.7822034,350,1268,39,1793
17869,8971,3222,3,Business,8,5,51561,8,5,51601,8,5,53365,8,5,53619,8,5,55915,4,27.1,-1.2551895,36.7822034,-1.2617028,36.7983849,913,2296,40,2018
17870,7663,1502,3,Business,11,2,47871,11,2,50861,11,2,51037,11,2,52548,11,2,55233,13,21.5,-1.215909,36.886056,-1.279395,36.825364,519,2685,2990,1687
17871,8749,3456,3,Personal,9,4,51029,9,4,51045,9,4,51195,9,4,51887,9,4,53870,8,25.9,-1.282357,36.782501,-1.311547,36.818749,722,1983,16,842
17872,9888,3291,3,Business,31,5,35522,31,5,35552,31,5,35726,31,5,36086,31,5,37322,11,23.25888921888938,-1.303596,36.778378,-1.2600926,36.8088685,176,1236,30,534
17873,26280,2523,3,Business,7,4,36978,7,4,37001,7,4,37119,7,4,37715,7,4,39881,7,19.2,-1.2551895,36.7822034,-1.2545163,36.8243717,854,2166,23,714
17874,1427,2066,3,Business,28,4,63841,28,4,63918,28,4,65272,28,4,65463,28,4,67528,9,28.0,-1.3210189,36.8410551,-1.2715686,36.8023526,328,2065,77,1545
17875,5527,3404,3,Business,5,3,51726,5,3,52110,5,3,53479,5,3,53810,5,3,56811,9,25.0,-1.279395,36.825364,-1.2413316,36.8785525,436,3001,384,1700
17876,7721,3602,3,Business,21,4,30982,21,4,31275,21,4,34599,21,4,34818,21,4,36714,10,19.0,-1.3023756,36.7949276,-1.3224102,36.8307207,452,1896,293,3543
17877,25066,3674,3,Business,19,3,37326,19,3,37353,19,3,39587,19,3,39825,19,3,40678,4,22.4,-1.2551895,36.7822034,-1.2707177,36.8009828,167,853,27,2472
17878,22734,536,3,Personal,6,1,36622,6,1,36646,6,1,36668,6,1,39272,6,1,41024,9,20.5,-1.23851,36.88478,-1.2176348,36.8495951,539,1752,24,2626
17879,21309,2069,3,Business,17,1,39722,17,1,39729,17,1,39736,17,1,40959,17,1,41218,9,23.9,-1.265715,36.823815,-1.228911,36.881876,137,259,7,1230
17880,8586,1939,2,Personal,3,5,35857,3,5,35953,3,5,36687,3,5,37295,3,5,37969,4,17.2,-1.2851847,36.8314086,-1.3019862,36.8277524,754,674,96,1342
17881,26481,374,2,Personal,16,3,35690,16,3,36312,16,3,36567,16,3,36729,16,3,37549,6,19.8,-1.2580979,36.7959844,-1.2900727,36.7890059,663,820,622,417
17882,13424,299,3,Business,14,5,60564,14,5,60598,14,5,63282,14,5,64160,14,5,64167,15,21.7,-1.2629666,36.8068369,-1.3465623,36.7677838,139,7,34,3562
17883,25229,1809,3,Business,8,1,41362,8,1,41384,8,1,41679,8,1,42395,8,1,43008,2,24.6,-1.2527958,36.8003131,-1.2646084,36.8028645,407,613,22,1011
17884,730,1986,3,Personal,7,4,44867,7,4,44926,7,4,46295,7,4,46537,7,4,48457,14,24.2,-1.2326041,36.8009029,-1.2980345,36.7921228,79,1920,59,1611
17885,25068,3517,3,Business,15,6,30624,15,6,30664,15,6,32650,15,6,37253,15,6,39025,15,17.6,-1.300921,36.828195,-1.3882008,36.7699445,208,1772,40,6589
17886,7977,1561,3,Business,8,5,42246,8,5,42289,8,5,43157,8,5,43519,8,5,45443,14,23.25888921888938,-1.328259,36.860975,-1.2615584,36.8149506,865,1924,43,1230
17887,4147,2330,3,Business,10,5,45289,10,5,45321,10,5,46288,10,5,46671,10,5,48257,18,23.25888921888938,-1.3443583,36.7571528,-1.2645318,36.7981775,267,1586,32,1350
17888,1038,2459,1,Personal,22,3,25846,22,3,25904,22,3,27917,22,3,28442,22,3,30750,21,15.3,-1.2082468,36.7691703,-1.3012173,36.8093987,875,2308,58,2538
17889,6710,1168,3,Personal,28,2,47425,28,2,47510,28,2,48267,28,2,48365,28,2,49445,7,21.5,-1.2813012,36.8323962,-1.3159197,36.8516724,812,1080,85,855
17890,16277,393,3,Business,18,5,46879,18,5,46898,18,5,47355,18,5,47762,18,5,49192,11,20.2,-1.3167113,36.8301563,-1.2574219,36.7927073,523,1430,19,864
17891,6202,2789,3,Business,8,2,52733,8,2,54476,8,2,55480,8,2,55981,8,2,57027,5,25.3,-1.2947777,36.8194497,-1.304735,36.7846054,819,1046,1743,1505
17892,24599,635,3,Business,24,4,54336,24,4,55920,24,4,56497,24,4,57428,24,4,58759,8,22.8,-1.3016417,36.8271679,-1.2599563,36.7993439,661,1331,1584,1508
17893,25778,3032,3,Business,15,2,48408,15,2,48419,15,2,49371,15,2,53088,15,2,54568,19,24.4,-1.2812821,36.8891847,-1.2579304,36.8019667,621,1480,11,4669
17894,12891,1500,3,Business,31,5,58317,31,5,58521,31,5,59082,31,5,59406,31,5,60982,8,24.9,-1.3004062,36.829741,-1.2638185,36.7930057,591,1576,204,885
17895,25631,3326,3,Business,21,4,34109,21,4,34133,21,4,34425,21,4,34687,21,4,37193,18,21.8,-1.2551895,36.7822034,-1.2198413,36.9054958,854,2506,24,554
17896,21956,3326,3,Business,28,4,51887,28,4,52017,28,4,54136,28,4,55439,28,4,57259,7,30.2,-1.2571472,36.7950633,-1.304344,36.812274,399,1820,130,3422
17897,21100,2069,3,Business,27,4,42829,27,4,42847,27,4,42854,27,4,43690,27,4,46106,12,23.0,-1.293515,36.897607,-1.228911,36.881876,900,2416,18,843
17898,8868,1410,3,Business,11,1,56370,11,1,56622,11,1,57217,11,1,58576,11,1,60873,27,29.0,-1.300921,36.828195,-1.15135,36.9566534,8,2297,252,1954
17899,24698,2643,3,Personal,24,4,43852,24,4,43860,24,4,44156,24,4,44228,24,4,45106,6,24.7,-1.2844516,36.8245932,-1.3008085,36.8356717,70,878,8,368
17900,26881,393,3,Business,22,5,29899,22,5,31545,22,5,31587,22,5,32498,22,5,33416,8,23.25888921888938,-1.3167113,36.8301563,-1.2770708,36.8231093,809,918,1646,953
17901,4625,53,3,Business,25,1,44973,25,1,45082,25,1,45147,25,1,46568,25,1,47681,5,25.5,-1.3004062,36.829741,-1.2770708,36.8231093,863,1113,109,1486
17902,19046,635,3,Business,22,5,45670,22,5,45819,22,5,46551,22,5,46801,22,5,47935,7,23.25888921888938,-1.300921,36.828195,-1.2599563,36.7993439,25,1134,149,982
17903,4695,2745,2,Personal,19,6,37557,19,6,37579,19,6,38275,19,6,39646,19,6,41099,5,21.5,-1.2738167,36.8157821,-1.2817856,36.7881009,338,1453,22,2067
17904,5496,972,3,Business,8,4,62889,8,4,64586,8,4,64948,8,4,65348,8,4,66119,6,25.6,-1.2862033,36.8152966,-1.2961968,36.7801894,510,771,1697,762
17905,21760,1719,3,Business,23,2,37081,23,2,37098,23,2,37345,23,2,37486,23,2,40402,16,23.25888921888938,-1.3039706,36.7688174,-1.23966,36.75258,831,2916,17,388
17906,8277,186,3,Business,3,5,43342,3,5,43389,3,5,43660,3,5,44463,3,5,46369,9,23.25888921888938,-1.2571472,36.7950633,-1.2326041,36.8009029,660,1906,47,1074
17907,14497,970,3,Business,13,3,26639,13,3,27461,13,3,29164,13,3,29371,13,3,30306,4,20.2,-1.2551895,36.7822034,-1.2525704,36.7955754,580,935,822,1910
17908,20343,1841,3,Business,7,2,34154,7,2,34163,7,2,35139,7,2,35488,7,2,36918,8,16.7,-1.2571472,36.7950633,-1.3007234,36.8053018,882,1430,9,1325
17909,22307,1205,3,Business,27,5,60565,27,5,60601,27,5,61181,27,5,61320,27,5,62286,8,17.8,-1.2810807,36.8144229,-1.2618539,36.7772405,857,966,36,719
17910,27848,868,3,Business,15,3,34777,15,3,36319,15,3,36767,15,3,37383,15,3,39556,17,23.25888921888938,-1.3181159,36.7101559,-1.265715,36.823815,326,2173,1542,1064
17911,2214,3091,3,Business,13,1,38086,13,1,38217,13,1,38845,13,1,40153,13,1,40550,2,23.25888921888938,-1.28878,36.8168312,-1.290894,36.822971,289,397,131,1936
17912,531,1271,3,Business,27,3,58807,27,3,58841,27,3,60005,27,3,60376,27,3,62274,12,27.5,-1.3107918,36.761794,-1.3287648,36.7445732,682,1898,34,1535
17913,15041,3557,3,Business,28,3,59275,28,3,59694,28,3,59735,28,3,60751,28,3,60755,4,23.3,-1.2546732,36.8086796,-1.2569503,36.7834728,848,4,419,1057
17914,27055,2423,3,Business,31,2,43668,31,2,43689,31,2,44453,31,2,46225,31,2,48343,6,18.6,-1.2571472,36.7950633,-1.300722,36.816865,844,2118,21,2536
17915,12287,1402,3,Business,31,5,39307,31,5,39426,31,5,40100,31,5,40574,31,5,41622,1,21.8,-1.290894,36.822971,-1.2813012,36.8323962,895,1048,119,1148
17916,28119,2100,3,Business,20,4,40732,20,4,46266,20,4,46949,20,4,47832,20,4,48783,5,24.5,-1.290894,36.822971,-1.2765736,36.8513646,532,951,5534,1566
17917,619,1058,1,Business,25,2,53982,25,2,53997,25,2,56042,25,2,56157,25,2,57389,16,27.1,-1.2251703,36.8904714,-1.2571472,36.7950633,498,1232,15,2160
17918,24382,1304,3,Business,17,5,56355,17,5,56385,17,5,56532,17,5,57066,17,5,57531,3,23.25888921888938,-1.2551895,36.7822034,-1.2707332,36.7970816,178,465,30,681
17919,27223,517,3,Business,29,2,54434,29,2,54901,29,2,54989,29,2,55788,29,2,56588,4,27.2,-1.3167113,36.8301563,-1.3004062,36.829741,515,800,467,887
17920,3648,778,3,Business,4,1,36535,4,1,36559,4,1,37493,4,1,37649,4,1,38567,7,21.7,-1.2535486,36.7933541,-1.2717174,36.7753883,103,918,24,1090
17921,15879,2956,3,Business,9,3,51399,9,3,51479,9,3,51872,9,3,52172,9,3,52193,2,23.5,-1.291768,36.8297208,-1.2820175,36.8223974,358,21,80,693
17922,8647,2886,3,Personal,15,6,49384,15,6,49406,15,6,50179,15,6,51175,15,6,51943,6,23.5,-1.280549,36.820641,-1.2637591,36.7903832,812,768,22,1769
17923,22967,302,3,Business,20,4,48696,20,4,48748,20,4,49019,20,4,49873,20,4,50482,5,27.8,-1.2649605,36.7981777,-1.2652741,36.8334395,906,609,52,1125
17924,26594,2317,1,Personal,23,3,51778,23,3,51798,23,3,52264,23,3,52505,23,3,54525,28,22.4,-1.3077027,36.8163543,-1.167619,36.969287,409,2020,20,707
17925,2981,2195,1,Business,3,3,34546,3,3,34622,3,3,34929,3,3,35546,3,3,36005,6,18.4,-1.307143,36.825009,-1.3313643,36.8577422,890,459,76,924
17926,15617,635,3,Business,30,4,46963,30,4,46999,30,4,47528,30,4,48466,30,4,50275,18,23.25888921888938,-1.3204931,36.7043102,-1.300921,36.828195,344,1809,36,1467
17927,15977,190,3,Business,16,1,54502,16,1,54810,16,1,55551,16,1,56177,16,1,56543,7,22.5,-1.3385185,36.8725654,-1.3270347,36.8667362,890,366,308,1367
17928,2190,1469,3,Business,30,2,62784,30,2,63241,30,2,64837,30,2,65034,30,2,65768,4,23.25888921888938,-1.2551895,36.7822034,-1.2737314,36.8072694,547,734,457,1793
17929,14068,1651,3,Business,6,5,45626,6,5,45669,6,5,45767,6,5,46348,6,5,47307,8,20.4,-1.2551895,36.7822034,-1.2965679,36.8158653,908,959,43,679
17930,13523,3686,3,Business,13,3,40824,13,3,40832,13,3,40854,13,3,41149,13,3,43185,11,25.0,-1.2551895,36.7822034,-1.3197323,36.8120386,751,2036,8,317
17931,19849,633,3,Business,26,2,50553,26,2,50568,26,2,50586,26,2,53586,26,2,53609,9,31.2,-1.2638185,36.7930057,-1.3004062,36.829741,669,23,15,3018
17932,2891,269,3,Business,23,2,54946,23,2,54998,23,2,56427,23,2,56808,23,2,59394,16,19.1,-1.3332749,36.8708147,-1.2551895,36.7822034,675,2586,52,1810
17933,14633,2982,3,Business,10,1,46836,10,1,47330,10,1,48851,10,1,50303,10,1,52869,18,18.9,-1.300921,36.828195,-1.177202,36.8351183,631,2566,494,2973
17934,635,3491,3,Business,24,1,55535,24,1,55647,24,1,55914,24,1,56262,24,1,57653,9,24.8,-1.2283403,36.8822756,-1.2741556,36.8693943,933,1391,112,615
17935,13030,2733,3,Business,19,2,36972,19,2,39384,19,2,41703,19,2,42067,19,2,43717,8,27.5,-1.2857521,36.8277457,-1.2963097,36.7688221,683,1650,2412,2683
17936,10139,1502,3,Business,6,1,35810,6,1,35846,6,1,39152,6,1,39993,6,1,40920,12,23.25888921888938,-1.28878,36.8168312,-1.2232123,36.8932547,341,927,36,4147
17937,24560,3560,3,Business,23,3,54113,23,3,57408,23,3,57417,23,3,58959,23,3,61536,12,27.2,-1.2860183,36.8975338,-1.279395,36.825364,828,2577,3295,1551
17938,27617,868,3,Business,13,1,40830,13,1,41187,13,1,44331,13,1,44909,13,1,46391,10,23.25888921888938,-1.228911,36.881876,-1.265715,36.823815,771,1482,357,3722
17939,701,3381,3,Business,31,3,36794,31,3,41170,31,3,41175,31,3,41725,31,3,42825,5,24.6,-1.3172551,36.8208701,-1.279662,36.814902,456,1100,4376,555
17940,2364,3669,3,Business,15,1,54302,15,1,54333,15,1,54437,15,1,55989,15,1,56005,4,23.25888921888938,-1.2551895,36.7822034,-1.2657464,36.7801144,436,16,31,1656
17941,27563,1195,3,Business,20,3,42607,20,3,42654,20,3,43196,20,3,43303,20,3,44174,5,27.3,-1.2983042,36.8261141,-1.3228003,36.8306435,206,871,47,649
17942,8276,1882,3,Business,3,1,65625,3,1,66383,3,1,67482,3,1,67834,3,1,69702,18,22.3,-1.2273427,36.7994683,-1.2160907,36.8851949,743,1868,758,1451
17943,20785,1245,3,Business,30,2,32907,30,2,32916,30,2,33382,30,2,34718,30,2,36252,19,23.25888921888938,-1.300921,36.828195,-1.3198615,36.7110323,595,1534,9,1802
17944,22474,3629,3,Personal,13,3,54648,13,3,54839,13,3,56086,13,3,56380,13,3,60197,3,27.1,-1.2857524,36.8196806,-1.2651643,36.8072214,452,3817,191,1541
17945,582,3727,3,Business,10,4,58511,10,4,58528,10,4,59432,10,4,59567,10,4,60134,3,23.3,-1.2963097,36.7688221,-1.293393,36.790237,862,567,17,1039
17946,18695,2906,2,Personal,27,4,38283,27,4,38292,27,4,38595,27,4,38890,27,4,39710,7,22.7,-1.2649605,36.7981777,-1.2979147,36.7857814,216,820,9,598
17947,10115,393,3,Business,7,2,51311,7,2,51401,7,2,51980,7,2,53056,7,2,53906,4,23.25888921888938,-1.3167113,36.8301563,-1.3004062,36.829741,206,850,90,1655
17948,8102,1384,3,Business,10,5,52712,10,5,52821,10,5,56259,10,5,56424,10,5,60063,19,23.25888921888938,-1.2517448,36.7924971,-1.1927453,36.8985941,580,3639,109,3603
17949,24816,2956,3,Business,19,2,55882,19,2,55928,19,2,56446,19,2,56834,19,2,57953,10,29.9,-1.2584143,36.8048002,-1.2413316,36.8785525,407,1119,46,906
17950,10941,2330,3,Business,21,2,41980,21,2,42006,21,2,42359,21,2,43347,21,2,44195,6,22.6,-1.2645318,36.7981775,-1.2464559,36.8169857,119,848,26,1341
17951,2389,2330,3,Business,10,5,64470,10,5,65984,10,5,67252,10,5,67423,10,5,69520,19,23.25888921888938,-1.1926151,36.9347904,-1.2671943,36.8062533,936,2097,1514,1439
17952,11263,2804,3,Business,15,1,50236,15,1,54341,15,1,54775,15,1,54929,15,1,56269,6,23.25888921888938,-1.2551895,36.7822034,-1.2825341,36.8190785,330,1340,4105,588
17953,5560,3283,3,Business,2,6,46604,2,6,46615,2,6,47202,2,6,47759,2,6,48648,5,27.3,-1.2600926,36.8088685,-1.2628473,36.781805,427,889,11,1144
17954,765,1148,3,Business,13,4,53812,13,4,53876,13,4,54508,13,4,56123,13,4,57991,15,22.3,-1.3100586,36.8500329,-1.2409761,36.7760062,676,1868,64,2247
17955,26805,972,3,Business,7,2,47395,7,2,47425,7,2,48164,7,2,48226,7,2,49435,4,23.0,-1.2862033,36.8152966,-1.2996681,36.8068413,674,1209,30,801
17956,7093,3203,3,Business,6,1,53425,6,1,53469,6,1,53745,6,1,54413,6,1,55558,9,24.8,-1.265715,36.823815,-1.228911,36.881876,427,1145,44,944
17957,18903,1154,3,Business,15,3,34785,15,3,34797,15,3,34849,15,3,35078,15,3,36686,13,23.25888921888938,-1.2917868,36.7872675,-1.332454,36.8835186,829,1608,12,281
17958,13628,2112,3,Business,10,4,39388,10,4,39414,10,4,39956,10,4,40063,10,4,41736,16,24.9,-1.2156006,36.8916865,-1.3285517,36.9018,685,1673,26,649
17959,13127,1329,3,Business,1,6,44789,1,6,44813,1,6,44974,1,6,47154,1,6,50218,21,22.1,-1.273056,36.811298,-1.2995252,36.6871615,704,3064,24,2341
17960,2872,2175,3,Business,29,3,52797,29,3,54351,29,3,55497,29,3,55938,29,3,57824,7,21.3,-1.2551895,36.7822034,-1.2857548,36.819062,624,1886,1554,1587
17961,2531,867,3,Business,31,3,40905,31,3,41046,31,3,42479,31,3,43079,31,3,44656,10,24.8,-1.2996533,36.8292629,-1.306378,36.7519845,532,1577,141,2033
17962,15581,3517,3,Business,1,1,34464,1,1,34505,1,1,36239,1,1,38189,1,1,40872,20,23.25888921888938,-1.3882008,36.7699445,-1.2964987,36.7741132,559,2683,41,3684
17963,12203,1787,3,Business,11,4,45320,11,4,45419,11,4,46776,11,4,49375,11,4,50486,11,26.5,-1.291768,36.8297208,-1.2297202,36.8819507,402,1111,99,3956
17964,21771,3439,3,Business,10,1,47599,10,1,47602,10,1,49521,10,1,49828,10,1,50578,5,18.3,-1.2393157,36.7668877,-1.2566689,36.7796952,689,750,3,2226
17965,4242,2956,3,Business,18,2,65055,18,2,65132,18,2,65944,18,2,66461,18,2,68640,16,23.8,-1.2584143,36.8048002,-1.2860183,36.8975338,932,2179,77,1329
17966,5154,510,3,Business,4,1,59264,4,1,59285,4,1,59995,4,1,60557,4,1,62227,12,27.5,-1.2283403,36.8822756,-1.2860183,36.8975338,925,1670,21,1272
17967,4619,1792,3,Business,21,3,35862,21,3,36585,21,3,37258,21,3,37344,21,3,38465,6,17.2,-1.2809121,36.7852524,-1.2619756,36.800139,114,1121,723,759
17968,13410,830,3,Business,1,4,45909,1,4,50081,1,4,50380,1,4,51890,1,4,51893,8,23.25888921888938,-1.2551895,36.7822034,-1.2904016,36.8226303,726,3,4172,1809
17969,25037,2423,3,Business,24,4,47301,24,4,47574,24,4,48016,24,4,48395,24,4,49542,8,24.7,-1.2551895,36.7822034,-1.3044313,36.818504,937,1147,273,821
17970,16619,1463,3,Personal,9,3,42692,9,3,42802,9,3,44226,9,3,44499,9,3,46009,7,25.5,-1.2931121,36.8224572,-1.2538731,36.7850223,534,1510,110,1697
17971,11634,3239,3,Personal,3,5,44701,3,5,44708,3,5,44875,3,5,45467,3,5,48399,22,21.2,-1.2836832,36.8306719,-1.3886344,36.9372718,414,2932,7,759
17972,25136,1927,3,Business,26,5,52031,26,5,52308,26,5,52735,26,5,53365,26,5,54680,1,23.25888921888938,-1.3463042,36.768164,-1.3387568,36.7534318,532,1315,277,1057
17973,2876,2792,3,Personal,16,3,51317,16,3,52718,16,3,53129,16,3,53495,16,3,55926,6,25.7,-1.3019137,36.7925105,-1.286937,36.8246742,352,2431,1401,777
17974,19746,2756,3,Business,6,1,62410,6,1,62549,6,1,64146,6,1,64228,6,1,65652,5,23.25888921888938,-1.2544051,36.7982934,-1.2814609,36.8265932,624,1424,139,1679
17975,19446,1552,1,Personal,29,6,50065,29,6,50214,29,6,50682,29,6,51060,29,6,51760,6,27.8,-1.2836832,36.8306719,-1.2668093,36.7966542,622,700,149,846
17976,6746,2102,3,Business,27,3,55777,27,3,55805,27,3,56422,27,3,56900,27,3,58770,13,29.2,-1.2613768,36.8019418,-1.3323107,36.8692616,411,1870,28,1095
17977,3063,2523,3,Business,16,4,33865,16,4,33944,16,4,34564,16,4,34961,16,4,36586,18,15.5,-1.2551895,36.7822034,-1.2198413,36.9054958,754,1625,79,1017
17978,9933,3647,3,Business,2,4,55898,2,4,55930,2,4,56895,2,4,57255,2,4,58140,3,23.25888921888938,-1.272639,36.794723,-1.274755,36.7906585,452,885,32,1325
17979,16730,1271,3,Business,20,2,62146,20,2,62244,20,2,64657,20,2,65755,20,2,68793,17,23.6,-1.3244885,36.897792,-1.212785,36.8904703,520,3038,98,3511
17980,3457,2523,3,Business,13,2,34922,13,2,35353,13,2,36183,13,2,36366,13,2,39948,10,19.9,-1.2551895,36.7822034,-1.3072605,36.8474457,829,3582,431,1013
17981,11391,2810,1,Personal,30,1,35703,30,1,35732,30,1,36617,30,1,37412,30,1,38844,8,16.3,-1.2549476,36.8269576,-1.2105984,36.8109774,427,1432,29,1680
17982,21824,635,3,Business,7,2,43598,7,2,43937,7,2,45134,7,2,46442,7,2,48313,8,23.25888921888938,-1.2602337,36.7990548,-1.22589,36.7822548,309,1871,339,2505
17983,16668,909,3,Business,10,3,35597,10,3,35610,10,3,35840,10,3,36168,10,3,40286,14,21.8,-1.225322,36.80855,-1.2486689,36.8748969,863,4118,13,558
17984,20922,3300,3,Business,7,5,31359,7,5,31446,7,5,31864,7,5,32565,7,5,34720,8,23.25888921888938,-1.265715,36.823815,-1.303596,36.778378,27,2155,87,1119
17985,25131,895,1,Personal,4,3,59615,4,3,60015,4,3,60759,4,3,63030,4,3,64057,4,23.25888921888938,-1.2917729,36.8097997,-1.3044313,36.818504,192,1027,400,3015
17986,13896,2066,3,Business,14,2,42027,14,2,42086,14,2,43555,14,2,43624,14,2,45007,5,21.7,-1.316961,36.820337,-1.3004846,36.7901591,234,1383,59,1538
17987,24711,3404,3,Business,22,6,37275,22,6,37566,22,6,38156,22,6,38475,22,6,40018,5,23.2,-1.2765736,36.8513646,-1.279395,36.825364,26,1543,291,909
17988,1414,393,3,Business,30,2,49116,30,2,49315,30,2,49636,30,2,50795,30,2,51340,4,23.25888921888938,-1.3167113,36.8301563,-1.3004062,36.829741,448,545,199,1480
17989,21347,223,1,Personal,8,1,49030,8,1,49066,8,1,49850,8,1,50074,8,1,51372,12,24.9,-1.2807298,36.8299116,-1.2155671,36.8898931,219,1298,36,1008
17990,3025,1326,1,Personal,27,3,37041,27,3,37051,27,3,37333,27,3,38857,27,3,40196,7,23.25888921888938,-1.2821211,36.8222021,-1.2551895,36.7822034,585,1339,10,1806
17991,25633,3647,3,Business,22,4,36293,22,4,37151,22,4,37693,22,4,37983,22,4,40398,7,22.6,-1.272639,36.794723,-1.29502,36.8086721,441,2415,858,832
17992,6352,136,3,Business,18,1,44412,18,1,44472,18,1,45044,18,1,45418,18,1,46420,11,27.9,-1.3254522,36.7216584,-1.2887613,36.7730538,72,1002,60,946
17993,23635,265,3,Business,13,4,39835,13,4,40866,13,4,41111,13,4,41872,13,4,42753,5,22.0,-1.2835586,36.8125641,-1.300921,36.828195,669,881,1031,1006
17994,20433,635,3,Business,26,2,51059,26,2,52614,26,2,53285,26,2,53578,26,2,55372,5,29.6,-1.2892669,36.8273814,-1.2602337,36.7990548,959,1794,1555,964
17995,20663,3521,3,Business,22,5,42456,22,5,42659,22,5,43894,22,5,44341,22,5,44913,3,28.3,-1.2533659,36.8142394,-1.2696908,36.81519,52,572,203,1682
17996,253,1568,3,Business,4,1,58622,4,1,58795,4,1,60151,4,1,61252,4,1,64300,13,26.2,-1.2897368,36.8226783,-1.2421591,36.8939721,26,3048,173,2457
17997,21466,1446,1,Personal,17,3,35673,17,3,35750,17,3,36296,17,3,36508,17,3,39707,17,20.9,-1.3688433,36.7402114,-1.276805,36.8291877,726,3199,77,758
17998,15659,1642,3,Business,3,3,40922,3,3,40964,3,3,43034,3,3,43520,3,3,45323,5,27.4,-1.288269,36.8182753,-1.2728069,36.7962362,760,1803,42,2556
17999,15361,1552,1,Personal,11,2,42615,11,2,42674,11,2,43848,11,2,44374,11,2,45263,12,24.4,-1.2668093,36.7966542,-1.2405791,36.8634291,857,889,59,1700
18000,18066,617,3,Personal,26,2,34695,26,2,43639,26,2,45468,26,2,45828,26,2,47511,7,23.25888921888938,-1.3222627,36.8234096,-1.2823301,36.8266816,752,1683,8944,2189
18001,18196,1363,3,Business,30,2,57772,30,2,58266,30,2,58629,30,2,58697,30,2,59350,6,23.25888921888938,-1.3004062,36.829741,-1.3228003,36.8306435,328,653,494,431
18002,18841,136,3,Business,12,3,46402,12,3,46644,12,3,48042,12,3,48389,12,3,50671,15,19.2,-1.2949455,36.8195238,-1.3254522,36.7216584,161,2282,242,1745
18003,9304,3045,1,Personal,18,6,51025,18,6,51048,18,6,51707,18,6,52355,18,6,53249,5,20.5,-1.2859116,36.8098035,-1.2735236,36.7992196,414,894,23,1307
18004,12434,1195,3,Business,18,6,42925,18,6,42978,18,6,42999,18,6,43843,18,6,45886,16,21.2,-1.3228003,36.8306435,-1.2811975,36.7446573,206,2043,53,865
18005,19625,510,3,Business,31,5,41321,31,5,41389,31,5,42496,31,5,42780,31,5,44743,18,21.5,-1.2860183,36.8975338,-1.2629594,36.8077626,377,1963,68,1391
18006,3771,3748,1,Personal,5,7,23742,5,7,25442,5,7,28809,5,7,29756,5,7,31783,20,15.6,-1.1917753,36.9211989,-1.2772632,36.7922251,836,2027,1700,4314
18007,3655,478,1,Business,25,3,43369,25,3,43392,25,3,43977,25,3,44521,25,3,45607,9,23.25888921888938,-1.2551895,36.7822034,-1.2985032,36.7808727,726,1086,23,1129
18008,28025,1154,3,Business,25,1,45329,25,1,45353,25,1,45379,25,1,46246,25,1,48432,20,27.0,-1.2917868,36.7872675,-1.3700383,36.9190174,942,2186,24,893
18009,20629,3291,3,Business,18,1,39797,18,1,40170,18,1,40435,18,1,41384,18,1,42326,8,28.0,-1.307143,36.825009,-1.2600926,36.8088685,675,942,373,1214
18010,27309,2530,1,Personal,22,2,60383,22,2,60855,22,2,61398,22,2,61822,22,2,62623,2,18.4,-1.2886366,36.8245436,-1.2990606,36.8033028,531,801,472,967
18011,28031,3717,2,Personal,10,1,55381,10,1,55490,10,1,56728,10,1,56932,10,1,57853,7,23.25888921888938,-1.2899639,36.803717,-1.3173869,36.8112044,148,921,109,1442
18012,6913,3599,3,Business,26,1,39490,26,1,40383,26,1,40897,26,1,44463,26,1,46804,15,22.9,-1.3302996,36.8707935,-1.2912772,36.7734495,937,2341,893,4080
18013,15801,3647,3,Business,25,4,56159,25,4,56349,25,4,57830,25,4,57907,25,4,60418,13,21.0,-1.272639,36.794723,-1.3228877,36.8460277,731,2511,190,1558
18014,15734,3647,3,Business,29,3,59109,29,3,59300,29,3,60505,29,3,61057,29,3,62054,4,20.9,-1.272639,36.794723,-1.2569503,36.7834728,158,997,191,1757
18015,10412,552,3,Business,26,2,35702,26,2,36446,26,2,37062,26,2,37691,26,2,40967,18,23.25888921888938,-1.290894,36.822971,-1.335477,36.9308297,905,3276,744,1245
18016,8657,418,1,Personal,23,3,46625,23,3,46731,23,3,46814,23,3,47379,23,3,50612,6,21.9,-1.304033,36.7848695,-1.2816234,36.8239846,79,3233,106,648
18017,14671,53,3,Business,11,4,37852,11,4,38704,11,4,39947,11,4,40297,11,4,41685,6,23.9,-1.2574219,36.7927073,-1.2770708,36.8231093,208,1388,852,1593
18018,26099,2956,3,Business,11,4,55638,11,4,55664,11,4,56423,11,4,56724,11,4,57137,1,27.2,-1.2571472,36.7950633,-1.2584143,36.8048002,658,413,26,1060
18019,16299,3450,3,Business,28,3,52284,28,3,52381,28,3,52955,28,3,53422,28,3,55689,14,23.25888921888938,-1.2551895,36.7822034,-1.3332749,36.8708147,65,2267,97,1041
18020,10505,391,3,Business,9,4,29975,9,4,30848,9,4,33067,9,4,34134,9,4,36821,5,23.25888921888938,-1.300921,36.828195,-1.2867454,36.8259017,106,2687,873,3286
18021,27925,3669,3,Business,11,4,57959,11,4,58916,11,4,59525,11,4,59917,11,4,63192,8,26.6,-1.2615888,36.7928732,-1.2922992,36.7983035,613,3275,957,1001
18022,10136,2942,3,Business,14,2,52916,14,2,53655,14,2,54837,14,2,55486,14,2,56303,5,24.2,-1.2614346,36.8283124,-1.298529,36.816482,427,817,739,1831
18023,3605,3647,3,Business,4,2,52156,4,2,52207,4,2,52966,4,2,53492,4,2,54276,5,23.6,-1.272639,36.794723,-1.262805,36.7942423,259,784,51,1285
18024,11019,3487,3,Business,3,5,36398,3,5,36486,3,5,36777,3,5,37003,3,5,37730,5,23.25888921888938,-1.2658424,36.8101804,-1.279395,36.825364,205,727,88,517
18025,18666,2869,3,Business,8,3,54528,8,3,54581,8,3,55393,8,3,55818,8,3,59196,3,23.25888921888938,-1.3025826,36.7670807,-1.2763494,36.7671783,211,3378,53,1237
18026,14487,3647,3,Business,11,1,50934,11,1,50962,11,1,51540,11,1,51923,11,1,56814,33,28.2,-1.272639,36.794723,-1.1105305,36.6461267,770,4891,28,961
18027,8021,868,3,Business,6,3,47325,6,3,47374,6,3,48333,6,3,48502,6,3,49339,8,23.25888921888938,-1.303596,36.778378,-1.265715,36.823815,920,837,49,1128
18028,5001,3557,3,Business,15,5,40339,15,5,40581,15,5,41373,15,5,41850,15,5,45082,7,25.7,-1.2546732,36.8086796,-1.2817763,36.7792738,709,3232,242,1269
18029,10572,517,3,Business,3,1,40866,3,1,40909,3,1,41325,3,1,41966,3,1,43113,11,21.4,-1.3228003,36.8306435,-1.2638185,36.7930057,155,1147,43,1057
18030,23106,419,3,Business,21,5,41523,21,5,41551,21,5,42439,21,5,42831,21,5,43506,3,22.7,-1.2571472,36.7950633,-1.2551895,36.7822034,866,675,28,1280
18031,15304,1865,1,Personal,28,5,32804,28,5,32947,28,5,34214,28,5,36138,28,5,37652,13,20.7,-1.2765689,36.8406151,-1.2166078,36.882501,895,1514,143,3191
18032,12655,517,3,Business,27,6,44867,27,6,44929,27,6,44933,27,6,47515,27,6,47530,14,23.25888921888938,-1.3167113,36.8301563,-1.2991441,36.7528804,39,15,62,2586
18033,25334,1245,3,Business,25,1,51020,25,1,51064,25,1,51102,25,1,52940,25,1,56398,17,28.1,-1.300921,36.828195,-1.3198615,36.7110323,239,3458,44,1876
18034,26536,60,3,Business,7,2,42308,7,2,42341,7,2,42460,7,2,42941,7,2,44514,15,23.2,-1.303596,36.778378,-1.2296618,36.8438272,517,1573,33,600
18035,1862,3194,3,Business,30,5,47397,30,5,47427,30,5,47476,30,5,49054,30,5,50235,8,24.7,-1.3052491,36.8223899,-1.2551895,36.7822034,19,1181,30,1627
18036,6622,1329,3,Business,6,4,53273,6,4,53483,6,4,53916,6,4,54942,6,4,56334,3,23.25888921888938,-1.273056,36.811298,-1.2657054,36.7930278,925,1392,210,1459
18037,6919,1425,3,Business,26,5,60715,26,5,60820,26,5,63330,26,5,63680,26,5,65044,10,23.25888921888938,-1.338283,36.8871775,-1.3004062,36.829741,68,1364,105,2860
18038,25803,1927,3,Business,14,5,62848,14,5,62910,14,5,63690,14,5,64498,14,5,65931,12,21.5,-1.290894,36.822971,-1.3472066,36.7692638,336,1433,62,1588
18039,6417,3264,3,Business,24,4,57696,24,4,57796,24,4,58228,24,4,59565,24,4,59569,8,26.2,-1.2551895,36.7822034,-1.2963316,36.7863289,322,4,100,1769
18040,11881,2358,4,Business,13,3,59603,13,3,59617,13,3,60956,13,3,61698,13,3,64129,20,22.1,-1.3256904,36.8747943,-1.2688521,36.8359672,192,2431,14,2081
18041,13305,2247,2,Personal,29,2,59033,29,2,59083,29,2,60019,29,2,60247,29,2,62669,21,22.2,-1.2846,36.7873609,-1.3664581,36.9177807,919,2422,50,1164
18042,20125,190,3,Business,29,1,58264,29,1,58331,29,1,59337,29,1,60201,29,1,61354,15,23.25888921888938,-1.3456714,36.9193692,-1.3270347,36.8667362,940,1153,67,1870
18043,6133,2763,3,Business,4,4,46745,4,4,46849,4,4,46853,4,4,48608,4,4,50053,8,25.5,-1.2551895,36.7822034,-1.2934638,36.7668028,508,1445,104,1759
18044,15012,3413,1,Personal,4,5,65765,4,5,65838,4,5,67758,4,5,69070,4,5,72725,15,22.4,-1.3112653,36.8269197,-1.2598589,36.7470168,948,3655,73,3232
18045,5730,627,3,Business,17,3,28059,17,3,28146,17,3,29381,17,3,30062,17,3,31253,7,23.25888921888938,-1.2551895,36.7822034,-1.2897399,36.8270975,155,1191,87,1916
18046,12068,2119,3,Personal,9,3,47025,9,3,47149,9,3,48270,9,3,49334,9,3,50755,3,23.5,-1.280572,36.826162,-1.2706041,36.8303142,101,1421,124,2185
18047,5258,3149,3,Business,6,4,40513,6,4,40636,6,4,40656,6,4,42190,6,4,42617,6,19.8,-1.3004062,36.829741,-1.3167113,36.8301563,2,427,123,1554
18048,15597,1207,3,Business,10,6,37705,10,6,37730,10,6,38109,10,6,38269,10,6,39217,8,23.7,-1.2628638,36.8070399,-1.2745321,36.765088,453,948,25,539
18049,11990,2271,3,Business,15,6,60436,15,6,60591,15,6,61050,15,6,62414,15,6,64540,11,20.8,-1.228911,36.881876,-1.293515,36.897607,75,2126,155,1823
18050,4773,2412,3,Business,21,4,44722,21,4,44803,21,4,46341,21,4,46415,21,4,47462,11,25.4,-1.2843634,36.8279416,-1.2285835,36.8826468,411,1047,81,1612
18051,12092,1719,3,Business,8,2,36221,8,2,36231,8,2,37128,8,2,37649,8,2,39801,15,18.8,-1.2330694,36.745451,-1.296797,36.7764525,442,2152,10,1418
18052,5739,2982,3,Business,4,1,44371,4,1,44389,4,1,45746,4,1,46795,4,1,48860,18,25.6,-1.300921,36.828195,-1.177202,36.8351183,715,2065,18,2406
18053,893,3621,3,Business,9,4,31581,9,4,31627,9,4,32060,9,4,32167,9,4,36589,11,23.25888921888938,-1.2836583,36.7886014,-1.320321,36.7195522,99,4422,46,540
18054,18435,2423,3,Business,22,5,47909,22,5,48012,22,5,48199,22,5,48765,22,5,50101,9,31.1,-1.2551895,36.7822034,-1.2940713,36.7890758,177,1336,103,753
18055,12500,970,3,Business,2,2,55221,2,2,55239,2,2,55742,2,2,55954,2,2,57299,8,26.0,-1.2551895,36.7822034,-1.2925919,36.8170577,43,1345,18,715
18056,21654,510,3,Business,9,5,63724,9,5,63733,9,5,64089,9,5,64163,9,5,65374,6,24.8,-1.2860183,36.8975338,-1.3195936,36.9161697,675,1211,9,430
18057,6584,2190,3,Business,20,1,27009,20,1,27039,20,1,28456,20,1,29291,20,1,31769,16,14.3,-1.301953,36.788458,-1.206696,36.847709,478,2478,30,2252
18058,24951,3647,3,Business,24,4,49018,24,4,49058,24,4,49861,24,4,50098,24,4,50897,6,28.3,-1.272639,36.794723,-1.2628638,36.8070399,228,799,40,1040
18059,26310,1500,3,Business,15,2,56724,15,2,56743,15,2,56836,15,2,57243,15,2,59645,12,24.4,-1.2574219,36.7927073,-1.32256,36.8396386,931,2402,19,500
18060,25848,788,3,Business,8,2,43016,8,2,43083,8,2,43728,8,2,44272,8,2,44750,9,23.5,-1.2551895,36.7822034,-1.225322,36.80855,501,478,67,1189
18061,19669,59,3,Business,16,2,59304,16,2,59386,16,2,60610,16,2,60919,16,2,62693,5,23.25888921888938,-1.290894,36.822971,-1.2944842,36.8011625,583,1774,82,1533
18062,837,391,3,Business,27,6,36830,27,6,42887,27,6,43287,27,6,43553,27,6,44187,5,23.25888921888938,-1.2777924,36.8231577,-1.3016417,36.8271679,237,634,6057,666
18063,7003,20,3,Business,9,3,41009,9,3,41041,9,3,41370,9,3,41600,9,3,42520,8,21.0,-1.2629666,36.8068369,-1.3090533,36.8371502,100,920,32,559
18064,22119,868,3,Business,25,1,55296,25,1,55328,25,1,55396,25,1,57983,25,1,58672,5,28.0,-1.2600926,36.8088685,-1.265715,36.823815,332,689,32,2655
18065,20662,6,3,Personal,29,3,39494,29,3,39718,29,3,40539,29,3,40844,29,3,42336,10,18.4,-1.322759,36.844804,-1.2668734,36.8054026,74,1492,224,1126
18066,3898,3711,3,Business,7,1,40408,7,1,40419,7,1,40436,7,1,40902,7,1,41775,9,25.0,-1.2551895,36.7822034,-1.3012008,36.764868,89,873,11,483
18067,8118,1926,3,Business,24,3,51640,24,3,51721,24,3,53643,24,3,55423,24,3,58373,16,18.4,-1.3332749,36.8708147,-1.2571472,36.7950633,520,2950,81,3702
18068,1703,1543,1,Personal,25,1,52793,25,1,52908,25,1,54767,25,1,55017,25,1,56239,3,23.25888921888938,-1.26559,36.8027,-1.2678872,36.7944356,379,1222,115,2109
18069,1549,3192,2,Personal,11,4,55155,11,4,55720,11,4,55995,11,4,56892,11,4,58773,6,26.5,-1.2658315,36.809049,-1.2965824,36.8153022,86,1881,565,1172
18070,15787,154,2,Business,5,2,59072,5,2,59776,5,2,61566,5,2,61714,5,2,62743,6,21.3,-1.2553615,36.7895376,-1.2878149,36.8146245,742,1029,704,1938
18071,23284,3355,3,Business,24,3,41584,24,3,41696,24,3,42613,24,3,42778,24,3,44079,10,20.1,-1.3472066,36.7692638,-1.3052491,36.8223899,352,1301,112,1082
18072,2410,1470,1,Personal,1,6,42196,1,6,42870,1,6,43528,1,6,43735,1,6,45325,9,18.5,-1.2864674,36.820262,-1.2810586,36.8838294,387,1590,674,865
18073,24026,3517,3,Business,27,6,37632,27,6,37656,27,6,38588,27,6,40449,27,6,42006,15,23.25888921888938,-1.300921,36.828195,-1.3882008,36.7699445,171,1557,24,2793
18074,27678,265,3,Business,24,3,37297,24,3,37366,24,3,37680,24,3,37882,24,3,39516,9,23.25888921888938,-1.2569503,36.7834728,-1.300921,36.828195,411,1634,69,516
18075,14715,805,3,Personal,25,1,66890,25,1,68653,25,1,71197,25,1,73314,25,1,75097,12,24.4,-1.3987598,36.7677036,-1.3165719,36.7871583,226,1783,1763,4661
18076,21125,1500,3,Business,3,3,36695,3,3,36709,3,3,39463,3,3,39831,3,3,41919,11,27.4,-1.3077869,36.8443207,-1.2638185,36.7930057,448,2088,14,3122
18077,27605,771,1,Personal,17,1,56611,17,1,56629,17,1,57420,17,1,58024,17,1,60656,24,28.3,-1.3178402,36.8737336,-1.3207446,36.6969684,676,2632,18,1395
18078,16840,2948,1,Personal,18,3,60595,18,3,60610,18,3,60702,18,3,61489,18,3,63384,10,20.3,-1.3014461,36.7661381,-1.3194988,36.7966681,668,1895,15,879
18079,11128,3291,3,Business,28,4,32618,28,4,32651,28,4,33501,28,4,33971,28,4,34573,5,22.5,-1.2628473,36.781805,-1.2600926,36.8088685,269,602,33,1320
18080,544,667,1,Personal,25,6,48351,25,6,48358,25,6,48557,25,6,48918,25,6,49714,6,23.25888921888938,-1.2866544,36.8217978,-1.296452,36.775749,857,796,7,560
18081,22454,1329,3,Business,10,3,68572,10,3,68765,10,3,69317,10,3,69661,10,3,70543,5,27.5,-1.273056,36.811298,-1.2913246,36.8019522,96,882,193,896
18082,22064,2330,3,Business,24,3,48688,24,3,48786,24,3,49893,24,3,50545,24,3,52254,7,23.25888921888938,-1.2687407,36.7373043,-1.3015197,36.7658456,523,1709,98,1759
18083,19037,3391,1,Personal,7,5,46925,7,5,49569,7,5,49685,7,5,50337,7,5,51599,6,24.8,-1.3009926,36.8208532,-1.2858757,36.8430207,669,1262,2644,768
18084,26571,3683,3,Business,30,2,53735,30,2,53920,30,2,54007,30,2,54647,30,2,57843,4,27.6,-1.2897368,36.8226783,-1.2682478,36.8072852,928,3196,185,727
18085,22546,2801,3,Business,9,5,41874,9,5,42266,9,5,43127,9,5,44312,9,5,46193,8,25.8,-1.304592,36.822007,-1.2595422,36.7871178,634,1881,392,2046
18086,23819,2587,3,Business,12,1,45269,12,1,45293,12,1,46239,12,1,47217,12,1,49933,5,24.0,-1.2584143,36.8048002,-1.28878,36.8168312,88,2716,24,1924
18087,8641,2733,3,Business,5,3,34094,5,3,34258,5,3,35213,5,3,37049,5,3,37873,2,18.0,-1.3047482,36.7849672,-1.2963097,36.7688221,404,824,164,2791
18088,17041,688,3,Personal,22,2,51391,22,2,51744,22,2,52352,22,2,53407,22,2,54693,6,21.5,-1.299313,36.7831488,-1.2701356,36.7694292,898,1286,353,1663
18089,15875,2154,3,Business,2,3,50257,2,3,50297,2,3,50704,2,3,51978,2,3,54323,5,26.0,-1.290894,36.822971,-1.2765736,36.8513646,933,2345,40,1681
18090,11387,393,3,Business,28,1,49992,28,1,52729,28,1,52778,28,1,53622,28,1,55353,11,26.4,-1.3167113,36.8301563,-1.2574219,36.7927073,809,1731,2737,893
18091,24575,2801,3,Business,19,2,48322,19,2,48401,19,2,49450,19,2,49901,19,2,51222,6,29.8,-1.2595422,36.7871178,-1.2896399,36.8124498,660,1321,79,1500
18092,27200,373,2,Personal,14,4,46402,14,4,46408,14,4,47380,14,4,47975,14,4,50163,22,19.1,-1.2523599,36.8017648,-1.3376943,36.9139331,752,2188,6,1567
18093,22607,3291,3,Business,24,3,48001,24,3,48422,24,3,49080,24,3,50515,24,3,50734,8,18.3,-1.307143,36.825009,-1.2600926,36.8088685,70,219,421,2093
18094,18671,3647,3,Business,9,4,40698,9,4,40734,9,4,41615,9,4,41844,9,4,43266,12,23.25888921888938,-1.272639,36.794723,-1.2219929,36.8349924,770,1422,36,1110
18095,10695,3194,3,Business,25,1,55618,25,1,55637,25,1,56727,25,1,56948,25,1,58412,8,29.9,-1.2551895,36.7822034,-1.2597436,36.8282526,828,1464,19,1311
18096,2035,2200,3,Business,9,2,55232,9,2,55522,9,2,56065,9,2,57979,9,2,58538,2,22.4,-1.279395,36.825364,-1.290894,36.822971,330,559,290,2457
18097,28049,2737,1,Personal,18,4,63721,18,4,63845,18,4,63871,18,4,64896,18,4,65523,3,23.7,-1.2666534,36.7935346,-1.2664491,36.8102685,519,627,124,1051
18098,4336,393,3,Business,6,1,39662,6,1,39704,6,1,39888,6,1,40341,6,1,42099,11,23.25888921888938,-1.3167113,36.8301563,-1.2638185,36.7930057,25,1758,42,637
18099,23594,2523,3,Business,18,2,34067,18,2,34252,18,2,35118,18,2,35447,18,2,36729,11,19.8,-1.2551895,36.7822034,-1.2310607,36.8035776,453,1282,185,1195
18100,8260,2803,3,Business,14,4,35221,14,4,35602,14,4,36978,14,4,37146,14,4,39967,6,18.0,-1.2765736,36.8513646,-1.2989287,36.8163082,436,2821,381,1544
18101,20311,391,3,Business,8,5,45224,8,5,45443,8,5,47021,8,5,48844,8,5,52634,5,27.0,-1.300921,36.828195,-1.2867454,36.8259017,686,3790,219,3401
18102,9286,3511,3,Personal,18,1,39923,18,1,40887,18,1,41759,18,1,42141,18,1,43298,6,23.25888921888938,-1.3339461,36.8219129,-1.3127304,36.8189817,46,1157,964,1254
18103,2652,3718,3,Business,16,5,52553,16,5,52618,16,5,52649,16,5,53592,16,5,53829,1,23.25888921888938,-1.2650027,36.8126242,-1.2768326,36.8073804,848,237,65,974
18104,27893,3674,3,Business,18,2,47900,18,2,47923,18,2,48626,18,2,48864,18,2,49399,4,25.4,-1.2551895,36.7822034,-1.2651643,36.8072214,727,535,23,941
18105,18259,136,3,Business,27,3,53219,27,3,53243,27,3,54140,27,3,54408,27,3,55507,8,23.25888921888938,-1.3014461,36.7661381,-1.3326173,36.7146233,735,1099,24,1165
18106,10732,3369,3,Business,18,1,52500,18,1,52558,18,1,53255,18,1,53447,18,1,54388,6,17.0,-1.2696183,36.8021778,-1.260345,36.8415986,434,941,58,889
18107,18729,2017,3,Business,11,1,55043,11,1,56459,11,1,56971,11,1,57962,11,1,58316,2,23.0,-1.304033,36.7848695,-1.2963097,36.7688221,216,354,1416,1503
18108,17486,2801,3,Business,11,1,48049,11,1,48111,11,1,48129,11,1,51369,11,1,52395,7,29.0,-1.2595422,36.7871178,-1.2809847,36.8274169,926,1026,62,3258
18109,27435,2344,3,Business,21,4,57571,21,4,57624,21,4,57631,21,4,60110,21,4,60751,5,19.8,-1.2551895,36.7822034,-1.2657199,36.7914391,379,641,53,2486
18110,9254,552,3,Business,30,3,33712,30,3,33783,30,3,34783,30,3,35084,30,3,36423,14,19.6,-1.2852569,36.8976121,-1.3562374,36.9042954,622,1339,71,1301
18111,20814,2154,3,Business,13,4,55334,13,4,56444,13,4,58536,13,4,59544,13,4,63983,29,22.6,-1.225322,36.80855,-1.2599674,36.9590992,547,4439,1110,3100
18112,26096,1849,3,Business,14,3,60039,14,3,60334,14,3,60371,14,3,61496,14,3,63621,8,23.4,-1.3014461,36.7661381,-1.290894,36.822971,669,2125,295,1162
18113,11051,2701,3,Business,29,1,51273,29,1,51367,29,1,51372,29,1,54019,29,1,54862,8,24.2,-1.2584143,36.8048002,-1.2765736,36.8513646,260,843,94,2652
18114,1729,3560,3,Business,24,1,28270,24,1,28293,24,1,30001,24,1,30715,24,1,32242,10,19.5,-1.2859912,36.8756811,-1.279395,36.825364,26,1527,23,2422
18115,22289,2544,3,Personal,23,4,52075,23,4,52108,23,4,52988,23,4,53315,23,4,53843,4,24.7,-1.2664677,36.7793258,-1.2580991,36.7941519,269,528,33,1207
18116,2980,3517,3,Business,13,3,41806,13,3,41817,13,3,42241,13,3,46106,13,3,47642,16,25.0,-1.300921,36.828195,-1.3882008,36.7699445,164,1536,11,4289
18117,19432,111,3,Business,24,3,46051,24,3,46106,24,3,46108,24,3,46732,24,3,47608,7,23.25888921888938,-1.2551895,36.7822034,-1.2841836,36.8065502,291,876,55,626
18118,15835,2075,1,Personal,7,5,34823,7,5,34831,7,5,35309,7,5,35644,7,5,38368,21,18.5,-1.3045487,36.7764687,-1.2143387,36.7914548,644,2724,8,813
18119,24089,2200,3,Business,24,5,41904,24,5,41915,24,5,42656,24,5,43167,24,5,44224,6,20.9,-1.2584143,36.8048002,-1.290894,36.822971,88,1057,11,1252
18120,9011,3064,3,Business,8,5,52849,8,5,53341,8,5,54919,8,5,55374,8,5,56464,8,30.5,-1.2571472,36.7950633,-1.2969741,36.7856612,590,1090,492,2033
18121,26047,517,3,Business,27,4,31894,27,4,34078,27,4,34099,27,4,34568,27,4,35799,11,17.7,-1.3167113,36.8301563,-1.2574219,36.7927073,515,1231,2184,490
18122,13609,2423,3,Business,21,5,35094,21,5,35198,21,5,35996,21,5,36109,21,5,37257,8,20.2,-1.2551895,36.7822034,-1.2904049,36.8055154,383,1148,104,911
18123,9619,1271,3,Business,5,5,33358,5,5,33396,5,5,34837,5,5,35082,5,5,37009,15,19.9,-1.3244885,36.897792,-1.2285835,36.8826468,411,1927,38,1686
18124,6068,3521,3,Business,20,1,55783,20,1,55828,20,1,56040,20,1,57589,20,1,57799,1,23.25888921888938,-1.2701582,36.8074433,-1.2594474,36.8089122,68,210,45,1761
18125,9243,2956,3,Business,2,5,49558,2,5,49582,2,5,49685,2,5,51077,2,5,54949,17,25.0,-1.3165542,36.700067,-1.2584143,36.8048002,105,3872,24,1495
18126,17610,59,3,Business,7,5,55130,7,5,55142,7,5,55685,7,5,55746,7,5,56672,7,25.0,-1.290894,36.822971,-1.2551895,36.7822034,88,926,12,604
18127,6171,1390,1,Personal,21,4,30710,21,4,32654,21,4,33471,21,4,33772,21,4,36107,9,17.1,-1.2994194,36.7647917,-1.2889576,36.8183358,79,2335,1944,1118
18128,26157,1882,1,Business,20,7,45067,20,7,51486,20,7,52820,20,7,52944,20,7,55053,14,20.4,-1.2847654,36.820105,-1.2156006,36.8916865,334,2109,6419,1458
18129,16772,149,3,Business,23,3,63785,23,3,63811,23,3,64203,23,3,64516,23,3,66186,6,20.6,-1.289498,36.818878,-1.2745187,36.7876436,956,1670,26,705
18130,27456,2415,3,Personal,15,5,46830,15,5,47812,15,5,48228,15,5,49029,15,5,49794,5,22.3,-1.2863177,36.8237972,-1.2988168,36.8198572,64,765,982,1217
18131,18965,1162,3,Business,8,2,57133,8,2,57243,8,2,58486,8,2,59192,8,2,63680,16,25.4,-1.312261,36.794658,-1.3111777,36.9066683,847,4488,110,1949
18132,25582,2510,1,Business,27,4,61495,27,4,61533,27,4,62780,27,4,63177,27,4,65940,14,23.0,-1.303097,36.846517,-1.2541432,36.7707094,96,2763,38,1644
18133,3011,1245,3,Business,25,4,52021,25,4,52289,25,4,52850,25,4,53274,25,4,55109,14,21.0,-1.3878505,36.7692885,-1.3198615,36.7110323,456,1835,268,985
18134,27290,1207,3,Business,23,6,41317,23,6,41334,23,6,41598,23,6,41839,23,6,43212,10,23.25888921888938,-1.2628638,36.8070399,-1.3178672,36.8121663,484,1373,17,505
18135,18260,3291,3,Business,6,3,47679,6,3,47771,6,3,48353,6,3,48906,6,3,49724,4,27.6,-1.272828,36.816608,-1.2600926,36.8088685,535,818,92,1135
18136,13067,3517,3,Business,10,4,36795,10,4,36801,10,4,37623,10,4,39243,10,4,41011,16,23.25888921888938,-1.300921,36.828195,-1.3882008,36.7699445,297,1768,6,2442
18137,1530,496,3,Business,1,3,40343,1,3,40397,1,3,40830,1,3,41308,1,3,43912,10,19.7,-1.2551895,36.7822034,-1.3127304,36.8189817,519,2604,54,911
18138,15384,3496,3,Business,30,2,40801,30,2,41576,30,2,42368,30,2,44193,30,2,45522,5,23.25888921888938,-1.300921,36.828195,-1.323971,36.8512242,613,1329,775,2617
18139,10680,265,3,Business,10,5,39844,10,5,39931,10,5,41603,10,5,41863,10,5,44502,13,23.25888921888938,-1.2569714,36.7799637,-1.300921,36.828195,411,2639,87,1932
18140,3907,1245,3,Business,10,4,39295,10,4,39323,10,4,40297,10,4,41459,10,4,43458,19,24.9,-1.300921,36.828195,-1.3198615,36.7110323,95,1999,28,2136
18141,26166,1500,3,Business,18,4,54612,18,4,54630,18,4,54678,18,4,56364,18,4,58312,8,23.25888921888938,-1.3004062,36.829741,-1.2638185,36.7930057,668,1948,18,1734
18142,14139,3599,3,Business,3,1,41971,3,1,41996,3,1,42361,3,1,42797,3,1,45486,19,22.4,-1.3302996,36.8707935,-1.309538,36.7353407,654,2689,25,801
18143,4914,2066,3,Business,17,6,48519,17,6,48571,17,6,51271,17,6,51411,17,6,54406,14,24.1,-1.3270716,36.8406371,-1.3855778,36.9269619,559,2995,52,2840
18144,9963,2587,3,Business,3,1,45271,3,1,46525,3,1,46834,3,1,48060,3,1,49302,7,22.1,-1.28878,36.8168312,-1.2551895,36.7822034,454,1242,1254,1535
18145,16565,238,3,Business,26,5,55316,26,5,55467,26,5,56345,26,5,56482,26,5,57100,3,23.25888921888938,-1.3077869,36.8443207,-1.3166812,36.8594608,161,618,151,1015
18146,3894,2372,2,Personal,11,5,44681,11,5,44686,11,5,45512,11,5,46281,11,5,47778,16,20.7,-1.3319467,36.7766998,-1.2765737,36.8175399,62,1497,5,1595
18147,19107,3521,3,Business,19,2,61049,19,2,61091,19,2,62159,19,2,62406,19,2,63383,5,28.5,-1.2696908,36.81519,-1.2472601,36.7859285,291,977,42,1315
18148,23763,3689,3,Business,8,5,52637,8,5,52732,8,5,53838,8,5,54514,8,5,57887,12,21.4,-1.2297202,36.8745508,-1.2601709,36.8002238,844,3373,95,1782
18149,25990,2587,3,Business,21,5,39560,21,5,39823,21,5,41278,21,5,41998,21,5,46039,12,22.7,-1.2859912,36.8756811,-1.28878,36.8168312,404,4041,263,2175
18150,6968,269,1,Business,4,4,52254,4,4,58918,4,4,60094,4,4,60293,4,4,61958,10,23.25888921888938,-1.3332749,36.8708147,-1.2810586,36.8838294,890,1665,6664,1375
18151,25308,1457,1,Personal,16,4,43866,16,4,43901,16,4,45401,16,4,45960,16,4,47829,11,14.7,-1.2755887,36.8742523,-1.3047026,36.8172033,932,1869,35,2059
18152,14430,649,3,Business,18,1,43128,18,1,43156,18,1,43988,18,1,44892,18,1,46844,17,23.25888921888938,-1.2551895,36.7822034,-1.3404187,36.7614685,159,1952,28,1736
18153,11398,1341,3,Business,18,6,32881,18,6,32958,18,6,33326,18,6,33703,18,6,34390,6,23.25888921888938,-1.318062,36.849326,-1.331619,36.847976,943,687,77,745
18154,11531,2415,1,Personal,22,5,51826,22,5,51974,22,5,53737,22,5,54618,22,5,55331,8,23.25888921888938,-1.2699263,36.8468961,-1.2697141,36.7981777,919,713,148,2644
18155,44,3201,3,Business,5,3,35547,5,3,35560,5,3,35913,5,3,36257,5,3,37284,3,18.3,-1.2649605,36.7981777,-1.2551895,36.7822034,611,1027,13,697
18156,9368,3091,3,Business,26,3,58351,26,3,58370,26,3,58630,26,3,59146,26,3,60925,8,27.2,-1.3012008,36.764868,-1.2615888,36.7928732,62,1779,19,776
18157,7009,627,3,Business,20,3,51525,20,3,51538,20,3,51597,20,3,52147,20,3,53370,4,29.6,-1.2551895,36.7822034,-1.2695287,36.7981777,177,1223,13,609
18158,7369,1721,3,Business,13,3,51017,13,3,51570,13,3,53251,13,3,53567,13,3,54742,11,27.3,-1.2551895,36.7822034,-1.2310607,36.8035776,152,1175,553,1997
18159,26853,1316,3,Business,5,5,58967,5,5,59069,5,5,60059,5,5,60156,5,5,61898,13,26.3,-1.2551895,36.7822034,-1.2257539,36.845929,937,1742,102,1087
18160,26789,393,3,Business,15,1,49741,15,1,49811,15,1,50015,15,1,50551,15,1,51047,4,23.25888921888938,-1.3167113,36.8301563,-1.3004062,36.829741,942,496,70,740
18161,10509,2066,3,Business,8,5,59639,8,5,59885,8,5,61112,8,5,61206,8,5,62901,12,25.2,-1.3210189,36.8410551,-1.3664581,36.9177807,675,1695,246,1321
18162,25420,306,1,Personal,6,5,46072,6,5,46226,6,5,47869,6,5,50141,6,5,50767,6,22.7,-1.2907062,36.7910207,-1.3157973,36.815148,726,626,154,3915
18163,25863,1209,3,Business,24,3,51104,24,3,51121,24,3,51230,24,3,51438,24,3,52560,9,23.25888921888938,-1.2638185,36.7930057,-1.3004062,36.829741,690,1122,17,317
18164,25097,1976,3,Business,31,5,45902,31,5,46425,31,5,47242,31,5,47513,31,5,48159,5,21.8,-1.257028,36.7810435,-1.2580991,36.7941519,553,646,523,1088
18165,24160,733,3,Business,31,4,48083,31,4,49435,31,4,50307,31,4,51553,31,4,53893,5,28.9,-1.2571472,36.7950633,-1.2884243,36.8207248,332,2340,1352,2118
18166,19097,1402,3,Business,15,1,44151,15,1,44247,15,1,44610,15,1,45315,15,1,45596,1,23.25888921888938,-1.290894,36.822971,-1.2813012,36.8323962,99,281,96,1068
18167,441,496,3,Business,3,3,54078,3,3,54110,3,3,54223,3,3,54613,3,3,57420,23,28.4,-1.2551895,36.7822034,-1.374163,36.913444,709,2807,32,503
18168,6098,2330,3,Business,10,3,61132,10,3,61222,10,3,62111,10,3,62384,10,3,63437,7,27.3,-1.2536275,36.7987932,-1.2921463,36.8029626,251,1053,90,1162
18169,10833,2701,3,Business,4,2,39573,4,2,39605,4,2,40513,4,2,41333,4,2,43498,10,20.3,-1.2283403,36.8822756,-1.2765736,36.8513646,788,2165,32,1728
18170,4979,391,3,Business,31,5,51766,31,5,52207,31,5,55140,31,5,58484,31,5,59842,5,24.5,-1.300921,36.828195,-1.2867454,36.8259017,673,1358,441,6277
18171,7879,2565,3,Personal,3,5,52235,3,5,52333,3,5,52954,3,5,53941,3,5,55275,7,25.2,-1.296797,36.7764525,-1.3090066,36.8136512,846,1334,98,1608
18172,23208,3635,3,Business,13,2,62548,13,2,62665,13,2,63671,13,2,64142,13,2,65199,7,23.4,-1.2615888,36.7928732,-1.2865726,36.7642184,550,1057,117,1477
18173,15374,2587,3,Business,11,2,55088,11,2,55780,11,2,55846,11,2,56543,11,2,57913,2,21.3,-1.28878,36.8168312,-1.2880129,36.8308097,519,1370,692,763
18174,13447,1527,3,Business,6,6,39200,6,6,39212,6,6,40661,6,6,42155,6,6,42191,4,26.6,-1.2770708,36.8231093,-1.3004062,36.829741,436,36,12,2943
18175,14809,633,3,Business,24,6,40877,24,6,40994,24,6,42133,24,6,42374,24,6,43087,4,24.1,-1.3077869,36.8443207,-1.3004062,36.829741,668,713,117,1380
18176,14517,867,3,Business,30,5,40742,30,5,42482,30,5,42730,30,5,43447,30,5,45258,10,23.7,-1.2996533,36.8292629,-1.306378,36.7519845,523,1811,1740,965
18177,25340,1205,3,Business,17,3,42880,17,3,43645,17,3,44117,17,3,44263,17,3,45471,7,25.6,-1.257309,36.8060084,-1.2963544,36.8200071,22,1208,765,618
18178,4936,1591,2,Personal,21,2,39869,21,2,39926,21,2,41352,21,2,41721,21,2,42439,5,19.8,-1.2421591,36.8153854,-1.2655306,36.828148,400,718,57,1795
18179,1273,2828,2,Business,28,4,51934,28,4,51945,28,4,52860,28,4,53430,28,4,53951,3,23.25888921888938,-1.2584143,36.8048002,-1.2615888,36.7928732,865,521,11,1485
18180,26295,2789,3,Business,24,4,45603,24,4,45689,24,4,46468,24,4,46597,24,4,47404,7,24.3,-1.304735,36.7846054,-1.3044313,36.818504,432,807,86,908
18181,22087,2701,3,Business,23,5,46284,23,5,46363,23,5,47209,23,5,47357,23,5,49702,4,24.0,-1.2765736,36.8513646,-1.2857548,36.819062,134,2345,79,994
18182,15508,2306,3,Business,21,2,37331,21,2,37438,21,2,40546,21,2,41420,21,2,43482,14,22.5,-1.2271998,36.8084905,-1.301953,36.788458,870,2062,107,3982
18183,6493,1363,3,Business,16,4,53379,16,4,53420,16,4,53564,16,4,54200,16,4,56089,10,19.1,-1.3004062,36.829741,-1.2991441,36.7528804,213,1889,41,780
18184,492,53,3,Business,2,6,34017,2,6,35868,2,6,36354,2,6,37296,2,6,38191,5,22.7,-1.3004062,36.829741,-1.2770708,36.8231093,448,895,1851,1428
18185,780,1075,3,Business,31,4,43959,31,4,44041,31,4,45675,31,4,45981,31,4,48521,14,26.7,-1.3035886,36.8599564,-1.2527958,36.8003131,332,2540,82,1940
18186,9355,3291,3,Business,13,3,32613,13,3,32639,13,3,32937,13,3,34112,13,3,36195,4,20.1,-1.272828,36.816608,-1.2600926,36.8088685,63,2083,26,1473
18187,18362,868,3,Business,29,2,52756,29,2,52812,29,2,53282,29,2,54092,29,2,54742,5,27.1,-1.2600926,36.8088685,-1.265715,36.823815,611,650,56,1280
18188,14470,2325,2,Personal,7,6,29038,7,6,31661,7,6,32243,7,6,33055,7,6,33689,4,14.1,-1.2611916,36.8444489,-1.2857902,36.8316231,88,634,2623,1394
18189,14472,1471,3,Business,15,5,45349,15,5,45359,15,5,45462,15,5,45986,15,5,47784,13,26.6,-1.2551895,36.7822034,-1.3206842,36.8362301,854,1798,10,627
18190,1875,246,3,Business,22,5,53433,22,5,53440,22,5,53473,22,5,53978,22,5,54276,2,23.25888921888938,-1.2584143,36.8048002,-1.2620912,36.8013562,379,298,7,538
18191,17541,2587,3,Business,25,1,45706,25,1,45751,25,1,45908,25,1,46427,25,1,46432,2,25.5,-1.28878,36.8168312,-1.2880129,36.8308097,686,5,45,676
18192,21516,393,3,Business,30,2,48387,30,2,48444,30,2,48453,30,2,50613,30,2,50620,14,23.25888921888938,-1.3167113,36.8301563,-1.2991441,36.7528804,239,7,57,2169
18193,20464,2000,3,Business,12,2,49421,12,2,49462,12,2,49534,12,2,49967,12,2,49995,3,23.25888921888938,-1.2551895,36.7822034,-1.2595422,36.7871178,634,28,41,505
18194,13281,1724,3,Business,5,4,42098,5,4,42110,5,4,42268,5,4,42873,5,4,46199,19,23.25888921888938,-1.2579304,36.8019667,-1.3339943,36.7263409,379,3326,12,763
18195,17724,788,3,Business,27,6,31517,27,6,31744,27,6,31765,27,6,34639,27,6,36750,16,23.25888921888938,-1.3052491,36.8223899,-1.225322,36.80855,593,2111,227,2895
18196,14656,2866,3,Business,18,4,51959,18,4,52803,18,4,53269,18,4,54048,18,4,55367,9,27.0,-1.2551895,36.7822034,-1.301796,36.8012024,726,1319,844,1245
18197,27108,246,3,Business,5,3,63961,5,3,63978,5,3,64290,5,3,64565,5,3,65034,3,22.4,-1.2584143,36.8048002,-1.2551895,36.7822034,247,469,17,587
18198,17656,53,3,Business,2,2,35024,2,2,35132,2,2,35171,2,2,35241,2,2,37522,5,20.3,-1.3004062,36.829741,-1.2770708,36.8231093,306,2281,108,109
18199,23878,1205,3,Business,13,3,29885,13,3,29921,13,3,31067,13,3,31186,13,3,32416,9,16.2,-1.2707742,36.7578609,-1.2475136,36.7703179,752,1230,36,1265
18200,24232,2691,3,Business,21,3,47813,21,3,54963,21,3,55534,21,3,56294,21,3,56792,5,23.2,-1.295034,36.7820505,-1.2984649,36.8171889,669,498,7150,1331
18201,5361,2733,3,Business,19,1,34567,19,1,38270,19,1,38517,19,1,39609,19,1,40283,2,24.8,-1.3014497,36.7582475,-1.2963097,36.7688221,509,674,3703,1339
18202,20826,2801,3,Business,9,2,41054,9,2,41092,9,2,41713,9,2,42092,9,2,43216,5,27.2,-1.2595422,36.7871178,-1.269534,36.80697,690,1124,38,1000
18203,10172,1502,3,Business,29,3,52331,29,3,53049,29,3,55345,29,3,55511,29,3,57062,3,21.0,-1.2232123,36.8932547,-1.2198413,36.9054958,27,1551,718,2462
18204,14062,3201,3,Business,21,5,44107,21,5,44670,21,5,45587,21,5,45841,21,5,47409,9,22.6,-1.3014461,36.7661381,-1.2584143,36.8048002,847,1568,563,1171
18205,19420,393,3,Business,17,3,36674,17,3,36694,17,3,36703,17,3,38177,17,3,38179,5,23.25888921888938,-1.3167113,36.8301563,-1.3077869,36.8443207,39,2,20,1483
18206,26300,393,3,Business,13,3,52945,13,3,52990,13,3,53006,13,3,54897,13,3,56079,11,29.4,-1.3167113,36.8301563,-1.2638185,36.7930057,796,1182,45,1907
18207,6655,2195,3,Business,13,4,46955,13,4,46996,13,4,47426,13,4,48356,13,4,51397,16,22.1,-1.303596,36.778378,-1.228911,36.881876,492,3041,41,1360
18208,7775,2330,3,Business,18,1,43896,18,1,43931,18,1,44680,18,1,45068,18,1,45071,5,27.8,-1.2355732,36.8786063,-1.2524916,36.8656196,521,3,35,1137
18209,410,2801,3,Business,24,4,41148,24,4,41157,24,4,41203,24,4,42489,24,4,44361,16,24.7,-1.3104506,36.8687235,-1.2595422,36.7871178,669,1872,9,1332
18210,2118,2763,3,Business,5,2,34401,5,2,34436,5,2,35701,5,2,36641,5,2,38616,6,18.0,-1.2551895,36.7822034,-1.2870705,36.8256017,88,1975,35,2205
18211,4450,868,3,Business,12,1,57330,12,1,57425,12,1,57592,12,1,58243,12,1,59160,10,27.1,-1.228911,36.881876,-1.265715,36.823815,836,917,95,818
18212,23591,1271,3,Business,14,3,49170,14,3,49546,14,3,50360,14,3,54054,14,3,56763,11,25.5,-1.3107918,36.761794,-1.2569651,36.7849493,660,2709,376,4508
18213,26003,3434,3,Business,14,5,43925,14,5,43978,14,5,43983,14,5,44788,14,5,46962,20,24.3,-1.2963097,36.7688221,-1.3123562,36.9157558,886,2174,53,810
18214,13912,3283,3,Business,8,1,55094,8,1,55109,8,1,55128,8,1,55545,8,1,56162,5,29.7,-1.2600926,36.8088685,-1.2628473,36.781805,881,617,15,436
18215,16232,2982,3,Business,13,4,31666,13,4,31703,13,4,32001,13,4,35902,13,4,37707,14,18.5,-1.300921,36.828195,-1.3195936,36.9161697,459,1805,37,4199
18216,24549,3517,3,Business,9,2,36030,9,2,36059,9,2,36067,9,2,38084,9,2,39727,15,27.1,-1.300921,36.828195,-1.3882008,36.7699445,450,1643,29,2025
18217,1937,1209,3,Business,10,5,35711,10,5,35729,10,5,36637,10,5,36867,10,5,37294,4,23.25888921888938,-1.3077869,36.8443207,-1.3004062,36.829741,448,427,18,1138
18218,25452,2661,2,Personal,15,1,49509,15,1,49703,15,1,50415,15,1,50494,15,1,51728,11,23.25888921888938,-1.3472066,36.7692638,-1.2905138,36.829301,328,1234,194,791
18219,4053,1099,3,Business,7,3,42203,7,3,42292,7,3,43166,7,3,43881,7,3,45759,11,25.3,-1.2764099,36.8208451,-1.303924,36.8758792,200,1878,89,1589
18220,27730,198,3,Business,18,3,49182,18,3,54464,18,3,55155,18,3,55545,18,3,56689,11,20.9,-1.3396256,36.8863135,-1.3154651,36.8648005,397,1144,5282,1081
18221,5878,635,3,Business,10,1,52140,10,1,52164,10,1,52423,10,1,52571,10,1,52832,2,18.8,-1.2633732,36.8131683,-1.2599563,36.7993439,283,261,24,407
18222,6450,1862,1,Personal,28,1,47303,28,1,47357,28,1,47849,28,1,48891,28,1,50158,8,24.4,-1.2738167,36.8157821,-1.277256,36.7572427,852,1267,54,1534
18223,20545,2330,3,Business,1,5,58960,1,5,59017,1,5,59461,1,5,59728,1,5,60967,9,26.6,-1.3015197,36.7658456,-1.2649605,36.7981777,246,1239,57,711
18224,11548,2154,3,Business,16,2,47120,16,2,47378,16,2,47816,16,2,47926,16,2,50335,8,23.25888921888938,-1.2584143,36.8048002,-1.2765736,36.8513646,933,2409,258,548
18225,12900,590,3,Business,3,1,57241,3,1,57257,3,1,58504,3,1,58672,3,1,58863,2,23.4,-1.257773,36.795486,-1.2529635,36.7885404,216,191,16,1415
18226,9776,2383,3,Business,5,2,57453,5,2,57528,5,2,58249,5,2,58424,5,2,59471,5,23.25888921888938,-1.2608993,36.799246,-1.2816234,36.8239846,452,1047,75,896
18227,27261,2987,3,Business,3,1,40360,3,1,40372,3,1,40454,3,1,41276,3,1,42072,9,20.6,-1.270212,36.8210877,-1.3280091,36.8524146,179,796,12,904
18228,7334,2658,3,Business,7,5,62886,7,5,63025,7,5,63727,7,5,68658,7,5,73078,12,23.1,-1.2694178,36.8126928,-1.28877,36.7403,303,4420,139,5633
18229,28069,3510,1,Business,25,3,45960,25,3,45989,25,3,46928,25,3,47165,25,3,48908,5,23.25888921888938,-1.2472211,36.7826109,-1.267452,36.806015,956,1743,29,1176
18230,14910,1578,3,Business,8,4,47347,8,4,54133,8,4,55549,8,4,56221,8,4,57641,6,27.4,-1.2765736,36.8513646,-1.28878,36.8168312,219,1420,6786,2088
18231,14397,3517,3,Business,17,5,57088,17,5,57107,17,5,57132,17,5,58133,17,5,59645,16,23.25888921888938,-1.3882008,36.7699445,-1.300921,36.828195,332,1512,19,1026
18232,20610,393,3,Business,18,1,36908,18,1,37048,18,1,37055,18,1,38957,18,1,38959,11,27.9,-1.3167113,36.8301563,-1.2638185,36.7930057,619,2,140,1909
18233,752,1642,3,Business,24,4,46448,24,4,47015,24,4,47698,24,4,48156,24,4,49864,6,21.4,-1.2728069,36.7962362,-1.288269,36.8182753,116,1708,567,1141
18234,26810,1603,1,Personal,28,1,60672,28,1,61035,28,1,62156,28,1,62247,28,1,64143,7,22.5,-1.2806774,36.8370763,-1.3220191,36.8400166,208,1896,363,1212
18235,11154,2330,3,Business,1,3,45624,1,3,45657,1,3,46047,1,3,46130,1,3,48941,12,23.25888921888938,-1.2921463,36.8029626,-1.2687407,36.7373043,440,2811,33,473
18236,17026,2701,3,Business,16,3,37816,16,3,37869,16,3,39434,16,3,39572,16,3,40652,6,22.6,-1.2765736,36.8513646,-1.2573382,36.877362,530,1080,53,1703
18237,14023,758,3,Business,25,5,40830,25,5,40903,25,5,41275,25,5,43395,25,5,44251,7,26.5,-1.2917868,36.7872675,-1.264917,36.8150651,379,856,73,2492
18238,17522,393,3,Business,7,2,42676,7,2,42848,7,2,43990,7,2,44929,7,2,46669,11,23.25888921888938,-1.3167113,36.8301563,-1.2638185,36.7930057,349,1740,172,2081
18239,1335,1721,3,Business,11,2,36289,11,2,36320,11,2,37010,11,2,37656,11,2,39731,17,16.6,-1.2571472,36.7950633,-1.3194911,36.7200853,279,2075,31,1336
18240,25426,3291,3,Business,10,5,36139,10,5,36182,10,5,37594,10,5,38441,10,5,39360,5,23.25888921888938,-1.2628473,36.781805,-1.2600926,36.8088685,427,919,43,2259
18241,22805,393,3,Business,21,2,39177,21,2,39202,21,2,39708,21,2,41560,21,2,41950,4,22.4,-1.3167113,36.8301563,-1.3004062,36.829741,183,390,25,2358
18242,5318,3291,3,Business,22,2,46242,22,2,46260,22,2,49028,22,2,52199,22,2,53990,12,25.4,-1.228911,36.881876,-1.2600926,36.8088685,82,1791,18,5939
18243,3130,3326,3,Business,6,3,58894,6,3,59212,6,3,59982,6,3,60272,6,3,63634,9,23.25888921888938,-1.2551895,36.7822034,-1.2987732,36.7932128,269,3362,318,1060
18244,20205,437,3,Business,10,4,58210,10,4,58228,10,4,58395,10,4,59077,10,4,59087,2,25.4,-1.2551895,36.7822034,-1.2571472,36.7950633,536,10,18,849
18245,2350,661,3,Business,7,3,52021,7,3,52052,7,3,53164,7,3,54299,7,3,54784,3,28.4,-1.311208,36.778743,-1.2963097,36.7688221,649,485,31,2247
18246,22243,635,3,Business,15,3,53645,15,3,54727,15,3,56602,15,3,57388,15,3,60961,28,26.0,-1.2847613,36.967084,-1.2602337,36.7990548,864,3573,1082,2661
18247,22057,2069,3,Business,8,6,48137,8,6,48197,8,6,48202,8,6,49086,8,6,49985,9,23.25888921888938,-1.265715,36.823815,-1.228911,36.881876,698,899,60,889
18248,10190,3262,3,Personal,29,1,46117,29,1,46131,29,1,46172,29,1,47559,29,1,52030,34,23.25888921888938,-1.2836832,36.8306719,-1.0921599,37.005025,456,4471,14,1428
18249,11750,1482,3,Business,13,2,54719,13,2,54971,13,2,55694,13,2,55846,13,2,57519,8,26.2,-1.29666,36.828668,-1.2848964,36.777431,338,1673,252,875
18250,5057,2869,3,Business,21,2,38454,21,2,38688,21,2,40799,21,2,41858,21,2,43706,9,22.5,-1.28878,36.8168312,-1.3025826,36.7670807,155,1848,234,3170
18251,22649,1271,3,Business,20,3,41338,20,3,41352,20,3,41952,20,3,43560,20,3,46100,24,27.3,-1.3244885,36.897792,-1.3107918,36.761794,218,2540,14,2208
18252,13983,496,3,Business,12,2,39956,12,2,40010,12,2,40512,12,2,41461,12,2,41877,4,24.5,-1.2551895,36.7822034,-1.2736498,36.8061911,383,416,54,1451
18253,21101,3440,1,Personal,8,3,31389,8,3,31401,8,3,32080,8,3,32668,8,3,33867,17,17.5,-1.2637632,36.8206683,-1.1926735,36.9311812,857,1199,12,1267
18254,18674,867,3,Business,11,4,44073,11,4,44451,11,4,45169,11,4,47598,11,4,49551,15,24.0,-1.2991441,36.7528804,-1.3177547,36.8303703,606,1953,378,3147
18255,18584,393,3,Business,16,2,32977,16,2,33508,16,2,34425,16,2,35368,16,2,37381,8,23.25888921888938,-1.3167113,36.8301563,-1.2770708,36.8231093,709,2013,531,1860
18256,17105,2150,3,Business,17,3,33455,17,3,34139,17,3,34758,17,3,35076,17,3,36558,12,23.25888921888938,-1.331619,36.847976,-1.344446,36.756597,263,1482,684,937
18257,13636,1469,3,Business,30,2,55222,30,2,56919,30,2,57272,30,2,57678,30,2,57925,3,23.25888921888938,-1.2551895,36.7822034,-1.2646569,36.7809444,125,247,1697,759
18258,25962,640,3,Business,10,1,39251,10,1,39336,10,1,40689,10,1,41378,10,1,44601,10,18.7,-1.304033,36.7848695,-1.2625087,36.8263725,938,3223,85,2042
18259,27608,3283,3,Business,18,1,33637,18,1,33781,18,1,34724,18,1,36042,18,1,37344,13,21.3,-1.331619,36.847976,-1.2628473,36.781805,459,1302,144,2261
18260,27655,3688,3,Business,4,2,54836,4,2,54946,4,2,54958,4,2,55640,4,2,56587,5,20.2,-1.2551895,36.7822034,-1.2668454,36.7940642,350,947,110,694
18261,10316,1840,1,Personal,27,1,58637,27,1,58642,27,1,58675,27,1,62351,27,1,64722,9,17.3,-1.300673,36.8153812,-1.255956,36.772901,213,2371,5,3709
18262,3327,510,3,Business,18,2,56575,18,2,64039,18,2,65342,18,2,65445,18,2,67644,13,23.6,-1.2860183,36.8975338,-1.3189252,36.8617269,399,2199,7464,1406
18263,1485,706,3,Business,18,2,55854,18,2,56353,18,2,59806,18,2,59884,18,2,60036,6,23.5,-1.3077869,36.8443207,-1.3228003,36.8306435,728,152,499,3531
18264,9618,3599,3,Business,25,4,36199,25,4,40118,25,4,41589,25,4,42679,25,4,46045,12,20.2,-1.3302996,36.8707935,-1.2672002,36.8245542,675,3366,3919,2561
18265,20628,391,3,Business,3,5,54308,3,5,58216,3,5,58577,3,5,59245,3,5,60328,5,23.25888921888938,-1.300921,36.828195,-1.2867454,36.8259017,438,1083,3908,1029
18266,14376,1687,3,Business,22,5,36318,22,5,36373,22,5,37572,22,5,38160,22,5,40535,9,23.25888921888938,-1.2626574,36.8014034,-1.3251584,36.8199384,205,2375,55,1787
18267,26610,2828,1,Business,22,6,50159,22,6,50172,22,6,50691,22,6,52543,22,6,54039,15,23.25888921888938,-1.2615888,36.7928732,-1.3291155,36.8861,65,1496,13,2371
18268,20362,733,3,Business,3,3,54411,3,3,54440,3,3,55305,3,3,57094,3,3,57399,11,28.3,-1.2571472,36.7950633,-1.3257473,36.8592068,349,305,29,2654
18269,13770,2858,3,Business,25,1,72393,25,1,73585,25,1,75620,25,1,76001,25,1,76786,9,22.7,-1.3019797,36.8033961,-1.3280122,36.7861446,801,785,1192,2416
18270,11991,1856,3,Business,8,4,32989,8,4,33710,8,4,35714,8,4,35940,8,4,37135,5,20.5,-1.273009,36.802807,-1.2930705,36.8279433,114,1195,721,2230
18271,26037,439,3,Business,13,3,55690,13,3,56173,13,3,56947,13,3,57646,13,3,59017,10,27.4,-1.2887801,36.8297743,-1.3323107,36.8692616,863,1371,483,1473
18272,21227,635,3,Business,16,3,53243,16,3,53356,16,3,54549,16,3,55363,16,3,56209,8,27.1,-1.3081376,36.8329772,-1.2602337,36.7990548,828,846,113,2007
18273,13284,2612,2,Personal,8,1,38363,8,1,39839,8,1,40299,8,1,40516,8,1,40853,2,24.6,-1.2995738,36.8199719,-1.286937,36.8246742,662,337,1476,677
18274,18827,46,3,Business,16,6,39003,16,6,39073,16,6,40073,16,6,40690,16,6,42669,7,25.9,-1.2836832,36.8306719,-1.3056581,36.8445565,954,1979,70,1617
18275,18607,1809,3,Business,27,3,41422,27,3,41437,27,3,41778,27,3,42056,27,3,42495,1,23.25888921888938,-1.2646084,36.8028645,-1.2620912,36.8013562,345,439,15,619
18276,19500,3599,3,Business,25,2,42512,25,2,45525,25,2,48395,25,2,49963,25,2,51509,14,26.9,-1.3302996,36.8707935,-1.2653185,36.8358841,946,1546,3013,4438
18277,8639,1642,3,Business,14,5,45591,14,5,47128,14,5,47722,14,5,48322,14,5,48929,5,21.3,-1.2846195,36.7958316,-1.2728069,36.7962362,607,607,1537,1194
18278,8650,1047,3,Personal,17,1,36652,17,1,36669,17,1,37360,17,1,37439,17,1,38494,6,18.9,-1.3077869,36.8443207,-1.3010059,36.8216816,281,1055,17,770
18279,23525,1075,3,Business,22,5,43850,22,5,43883,22,5,44410,22,5,44539,22,5,48195,9,23.25888921888938,-1.2527958,36.8003131,-1.3047101,36.7832899,275,3656,33,656
18280,16713,1109,3,Personal,30,2,37876,30,2,38069,30,2,38899,30,2,39116,30,2,41960,9,23.25888921888938,-1.2658424,36.8101804,-1.3139995,36.8176693,911,2844,193,1047
18281,24636,3064,3,Business,17,4,55700,17,4,55786,17,4,56177,17,4,56504,17,4,57964,9,27.9,-1.2571472,36.7950633,-1.292188,36.764855,361,1460,86,718
18282,2332,868,3,Business,30,3,53685,30,3,55977,30,3,56554,30,3,57160,30,3,59070,15,25.0,-1.344446,36.756597,-1.265715,36.823815,852,1910,2292,1183
18283,2239,2701,3,Business,11,2,50396,11,2,50589,11,2,51489,11,2,51665,11,2,55490,13,21.2,-1.2765736,36.8513646,-1.2852139,36.751683,4,3825,193,1076
18284,14563,1792,3,Business,25,2,33835,25,2,34100,25,2,34804,25,2,35087,25,2,35986,6,18.1,-1.2850851,36.82176,-1.2809121,36.7852524,857,899,265,987
18285,27513,186,3,Business,6,4,57586,6,4,57648,6,4,57686,6,4,58785,6,4,61226,20,21.5,-1.2571472,36.7950633,-1.3700383,36.9190174,720,2441,62,1137
18286,16270,187,3,Business,30,2,39960,30,2,40482,30,2,41207,30,2,41478,30,2,42706,8,22.2,-1.3472066,36.7692638,-1.3169591,36.7000029,905,1228,522,996
18287,5063,1500,3,Business,13,4,55176,13,4,55366,13,4,55709,13,4,55944,13,4,56635,6,23.0,-1.2770708,36.8231093,-1.2638185,36.7930057,291,691,190,578
18288,7308,3555,2,Personal,11,4,40192,11,4,40204,11,4,40512,11,4,42122,11,4,42643,4,24.1,-1.2622145,36.8087391,-1.2587023,36.7898488,754,521,12,1918
18289,2854,1880,3,Business,29,5,46248,29,5,46263,29,5,46432,29,5,47399,29,5,50105,7,19.6,-1.2551895,36.7822034,-1.2924886,36.8084039,727,2706,15,1136
18290,22555,3283,3,Business,31,4,56835,31,4,57345,31,4,58634,31,4,59051,31,4,59752,5,28.7,-1.2600926,36.8088685,-1.2628473,36.781805,489,701,510,1706
18291,16882,2069,3,Business,29,3,37490,29,3,40189,29,3,40735,29,3,41048,29,3,42264,9,23.25888921888938,-1.265715,36.823815,-1.228911,36.881876,27,1216,2699,859
18292,7834,1424,3,Business,31,3,58806,31,3,58880,31,3,60889,31,3,61109,31,3,62803,13,24.6,-1.329424,36.862726,-1.30157,36.7871,731,1694,74,2229
18293,7159,2412,3,Business,27,2,51140,27,2,51168,27,2,52801,27,2,53314,27,2,53830,5,25.5,-1.2156006,36.8916865,-1.2297202,36.8819507,358,516,28,2146
18294,16520,1106,1,Personal,31,2,37723,31,2,37742,31,2,38522,31,2,38742,31,2,40965,13,18.4,-1.3025043,36.7535329,-1.3529387,36.6642562,414,2223,19,1000
18295,12987,97,3,Business,23,3,33357,23,3,33435,23,3,34550,23,3,35407,23,3,36005,3,23.25888921888938,-1.2934995,36.7916007,-1.2969741,36.7856612,200,598,78,1972
18296,16857,2866,3,Business,20,2,35705,20,2,35735,20,2,36244,20,2,36807,20,2,39009,21,19.0,-1.2551895,36.7822034,-1.332624,36.913187,651,2202,30,1072
18297,11589,2583,3,Personal,6,4,49469,6,4,49524,6,4,49900,6,4,50222,6,4,51313,6,21.4,-1.2607569,36.7747575,-1.258685,36.805292,663,1091,55,698
18298,24573,2444,1,Personal,22,3,31130,22,3,31879,22,3,34431,22,3,34565,22,3,35887,10,15.1,-1.2633255,36.7105693,-1.2640571,36.7883547,4,1322,749,2686
18299,6482,393,3,Business,20,3,51970,20,3,52588,20,3,52593,20,3,53903,20,3,54864,4,28.5,-1.3167113,36.8301563,-1.3004062,36.829741,111,961,618,1315
18300,20740,136,3,Business,28,5,60550,28,5,60934,28,5,61695,28,5,61868,28,5,62908,4,23.25888921888938,-1.3025826,36.7670807,-1.2962832,36.7849683,747,1040,384,934
18301,17580,970,3,Business,13,2,36032,13,2,38174,13,2,38806,13,2,39012,13,2,39223,3,22.5,-1.2551895,36.7822034,-1.25537,36.7756,932,211,2142,838
18302,21030,136,3,Business,18,2,32123,18,2,32137,18,2,32543,18,2,33146,18,2,34665,20,19.6,-1.2943371,36.8267,-1.3319269,36.7142325,404,1519,14,1009
18303,10194,3525,3,Business,21,4,42153,21,4,42654,21,4,43280,21,4,43541,21,4,44999,18,27.8,-1.3700383,36.9190174,-1.3038156,36.8122733,856,1458,501,887
18304,16432,2178,1,Personal,26,4,68347,26,4,68596,26,4,69370,26,4,69659,26,4,71083,11,19.5,-1.3013991,36.8948904,-1.3077027,36.8163543,890,1424,249,1063
18305,18640,2065,3,Personal,21,4,57744,21,4,57828,21,4,58585,21,4,58707,21,4,59691,4,22.7,-1.2961952,36.7876396,-1.2883346,36.8148489,322,984,84,879
18306,19804,1684,1,Personal,17,1,51505,17,1,51526,17,1,52434,17,1,54065,17,1,55849,17,28.5,-1.2095044,36.7832064,-1.2933789,36.8087535,882,1784,21,2539
18307,27519,3326,3,Business,12,3,40905,12,3,41299,12,3,41975,12,3,44063,12,3,44396,8,19.4,-1.2571472,36.7950633,-1.3025667,36.7803495,139,333,394,2764
18308,2231,635,3,Business,19,6,32938,19,6,32955,19,6,33363,19,6,34870,19,6,35848,7,21.4,-1.3081376,36.8329772,-1.2599563,36.7993439,15,978,17,1915
18309,14829,3557,3,Business,7,5,47014,7,5,47079,7,5,47102,7,5,47368,7,5,48755,6,25.0,-1.2546732,36.8086796,-1.288167,36.8181484,547,1387,65,289
18310,12548,1410,3,Business,27,3,44424,27,3,44439,27,3,44872,27,3,47382,27,3,48836,18,26.2,-1.3387453,36.9118517,-1.2847613,36.967084,242,1454,15,2943
18311,8471,1856,3,Business,10,5,43473,10,5,43495,10,5,43910,10,5,44835,10,5,44988,7,23.25888921888938,-1.273009,36.802807,-1.2653185,36.8358841,778,153,22,1340
18312,1388,540,3,Business,29,3,54806,29,3,54917,29,3,55631,29,3,56273,29,3,57756,5,19.2,-1.2571472,36.7950633,-1.2890893,36.8268633,19,1483,111,1356
18313,4133,3647,3,Business,26,3,58730,26,3,58750,26,3,59375,26,3,59451,26,3,62492,11,27.2,-1.272639,36.794723,-1.3184421,36.8312624,755,3041,20,701
18314,11879,2587,3,Business,9,2,43327,9,2,43948,9,2,44764,9,2,44953,9,2,45938,5,21.8,-1.28878,36.8168312,-1.259697,36.800802,85,985,621,1005
18315,13186,1724,3,Business,16,5,49156,16,5,49163,16,5,49429,16,5,50166,16,5,52138,21,23.25888921888938,-1.2551895,36.7822034,-1.1848195,36.915472,932,1972,7,1003
18316,21337,3409,2,Personal,20,6,47964,20,6,48042,20,6,48758,20,6,49193,20,6,49918,9,28.5,-1.3149257,36.8441635,-1.2657148,36.8151464,622,725,78,1151
18317,21414,3317,2,Personal,16,4,53752,16,4,53799,16,4,54344,16,4,54793,16,4,55914,4,19.2,-1.2946581,36.7792921,-1.3014461,36.7661381,4,1121,47,994
18318,28112,2828,3,Business,1,4,36167,1,4,36196,1,4,36619,1,4,36864,1,4,38484,13,23.25888921888938,-1.2615888,36.7928732,-1.3332749,36.8708147,116,1620,29,668
18319,23264,1961,3,Business,29,3,43851,29,3,43886,29,3,44287,29,3,44902,29,3,46699,17,23.25888921888938,-1.2663631,36.8163329,-1.3188359,36.7038526,675,1797,35,1016
18320,11884,913,3,Personal,4,2,55259,4,2,55477,4,2,56213,4,2,56798,4,2,58023,5,22.5,-1.2857315,36.7953424,-1.2692689,36.8055169,826,1225,218,1321
18321,879,2330,3,Business,21,4,52025,21,4,52978,21,4,55491,21,4,55943,21,4,57055,5,26.5,-1.2649605,36.7981777,-1.293082,36.8278578,88,1112,953,2965
18322,412,2041,1,Business,5,5,55184,5,5,55270,5,5,57198,5,5,59400,5,5,60790,3,26.7,-1.2995132,36.8043032,-1.290894,36.822971,532,1390,86,4130
18323,23288,2509,3,Business,18,2,38007,18,2,38062,18,2,38911,18,2,39944,18,2,42315,20,23.25888921888938,-1.2571472,36.7950633,-1.3700383,36.9190174,931,2371,55,1882
18324,12220,2987,3,Business,31,3,40080,31,3,40131,31,3,40696,31,3,41043,31,3,41951,10,24.5,-1.270212,36.8210877,-1.2297202,36.8819507,279,908,51,912
18325,14726,1104,2,Business,20,5,41132,20,5,41180,20,5,41386,20,5,41882,20,5,42648,4,18.5,-1.2551895,36.7822034,-1.2736498,36.8061911,951,766,48,702
18326,15188,1927,3,Business,17,4,51730,17,4,51740,17,4,52743,17,4,53437,17,4,56285,23,27.9,-1.3472066,36.7692638,-1.2232123,36.8932547,669,2848,10,1697
18327,19300,635,3,Business,7,4,40551,7,4,40561,7,4,40978,7,4,41616,7,4,44100,14,27.6,-1.3081376,36.8329772,-1.2603185,36.7400255,329,2484,10,1055
18328,2926,3222,3,Business,6,3,58212,6,3,58260,6,3,58643,6,3,58980,6,3,59714,5,23.25888921888938,-1.2551895,36.7822034,-1.2731645,36.7900343,523,734,48,720
18329,22950,2829,3,Business,30,2,39779,30,2,39798,30,2,40001,30,2,40285,30,2,41528,8,23.25888921888938,-1.2571472,36.7950633,-1.3055447,36.82332,253,1243,19,487
18330,9950,3050,3,Business,27,3,54317,27,3,54453,27,3,54993,27,3,55448,27,3,57068,10,29.3,-1.2945074,36.8083195,-1.3104734,36.7363698,801,1620,136,995
18331,16813,3517,3,Business,11,1,57571,11,1,57875,11,1,58519,11,1,60499,11,1,62965,15,27.4,-1.300921,36.828195,-1.3882008,36.7699445,931,2466,304,2624
18332,5275,1075,3,Business,29,5,43836,29,5,43953,29,5,46318,29,5,46679,29,5,47155,1,26.9,-1.2649605,36.7981777,-1.2527958,36.8003131,96,476,117,2726
18333,7926,3283,3,Business,20,1,58203,20,1,58238,20,1,58653,20,1,58838,20,1,59539,5,23.25888921888938,-1.266837,36.799249,-1.2628473,36.781805,138,701,35,600
18334,9506,2207,3,Business,21,4,37176,21,4,37354,21,4,38227,21,4,38548,21,4,39326,5,27.8,-1.2939186,36.8069693,-1.2696908,36.81519,61,778,178,1194
18335,18182,1329,3,Business,24,5,58872,24,5,58938,24,5,59833,24,5,59913,24,5,64428,6,20.1,-1.273056,36.811298,-1.2974317,36.8028609,203,4515,66,975
18336,22434,186,3,Business,18,4,44367,18,4,44437,18,4,44676,18,4,45661,18,4,46422,5,23.25888921888938,-1.2825816,36.8092346,-1.2571472,36.7950633,322,761,70,1224
18337,18301,3547,3,Business,21,2,36684,21,2,36764,21,2,38036,21,2,38325,21,2,40556,13,22.7,-1.2856319,36.7672998,-1.274374,36.8550291,599,2231,80,1561
18338,15499,3517,3,Business,23,3,42828,23,3,44428,23,3,45579,23,3,46309,23,3,47874,16,23.25888921888938,-1.3882008,36.7699445,-1.300921,36.828195,293,1565,1600,1881
18339,17442,2968,1,Business,20,1,63753,20,1,63792,20,1,64931,20,1,65401,20,1,67244,11,20.5,-1.3049726,36.8912382,-1.2782978,36.8273238,456,1843,39,1609
18340,10982,3525,3,Business,27,1,46952,27,1,51342,27,1,51972,27,1,52271,27,1,55675,22,23.3,-1.3700383,36.9190174,-1.2674274,36.7870827,868,3404,4390,929
18341,24885,3263,2,Personal,7,6,52124,7,6,52150,7,6,52179,7,6,52750,7,6,54628,12,21.3,-1.255956,36.772901,-1.2201106,36.803634,101,1878,26,600
18342,13681,2112,3,Business,25,4,41198,25,4,41207,25,4,41232,25,4,42405,25,4,44177,13,23.25888921888938,-1.2527958,36.8003131,-1.2156006,36.8916865,89,1772,9,1198
18343,5390,46,3,Business,3,1,30497,3,1,30648,3,1,34922,3,1,35695,3,1,39277,8,18.3,-1.2996396,36.8520799,-1.28523,36.8248292,567,3582,151,5047
18344,17054,1336,3,Business,15,1,44206,15,1,44396,15,1,44761,15,1,45091,15,1,46085,6,23.25888921888938,-1.2891922,36.825189,-1.2756303,36.8074406,726,994,190,695
18345,7385,2801,3,Business,14,5,45636,14,5,47222,14,5,47585,14,5,47978,14,5,49742,8,21.7,-1.2674274,36.7870827,-1.2879652,36.8203441,709,1764,1586,756
18346,20795,53,3,Business,12,2,40702,12,2,42571,12,2,44266,12,2,45112,12,2,47381,8,24.5,-1.3167113,36.8301563,-1.2770708,36.8231093,452,2269,1869,2541
18347,22290,393,3,Business,8,3,49404,8,3,49417,8,3,49978,8,3,51765,8,3,53391,15,23.25888921888938,-1.306378,36.7519845,-1.3167113,36.8301563,831,1626,13,2348
18348,8387,2956,3,Business,10,5,65995,10,5,66243,10,5,67270,10,5,70815,10,5,70822,9,23.25888921888938,-1.3014461,36.7661381,-1.2584143,36.8048002,567,7,248,4572
18349,521,3283,3,Business,16,6,45554,16,6,45581,16,6,45910,16,6,46544,16,6,47137,6,25.8,-1.272828,36.816608,-1.2628473,36.781805,461,593,27,963
18350,25433,2829,3,Business,4,1,49878,4,1,49986,4,1,52143,4,1,52443,4,1,53480,4,22.8,-1.2579304,36.8019667,-1.2833106,36.8240238,586,1037,108,2457
18351,10230,868,3,Business,29,3,61801,29,3,61897,29,3,62153,29,3,63192,29,3,64081,7,21.1,-1.2628473,36.781805,-1.265715,36.823815,576,889,96,1295
18352,8246,635,3,Business,13,3,49460,13,3,49697,13,3,50122,13,3,52858,13,3,53781,7,29.4,-1.3081376,36.8329772,-1.2602337,36.7990548,177,923,237,3161
18353,24390,633,3,Business,20,3,52363,20,3,52481,20,3,53248,20,3,53462,20,3,55162,11,29.4,-1.2991441,36.7528804,-1.3004062,36.829741,692,1700,118,981
18354,9689,3486,3,Business,20,3,40591,20,3,40636,20,3,41151,20,3,41254,20,3,43712,21,27.2,-1.2551895,36.7822034,-1.3705766,36.9120742,876,2458,45,618
18355,4606,2383,3,Business,21,2,34061,21,2,34114,21,2,34366,21,2,34776,21,2,35234,3,23.25888921888938,-1.2608993,36.799246,-1.2558951,36.78602,247,458,53,662
18356,27452,3283,3,Business,17,4,39287,17,4,39307,17,4,39372,17,4,39706,17,4,41193,18,25.2,-1.344446,36.756597,-1.2628473,36.781805,741,1487,20,399
18357,1456,3283,3,Business,22,5,58355,22,5,58383,22,5,58713,22,5,59110,22,5,60244,7,27.5,-1.303596,36.778378,-1.2628473,36.781805,210,1134,28,727
18358,10056,53,3,Business,29,5,52761,29,5,52860,29,5,52888,29,5,54054,29,5,55283,5,28.9,-1.3004062,36.829741,-1.2770708,36.8231093,901,1229,99,1194
18359,12552,393,3,Business,10,1,47923,10,1,48167,10,1,48579,10,1,50948,10,1,51959,8,18.5,-1.3228003,36.8306435,-1.2770708,36.8231093,35,1011,244,2781
18360,3,635,3,Business,29,3,54012,29,3,54986,29,3,57112,29,3,57217,29,3,59403,4,20.9,-1.2602337,36.7990548,-1.2833335,36.8260084,393,2186,974,2231
18361,456,2089,3,Business,21,3,47084,21,3,47098,21,3,47336,21,3,47581,21,3,49188,7,22.2,-1.2655824,36.8013576,-1.2610722,36.8147074,38,1607,14,483
18362,13404,2607,2,Personal,11,6,40961,11,6,40986,11,6,41016,11,6,41464,11,6,41942,3,21.1,-1.2860203,36.7832538,-1.2917966,36.7730221,88,478,25,478
18363,18273,3355,3,Business,24,3,64157,24,3,64478,24,3,66996,24,3,67397,24,3,68325,9,18.6,-1.2551895,36.7822034,-1.3052491,36.8223899,578,928,321,2919
18364,4870,3705,2,Personal,11,2,43417,11,2,43471,11,2,44547,11,2,45411,11,2,45972,5,24.0,-1.2771886,36.8419032,-1.2855799,36.8176209,409,561,54,1940
18365,19494,2207,3,Business,30,4,39729,30,4,39749,30,4,40084,30,4,41435,30,4,41987,1,20.5,-1.2630521,36.8068019,-1.2696908,36.81519,520,552,20,1686
18366,3062,53,3,Business,15,2,44882,15,2,46256,15,2,46803,15,2,47067,15,2,48195,7,24.4,-1.2574219,36.7927073,-1.2770708,36.8231093,576,1128,1374,811
18367,1362,1329,3,Business,15,5,39222,15,5,39246,15,5,39777,15,5,39877,15,5,41099,9,26.1,-1.273056,36.811298,-1.324658,36.834048,76,1222,24,631
18368,28247,3677,1,Personal,11,5,39074,11,5,39227,11,5,40333,11,5,40578,11,5,41826,6,20.9,-1.2921983,36.7965431,-1.2717851,36.8105363,782,1248,153,1351
18369,5898,2946,2,Personal,4,2,43678,4,2,43786,4,2,44718,4,2,44997,4,2,46248,7,18.6,-1.2749662,36.7658781,-1.289521,36.8190724,88,1251,108,1211
18370,4650,393,3,Business,15,5,47125,15,5,47134,15,5,47169,15,5,47793,15,5,50316,14,25.7,-1.3167113,36.8301563,-1.2991441,36.7528804,349,2523,9,659
18371,9952,1205,3,Business,3,1,57689,3,1,57958,3,1,58877,3,1,59239,3,1,60125,6,23.1,-1.2707623,36.7581285,-1.265737,36.7889295,269,886,269,1281
18372,332,2083,3,Personal,27,3,53163,27,3,53176,27,3,53193,27,3,53759,27,3,55993,9,29.1,-1.2615888,36.7928732,-1.2981239,36.8367977,279,2234,13,583
18373,23713,1482,3,Business,13,4,46330,13,4,46360,13,4,46409,13,4,46969,13,4,49335,22,22.2,-1.338579,36.8963038,-1.3686413,36.7463562,31,2366,30,609
18374,21341,3635,1,Business,8,6,58959,8,6,58978,8,6,59425,8,6,63321,8,6,64510,20,23.0,-1.2615888,36.7928732,-1.3103985,36.9114173,647,1189,19,4343
18375,24990,1767,3,Personal,9,3,53750,9,3,53890,9,3,55221,9,3,55663,9,3,56152,3,25.3,-1.2834669,36.8297516,-1.2950041,36.8143583,489,489,140,1773
18376,23759,393,3,Business,16,4,34483,16,4,34499,16,4,34512,16,4,36634,16,4,37998,14,15.7,-1.3177547,36.8303703,-1.306378,36.7519845,659,1364,16,2135
18377,25604,2457,3,Business,21,3,55190,21,3,56210,21,3,57240,21,3,57445,21,3,58082,8,23.2,-1.2551895,36.7822034,-1.2862436,36.791017,195,637,1020,1235
18378,20926,633,3,Business,27,3,37786,27,3,37876,27,3,37881,27,3,38577,27,3,38582,6,26.0,-1.3004062,36.829741,-1.3228003,36.8306435,515,5,90,701
18379,23112,3404,3,Business,11,2,46850,11,2,48882,11,2,49048,11,2,50203,11,2,50589,1,22.5,-1.290894,36.822971,-1.279395,36.825364,845,386,2032,1321
18380,11900,1899,3,Business,18,6,39496,18,6,39528,18,6,40283,18,6,40847,18,6,41308,7,19.0,-1.307143,36.825009,-1.331619,36.847976,415,461,32,1319
18381,23325,1209,3,Business,12,5,45268,12,5,45487,12,5,45719,12,5,46441,12,5,46891,6,26.6,-1.3004062,36.829741,-1.3228003,36.8306435,459,450,219,954
18382,7502,1772,3,Personal,2,2,47093,2,2,47117,2,2,47125,2,2,47858,2,2,48861,5,20.9,-1.2916556,36.8262516,-1.3175119,36.8058513,726,1003,24,741
18383,957,2310,1,Business,23,4,31889,23,4,31923,23,4,32810,23,4,33137,23,4,34784,11,15.6,-1.3332749,36.8708147,-1.2859912,36.8756811,281,1647,34,1214
18384,18950,2069,3,Business,27,4,52267,27,4,52292,27,4,52807,27,4,53156,27,4,53861,6,23.5,-1.2296618,36.8438272,-1.228911,36.881876,845,705,25,864
18385,15978,3226,3,Personal,16,2,38629,16,2,39042,16,2,39611,16,2,39888,16,2,40476,7,23.3,-1.2669026,36.8445273,-1.2567464,36.7915273,22,588,413,846
18386,20,2412,3,Business,3,4,53267,3,4,53290,3,4,54207,3,4,54497,3,4,55156,3,26.1,-1.2156006,36.8916865,-1.2285835,36.8826468,854,659,23,1207
18387,27206,1958,3,Business,31,4,55885,31,4,57092,31,4,57611,31,4,57825,31,4,60404,23,28.9,-1.3700383,36.9190174,-1.2551895,36.7822034,813,2579,1207,733
18388,13855,2457,3,Business,23,4,53009,23,4,53040,23,4,53049,23,4,53364,23,4,54072,6,24.4,-1.2551895,36.7822034,-1.2407027,36.7650043,576,708,31,324
18389,8769,3222,3,Business,25,1,43158,25,1,43171,25,1,43183,25,1,43451,25,1,43912,3,25.7,-1.2551895,36.7822034,-1.2622145,36.8087391,576,461,13,280
18390,20009,2956,3,Business,29,3,60707,29,3,60716,29,3,61586,29,3,62130,29,3,63445,15,18.9,-1.2297202,36.8819507,-1.2584143,36.8048002,384,1315,9,1414
18391,11322,393,3,Business,4,1,30509,4,1,30600,4,1,31567,4,1,32890,4,1,33734,4,21.9,-1.3167113,36.8301563,-1.3004062,36.829741,378,844,91,2290
18392,23796,1280,3,Business,11,1,33940,11,1,33970,11,1,34464,11,1,34984,11,1,36021,4,21.1,-1.2551895,36.7822034,-1.2768326,36.8073804,245,1037,30,1014
18393,2825,3641,3,Business,23,4,44186,23,4,44208,23,4,47362,23,4,47429,23,4,48148,8,23.5,-1.2831463,36.7636022,-1.2551895,36.7822034,451,719,22,3221
18394,4319,3283,3,Business,16,3,55394,16,3,55439,16,3,56022,16,3,56789,16,3,57455,5,27.2,-1.2600926,36.8088685,-1.2628473,36.781805,46,666,45,1350
18395,24870,393,3,Business,11,2,40370,11,2,47397,11,2,47429,11,2,48855,11,2,50864,11,22.5,-1.3228003,36.8306435,-1.2574219,36.7927073,914,2009,7027,1458
18396,22747,1500,3,Business,4,4,41694,4,4,41799,4,4,42478,4,4,42600,4,4,44310,10,25.3,-1.2991441,36.7528804,-1.2638185,36.7930057,933,1710,105,801
18397,23120,136,3,Business,7,5,44916,7,5,44987,7,5,45342,7,5,45667,7,5,46740,2,23.25888921888938,-1.2654716,36.7983635,-1.2760462,36.8074697,401,1073,71,680
18398,26396,1798,3,Business,7,4,36947,7,4,37060,7,4,37259,7,4,37898,7,4,39127,6,19.6,-1.2899256,36.815551,-1.2615888,36.7928732,86,1229,113,838
18399,26884,302,3,Business,5,6,56016,5,6,56033,5,6,56350,5,6,57179,5,6,57644,2,21.9,-1.2649605,36.7981777,-1.2517571,36.8170267,881,465,17,1146
18400,2812,1798,3,Business,11,4,57653,11,4,57861,11,4,58592,11,4,59076,11,4,60122,3,27.2,-1.2696183,36.8021778,-1.2615888,36.7928732,349,1046,208,1215
18401,12925,2919,1,Personal,11,1,28767,11,1,28793,11,1,29581,11,1,30072,11,1,31148,17,14.5,-1.3047132,36.8089553,-1.3441051,36.8971273,71,1076,26,1279
18402,25901,2982,3,Business,15,6,32730,15,6,32741,15,6,32847,15,6,34417,15,6,36632,11,16.6,-1.300921,36.828195,-1.3296956,36.87821,2,2215,11,1676
18403,25772,3291,3,Business,24,5,59330,24,5,59350,24,5,60304,24,5,60386,24,5,60694,2,23.25888921888938,-1.2673935,36.8030328,-1.2600926,36.8088685,857,308,20,1036
18404,16513,868,3,Business,5,3,32119,5,3,36102,5,3,36812,5,3,36889,5,3,39163,8,18.2,-1.303596,36.778378,-1.265715,36.823815,89,2274,3983,787
18405,11189,3331,1,Business,25,5,48861,25,5,48935,25,5,49976,25,5,50704,25,5,52851,12,23.6,-1.255956,36.789867,-1.3083777,36.8590077,888,2147,74,1769
18406,24680,1329,3,Business,12,5,67163,12,5,67236,12,5,67579,12,5,67906,12,5,68687,6,26.6,-1.273056,36.811298,-1.2832105,36.7777664,484,781,73,670
18407,16283,3462,1,Personal,16,4,44098,16,4,44119,16,4,45087,16,4,45255,16,4,46124,5,14.7,-1.255683,36.813771,-1.2721028,36.7953485,857,869,21,1136
18408,17606,190,3,Business,21,4,59705,21,4,59711,21,4,59853,21,4,60105,21,4,62097,16,28.3,-1.240431,36.8739331,-1.3270347,36.8667362,910,1992,6,394
18409,14285,2183,3,Business,5,1,38634,5,1,38671,5,1,41119,5,1,42526,5,1,44102,7,24.3,-1.2551895,36.7822034,-1.2549476,36.8269576,916,1576,37,3855
18410,17891,3621,3,Business,17,1,37240,17,1,37261,17,1,40050,17,1,40120,17,1,41119,5,25.0,-1.2836583,36.7886014,-1.3041129,36.8104939,844,999,21,2859
18411,27047,2523,3,Business,29,3,41244,29,3,41261,29,3,41288,29,3,41599,29,3,42706,8,23.25888921888938,-1.2551895,36.7822034,-1.2876155,36.7868444,535,1107,17,338
18412,335,1417,3,Business,2,4,58286,2,4,58306,2,4,59123,2,4,60082,2,4,60978,5,23.25888921888938,-1.2985749,36.8088,-1.2741728,36.7969108,96,896,20,1776
18413,10715,3679,2,Personal,8,6,52733,8,6,52740,8,6,54097,8,6,54851,8,6,56628,17,24.8,-1.2870003,36.8312206,-1.3662811,36.7542142,414,1777,7,2111
18414,13309,695,1,Personal,27,5,52908,27,5,52956,27,5,53504,27,5,53837,27,5,56137,13,24.1,-1.2029267,36.7877173,-1.2770826,36.8174088,144,2300,48,881
18415,6296,2957,3,Personal,27,3,44009,27,3,44021,27,3,44184,27,3,45044,27,3,46390,8,23.25888921888938,-1.3004311,36.7524273,-1.2633494,36.7959696,327,1346,12,1023
18416,109,1482,3,Business,7,5,56976,7,5,58718,7,5,61023,7,5,62670,7,5,63337,4,22.9,-1.3231725,36.8640177,-1.338579,36.8963038,48,667,1742,3952
18417,3660,2656,2,Personal,5,6,36672,5,6,36699,5,6,39268,5,6,40189,5,6,42280,26,22.4,-1.1874211,36.9286449,-1.2925505,36.7953715,813,2091,27,3490
18418,17380,186,3,Business,17,3,31863,17,3,31933,17,3,32980,17,3,33338,17,3,34137,6,21.1,-1.2890399,36.8164942,-1.2571472,36.7950633,85,799,70,1405
18419,19427,84,3,Business,2,2,59669,2,2,59797,2,2,60468,2,2,61376,2,2,61963,3,28.3,-1.2572951,36.79886,-1.2551895,36.7822034,279,587,128,1579
18420,1896,733,3,Business,30,2,51526,30,2,51723,30,2,52315,30,2,52945,30,2,53686,5,23.25888921888938,-1.2551895,36.7822034,-1.2629461,36.7653137,937,741,197,1222
18421,9575,2547,3,Business,22,2,37195,22,2,37292,22,2,37897,22,2,38898,22,2,40196,11,19.4,-1.3028118,36.8174764,-1.3321944,36.8892329,216,1298,97,1606
18422,5592,2941,1,Personal,9,2,33144,9,2,33147,9,2,33488,9,2,34363,9,2,35783,13,17.7,-1.2977387,36.8031447,-1.2288359,36.8492095,829,1420,3,1216
18423,3994,517,3,Business,29,3,32092,29,3,32154,29,3,32910,29,3,33871,29,3,34552,11,17.7,-1.3228003,36.8306435,-1.2638185,36.7930057,706,681,62,1717
18424,17694,1392,3,Business,13,1,56201,13,1,59677,13,1,62839,13,1,63324,13,1,64555,8,23.25888921888938,-1.2551895,36.7822034,-1.3050332,36.8100437,716,1231,3476,3647
18425,9055,627,3,Business,24,3,50222,24,3,50293,24,3,50893,24,3,51649,24,3,54524,11,23.25888921888938,-1.2571472,36.7950633,-1.2416156,36.8736721,24,2875,71,1356
18426,6831,2112,3,Business,2,2,48312,2,2,48487,2,2,48655,2,2,49240,2,2,50478,13,26.3,-1.2872899,36.820434,-1.2156006,36.8916865,648,1238,175,753
18427,27323,3635,1,Business,28,2,33700,28,2,33929,28,2,34531,28,2,35824,28,2,36357,7,16.1,-1.22589,36.7822548,-1.225322,36.80855,882,533,229,1895
18428,12969,3437,1,Personal,18,3,57027,18,3,57035,18,3,57531,18,3,57830,18,3,58743,3,20.9,-1.2627937,36.8156957,-1.2733004,36.7943468,616,913,8,795
18429,7957,53,3,Business,2,6,34953,2,6,34986,2,6,34996,2,6,35830,2,6,36942,8,20.9,-1.3167113,36.8301563,-1.2770708,36.8231093,842,1112,33,844
18430,24438,478,3,Business,2,4,56034,2,4,56068,2,4,56673,2,4,57418,2,4,58046,3,23.25888921888938,-1.2617028,36.7983849,-1.2551895,36.7822034,660,628,34,1350
18431,1808,3547,3,Business,31,4,35221,31,4,35231,31,4,38272,31,4,38399,31,4,40885,18,26.4,-1.2856319,36.7672998,-1.3194518,36.869396,362,2486,10,3168
18432,3437,3621,3,Business,31,3,51502,31,3,51526,31,3,52152,31,3,52236,31,3,53366,5,26.9,-1.2836583,36.7886014,-1.2810889,36.8247135,634,1130,24,710
18433,26445,1644,1,Personal,14,5,44606,14,5,44625,14,5,44946,14,5,45976,14,5,46750,8,24.2,-1.2850851,36.82176,-1.2551895,36.7822034,124,774,19,1351
18434,17029,1327,3,Personal,21,5,47912,21,5,48013,21,5,48288,21,5,48362,21,5,50271,8,22.7,-1.2615518,36.7889052,-1.2924639,36.7795798,866,1909,101,349
18435,9148,3547,3,Business,7,2,38392,7,2,38426,7,2,40319,7,2,42524,7,2,45813,11,23.25888921888938,-1.278956,36.8375411,-1.2761408,36.7710839,790,3289,34,4098
18436,4349,2330,3,Business,31,5,48938,31,5,54506,31,5,54641,31,5,55918,31,5,57021,9,24.9,-1.2124582,36.802894,-1.2645318,36.7981775,7,1103,5568,1412
18437,5069,1642,3,Business,8,3,52271,8,3,52312,8,3,53775,8,3,53944,8,3,55086,5,23.25888921888938,-1.2728069,36.7962362,-1.2684816,36.8085622,422,1142,41,1632
18438,22249,868,3,Business,10,3,34907,10,3,34915,10,3,35077,10,3,37560,10,3,38123,4,22.0,-1.2600926,36.8088685,-1.265715,36.823815,205,563,8,2645
18439,24349,3647,3,Business,7,2,47267,7,2,47294,7,2,47760,7,2,48210,7,2,49143,5,23.3,-1.2795796,36.819062,-1.272639,36.794723,414,933,27,916
18440,6910,2388,2,Personal,16,4,41982,16,4,42003,16,4,42679,16,4,43090,16,4,46457,12,14.5,-1.2885364,36.7995016,-1.3192808,36.7121888,234,3367,21,1087
18441,23439,1329,3,Business,5,2,41405,5,2,41598,5,2,42060,5,2,42160,5,2,43469,6,21.3,-1.273056,36.811298,-1.2951297,36.8335521,808,1309,193,562
18442,1139,3091,3,Business,10,4,61175,10,4,61199,10,4,61433,10,4,61792,10,4,62676,3,23.5,-1.3012008,36.764868,-1.2765492,36.7669809,436,884,24,593
18443,11227,1244,3,Business,15,2,37206,15,2,37273,15,2,37819,15,2,38310,15,2,39474,6,24.1,-1.2628473,36.781805,-1.303596,36.778378,279,1164,67,1037
18444,27624,3239,3,Personal,7,1,38488,7,1,38967,7,1,39578,7,1,40573,7,1,42690,6,21.5,-1.276154,36.8224165,-1.3146122,36.8322723,742,2117,479,1606
18445,1886,3326,3,Business,27,3,50611,27,3,50624,27,3,51271,27,3,52317,27,3,56334,22,29.5,-1.2551895,36.7822034,-1.3190102,36.9230693,177,4017,13,1693
18446,18541,111,3,Business,12,3,49254,12,3,49380,12,3,49427,12,3,49815,12,3,50883,4,20.8,-1.2551895,36.7822034,-1.2707177,36.8009828,827,1068,126,435
18447,18402,2763,3,Business,13,4,47798,13,4,47841,13,4,48224,13,4,48449,13,4,49845,7,22.2,-1.2551895,36.7822034,-1.2885417,36.8100523,709,1396,43,608
18448,4412,2190,3,Business,27,1,54144,27,1,54216,27,1,55091,27,1,55565,27,1,56610,7,23.2,-1.301953,36.788458,-1.302088,36.831162,826,1045,72,1349
18449,1094,2079,3,Personal,25,5,33126,25,5,33175,25,5,33355,25,5,33480,25,5,36201,22,20.7,-1.2681004,36.7952081,-1.333148,36.922453,620,2721,49,305
18450,7023,3560,3,Business,23,6,43055,23,6,43076,23,6,43134,23,6,43664,23,6,43679,1,26.4,-1.28878,36.8168312,-1.279395,36.825364,101,15,21,588
18451,9735,1578,3,Business,10,4,47436,10,4,47718,10,4,49265,10,4,50342,10,4,54317,10,21.8,-1.2765736,36.8513646,-1.255956,36.789867,248,3975,282,2624
18452,21512,1341,3,Business,30,4,38126,30,4,38160,30,4,38820,30,4,40101,30,4,40845,7,23.25888921888938,-1.318062,36.849326,-1.331619,36.847976,875,744,34,1941
18453,14814,1402,3,Business,9,2,41876,9,2,46644,9,2,48386,9,2,48973,9,2,52840,7,30.5,-1.2813012,36.8323962,-1.3024388,36.859699,709,3867,4768,2329
18454,10964,2066,3,Business,13,1,39321,13,1,39384,13,1,40099,13,1,40310,13,1,41764,12,23.25888921888938,-1.2502493,36.7923169,-1.3210189,36.8410551,205,1454,63,926
18455,12604,1209,3,Business,28,1,58016,28,1,60559,28,1,60564,28,1,61012,28,1,62659,12,25.3,-1.2991441,36.7528804,-1.3004062,36.829741,523,1647,2543,453
18456,20720,1450,3,Personal,4,1,42851,4,1,43534,4,1,46369,4,1,47880,4,1,49778,9,20.8,-1.280753,36.8191175,-1.2912918,36.758141,929,1898,683,4346
18457,15982,2596,3,Business,11,5,40220,11,5,40280,11,5,40896,11,5,41852,11,5,43696,12,21.0,-1.3053135,36.8605848,-1.2963097,36.7688221,281,1844,60,1572
18458,4436,1721,3,Business,6,4,53797,6,4,53860,6,4,54041,6,4,54237,6,4,55778,9,21.5,-1.2551895,36.7822034,-1.2972988,36.7894461,16,1541,63,377
18459,11613,2582,3,Business,16,4,58906,16,4,58921,16,4,59061,16,4,59288,16,4,61202,18,23.25888921888938,-1.2551895,36.7822034,-1.3343129,36.8854175,931,1914,15,367
18460,13888,2454,3,Business,5,6,60115,5,6,60247,5,6,60545,5,6,60974,5,6,61379,2,21.9,-1.2993231,36.7753372,-1.2863547,36.7895376,649,405,132,727
18461,13436,1724,3,Business,11,4,32605,11,4,32672,11,4,32936,11,4,34219,11,4,34927,5,22.0,-1.2571472,36.7950633,-1.286067,36.8146155,953,708,67,1547
18462,24158,3354,3,Business,29,4,52811,29,4,53353,29,4,54186,29,4,54645,29,4,56054,9,24.8,-1.3004846,36.7901591,-1.2571472,36.7950633,50,1409,542,1292
18463,4494,816,3,Business,15,4,34800,15,4,34860,15,4,35623,15,4,35934,15,4,37457,5,19.7,-1.290894,36.822971,-1.259697,36.800802,81,1523,60,1074
18464,15125,1752,2,Personal,22,3,54525,22,3,54588,22,3,55097,22,3,55462,22,3,57910,20,25.9,-1.2989758,36.7753577,-1.2191053,36.8995881,334,2448,63,874
18465,26520,972,3,Business,7,3,30431,7,3,30485,7,3,31032,7,3,31180,7,3,32483,10,23.25888921888938,-1.286282,36.8217484,-1.2844303,36.8781656,235,1303,54,695
18466,26249,1693,3,Business,15,5,37995,15,5,38115,15,5,38160,15,5,38573,15,5,39498,7,25.7,-1.2993714,36.8196974,-1.2574088,36.799712,178,925,120,458
18467,18096,3647,3,Business,30,4,57679,30,4,57686,30,4,57788,30,4,58875,30,4,61940,18,21.0,-1.272639,36.794723,-1.1771233,36.7608016,720,3065,7,1189
18468,14212,1882,3,Business,5,6,60728,5,6,60741,5,6,61574,5,6,62914,5,6,63661,7,22.0,-1.2958783,36.7928125,-1.2588775,36.8079744,427,747,13,2173
18469,14510,3560,3,Business,23,6,43079,23,6,43206,23,6,43754,23,6,44144,23,6,45443,5,26.4,-1.2584143,36.8048002,-1.279395,36.825364,436,1299,127,938
18470,3549,393,3,Business,8,5,51787,8,5,53741,8,5,54111,8,5,54280,8,5,56614,14,21.3,-1.3177547,36.8303703,-1.306378,36.7519845,294,2334,1954,539
18471,6767,2457,3,Business,8,4,52804,8,4,52852,8,4,52907,8,4,53669,8,4,54213,3,27.1,-1.2551895,36.7822034,-1.259919,36.808244,40,544,48,817
18472,20475,635,3,Business,23,3,53782,23,3,53841,23,3,54810,23,3,55758,23,3,57010,6,27.4,-1.3081376,36.8329772,-1.3229345,36.8566974,332,1252,59,1917
18473,18921,2454,3,Business,23,2,34951,23,2,34964,23,2,35412,23,2,35903,23,2,36618,5,23.25888921888938,-1.3090343,36.7662134,-1.2942023,36.7958179,306,715,13,939
18474,5683,3432,3,Business,11,2,31556,11,2,31634,11,2,33592,11,2,34052,11,2,34937,7,16.4,-1.2672588,36.8000252,-1.2941024,36.79578,676,885,78,2418
18475,20050,635,3,Business,21,2,47861,21,2,48415,21,2,48948,21,2,50460,21,2,51596,10,24.8,-1.3081376,36.8329772,-1.2602337,36.7990548,591,1136,554,2045
18476,20490,1066,1,Personal,13,3,53760,13,3,53853,13,3,54885,13,3,58412,13,3,59744,9,23.5,-1.303846,36.779483,-1.2579304,36.8019667,474,1332,93,4559
18477,22565,2801,3,Business,8,3,36652,8,3,36922,8,3,38565,8,3,38854,8,3,39691,7,23.25888921888938,-1.2879652,36.8203441,-1.2674274,36.7870827,341,837,270,1932
18478,26919,2279,3,Business,22,3,39459,22,3,39541,22,3,40195,22,3,40486,22,3,41552,7,23.2,-1.2897368,36.8226783,-1.2571472,36.7950633,119,1066,82,945
18479,3714,635,3,Business,5,4,30413,5,4,30442,5,4,30746,5,4,31213,5,4,32206,6,23.25888921888938,-1.2599563,36.7993439,-1.2987976,36.829477,726,993,29,771
18480,26739,2344,3,Business,21,3,45221,21,3,45468,21,3,45817,21,3,46521,21,3,50378,4,21.9,-1.2571472,36.7950633,-1.285324,36.812901,265,3857,247,1053
18481,8872,2883,2,Personal,18,2,41527,18,2,41537,18,2,41881,18,2,41948,18,2,42566,4,22.5,-1.2847099,36.7722345,-1.2854174,36.7951152,726,618,10,411
18482,24295,3599,3,Business,7,5,43308,7,5,43370,7,5,43967,7,5,44520,7,5,45777,5,23.25888921888938,-1.3302996,36.8707935,-1.3308323,36.8840398,675,1257,62,1150
18483,26410,2583,3,Personal,24,3,58561,24,3,58635,24,3,59252,24,3,59579,24,3,61447,17,23.25888921888938,-1.2607569,36.7747575,-1.2091559,36.7753704,245,1868,74,944
18484,11625,3689,3,Business,26,5,44087,26,5,44102,26,5,44558,26,5,45341,26,5,45735,1,23.25888921888938,-1.2584143,36.8048002,-1.2527958,36.8003131,566,394,15,1239
18485,18466,1280,3,Business,18,4,53478,18,4,53788,18,4,54311,18,4,54568,18,4,57278,5,23.25888921888938,-1.2551895,36.7822034,-1.2812416,36.8192411,16,2710,310,780
18486,11732,3718,3,Business,12,1,33304,12,1,33504,12,1,34320,12,1,35237,12,1,36007,5,19.2,-1.2906618,36.8131222,-1.2650027,36.8126242,85,770,200,1733
18487,6394,3055,1,Personal,26,3,59673,26,3,59733,26,3,61609,26,3,61717,26,3,63824,9,19.5,-1.2248308,36.8012573,-1.2169587,36.8420167,607,2107,60,1984
18488,3814,1803,1,Personal,28,1,45351,28,1,45416,28,1,47303,28,1,47899,28,1,50315,10,22.6,-1.308126,36.8532641,-1.2673271,36.8064451,480,2416,65,2483
18489,1079,265,3,Business,7,2,52133,7,2,52146,7,2,52286,7,2,53605,7,2,54529,7,23.25888921888938,-1.2673786,36.8081593,-1.300921,36.828195,291,924,13,1459
18490,19755,3135,3,Personal,6,3,44950,6,3,45118,6,3,47840,6,3,48039,6,3,50599,18,20.2,-1.277585,36.77145,-1.3194518,36.869396,474,2560,168,2921
18491,7227,2069,3,Business,23,4,59431,23,4,59522,23,4,59891,23,4,60991,23,4,63817,16,23.25888921888938,-1.303596,36.778378,-1.228911,36.881876,20,2826,91,1469
18492,12620,1495,1,Personal,16,2,38561,16,2,38603,16,2,38658,16,2,39922,16,2,40512,8,23.7,-1.2528485,36.7953722,-1.2698168,36.7421898,875,590,42,1319
18493,23245,439,3,Business,23,5,51953,23,5,52517,23,5,52856,23,5,53860,23,5,56958,23,26.5,-1.3323107,36.8692616,-1.2633397,36.7454238,810,3098,564,1343
18494,8632,1856,3,Business,20,4,40195,20,4,40276,20,4,40617,20,4,41200,20,4,41948,4,22.2,-1.2731645,36.7900343,-1.2649605,36.7981777,453,748,81,924
18495,991,633,3,Business,26,2,57605,26,2,58570,26,2,58578,26,2,59756,26,2,60068,4,28.4,-1.3077869,36.8443207,-1.3004062,36.829741,111,312,965,1186
18496,2697,3647,3,Business,6,4,55856,6,4,55914,6,4,56672,6,4,56859,6,4,58759,8,23.5,-1.272639,36.794723,-1.2653185,36.8358841,279,1900,58,945
18497,22782,3247,3,Business,23,4,32178,23,4,32205,23,4,32228,23,4,33026,23,4,34959,18,23.25888921888938,-1.2571472,36.7950633,-1.3244885,36.897792,576,1933,27,821
18498,24391,1721,3,Business,30,2,33349,30,2,33385,30,2,33941,30,2,35061,30,2,35523,2,23.25888921888938,-1.2571472,36.7950633,-1.2495931,36.8065087,607,462,36,1676
18499,9257,2195,3,Business,4,2,47001,4,2,48455,4,2,48902,4,2,49831,4,2,50836,12,22.6,-1.2600926,36.8088685,-1.228911,36.881876,75,1005,1454,1376
18500,5060,526,2,Personal,9,1,49619,9,1,49715,9,1,50096,9,1,51069,9,1,51917,4,21.2,-1.260232,36.807334,-1.2545163,36.8243717,147,848,96,1354
18501,18667,3211,3,Personal,27,3,38628,27,3,39260,27,3,40072,27,3,40969,27,3,42453,12,23.25888921888938,-1.2783772,36.8201617,-1.2245407,36.7583778,661,1484,632,1709
18502,27114,3711,3,Business,14,5,55535,14,5,55579,14,5,56118,14,5,56422,14,5,57773,8,23.5,-1.3014461,36.7661381,-1.2615888,36.7928732,550,1351,44,843
18503,20725,478,3,Business,6,2,35194,6,2,35258,6,2,35286,6,2,35561,6,2,37235,15,20.0,-1.2551895,36.7822034,-1.3216456,36.7145156,651,1674,64,303
18504,4168,3149,3,Business,6,3,55409,6,3,55474,6,3,55980,6,3,56598,6,3,57369,5,23.25888921888938,-1.3004062,36.829741,-1.3167113,36.8301563,72,771,65,1124
18505,17769,3283,3,Business,30,2,36963,30,2,37061,30,2,38018,30,2,38456,30,2,39873,13,23.25888921888938,-1.2296618,36.8438272,-1.2628473,36.781805,686,1417,98,1395
18506,17840,1148,3,Business,15,3,52963,15,3,52989,15,3,53695,15,3,54091,15,3,54666,3,25.7,-1.3104867,36.8495593,-1.311818,36.8638544,715,575,26,1102
18507,1972,3300,3,Business,9,2,33841,9,2,33855,9,2,34201,9,2,35163,9,2,36731,17,20.9,-1.228911,36.881876,-1.303596,36.778378,484,1568,14,1308
18508,18031,3122,1,Personal,26,2,37794,26,2,37805,26,2,38445,26,2,40019,26,2,43623,15,23.25888921888938,-1.2750992,36.8689002,-1.2670847,36.7858231,584,3604,11,2214
18509,13000,1849,3,Business,25,3,50989,25,3,51584,25,3,52549,25,3,52668,25,3,54792,7,17.6,-1.290894,36.822971,-1.2632534,36.7993427,144,2124,595,1084
18510,1803,3218,3,Business,18,5,33268,18,5,33357,18,5,35364,18,5,35606,18,5,36755,9,17.6,-1.2297202,36.8745508,-1.2765736,36.8513646,408,1149,89,2249
18511,6800,1075,3,Business,23,4,36422,23,4,37101,23,4,38255,23,4,38615,23,4,40125,5,23.2,-1.2527958,36.8003131,-1.2821422,36.8161565,139,1510,679,1514
18512,22820,649,3,Business,30,3,45973,30,3,46007,30,3,46291,30,3,47471,30,3,51036,9,22.5,-1.2964396,36.7760609,-1.2553615,36.7895376,474,3565,34,1464
18513,21429,2829,3,Business,20,3,47619,20,3,47717,20,3,48102,20,3,48206,20,3,51877,24,20.0,-1.3700383,36.9190174,-1.2579304,36.8019667,676,3671,98,489
18514,5601,3027,1,Personal,1,7,64148,1,7,64440,1,7,64807,1,7,65426,1,7,66367,9,21.0,-1.3100609,36.8205365,-1.2785902,36.7931582,105,941,292,986
18515,13015,2200,3,Business,27,3,56464,27,3,56841,27,3,57311,27,3,58402,27,3,58408,1,29.7,-1.290894,36.822971,-1.2824911,36.8218042,386,6,377,1561
18516,18627,53,3,Business,21,4,56218,21,4,56519,21,4,57131,21,4,58659,21,4,59680,5,26.5,-1.3004062,36.829741,-1.2770708,36.8231093,448,1021,301,2140
18517,25152,3711,3,Business,23,3,53721,23,3,53761,23,3,54076,23,3,54323,23,3,56236,3,27.5,-1.3012008,36.764868,-1.2765492,36.7669809,210,1913,40,562
18518,18173,2750,3,Business,28,3,33952,28,3,33977,28,3,34414,28,3,34518,28,3,36297,13,20.6,-1.275442,36.7660207,-1.3164106,36.6952197,470,1779,25,541
18519,25556,633,3,Business,27,2,32499,27,2,32986,27,2,33392,27,2,34041,27,2,34581,4,18.7,-1.3077869,36.8443207,-1.3004062,36.829741,535,540,487,1055
18520,23467,3184,3,Business,8,4,42580,8,4,42614,8,4,43418,8,4,43491,8,4,46418,17,26.5,-1.3396256,36.8863135,-1.2662453,36.8219775,712,2927,34,877
18521,24387,2532,3,Business,10,5,43021,10,5,43128,10,5,43275,10,5,43651,10,5,45685,6,23.25888921888938,-1.2824911,36.8218042,-1.2571472,36.7950633,709,2034,107,523
18522,20329,1205,3,Business,20,4,44256,20,4,44270,20,4,44790,20,4,46343,20,4,49029,19,24.3,-1.257309,36.8060084,-1.364303,36.74292,72,2686,14,2073
18523,1368,1102,3,Business,7,5,55011,7,5,56238,7,5,58069,7,5,58136,7,5,58952,8,23.25888921888938,-1.3253022,36.8803995,-1.3004062,36.829741,139,816,1227,1898
18524,14913,49,3,Business,15,4,58300,15,4,58491,15,4,59145,15,4,60153,15,4,62381,15,25.3,-1.329449,36.890451,-1.2906533,36.7830688,64,2228,191,1662
18525,3843,3334,1,Personal,9,4,57272,9,4,57609,9,4,59088,9,4,59200,9,4,60294,4,25.7,-1.2699442,36.8206553,-1.2640779,36.8402848,636,1094,337,1591
18526,486,2112,3,Business,5,1,55051,5,1,56856,5,1,58081,5,1,58735,5,1,60538,16,26.1,-1.2156006,36.8916865,-1.3285517,36.9018,101,1803,1805,1879
18527,7827,3291,3,Business,6,2,40981,6,2,41043,6,2,41365,6,2,42870,6,2,43663,5,24.8,-1.2628473,36.781805,-1.2600926,36.8088685,519,793,62,1827
18528,9550,3734,3,Personal,23,7,57594,23,7,57662,23,7,58451,23,7,58750,23,7,60493,12,25.0,-1.280951,36.7990799,-1.2235201,36.8020608,920,1743,68,1088
18529,744,1861,1,Personal,16,4,41655,16,4,41820,16,4,44070,16,4,44630,16,4,46918,11,14.7,-1.2311903,36.8102105,-1.2802618,36.8191684,213,2288,165,2810
18530,15349,635,3,Business,21,4,60227,21,4,60285,21,4,60460,21,4,61138,21,4,62004,6,28.6,-1.2602337,36.7990548,-1.2556108,36.8400444,709,866,58,853
18531,12082,1304,3,Business,28,4,53145,28,4,53228,28,4,53847,28,4,54136,28,4,55410,8,23.25888921888938,-1.2551895,36.7822034,-1.2883346,36.8148489,427,1274,83,908
18532,13528,863,3,Personal,3,5,38165,3,5,38263,3,5,38865,3,5,39053,3,5,39870,5,23.25888921888938,-1.2945684,36.8154093,-1.2963097,36.7688221,205,817,98,790
18533,3896,2801,3,Business,27,1,44054,27,1,44099,27,1,46126,27,1,46584,27,1,49084,9,21.0,-1.2674274,36.7870827,-1.294869,36.815327,155,2500,45,2485
18534,15307,693,2,Personal,15,1,31120,15,1,31159,15,1,31877,15,1,32282,15,1,32890,5,23.25888921888938,-1.2384447,36.7919924,-1.2580991,36.7941519,453,608,39,1123
18535,28065,510,3,Business,21,5,40119,21,5,40840,21,5,42655,21,5,42781,21,5,46172,12,22.9,-1.3052491,36.8223899,-1.2860183,36.8975338,31,3391,721,1941
18536,27038,2216,3,Business,1,1,47727,1,1,47742,1,1,48118,1,1,49196,1,1,50770,8,25.4,-1.2551895,36.7822034,-1.3038156,36.8122733,731,1574,15,1454
18537,13311,503,1,Business,22,3,59858,22,3,60112,22,3,60412,22,3,62046,22,3,67352,27,23.1,-1.3169591,36.7000029,-1.2859912,36.8756811,86,5306,254,1934
18538,4852,2978,3,Business,10,1,57183,10,1,57206,10,1,57658,10,1,57936,10,1,58606,4,18.7,-1.2551895,36.7822034,-1.2761764,36.8016961,881,670,23,730
18539,6712,1687,3,Business,12,1,46295,12,1,46480,12,1,47237,12,1,47495,12,1,48497,6,23.8,-1.2733004,36.7943468,-1.3014732,36.7781201,519,1002,185,1015
18540,11522,302,3,Business,21,5,64908,21,5,65399,21,5,65832,21,5,65991,21,5,69366,6,25.1,-1.2649605,36.7981777,-1.283016,36.8019595,279,3375,491,592
18541,23449,3238,3,Business,7,5,53458,7,5,53477,7,5,54200,7,5,54616,7,5,58241,25,23.25888921888938,-1.3976138,36.782966,-1.2539646,36.8362426,291,3625,19,1139
18542,27072,884,3,Personal,21,1,46558,21,1,46589,21,1,46703,21,1,47335,21,1,48862,19,25.3,-1.2640571,36.7883547,-1.1855927,36.843477,45,1527,31,746
18543,26894,2069,3,Business,21,4,37024,21,4,37031,21,4,37573,21,4,39047,21,4,39749,6,28.0,-1.2296618,36.8438272,-1.228911,36.881876,291,702,7,2016
18544,13230,2658,3,Business,1,5,54970,1,5,55455,1,5,57077,1,5,57510,1,5,61524,8,28.6,-1.2885029,36.825605,-1.2963097,36.7688221,88,4014,485,2055
18545,25684,472,3,Personal,22,5,30939,22,5,30993,22,5,31778,22,5,32282,22,5,35384,7,23.25888921888938,-1.293393,36.790237,-1.2684319,36.8165853,332,3102,54,1289
18546,205,1280,3,Business,3,5,56033,3,5,56171,3,5,56797,3,5,56898,3,5,58750,11,23.25888921888938,-1.2551895,36.7822034,-1.2639757,36.8602823,553,1852,138,727
18547,24561,53,3,Business,18,6,38644,18,6,38812,18,6,39408,18,6,40535,18,6,40973,4,21.0,-1.2770708,36.8231093,-1.3024505,36.8243189,843,438,168,1723
18548,7203,2411,3,Business,15,5,52586,15,5,52934,15,5,55162,15,5,55381,15,5,56091,6,17.9,-1.2864995,36.812605,-1.2615888,36.7928732,634,710,348,2447
18549,16924,2054,1,Personal,19,4,40001,19,4,40206,19,4,43650,19,4,43717,19,4,44893,11,20.2,-1.350736,36.8960004,-1.312734,36.855414,726,1176,205,3511
18550,24027,3689,1,Business,19,4,50600,19,4,50631,19,4,51067,19,4,51618,19,4,52037,2,20.4,-1.2571472,36.7950633,-1.2527958,36.8003131,100,419,31,987
18551,941,2150,3,Business,11,2,58541,11,2,58611,11,2,58921,11,2,59136,11,2,61204,15,22.4,-1.344446,36.756597,-1.265715,36.823815,257,2068,70,525
18552,19548,2665,3,Business,6,3,33177,6,3,33341,6,3,33353,6,3,34030,6,3,35545,12,17.0,-1.3241728,36.7210093,-1.3021506,36.7999444,515,1515,164,689
18553,12244,1244,3,Business,16,3,57142,16,3,57219,16,3,57830,16,3,58496,16,3,59483,8,26.9,-1.272828,36.816608,-1.303596,36.778378,247,987,77,1277
18554,26008,53,3,Business,27,3,45008,27,3,45114,27,3,46160,27,3,46847,27,3,48073,5,26.1,-1.3004062,36.829741,-1.2770708,36.8231093,603,1226,106,1733
18555,23748,1207,3,Business,26,2,66129,26,2,66156,26,2,66350,26,2,66577,26,2,67765,12,28.4,-1.2629666,36.8068369,-1.2351541,36.8748505,178,1188,27,421
18556,24355,2271,3,Business,8,5,55123,8,5,55643,8,5,56657,8,5,56988,8,5,58548,11,27.1,-1.228911,36.881876,-1.293515,36.897607,581,1560,520,1345
18557,10397,3698,3,Business,10,5,57968,10,5,58678,10,5,59188,10,5,59465,10,5,60221,7,23.25888921888938,-1.3244885,36.897792,-1.3190102,36.9230693,377,756,710,787
18558,18933,867,3,Business,7,3,50800,7,3,53089,7,3,53720,7,3,54054,7,3,55524,9,28.1,-1.2574219,36.7927073,-1.306378,36.7519845,956,1470,2289,965
18559,25955,1271,3,Business,7,5,57553,7,5,57573,7,5,57698,7,5,59144,7,5,61473,23,26.8,-1.3244885,36.897792,-1.3107918,36.761794,46,2329,20,1571
18560,16200,393,3,Business,20,4,34898,20,4,37454,20,4,38124,20,4,38633,20,4,40203,11,22.4,-1.3167113,36.8301563,-1.2574219,36.7927073,931,1570,2556,1179
18561,16131,3217,3,Business,13,3,56629,13,3,56659,13,3,56790,13,3,57471,13,3,60309,21,23.5,-1.214328,36.7911903,-1.2216291,36.9180415,101,2838,30,812
18562,4973,2069,3,Business,26,2,50956,26,2,50985,26,2,51041,26,2,52060,26,2,53476,14,31.1,-1.3033561,36.8163631,-1.228911,36.881876,614,1416,29,1075
18563,14123,3573,1,Personal,3,5,54731,3,5,54755,3,5,55961,3,5,57064,3,5,57972,4,25.2,-1.273854,36.8003368,-1.263194,36.797624,795,908,24,2309
18564,13255,3635,1,Business,16,2,32148,16,2,32181,16,2,32577,16,2,34246,16,2,34649,3,23.25888921888938,-1.2584143,36.8048002,-1.2615888,36.7928732,453,403,33,2065
18565,16722,867,3,Business,11,1,36471,11,1,36498,11,1,36578,11,1,38535,11,1,38847,10,26.8,-1.3004062,36.829741,-1.2991441,36.7528804,403,312,27,2037
18566,11481,2330,3,Business,30,3,41575,30,3,41640,30,3,42760,30,3,43425,30,3,45139,8,25.1,-1.3015197,36.7658456,-1.3270197,36.7037303,622,1714,65,1785
18567,17946,1246,3,Business,20,1,56840,20,1,56873,20,1,56943,20,1,58592,20,1,58689,2,23.25888921888938,-1.2571472,36.7950633,-1.2665327,36.8108799,536,97,33,1719
18568,19436,3347,1,Personal,1,3,48210,1,3,48220,1,3,48888,1,3,49204,1,3,49991,3,23.9,-1.2854406,36.789409,-1.280467,36.7859296,465,787,10,984
18569,7800,391,3,Business,2,2,37266,2,2,37674,2,2,38634,2,2,41075,2,2,42426,5,26.4,-1.300921,36.828195,-1.2784063,36.8222933,668,1351,408,3401
18570,22409,868,3,Business,14,5,57179,14,5,57210,14,5,58016,14,5,58513,14,5,58968,3,23.2,-1.2783849,36.8163445,-1.2663631,36.8163329,462,455,31,1303
18571,22100,3606,3,Business,1,4,57817,1,4,57865,1,4,58125,1,4,58424,1,4,59128,5,23.25888921888938,-1.2628638,36.8070399,-1.256522,36.7864132,647,704,48,559
18572,24005,306,1,Personal,5,7,55488,5,7,55971,5,7,56918,5,7,57153,5,7,58285,8,21.1,-1.3159197,36.8516724,-1.3086326,36.8080886,890,1132,483,1182
18573,28099,3686,3,Business,12,2,39618,12,2,39652,12,2,45611,12,2,45771,12,2,46869,7,28.0,-1.2551895,36.7822034,-1.2885417,36.8100523,268,1098,34,6119
18574,5470,3214,3,Business,13,2,37274,13,2,37949,13,2,38706,13,2,39042,13,2,40740,11,22.4,-1.308231,36.857306,-1.2604408,36.8206328,675,1698,675,1093
18575,24443,496,3,Business,7,2,36760,7,2,36793,7,2,39624,7,2,41385,7,2,43827,22,23.25888921888938,-1.2571472,36.7950633,-1.374163,36.913444,520,2442,33,4592
18576,13088,1651,3,Business,31,5,39348,31,5,39388,31,5,40284,31,5,40521,31,5,42576,21,21.9,-1.3562374,36.9042954,-1.2551895,36.7822034,96,2055,40,1133
18577,10007,302,3,Business,17,4,71363,17,4,71380,17,4,71739,17,4,72558,17,4,73169,7,22.6,-1.2649605,36.7981777,-1.2996632,36.789841,801,611,17,1178
18578,2642,1271,3,Business,18,2,50234,18,2,50239,18,2,50548,18,2,50758,18,2,52758,24,25.8,-1.3244885,36.897792,-1.3108386,36.7555239,675,2000,5,519
18579,4547,1209,3,Business,25,5,49981,25,5,50001,25,5,50856,25,5,51412,25,5,52981,9,29.1,-1.2574219,36.7927073,-1.3004062,36.829741,238,1569,20,1411
18580,21016,2523,3,Business,11,1,38618,11,1,38646,11,1,38925,11,1,39290,11,1,40124,4,26.6,-1.2551895,36.7822034,-1.2754343,36.8127158,520,834,28,644
18581,25695,2701,3,Business,22,2,43969,22,2,45152,22,2,47226,22,2,47479,22,2,48751,10,24.2,-1.2283403,36.8822756,-1.2765736,36.8513646,870,1272,1183,2327
18582,21750,1961,3,Business,30,2,54443,30,2,54778,30,2,57059,30,2,57681,30,2,58837,8,23.25888921888938,-1.344446,36.756597,-1.3181159,36.7101559,864,1156,335,2903
18583,12051,517,3,Business,8,6,36901,8,6,37128,8,6,37219,8,6,37863,8,6,39001,11,17.0,-1.3228003,36.8306435,-1.2638185,36.7930057,211,1138,227,735
18584,4197,1668,3,Personal,4,4,60553,4,4,60564,4,4,61085,4,4,61458,4,4,63039,8,23.25888921888938,-1.2987976,36.829477,-1.2551895,36.7822034,532,1581,11,894
18585,20355,3221,3,Business,11,4,36714,11,4,36723,11,4,36994,11,4,37639,11,4,40471,5,18.3,-1.2764851,36.8007126,-1.2551895,36.7822034,345,2832,9,916
18586,26667,3599,3,Business,29,4,39039,29,4,39946,29,4,40911,29,4,41038,29,4,43078,11,21.6,-1.3302996,36.8707935,-1.3136452,36.7974014,609,2040,907,1092
18587,18369,1341,3,Business,15,6,41584,15,6,41589,15,6,41950,15,6,42428,15,6,43623,11,19.0,-1.303596,36.778378,-1.3306113,36.8480521,109,1195,5,839
18588,16076,2567,1,Personal,29,3,57005,29,3,57053,29,3,57984,29,3,58140,29,3,60384,9,18.9,-1.3182646,36.8213128,-1.260039,36.8159152,224,2244,48,1087
18589,10619,3641,3,Business,23,5,39650,23,5,43899,23,5,43902,23,5,45172,23,5,45664,4,24.3,-1.2571472,36.7950633,-1.2787985,36.819832,813,492,4249,1273
18590,19062,2584,1,Personal,23,4,56040,23,4,60845,23,4,61067,23,4,61447,23,4,62300,6,19.9,-1.2560455,36.7800867,-1.2679786,36.8126862,726,853,4805,602
18591,7881,393,3,Business,16,4,40351,16,4,40412,16,4,41412,16,4,41629,16,4,42083,4,23.25888921888938,-1.3167113,36.8301563,-1.3004062,36.829741,910,454,61,1217
18592,25395,3222,3,Business,29,3,49641,29,3,49689,29,3,49900,29,3,50795,29,3,52430,7,21.3,-1.2551895,36.7822034,-1.2887816,36.8088885,330,1635,48,1106
18593,24229,1724,3,Business,16,4,53869,16,4,54046,16,4,54934,16,4,56396,16,4,56849,7,23.25888921888938,-1.2551895,36.7822034,-1.2823851,36.8186472,709,453,177,2350
18594,11061,1075,3,Business,4,4,56774,4,4,56786,4,4,56877,4,4,57049,4,4,57705,3,27.3,-1.2551895,36.7822034,-1.2527958,36.8003131,318,656,12,263
18595,11541,1104,2,Business,17,1,32433,17,1,32452,17,1,32871,17,1,32980,17,1,33477,4,18.1,-1.2639238,36.7889646,-1.2551895,36.7822034,731,497,19,528
18596,7164,1920,3,Business,19,1,33201,19,1,33206,19,1,33372,19,1,34596,19,1,36393,17,19.2,-1.2551895,36.7822034,-1.3323949,36.8915219,932,1797,5,1390
18597,16735,1500,3,Business,7,5,59258,7,5,59430,7,5,59757,7,5,60295,7,5,61749,10,21.6,-1.2991441,36.7528804,-1.2638185,36.7930057,161,1454,172,865
18598,24362,53,3,Business,21,4,46895,21,4,46982,21,4,47721,21,4,50296,21,4,51461,5,26.3,-1.3004062,36.829741,-1.2770708,36.8231093,660,1165,87,3314
18599,10650,3599,3,Business,30,4,39976,30,4,40044,30,4,41068,30,4,41784,30,4,43984,13,23.25888921888938,-1.3302996,36.8707935,-1.2735236,36.7992196,516,2200,68,1740
18600,10937,2008,3,Business,30,1,51537,30,1,51675,30,1,52812,30,1,53004,30,1,55151,6,20.4,-1.2508229,36.7895263,-1.2810199,36.8150453,754,2147,138,1329
18601,1809,510,3,Business,30,5,34198,30,5,34517,30,5,35970,30,5,36255,30,5,37429,6,19.0,-1.290683,36.871041,-1.2860183,36.8975338,114,1174,319,1738
18602,24671,1921,1,Personal,29,6,47531,29,6,47590,29,6,48325,29,6,48744,29,6,49531,3,28.0,-1.2728947,36.8079426,-1.2784495,36.7981729,584,787,59,1154
18603,7759,432,3,Business,27,1,50559,27,1,51460,27,1,53234,27,1,53359,27,1,55990,9,23.2,-1.3012008,36.764868,-1.290894,36.822971,544,2631,901,1899
18604,9562,2066,3,Business,30,1,40326,30,1,42160,30,1,43304,30,1,43408,30,1,45945,16,22.8,-1.316961,36.820337,-1.3319686,36.9115553,520,2537,1834,1248
18605,24925,3355,3,Business,9,1,56986,9,1,58192,9,1,58555,9,1,58866,9,1,60543,12,21.0,-1.3052491,36.8223899,-1.2927792,36.9053492,116,1677,1206,674
18606,16646,868,3,Business,2,4,32676,2,4,32698,2,4,32933,2,4,33662,2,4,34388,4,23.25888921888938,-1.2600926,36.8088685,-1.265715,36.823815,178,726,22,964
18607,6932,157,3,Business,17,1,47929,17,1,47948,17,1,48216,17,1,48436,17,1,49625,10,24.9,-1.264272,36.7978791,-1.2248308,36.8012573,882,1189,19,488
18608,17192,496,3,Business,3,5,43591,3,5,43680,3,5,44332,3,5,44458,3,5,45840,6,23.25888921888938,-1.282937,36.7816984,-1.2551895,36.7822034,741,1382,89,778
18609,7958,3291,3,Business,20,1,51410,20,1,51448,20,1,51468,20,1,52151,20,1,53166,12,23.25888921888938,-1.331619,36.847976,-1.2600926,36.8088685,598,1015,38,703
18610,12852,1874,3,Business,16,5,55235,16,5,59116,16,5,60155,16,5,60724,16,5,61680,5,26.2,-1.2571472,36.7950633,-1.2431489,36.7957656,427,956,3881,1608
18611,27702,1568,3,Business,4,1,56947,4,1,57006,4,1,57800,4,1,59753,4,1,60590,6,25.9,-1.2897368,36.8226783,-1.3017947,36.8497892,187,837,59,2747
18612,961,2190,3,Business,26,5,41199,26,5,41241,26,5,42037,26,5,42697,26,5,44588,7,23.25888921888938,-1.301953,36.788458,-1.2694398,36.7624483,613,1891,42,1456
18613,12507,3517,3,Business,13,3,31349,13,3,31361,13,3,32313,13,3,36188,13,3,37889,16,17.5,-1.300921,36.828195,-1.3882008,36.7699445,487,1701,12,4827
18614,19813,2330,3,Business,8,3,58395,8,3,58519,8,3,58908,8,3,59190,8,3,60127,9,23.25888921888938,-1.3040812,36.7924217,-1.2645318,36.7981775,520,937,124,671
18615,19424,1746,3,Business,10,1,63558,10,1,65510,10,1,65844,10,1,66276,10,1,67413,6,18.9,-1.296797,36.7764525,-1.2819174,36.821821,848,1137,1952,766
18616,4069,1356,3,Business,26,2,48414,26,2,48477,26,2,49799,26,2,49950,26,2,52141,17,29.5,-1.2000097,36.7670515,-1.2949474,36.8270407,959,2191,63,1473
18617,18867,3599,3,Business,5,5,52339,5,5,52461,5,5,53196,5,5,54305,5,5,57008,13,27.4,-1.3302996,36.8707935,-1.2567393,36.8143232,548,2703,122,1844
18618,27244,533,3,Business,5,3,45579,5,3,46713,5,3,46958,5,3,48325,5,3,50391,8,22.4,-1.2803414,36.8265456,-1.2765492,36.7669809,845,2066,1134,1612
18619,5608,346,3,Business,16,4,39929,16,4,43705,16,4,45547,16,4,45610,16,4,47880,15,23.25888921888938,-1.3562374,36.9042954,-1.28878,36.8168312,211,2270,3776,1905
18620,8842,1661,1,Personal,12,5,50409,12,5,50418,12,5,51617,12,5,51720,12,5,53541,18,27.3,-1.2825223,36.9014566,-1.2611642,36.7949932,622,1821,9,1302
18621,16663,3323,2,Personal,29,3,26823,29,3,28460,29,3,28730,29,3,29713,29,3,32073,6,15.6,-1.2885364,36.7995016,-1.269534,36.80697,722,2360,1637,1253
18622,17932,1705,3,Business,15,5,40717,15,5,40790,15,5,41812,15,5,41990,15,5,45124,9,26.3,-1.2551895,36.7822034,-1.2325706,36.8083923,436,3134,73,1200
18623,133,562,3,Business,12,5,43389,12,5,44738,12,5,48543,12,5,48715,12,5,50510,8,26.3,-1.3227181,36.8528097,-1.2811695,36.8200313,155,1795,1349,3977
18624,9569,2897,1,Personal,3,5,39160,3,5,39376,3,5,40747,3,5,41137,3,5,45395,23,21.4,-1.1683284,36.9487572,-1.2690947,36.7992995,447,4258,216,1761
18625,2512,1103,3,Business,31,3,56297,31,3,56489,31,3,56935,31,3,59026,31,3,60231,7,26.9,-1.290894,36.822971,-1.2551895,36.7822034,726,1205,192,2537
18626,18426,1724,3,Business,31,5,45756,31,5,46653,31,5,47675,31,5,47869,31,5,49373,7,21.9,-1.2551895,36.7822034,-1.2870829,36.8170741,341,1504,897,1216
18627,22845,250,2,Personal,23,3,50719,23,3,50757,23,3,51240,23,3,51403,23,3,52175,2,22.2,-1.2642903,36.8002137,-1.269534,36.80697,473,772,38,646
18628,20339,2700,3,Business,10,1,38320,10,1,39377,10,1,40041,10,1,41415,10,1,42581,7,23.7,-1.25537,36.7756,-1.2845835,36.8079121,669,1166,1057,2038
18629,20026,2869,3,Business,22,3,37197,22,3,37213,22,3,37364,22,3,37975,22,3,39143,10,23.0,-1.2584143,36.8048002,-1.3014461,36.7661381,411,1168,16,762
18630,20108,1244,3,Business,13,6,41617,13,6,41693,13,6,42064,13,6,44903,13,6,46203,8,26.1,-1.272828,36.816608,-1.303596,36.778378,713,1300,76,3210
18631,27463,1849,3,Business,5,2,33841,5,2,34512,5,2,35235,5,2,35675,5,2,37099,9,17.9,-1.290894,36.822971,-1.3014461,36.7661381,808,1424,671,1163
18632,14955,1850,3,Business,4,1,51683,4,1,51702,4,1,51712,4,1,54418,4,1,55361,9,28.7,-1.3047132,36.8089553,-1.2551895,36.7822034,704,943,19,2716
18633,7846,393,3,Business,25,1,31906,25,1,31991,25,1,32000,25,1,33479,25,1,34885,11,23.25888921888938,-1.3167113,36.8301563,-1.2638185,36.7930057,842,1406,85,1488
18634,27421,2271,3,Business,17,3,40640,17,3,40670,17,3,41510,17,3,42400,17,3,44021,20,23.25888921888938,-1.2628473,36.781805,-1.293515,36.897607,4,1621,30,1730
18635,8828,3517,3,Business,21,3,54755,21,3,54766,21,3,54783,21,3,58484,21,3,60081,15,23.4,-1.300921,36.828195,-1.3882008,36.7699445,293,1597,11,3718
18636,18511,700,3,Business,3,1,46159,3,1,46434,3,1,47821,3,1,48308,3,1,49141,11,22.2,-1.3319858,36.7533,-1.3205164,36.8098882,24,833,275,1874
18637,3010,1500,3,Business,20,3,39054,20,3,39074,20,3,39243,20,3,39984,20,3,41407,8,26.5,-1.3004062,36.829741,-1.2638185,36.7930057,411,1423,20,910
18638,22693,1469,3,Business,21,5,48091,21,5,48127,21,5,48485,21,5,49134,21,5,49811,6,27.1,-1.2571472,36.7950633,-1.269974,36.7753728,561,677,36,1007
18639,10855,728,2,Personal,17,5,53246,17,5,53253,17,5,53291,17,5,54199,17,5,55035,6,20.0,-1.2853965,36.8183118,-1.3090663,36.8136865,213,836,7,946
18640,1901,2271,3,Business,7,1,49068,7,1,49233,7,1,49850,7,1,51163,7,1,52855,14,26.6,-1.272828,36.816608,-1.293515,36.897607,547,1692,165,1930
18641,8430,1496,1,Personal,12,5,75098,12,5,75147,12,5,76404,12,5,77687,12,5,78893,14,21.9,-1.207546,36.7913976,-1.2544802,36.8111822,103,1206,49,2540
18642,5065,2195,3,Business,3,1,38052,3,1,38075,3,1,38661,3,1,40166,3,1,43189,12,21.6,-1.266837,36.799249,-1.228911,36.881876,829,3023,23,2091
18643,22673,1389,3,Business,6,1,58014,6,1,58023,6,1,58772,6,1,59317,6,1,60508,14,23.25888921888938,-1.2584143,36.8048002,-1.207546,36.7913976,205,1191,9,1294
18644,11230,3521,3,Business,4,1,47326,4,1,47414,4,1,48334,4,1,48828,4,1,49325,2,28.6,-1.2682478,36.8072852,-1.2696908,36.81519,547,497,88,1414
18645,28238,1133,3,Business,14,5,36718,14,5,36729,14,5,38493,14,5,39025,14,5,40797,17,24.2,-1.2194214,36.8915642,-1.2571472,36.7950633,447,1772,11,2296
18646,21762,190,3,Business,10,5,53672,10,5,53890,10,5,54246,10,5,54890,10,5,55521,10,23.25888921888938,-1.3270347,36.8667362,-1.3456714,36.9193692,349,631,218,1000
18647,20278,393,3,Business,28,1,58202,28,1,58233,28,1,58237,28,1,58592,28,1,60404,14,26.2,-1.3167113,36.8301563,-1.306378,36.7519845,523,1812,31,359
18648,23270,1469,3,Business,13,5,60509,13,5,60552,13,5,61471,13,5,61550,13,5,62534,3,19.4,-1.2551895,36.7822034,-1.2681821,36.8011109,937,984,43,998
18649,10728,3689,3,Business,29,6,46449,29,6,46459,29,6,46958,29,6,47430,29,6,48088,2,25.2,-1.2527958,36.8003131,-1.2661264,36.8030359,881,658,10,971
18650,6945,2278,1,Personal,26,3,44083,26,3,44187,26,3,45091,26,3,45319,26,3,46689,6,23.8,-1.2857117,36.7968296,-1.3012237,36.8261656,548,1370,104,1132
18651,17633,1738,3,Personal,27,1,52096,27,1,52152,27,1,53405,27,1,53889,27,1,56166,14,23.1,-1.312261,36.794658,-1.2315181,36.8140543,548,2277,56,1737
18652,15054,3709,2,Personal,8,6,59690,8,6,59886,8,6,61317,8,6,61701,8,6,62480,7,23.0,-1.2854453,36.8188363,-1.2882727,36.7705122,208,779,196,1815
18653,17310,3586,3,Business,15,1,30831,15,1,31425,15,1,32004,15,1,32825,15,1,34754,11,23.25888921888938,-1.2914795,36.8248973,-1.275442,36.7660207,208,1929,594,1400
18654,4476,53,3,Business,15,1,48482,15,1,48723,15,1,53008,15,1,53891,15,1,55891,6,23.25888921888938,-1.3077869,36.8443207,-1.2770708,36.8231093,435,2000,241,5168
18655,5064,3404,3,Business,8,5,43484,8,5,43530,8,5,44060,8,5,44178,8,5,45094,4,24.4,-1.279395,36.825364,-1.259697,36.800802,692,916,46,648
18656,21180,1469,3,Business,14,3,44344,14,3,44383,14,3,45252,14,3,45852,14,3,47738,8,24.5,-1.2551895,36.7822034,-1.300722,36.816865,579,1886,39,1469
18657,14236,3565,3,Business,9,6,30693,9,6,30706,9,6,31251,9,6,31343,9,6,34170,26,20.2,-1.2844665,36.7866113,-1.4010166,36.9457687,326,2827,13,637
18658,19378,1340,3,Business,14,5,59254,14,5,60362,14,5,61118,14,5,61552,14,5,64459,19,23.1,-1.2707179,36.7979713,-1.3138705,36.894434,622,2907,1108,1190
18659,22650,2931,3,Business,30,2,36066,30,2,36079,30,2,37921,30,2,38601,30,2,41103,23,23.25888921888938,-1.3442152,36.9199984,-1.2452664,36.8028541,585,2502,13,2522
18660,26984,868,3,Business,7,5,37866,7,5,38163,7,5,38824,7,5,39914,7,5,41158,9,25.6,-1.318062,36.849326,-1.265715,36.823815,622,1244,297,1751
18661,6702,157,3,Business,9,2,55638,9,2,56223,9,2,58376,9,2,58575,9,2,59865,8,30.7,-1.225322,36.80855,-1.2615888,36.7928732,668,1290,585,2352
18662,27664,2066,3,Business,18,4,41085,18,4,41109,18,4,41720,18,4,42125,18,4,44216,8,23.25888921888938,-1.3210189,36.8410551,-1.2960265,36.8780276,233,2091,24,1016
18663,10554,571,3,Business,23,3,39702,23,3,39720,23,3,39962,23,3,41037,23,3,42653,8,23.25888921888938,-1.3236332,36.701152,-1.2981318,36.718714,210,1616,18,1317
18664,24896,2330,3,Business,31,3,48523,31,3,48528,31,3,48963,31,3,49401,31,3,50127,9,27.1,-1.257901,36.7984382,-1.2681093,36.7438917,237,726,5,873
18665,24548,2527,2,Personal,26,2,42469,26,2,42506,26,2,43007,26,2,43175,26,2,44492,4,23.25888921888938,-1.2603714,36.7893387,-1.2672588,36.8000252,738,1317,37,669
18666,9948,2858,3,Business,31,3,39225,31,3,39247,31,3,42792,31,3,43061,31,3,46529,18,24.7,-1.3164106,36.6952197,-1.2605635,36.7985638,783,3468,22,3814
18667,11587,1245,3,Business,31,3,45157,31,3,45257,31,3,47068,31,3,48011,31,3,52726,20,24.9,-1.300921,36.828195,-1.3223908,36.6773487,64,4715,100,2754
18668,15862,2987,3,Business,30,2,41881,30,2,41902,30,2,42706,30,2,43289,30,2,43947,3,22.1,-1.253654,36.8204391,-1.270212,36.8210877,125,658,21,1387
18669,20486,154,2,Business,12,5,32973,12,5,32983,12,5,33020,12,5,33955,12,5,38073,16,18.8,-1.2960265,36.8780276,-1.2551895,36.7822034,43,4118,10,972
18670,15327,1715,3,Business,6,5,53371,6,5,53804,6,5,54928,6,5,55268,6,5,59851,7,22.7,-1.2608993,36.799246,-1.3022591,36.8074294,140,4583,433,1464
18671,2391,2219,3,Business,18,4,42770,18,4,42815,18,4,43157,18,4,43676,18,4,44454,6,23.25888921888938,-1.2946359,36.8352718,-1.3272104,36.8528418,85,778,45,861
18672,1429,733,3,Business,29,1,53198,29,1,53278,29,1,53814,29,1,54109,29,1,55781,7,23.25888921888938,-1.2551895,36.7822034,-1.2939186,36.8069693,205,1672,80,831
18673,4265,3239,3,Personal,30,3,37292,30,3,37871,30,3,38394,30,3,38903,30,3,41256,9,22.3,-1.2839322,36.8292426,-1.2950763,36.7645525,742,2353,579,1032
18674,785,2330,3,Business,10,3,66769,10,3,66907,10,3,67985,10,3,68236,10,3,71081,22,27.3,-1.2124582,36.802894,-1.2854537,36.9051024,72,2845,138,1329
18675,20669,3635,1,Business,25,2,57077,25,2,57092,25,2,57328,25,2,58056,25,2,58391,3,27.2,-1.2584143,36.8048002,-1.2615888,36.7928732,446,335,15,964
18676,12128,531,1,Personal,16,1,46877,16,1,46897,16,1,46991,16,1,49669,16,1,50553,6,22.6,-1.2864733,36.8239937,-1.2615983,36.8083096,726,884,20,2772
18677,9302,1502,1,Business,7,1,44635,7,1,45130,7,1,45418,7,1,46820,7,1,47697,4,21.7,-1.2913996,36.8274442,-1.3101624,36.818915,742,877,495,1690
18678,2819,2801,3,Business,20,3,40050,20,3,40093,20,3,40193,20,3,40555,20,3,42764,9,26.6,-1.2595422,36.7871178,-1.307726,36.839117,518,2209,43,462
18679,20288,1363,3,Business,14,2,37977,14,2,38013,14,2,40571,14,2,42310,14,2,43288,6,23.25888921888938,-1.3357287,36.8655463,-1.3004062,36.829741,448,978,36,4297
18680,3608,3462,1,Personal,16,2,35514,16,2,35536,16,2,36300,16,2,36825,16,2,38816,14,23.25888921888938,-1.255683,36.813771,-1.2137605,36.8788137,789,1991,22,1289
18681,24086,2330,3,Business,25,4,62321,25,4,62332,25,4,65232,25,4,65514,25,4,68578,16,23.25888921888938,-1.2915247,36.8055757,-1.2925641,36.8976449,678,3064,11,3182
18682,95,2523,3,Business,6,4,50842,6,4,50899,6,4,51232,6,4,51489,6,4,51827,2,21.5,-1.2551895,36.7822034,-1.2567251,36.798841,709,338,57,590
18683,24059,2330,3,Business,28,2,49636,28,2,49884,28,2,51277,28,2,53766,28,2,53769,15,23.3,-1.3015197,36.7658456,-1.2336843,36.8007259,652,3,248,3882
18684,24503,3186,3,Business,26,4,56313,26,4,56362,26,4,56792,26,4,57034,26,4,57757,4,21.9,-1.2980229,36.78865,-1.298529,36.816482,207,723,49,672
18685,24011,868,3,Business,8,1,43266,8,1,43332,8,1,45372,8,1,45509,8,1,46824,4,27.8,-1.2600926,36.8088685,-1.265715,36.823815,547,1315,66,2177
18686,13697,3560,3,Business,22,2,35076,22,2,36953,22,2,37214,22,2,37499,22,2,38142,4,17.5,-1.2793686,36.8259233,-1.303105,36.819135,932,643,1877,546
18687,14739,415,3,Personal,26,3,51933,26,3,51956,26,3,53786,26,3,54053,26,3,56753,15,27.0,-1.2773427,36.8266035,-1.1708105,36.8336102,31,2700,23,2097
18688,3397,2523,3,Business,13,5,53746,13,5,53768,13,5,54642,13,5,54863,13,5,58276,19,19.0,-1.2551895,36.7822034,-1.3327654,36.8853117,465,3413,22,1095
18689,1258,3283,3,Business,22,5,32675,22,5,32706,22,5,33107,22,5,34368,22,5,36901,13,23.25888921888938,-1.2296618,36.8438272,-1.2628473,36.781805,101,2533,31,1662
18690,212,2987,3,Business,3,4,54942,3,4,54968,3,4,55125,3,4,55239,3,4,56950,4,25.8,-1.270212,36.8210877,-1.2534301,36.8000983,829,1711,26,271
18691,12676,2866,3,Business,29,5,39415,29,5,39446,29,5,39604,29,5,40212,29,5,41713,10,19.6,-1.2551895,36.7822034,-1.2953162,36.7828041,16,1501,31,766
18692,3080,2457,3,Business,23,4,53175,23,4,53198,23,4,53231,23,4,54171,23,4,55548,10,24.7,-1.2551895,36.7822034,-1.3025299,36.7901963,19,1377,23,973
18693,21251,1500,3,Business,11,4,55672,11,4,58369,11,4,58787,11,4,59098,11,4,59772,6,27.0,-1.2770708,36.8231093,-1.2638185,36.7930057,291,674,2697,729
18694,2686,53,3,Business,22,5,36287,22,5,36386,22,5,37142,22,5,39156,22,5,40212,5,28.7,-1.3004062,36.829741,-1.2770708,36.8231093,812,1056,99,2770
18695,20711,3320,3,Business,17,5,30277,17,5,30302,17,5,30554,17,5,31419,17,5,32806,7,14.2,-1.3080092,36.8284543,-1.2722716,36.800345,179,1387,25,1117
18696,21746,2854,3,Business,4,2,30300,4,2,30432,4,2,30456,4,2,31446,4,2,31861,1,16.1,-1.2963097,36.7688221,-1.2948781,36.7844523,875,415,132,1014
18697,18121,1081,3,Business,13,3,39533,13,3,39572,13,3,39584,13,3,41757,13,3,43285,10,25.0,-1.2551895,36.7822034,-1.2967108,36.7871135,576,1528,39,2185
18698,16254,2008,3,Business,4,5,53811,4,5,53836,4,5,54313,4,5,55020,4,5,57553,17,23.25888921888938,-1.2508229,36.7895263,-1.2485923,36.6590962,283,2533,25,1184
18699,3420,3126,1,Personal,16,1,66439,16,1,66517,16,1,67232,16,1,67869,16,1,68645,3,23.25888921888938,-1.2597777,36.7927743,-1.2659149,36.8054322,116,776,78,1352
18700,23550,3283,3,Business,15,3,34978,15,3,34994,15,3,35203,15,3,37018,15,3,37794,5,16.3,-1.2600926,36.8088685,-1.2628473,36.781805,179,776,16,2024
18701,3384,2093,3,Personal,17,4,45623,17,4,46551,17,4,48574,17,4,48989,17,4,52883,33,27.9,-1.1954821,36.9064954,-1.287085,36.7232836,691,3894,928,2438
18702,12002,2956,3,Business,20,1,57029,20,1,57051,20,1,57745,20,1,58843,20,1,59145,1,23.25888921888938,-1.2571472,36.7950633,-1.2584143,36.8048002,448,302,22,1792
18703,20827,3201,3,Business,7,4,31135,7,4,31253,7,4,34768,7,4,35048,7,4,38580,17,23.25888921888938,-1.3463042,36.768164,-1.2584143,36.8048002,831,3532,118,3795
18704,1096,867,3,Business,22,5,42099,22,5,42218,22,5,43737,22,5,44568,22,5,46304,9,28.5,-1.2638185,36.7930057,-1.2991441,36.7528804,118,1736,119,2350
18705,9300,3462,1,Personal,6,6,35118,6,6,35156,6,6,36223,6,6,36387,6,6,37352,6,19.3,-1.255683,36.813771,-1.2842863,36.7951109,427,965,38,1231
18706,8859,1787,3,Business,6,3,39307,6,3,39322,6,3,39362,6,3,41525,6,3,43298,12,23.25888921888938,-1.2285835,36.8826468,-1.260039,36.8159152,8,1773,15,2203
18707,8916,3291,3,Business,3,4,31778,3,4,31935,3,4,32596,3,4,33509,3,4,34840,12,20.5,-1.331619,36.847976,-1.2600926,36.8088685,263,1331,157,1574
18708,26565,970,3,Business,16,4,29355,16,4,29488,16,4,30368,16,4,30439,16,4,32353,6,23.25888921888938,-1.2551895,36.7822034,-1.280753,36.8191175,617,1914,133,951
18709,17260,393,3,Business,8,2,41725,8,2,41735,8,2,41744,8,2,45383,8,2,45386,11,23.3,-1.3167113,36.8301563,-1.2574219,36.7927073,10,3,10,3648
18710,13877,2743,1,Personal,13,1,55122,13,1,55230,13,1,55767,13,1,56424,13,1,57727,9,19.7,-1.2615048,36.8116724,-1.290059,36.7703475,427,1303,108,1194
18711,14842,2132,3,Business,3,3,56663,3,3,56732,3,3,57258,3,3,59524,3,3,64055,12,27.2,-1.2384056,36.8718698,-1.2954051,36.8364161,448,4531,69,2792
18712,18749,590,3,Business,25,1,42322,25,1,42355,25,1,42481,25,1,42601,25,1,42851,2,27.1,-1.2509029,36.7883695,-1.2538731,36.7850223,756,250,33,246
18713,7647,200,3,Personal,3,7,41974,3,7,43160,3,7,43829,3,7,43998,3,7,46072,6,28.4,-1.2857315,36.7953424,-1.3173869,36.8112044,17,2074,1186,838
18714,12400,1267,1,Personal,6,1,41615,6,1,41624,6,1,42140,6,1,43247,6,1,44542,9,20.3,-1.2874215,36.7767292,-1.308366,36.823613,329,1295,9,1623
18715,24904,136,3,Business,10,1,53357,10,1,53592,10,1,54492,10,1,55410,10,1,57436,8,18.2,-1.3254522,36.7216584,-1.2957616,36.7669835,226,2026,235,1818
18716,8036,3674,3,Business,21,4,35349,21,4,35364,21,4,35448,21,4,35945,21,4,36393,4,21.6,-1.2551895,36.7822034,-1.2630856,36.8082807,205,448,15,581
18717,21386,2803,3,Business,18,4,35483,18,4,35501,18,4,37412,18,4,37694,18,4,39175,3,23.25888921888938,-1.2765736,36.8513646,-1.2689599,36.8398401,686,1481,18,2193
18718,19551,3376,1,Personal,3,1,53944,3,1,53960,3,1,55753,3,1,55945,3,1,58348,16,22.9,-1.2119232,36.8996459,-1.289498,36.818878,384,2403,16,1985
18719,21351,467,3,Business,20,1,55825,20,1,55881,20,1,56233,20,1,56604,20,1,57673,7,23.25888921888938,-1.304735,36.7846054,-1.2736095,36.8011282,247,1069,56,723
18720,1486,3291,3,Business,3,1,33911,3,1,33963,3,1,34244,3,1,34547,3,1,37198,14,18.1,-1.3306113,36.8480521,-1.2600926,36.8088685,839,2651,52,584
18721,9603,2587,3,Business,27,5,56626,27,5,56632,27,5,57565,27,5,57955,27,5,58509,2,23.9,-1.2967839,36.8128576,-1.2885529,36.8160141,229,554,6,1323
18722,21722,412,3,Business,25,1,32304,25,1,32346,25,1,33504,25,1,34069,25,1,35262,10,21.3,-1.303596,36.778378,-1.266837,36.799249,354,1193,42,1723
18723,13461,2523,3,Business,30,3,34651,30,3,35333,30,3,36394,30,3,36677,30,3,39937,8,19.6,-1.2551895,36.7822034,-1.2924639,36.7795798,761,3260,682,1344
18724,9935,1951,1,Personal,26,3,53000,26,3,53054,26,3,54096,26,3,54346,26,3,56574,5,27.3,-1.297684,36.800348,-1.3077197,36.7919466,565,2228,54,1292
18725,27098,1705,3,Business,8,4,55894,8,4,55901,8,4,55905,8,4,56675,8,4,59179,28,27.3,-1.2551895,36.7822034,-1.1427273,36.9371213,871,2504,7,774
18726,23254,393,3,Business,11,4,34482,11,4,34499,11,4,34553,11,4,36009,11,4,37217,10,18.6,-1.3177547,36.8303703,-1.2574219,36.7927073,731,1208,17,1510
18727,692,1527,3,Business,9,4,38731,9,4,38752,9,4,38827,9,4,40036,9,4,40288,4,23.25888921888938,-1.3228003,36.8306435,-1.3004062,36.829741,472,252,21,1284
18728,10334,3282,2,Personal,18,6,44494,18,6,44501,18,6,44661,18,6,45060,18,6,46638,8,18.8,-1.290059,36.7703475,-1.2861765,36.8209086,45,1578,7,559
18729,8193,3091,3,Business,11,2,37596,11,2,37658,11,2,38517,11,2,40086,11,2,40104,6,19.4,-1.2584143,36.8048002,-1.290894,36.822971,139,18,62,2428
18730,3251,1329,3,Business,30,5,35812,30,5,36750,30,5,37898,30,5,38186,30,5,39352,7,23.6,-1.273056,36.811298,-1.2771886,36.8419032,646,1166,938,1436
18731,20090,1329,3,Business,6,3,41577,6,3,41610,6,3,41848,6,3,41940,6,3,42828,10,23.25888921888938,-1.273056,36.811298,-1.2698168,36.7421898,216,888,33,330
18732,6612,1926,3,Business,13,3,57345,13,3,57357,13,3,58025,13,3,58559,13,3,60565,16,29.3,-1.3263105,36.8622904,-1.2571472,36.7950633,19,2006,12,1202
18733,12633,2333,2,Personal,12,3,32431,12,3,32473,12,3,32845,12,3,33121,12,3,33631,2,16.3,-1.2903421,36.7885282,-1.28467,36.794438,322,510,42,648
18734,5193,323,1,Business,17,5,54565,17,5,54573,17,5,54979,17,5,56079,17,5,61116,24,20.4,-1.3632162,36.9108253,-1.255956,36.789867,406,5037,8,1506
18735,4734,598,1,Business,16,3,55821,16,3,55864,16,3,56622,16,3,56837,16,3,60028,18,25.4,-1.2536797,36.7995085,-1.3157001,36.7075432,520,3191,43,973
18736,17737,1199,1,Personal,18,4,48064,18,4,49191,18,4,50240,18,4,50684,18,4,52141,7,26.7,-1.2924639,36.7795798,-1.2820581,36.8284909,477,1457,1127,1493
18737,4400,3404,3,Business,23,3,62524,23,3,62580,23,3,63078,23,3,63752,23,3,65838,15,24.1,-1.279395,36.825364,-1.356029,36.7444915,237,2086,56,1172
18738,22433,2069,3,Business,8,5,51461,8,5,51490,8,5,52084,8,5,52504,8,5,53267,9,30.5,-1.265715,36.823815,-1.228911,36.881876,52,763,29,1014
18739,8913,868,3,Business,11,2,55208,11,2,55676,11,2,56482,11,2,57938,11,2,57951,4,21.5,-1.259478,36.8017813,-1.2663631,36.8163329,245,13,468,2262
18740,18727,2836,1,Personal,9,2,40926,9,2,42335,9,2,43540,9,2,44060,9,2,44601,7,22.0,-1.2883572,36.8446699,-1.3205164,36.8098882,336,541,1409,1725
18741,17452,2678,2,Personal,18,6,33042,18,6,33048,18,6,34047,18,6,34176,18,6,35225,12,15.6,-1.3223068,36.7929881,-1.2891901,36.7620012,249,1049,6,1128
18742,22602,1102,3,Business,1,1,35137,1,1,35388,1,1,39442,1,1,40470,1,1,40477,10,23.25888921888938,-1.338283,36.8871775,-1.3004062,36.829741,507,7,251,5082
18743,23394,2509,3,Business,3,2,44402,3,2,44415,3,2,44788,3,2,45630,3,2,48088,20,18.5,-1.2579304,36.8019667,-1.3700383,36.9190174,103,2458,13,1215
18744,16493,3283,3,Business,1,1,50001,1,1,50955,1,1,51029,1,1,52935,1,1,53867,7,23.25888921888938,-1.303596,36.778378,-1.2628473,36.781805,61,932,954,1980
18745,18304,3149,3,Business,24,3,53085,24,3,53296,24,3,53706,24,3,56631,24,3,57542,6,23.25888921888938,-1.3004062,36.829741,-1.3167113,36.8301563,211,911,211,3335
18746,3539,1423,1,Personal,17,4,65485,17,4,66117,17,4,67411,17,4,68949,17,4,70224,12,21.8,-1.2025741,36.7865517,-1.2701979,36.8138177,623,1275,632,2832
18747,27067,2701,3,Business,23,5,40007,23,5,40354,23,5,43224,23,5,43289,23,5,46007,6,24.0,-1.2765736,36.8513646,-1.2885315,36.8230419,928,2718,347,2935
18748,10245,1578,3,Business,27,2,37963,27,2,40407,27,2,41609,27,2,42237,27,2,43216,5,23.7,-1.2584143,36.8048002,-1.28878,36.8168312,928,979,2444,1830
18749,13037,71,3,Business,31,1,32568,31,1,35128,31,1,35505,31,1,36237,31,1,41371,5,18.5,-1.281754,36.8324229,-1.2689015,36.7986106,237,5134,2560,1109
18750,13219,2423,3,Business,7,4,36618,7,4,36817,7,4,38446,7,4,39448,7,4,42577,6,27.8,-1.2571472,36.7950633,-1.290021,36.828206,520,3129,199,2631
18751,14482,3264,3,Business,17,1,44594,17,1,45921,17,1,47019,17,1,47612,17,1,48778,9,23.8,-1.2551895,36.7822034,-1.2963316,36.7863289,395,1166,1327,1691
18752,6203,3283,3,Business,7,1,34792,7,1,34824,7,1,35267,7,1,35919,7,1,37170,6,21.3,-1.265715,36.823815,-1.2628473,36.781805,289,1251,32,1095
18753,28217,884,3,Personal,8,1,44106,8,1,44525,8,1,45145,8,1,45308,8,1,48058,20,27.9,-1.1855927,36.843477,-1.2615909,36.7615129,7,2750,419,783
18754,16822,1341,3,Business,24,5,37248,24,5,37273,24,5,37661,24,5,38583,24,5,40548,17,20.9,-1.2600926,36.8088685,-1.3393547,36.8910035,882,1965,25,1310
18755,26694,2801,3,Business,12,3,31369,12,3,31425,12,3,32226,12,3,32675,12,3,34136,10,23.25888921888938,-1.2674274,36.7870827,-1.307726,36.839117,582,1461,56,1250
18756,13116,1146,3,Business,8,1,38002,8,1,38015,8,1,38109,8,1,40384,8,1,41422,7,28.1,-1.3167113,36.8301563,-1.3083266,36.8494756,728,1038,13,2369
18757,20202,1014,3,Business,16,5,66564,16,5,66623,16,5,68364,16,5,69564,16,5,70801,7,26.0,-1.2733546,36.7696069,-1.2647469,36.8157706,187,1237,59,2941
18758,9001,651,1,Personal,9,2,37020,9,2,37756,9,2,38629,9,2,38883,9,2,39715,6,22.1,-1.2794169,36.8180849,-1.2538731,36.7850223,281,832,736,1127
18759,14654,3517,3,Business,13,3,33212,13,3,33225,13,3,33238,13,3,36776,13,3,36991,16,17.1,-1.300921,36.828195,-1.3882008,36.7699445,70,215,13,3551
18760,20611,1271,3,Business,29,5,53743,29,5,53771,29,5,54224,29,5,54489,29,5,56621,18,29.2,-1.3244885,36.897792,-1.2600932,36.8041689,675,2132,28,718
18761,18972,811,3,Personal,12,3,47257,12,3,47751,12,3,48527,12,3,49292,12,3,50247,7,26.7,-1.2868973,36.8232984,-1.296797,36.7764525,676,955,494,1541
18762,9410,3647,3,Business,11,4,39017,11,4,39035,11,4,40358,11,4,40688,11,4,42024,6,25.6,-1.272639,36.794723,-1.303108,36.791262,260,1336,18,1653
18763,12508,970,3,Business,18,1,30896,18,1,30956,18,1,31398,18,1,31601,18,1,32899,6,22.1,-1.2551895,36.7822034,-1.2657935,36.7953389,778,1298,60,645
18764,2334,2329,2,Personal,16,2,35085,16,2,35124,16,2,37595,16,2,37990,16,2,39475,11,23.4,-1.2647213,36.7292267,-1.2922461,36.7873602,832,1485,39,2866
18765,641,970,3,Business,10,1,55532,10,1,63004,10,1,63662,10,1,64159,10,1,64912,5,18.9,-1.2551895,36.7822034,-1.2808188,36.8100137,247,753,7472,1155
18766,21348,1976,3,Business,26,2,55793,26,2,55808,26,2,56819,26,2,57128,26,2,58769,6,29.7,-1.257028,36.7810435,-1.2534301,36.8000983,167,1641,15,1320
18767,22330,3218,3,Business,5,6,37588,5,6,37651,5,6,38065,5,6,38457,5,6,39629,8,22.5,-1.2765736,36.8513646,-1.2413316,36.8785525,100,1172,63,806
18768,2905,788,3,Business,22,4,30931,22,4,33096,22,4,34106,22,4,35421,22,4,36498,12,19.4,-1.2494503,36.8531852,-1.225322,36.80855,878,1077,2165,2325
18769,21181,1260,3,Business,6,4,48623,6,4,48761,6,4,50554,6,4,51041,6,4,52423,6,21.5,-1.2551895,36.7822034,-1.2803414,36.8265456,183,1382,138,2280
18770,14180,186,3,Business,16,2,32223,16,2,32255,16,2,32800,16,2,33126,16,2,35034,20,23.25888921888938,-1.2571472,36.7950633,-1.3700383,36.9190174,147,1908,32,871
18771,15366,925,3,Business,28,3,54376,28,3,54921,28,3,56516,28,3,56701,28,3,58419,10,23.25888921888938,-1.2582514,36.8130701,-1.3239488,36.8316835,857,1718,545,1780
18772,21160,2531,3,Personal,25,5,48366,25,5,48914,25,5,49138,25,5,49559,25,5,51675,10,23.6,-1.2861765,36.8209086,-1.2884354,36.7606766,393,2116,548,645
18773,7668,681,1,Personal,19,3,35228,19,3,35240,19,3,35423,19,3,35668,19,3,39193,19,23.25888921888938,-1.2857315,36.7953424,-1.39598,36.776394,105,3525,12,428
18774,5030,1289,2,Personal,24,4,41873,24,4,41893,24,4,42406,24,4,44379,24,4,45144,2,21.0,-1.281196,36.8179321,-1.2833534,36.8165865,888,765,20,2486
18775,8265,1578,3,Business,20,1,60670,20,1,62184,20,1,63195,20,1,63706,20,1,64679,4,20.3,-1.2765736,36.8513646,-1.290894,36.822971,213,973,1514,1522
18776,2899,1179,3,Business,8,2,53766,8,2,53780,8,2,53800,8,2,55974,8,2,58819,21,25.2,-1.3700383,36.9190174,-1.2917868,36.7872675,191,2845,14,2194
18777,10600,2877,1,Personal,22,2,37846,22,2,37860,22,2,38672,22,2,39404,22,2,42878,21,19.5,-1.3610501,36.7520889,-1.2612532,36.7897977,663,3474,14,1544
18778,18323,3543,1,Personal,5,7,44272,5,7,44306,5,7,44900,5,7,45439,5,7,46247,6,19.1,-1.2927663,36.7875608,-1.2696568,36.7586514,101,808,34,1133
18779,741,2457,3,Business,9,4,53176,9,4,53904,9,4,54501,9,4,54905,9,4,57021,22,23.25888921888938,-1.2551895,36.7822034,-1.3692201,36.9252718,422,2116,728,1001
18780,9831,2200,3,Business,9,4,45496,9,4,45604,9,4,46780,9,4,47746,9,4,48883,6,23.25888921888938,-1.2571472,36.7950633,-1.290894,36.822971,263,1137,108,2142
18781,20411,700,3,Business,19,3,45198,19,3,48024,19,3,48511,19,3,50199,19,3,51197,5,24.2,-1.302478,36.7860038,-1.3123652,36.7964266,548,998,2826,2175
18782,5269,3194,3,Business,19,1,56639,19,1,56714,19,1,57228,19,1,57573,19,1,58564,8,25.0,-1.2551895,36.7822034,-1.2597436,36.8282526,649,991,75,859
18783,16911,1568,3,Business,21,4,55980,21,4,56753,21,4,57210,21,4,57668,21,4,58748,7,22.4,-1.2897368,36.8226783,-1.2551895,36.7822034,698,1080,773,915
18784,2621,3180,1,Personal,12,5,40267,12,5,40294,12,5,41099,12,5,44040,12,5,45864,10,24.7,-1.260232,36.807334,-1.2994194,36.7647917,651,1824,27,3746
18785,779,2154,3,Business,10,1,45905,10,1,45926,10,1,47942,10,1,48879,10,1,50325,13,18.8,-1.2156006,36.8916865,-1.2765736,36.8513646,522,1446,21,2953
18786,18741,3686,3,Business,15,4,56665,15,4,57787,15,4,58145,15,4,58428,15,4,59885,8,27.6,-1.2551895,36.7822034,-1.295156,36.8094306,254,1457,1122,641
18787,6607,1927,3,Business,8,6,48126,8,6,48935,8,6,49874,8,6,50073,8,6,52516,12,23.3,-1.290894,36.822971,-1.3463042,36.768164,569,2443,809,1138
18788,4680,2587,3,Business,16,2,51166,16,2,51262,16,2,52951,16,2,53182,16,2,54296,5,23.25888921888938,-1.2584143,36.8048002,-1.28878,36.8168312,394,1114,96,1920
18789,23693,948,3,Business,25,4,41684,25,4,41811,25,4,42676,25,4,44848,25,4,45669,7,23.25888921888938,-1.2959812,36.797232,-1.2696908,36.81519,855,821,127,3037
18790,4277,265,3,Business,11,1,57970,11,1,57981,11,1,57997,11,1,58668,11,1,60695,12,28.0,-1.300921,36.828195,-1.3253022,36.8803995,31,2027,11,687
18791,18200,3621,3,Business,9,3,39988,9,3,39999,9,3,40512,9,3,40979,9,3,42013,7,21.1,-1.2836583,36.7886014,-1.2473215,36.7948812,761,1034,11,980
18792,18195,2474,1,Personal,3,2,31918,3,2,31927,3,2,32304,3,2,32588,3,2,33755,12,15.1,-1.304033,36.7848695,-1.2643343,36.7447423,355,1167,9,661
18793,20427,3276,2,Personal,27,4,61605,27,4,61645,27,4,61665,27,4,62398,27,4,62407,2,22.8,-1.3053113,36.8424382,-1.3001072,36.8499697,179,9,40,753
18794,15475,393,3,Business,12,2,35545,12,2,35614,12,2,36616,12,2,37369,12,2,37900,4,20.7,-1.3167113,36.8301563,-1.3004062,36.829741,127,531,69,1755
18795,5159,2493,1,Personal,21,4,54571,21,4,54603,21,4,55587,21,4,55876,21,4,57783,9,22.6,-1.31471,36.8110941,-1.2658335,36.8042867,865,1907,32,1273
18796,12821,3689,1,Business,16,1,35076,16,1,35086,16,1,35467,16,1,35641,16,1,36307,9,14.7,-1.260232,36.807334,-1.2248308,36.8012573,103,666,10,555
18797,21430,2869,3,Business,8,6,63370,8,6,63563,8,6,63972,8,6,64687,8,6,66334,16,21.6,-1.2326041,36.8009029,-1.3025826,36.7670807,161,1647,193,1124
18798,25470,3052,3,Personal,13,4,58303,13,4,58364,13,4,59601,13,4,59985,13,4,64077,25,22.6,-1.2603185,36.7400255,-1.3686008,36.6579557,800,4092,61,1621
18799,13834,1244,3,Business,21,1,41310,21,1,41322,21,1,41328,21,1,42432,21,1,43252,8,25.6,-1.307143,36.825009,-1.303596,36.778378,842,820,12,1110
18800,26702,391,3,Business,8,5,51805,8,5,52071,8,5,53538,8,5,53621,8,5,54577,5,30.6,-1.2784063,36.8222933,-1.300921,36.828195,448,956,266,1550
18801,7345,246,3,Business,13,2,55595,13,2,56673,13,2,57310,13,2,57378,13,2,58370,5,26.4,-1.2584143,36.8048002,-1.2820175,36.8223974,88,992,1078,705
18802,12314,2130,3,Personal,10,1,46965,10,1,47303,10,1,48904,10,1,49047,10,1,52136,12,18.2,-1.2310607,36.8035776,-1.2981625,36.8130142,272,3089,338,1744
18803,19730,3517,3,Business,11,1,47632,11,1,47665,11,1,49142,11,1,49838,11,1,51740,13,28.0,-1.3338218,36.8135552,-1.3882008,36.7699445,328,1902,33,2173
18804,27430,246,3,Business,22,2,46397,22,2,46441,22,2,47494,22,2,48563,22,2,49609,6,23.9,-1.290894,36.822971,-1.2584143,36.8048002,456,1046,44,2122
18805,2012,3149,3,Business,21,5,35553,21,5,35916,21,5,38558,21,5,38931,21,5,44073,9,23.0,-1.2770708,36.8231093,-1.3228003,36.8306435,26,5142,363,3015
18806,5827,2330,3,Business,12,2,54586,12,2,54755,12,2,56410,12,2,56618,12,2,57763,9,23.25888921888938,-1.2326041,36.8009029,-1.2649605,36.7981777,547,1145,169,1863
18807,8579,3291,3,Business,7,3,51902,7,3,51916,7,3,52222,7,3,52650,7,3,53265,4,28.3,-1.272828,36.816608,-1.2600926,36.8088685,932,615,14,734
18808,22312,3127,3,Business,26,5,45163,26,5,45238,26,5,45899,26,5,46112,26,5,47354,8,23.25888921888938,-1.2914681,36.8012887,-1.2623805,36.7805404,722,1242,75,874
18809,25069,3686,3,Business,26,5,33816,26,5,33827,26,5,34023,26,5,35096,26,5,35812,10,23.25888921888938,-1.2551895,36.7822034,-1.3039706,36.7688174,245,716,11,1269
18810,5029,1271,3,Business,5,5,38338,5,5,38920,5,5,38936,5,5,39313,5,5,41260,18,24.7,-1.3244885,36.897792,-1.2987748,36.8024593,564,1947,582,393
18811,11687,136,3,Business,18,2,57455,18,2,57559,18,2,57618,18,2,57888,18,2,59308,11,25.7,-1.3326173,36.7146233,-1.2909634,36.7813995,48,1420,104,329
18812,2999,265,3,Business,27,2,45561,27,2,45635,27,2,45809,27,2,46574,27,2,47032,3,23.7,-1.306654,36.841897,-1.300921,36.828195,519,458,74,939
18813,25517,1384,3,Business,3,5,40995,3,5,41055,3,5,41957,3,5,42115,3,5,43990,17,23.25888921888938,-1.2517448,36.7924971,-1.2035268,36.8851132,575,1875,60,1060
18814,11136,3201,3,Business,30,2,50179,30,2,50188,30,2,50393,30,2,50588,30,2,50976,2,27.2,-1.2584143,36.8048002,-1.2591019,36.800577,587,388,9,400
18815,3725,3064,3,Business,25,4,42034,25,4,42957,25,4,42974,25,4,43674,25,4,45055,6,23.25888921888938,-1.2571472,36.7950633,-1.2990813,36.8034213,61,1381,923,717
18816,3920,111,3,Business,7,5,52836,7,5,52861,7,5,53358,7,5,54055,7,5,54647,4,23.25888921888938,-1.2551895,36.7822034,-1.2681518,36.8098164,624,592,25,1194
18817,10134,393,3,Business,8,1,31614,8,1,31653,8,1,32481,8,1,34372,8,1,35588,8,22.1,-1.3167113,36.8301563,-1.2770708,36.8231093,910,1216,39,2719
18818,19130,868,3,Business,1,3,41914,1,3,42847,1,3,43286,1,3,44701,1,3,46317,9,20.0,-1.331619,36.847976,-1.265715,36.823815,900,1616,933,1854
18819,15591,868,3,Business,19,2,52885,19,2,52976,19,2,53686,19,2,54084,19,2,54964,10,29.5,-1.228911,36.881876,-1.265715,36.823815,8,880,91,1108
18820,4968,3674,3,Business,14,3,39214,14,3,39516,14,3,39858,14,3,40339,14,3,41548,8,24.7,-1.2551895,36.7822034,-1.2747604,36.8259205,726,1209,302,823
18821,4375,3091,1,Business,28,6,44591,28,6,44611,28,6,45406,28,6,46102,28,6,49746,21,24.1,-1.2927792,36.9053492,-1.3014461,36.7661381,951,3644,20,1491
18822,14118,432,3,Business,14,5,64115,14,5,64149,14,5,64892,14,5,65909,14,5,67398,14,21.3,-1.225322,36.80855,-1.3012008,36.764868,178,1489,34,1760
18823,9076,265,3,Business,29,1,49219,29,1,49276,29,1,50396,29,1,51548,29,1,55374,22,23.25888921888938,-1.300921,36.828195,-1.3223908,36.6773487,61,3826,57,2272
18824,7066,346,3,Business,1,5,32792,1,5,33075,1,5,34247,1,5,34781,1,5,36982,3,23.25888921888938,-1.28878,36.8168312,-1.2896399,36.8124498,72,2201,283,1706
18825,22629,2248,1,Personal,31,4,68034,31,4,71303,31,4,72444,31,4,72701,31,4,73600,8,17.9,-1.3066143,36.8161046,-1.2825655,36.787261,116,899,3269,1398
18826,10201,2207,3,Business,18,1,42683,18,1,42774,18,1,44590,18,1,44865,18,1,46674,13,28.2,-1.3151858,36.854623,-1.2696908,36.81519,127,1809,91,2091
18827,8292,246,3,Business,25,2,60485,25,2,60493,25,2,60517,25,2,60951,25,2,61494,3,24.0,-1.2584143,36.8048002,-1.2551895,36.7822034,881,543,8,458
18828,1423,1368,3,Business,13,3,53247,13,3,53287,13,3,53581,13,3,53888,13,3,54728,4,29.1,-1.2571472,36.7950633,-1.26071,36.8206332,40,840,40,601
18829,24861,970,3,Business,12,3,51463,12,3,51481,12,3,51753,12,3,53016,12,3,54246,3,20.9,-1.2551895,36.7822034,-1.2629594,36.8077626,591,1230,18,1535
18830,23407,2350,1,Personal,19,5,45423,19,5,45982,19,5,46912,19,5,48191,19,5,48928,4,25.1,-1.2844084,36.8106592,-1.2745107,36.7974503,844,737,559,2209
18831,6664,2069,3,Business,27,1,42569,27,1,42777,27,1,43015,27,1,43760,27,1,44991,14,20.7,-1.3033561,36.8163631,-1.228911,36.881876,119,1231,208,983
18832,23982,2605,3,Business,10,4,58922,10,4,58932,10,4,58957,10,4,59730,10,4,62129,22,23.4,-1.2551895,36.7822034,-1.3562374,36.9042954,200,2399,10,798
18833,22469,1148,3,Business,23,2,42079,23,2,42117,23,2,42466,23,2,43283,23,2,44623,9,23.25888921888938,-1.3104867,36.8495593,-1.2664428,36.809453,855,1340,38,1166
18834,18578,1074,2,Personal,22,2,42696,22,2,42791,22,2,44052,22,2,45064,22,2,46923,10,19.3,-1.2762345,36.8543591,-1.2857685,36.7866843,845,1859,95,2273
18835,6149,1073,3,Business,19,2,40291,19,2,40361,19,2,41442,19,2,41695,19,2,43577,16,26.7,-1.290683,36.871041,-1.2561964,36.7885001,377,1882,70,1334
18836,21027,2834,3,Business,27,1,52887,27,1,52915,27,1,54853,27,1,55859,27,1,55892,2,22.9,-1.290894,36.822971,-1.2819054,36.8237089,855,33,28,2944
18837,22851,2330,3,Business,11,4,45501,11,4,45613,11,4,46482,11,4,46624,11,4,47712,9,25.8,-1.2124582,36.802894,-1.2642903,36.8002137,695,1088,112,1011
18838,2923,788,3,Business,23,1,35683,23,1,35689,23,1,36074,23,1,36299,23,1,37738,11,14.4,-1.2584143,36.8048002,-1.225322,36.80855,616,1439,6,610
18839,20085,1271,3,Business,20,4,55619,20,4,55644,20,4,56729,20,4,57864,20,4,61651,19,25.2,-1.3244885,36.897792,-1.3049238,36.7841898,548,3787,25,2220
18840,26517,3372,3,Business,25,1,46832,25,1,46851,25,1,47110,25,1,47351,25,1,49289,3,23.25888921888938,-1.2969741,36.7856612,-1.3002897,36.7601637,312,1938,19,500
18841,21143,28,3,Business,5,3,33057,5,3,33104,5,3,33757,5,3,35453,5,3,37013,14,18.2,-1.2935617,36.835057,-1.3384245,36.8794338,932,1560,47,2349
18842,16586,517,3,Business,27,4,43392,27,4,44234,27,4,44240,27,4,47895,27,4,47909,4,23.2,-1.3167113,36.8301563,-1.3004062,36.829741,10,14,842,3661
18843,3667,3674,3,Business,26,5,65311,26,5,67958,26,5,68018,26,5,69359,26,5,69895,6,23.25888921888938,-1.2551895,36.7822034,-1.2897368,36.8226783,855,536,2647,1401
18844,27009,3404,3,Business,26,1,39386,26,1,42608,26,1,43605,26,1,44316,26,1,46429,15,23.2,-1.279395,36.825364,-1.3251247,36.8995926,928,2113,3222,1708
18845,27285,391,3,Business,18,4,37487,18,4,38036,18,4,41188,18,4,42424,18,4,44722,18,23.25888921888938,-1.2491258,36.6894253,-1.2867454,36.8259017,217,2298,549,4388
18846,16959,2894,3,Business,26,5,57878,26,5,58126,26,5,58459,26,5,58865,26,5,61046,8,23.25888921888938,-1.2974913,36.8054296,-1.2549476,36.8269576,289,2181,248,739
18847,7423,265,3,Business,12,2,57881,12,2,58059,12,2,58547,12,2,59374,12,2,60041,4,23.25888921888938,-1.3047132,36.8089553,-1.300921,36.828195,99,667,178,1315
18848,5865,1245,3,Business,6,4,31530,6,4,32805,6,4,33437,6,4,34358,6,4,35936,19,18.6,-1.300921,36.828195,-1.3198615,36.7110323,90,1578,1275,1553
18849,9566,2330,3,Business,22,5,54447,22,5,54605,22,5,55367,22,5,55864,22,5,57159,8,27.1,-1.3015197,36.7658456,-1.2649605,36.7981777,328,1295,158,1259
18850,28166,268,3,Business,22,4,39915,22,4,39961,22,4,40711,22,4,42363,22,4,44604,15,22.6,-1.2551895,36.7822034,-1.3319467,36.7766998,793,2241,46,2402
18851,4865,1065,2,Personal,27,5,60063,27,5,60119,27,5,60426,27,5,60645,27,5,61527,8,17.7,-1.2740027,36.8049172,-1.3016151,36.8117354,510,882,56,526
18852,26593,653,3,Business,12,5,44886,12,5,45128,12,5,47475,12,5,47715,12,5,48171,6,24.5,-1.279395,36.825364,-1.2571472,36.7950633,409,456,242,2587
18853,11725,1578,3,Business,8,1,37557,8,1,37695,8,1,38096,8,1,38395,8,1,39627,9,24.6,-1.28878,36.8168312,-1.2413316,36.8785525,88,1232,138,700
18854,24894,136,3,Business,10,4,49587,10,4,49688,10,4,49708,10,4,50983,10,4,51796,4,25.3,-1.3165104,36.7077726,-1.3254522,36.7216584,829,813,101,1295
18855,7986,3524,2,Personal,10,2,45950,10,2,46010,10,2,46255,10,2,46599,10,2,49139,14,20.4,-1.2809666,36.8765961,-1.2841952,36.8030328,618,2540,60,589
18856,20937,186,3,Business,13,4,56379,13,4,56420,13,4,56668,13,4,57000,13,4,57868,7,23.3,-1.2825816,36.8092346,-1.2571472,36.7950633,407,868,41,580
18857,7391,2763,3,Business,9,4,54521,9,4,54831,9,4,55397,9,4,55777,9,4,56467,6,23.25888921888938,-1.2571472,36.7950633,-1.2885417,36.8100523,96,690,310,946
18858,17,2346,1,Personal,9,3,49816,9,3,49830,9,3,50315,9,3,50502,9,3,53422,25,23.3,-1.2857072,36.822586,-1.2480844,36.6596223,742,2920,14,672
18859,19860,2801,3,Business,2,4,36601,2,4,36635,2,4,36977,2,4,37108,2,4,38234,9,23.25888921888938,-1.2674274,36.7870827,-1.257569,36.842164,245,1126,34,473
18860,12662,136,3,Business,23,5,42381,23,5,42398,23,5,43622,23,5,44164,23,5,45146,4,24.1,-1.2965045,36.7913036,-1.3009676,36.7657189,322,982,17,1766
18861,13701,2391,3,Personal,12,2,60844,12,2,60926,12,2,61757,12,2,62907,12,2,63010,6,28.2,-1.311706,36.802841,-1.2993094,36.7772069,678,103,82,1981
18862,13148,59,3,Business,18,4,36411,18,4,37607,18,4,38654,18,4,39408,18,4,43870,4,23.25888921888938,-1.290894,36.822971,-1.3047026,36.8172033,394,4462,1196,1801
18863,14716,1304,3,Business,21,1,41493,21,1,41616,21,1,41649,21,1,42112,21,1,42651,6,20.2,-1.2626906,36.7827022,-1.2765492,36.7669809,633,539,123,496
18864,1580,136,3,Business,5,5,44433,5,5,47990,5,5,49354,5,5,49690,5,5,51512,9,26.6,-1.3326173,36.7146233,-1.3601057,36.767584,565,1822,3557,1700
18865,21878,299,3,Business,15,4,38156,15,4,38300,15,4,38627,15,4,38802,15,4,43431,18,24.3,-1.3175825,36.7004796,-1.2628638,36.8070399,125,4629,144,502
18866,1261,2587,3,Business,10,1,30568,10,1,30662,10,1,31905,10,1,32802,10,1,35342,11,18.3,-1.2283403,36.8822756,-1.28878,36.8168312,467,2540,94,2140
18867,23552,1932,3,Business,28,4,47645,28,4,48056,28,4,50107,28,4,50637,28,4,52080,7,23.25888921888938,-1.2865096,36.8169364,-1.2922857,36.7813274,268,1443,411,2581
18868,4359,1746,3,Business,5,5,32086,5,5,32897,5,5,33810,5,5,33991,5,5,37061,11,17.7,-1.2712358,36.8345749,-1.3039706,36.7688174,107,3070,811,1094
18869,26402,59,3,Business,29,5,41151,29,5,45457,29,5,46311,29,5,46389,29,5,49616,5,26.6,-1.3001909,36.8163627,-1.290894,36.822971,682,3227,4306,932
18870,16266,1882,3,Business,5,2,58102,5,2,58371,5,2,59507,5,2,59978,5,2,61963,13,23.25888921888938,-1.2534301,36.8000983,-1.2156006,36.8916865,300,1985,269,1607
18871,21481,3521,3,Business,10,1,50742,10,1,50838,10,1,53230,10,1,53972,10,1,55001,7,23.25888921888938,-1.2597436,36.8282526,-1.2696908,36.81519,537,1029,96,3134
18872,17576,760,3,Business,29,2,38801,29,2,38855,29,2,42175,29,2,42516,29,2,44878,9,23.4,-1.2801075,36.8100471,-1.3088205,36.853849,26,2362,54,3661
18873,11072,503,3,Business,13,3,52796,13,3,52824,13,3,53739,13,3,53960,13,3,54471,8,23.4,-1.2859912,36.8756811,-1.2413316,36.8785525,900,511,28,1136
18874,13487,2031,1,Personal,9,4,42678,9,4,42774,9,4,43310,9,4,43859,9,4,45164,11,23.8,-1.2802151,36.8231386,-1.2317292,36.79682,865,1305,96,1085
18875,24431,700,3,Business,28,2,45830,28,2,45848,28,2,46743,28,2,46805,28,2,47654,4,17.8,-1.2884227,36.7724509,-1.2900727,36.7890059,919,849,18,957
18876,8702,85,2,Business,3,2,51644,3,2,51673,3,2,52040,3,2,52836,3,2,53820,11,20.1,-1.2579304,36.8019667,-1.3014461,36.7661381,103,984,29,1163
18877,6387,1231,3,Business,18,2,38947,18,2,39321,18,2,39619,18,2,40085,18,2,41540,13,23.25888921888938,-1.2821422,36.8161565,-1.2156006,36.8916865,268,1455,374,764
18878,28043,2521,3,Business,5,5,49985,5,5,50045,5,5,50500,5,5,51561,5,5,52337,6,27.7,-1.3167113,36.8301563,-1.3077869,36.8443207,855,776,60,1516
18879,3430,3203,3,Business,19,3,45093,19,3,45112,19,3,45709,19,3,46530,19,3,48088,16,22.3,-1.2628473,36.781805,-1.228911,36.881876,274,1558,19,1418
18880,23547,517,3,Business,17,6,35740,17,6,37320,17,6,37699,17,6,39005,17,6,39390,4,24.0,-1.3177547,36.8303703,-1.3004062,36.829741,708,385,1580,1685
18881,7482,393,3,Business,2,6,31030,2,6,31039,2,6,31090,2,6,31888,2,6,33639,14,20.8,-1.3167113,36.8301563,-1.306378,36.7519845,523,1751,9,849
18882,22183,2701,3,Business,10,1,46263,10,1,47556,10,1,47559,10,1,49297,10,1,50542,8,18.1,-1.2571472,36.7950633,-1.2765736,36.8513646,79,1245,1293,1741
18883,14357,71,3,Business,26,1,60318,26,1,61458,26,1,62111,26,1,62633,26,1,63306,2,20.0,-1.2793686,36.8259233,-1.2891922,36.825189,268,673,1140,1175
18884,18427,1209,3,Business,17,5,51552,17,5,51565,17,5,51574,17,5,54024,17,5,55306,12,23.25888921888938,-1.2991441,36.7528804,-1.3004062,36.829741,349,1282,13,2459
18885,26102,2066,3,Business,7,2,40561,7,2,40571,7,2,41283,7,2,41382,7,2,42696,8,23.3,-1.316961,36.820337,-1.2681181,36.8022805,229,1314,10,811
18886,100,1787,3,Business,8,2,35635,8,2,36028,8,2,36481,8,2,36949,8,2,38592,7,18.8,-1.2609721,36.8480813,-1.2283403,36.8822756,79,1643,393,921
18887,5925,2144,3,Personal,21,1,51756,21,1,52351,21,1,53390,21,1,54295,21,1,56269,10,21.4,-1.2655306,36.828148,-1.214328,36.7911903,770,1974,595,1944
18888,6435,3517,3,Business,19,2,50434,19,2,52081,19,2,54868,19,2,55007,19,2,56601,16,29.8,-1.3882008,36.7699445,-1.300921,36.828195,448,1594,1647,2926
18889,12006,1336,3,Business,20,3,41910,20,3,42632,20,3,43466,20,3,43540,20,3,44181,3,26.2,-1.2765736,36.8513646,-1.2885029,36.825605,953,641,722,908
18890,16866,1500,3,Business,25,1,59204,25,1,59239,25,1,59279,25,1,60813,25,1,62028,8,27.7,-1.3080092,36.8284543,-1.2638185,36.7930057,206,1215,35,1574
18891,15489,2066,3,Business,7,2,59660,7,2,59700,7,2,61317,7,2,61438,7,2,63385,12,23.25888921888938,-1.3210189,36.8410551,-1.304842,36.90576,233,1947,40,1738
18892,11749,3727,3,Business,11,2,42567,11,2,43016,11,2,44618,11,2,46461,11,2,47917,11,19.6,-1.2514753,36.7870287,-1.2963097,36.7688221,762,1456,449,3445
18893,12550,3231,2,Personal,8,3,51265,8,3,51366,8,3,52259,8,3,52837,8,3,54415,6,26.0,-1.2858016,36.8226814,-1.2817856,36.7881009,622,1578,101,1471
18894,8165,3647,3,Business,17,4,50193,17,4,50223,17,4,51019,17,4,51213,17,4,53976,8,27.8,-1.272639,36.794723,-1.2981102,36.8293513,875,2763,30,990
18895,8740,2523,3,Business,27,3,44204,27,3,44218,27,3,44448,27,3,44766,27,3,46041,8,26.0,-1.2551895,36.7822034,-1.2866381,36.7963662,26,1275,14,548
18896,20307,391,3,Business,20,3,53095,20,3,53329,20,3,54151,20,3,55213,20,3,57133,5,28.5,-1.300921,36.828195,-1.2867454,36.8259017,411,1920,234,1884
18897,21903,3621,3,Business,15,4,56356,15,4,56477,15,4,57782,15,4,57963,15,4,59105,6,27.5,-1.2836583,36.7886014,-1.25896,36.8016691,228,1142,121,1486
18898,3359,3487,3,Business,21,2,34278,21,2,34440,21,2,35697,21,2,35993,21,2,39354,5,23.25888921888938,-1.279395,36.825364,-1.2923412,36.7951972,155,3361,162,1553
18899,7344,868,3,Business,9,2,47758,9,2,47975,9,2,49734,9,2,50421,9,2,51263,9,30.7,-1.2296618,36.8438272,-1.265715,36.823815,525,842,217,2446
18900,26206,2509,3,Business,21,3,46366,21,3,47559,21,3,48150,21,3,49095,21,3,53633,22,23.0,-1.3287857,36.9042514,-1.2571472,36.7950633,900,4538,1193,1536
18901,21280,357,3,Business,17,3,39923,17,3,40020,17,3,40784,17,3,43406,17,3,45803,16,23.25888921888938,-1.2326041,36.8009029,-1.2945179,36.7685349,870,2397,97,3386
18902,19797,3517,3,Business,12,2,32528,12,2,32594,12,2,35520,12,2,37544,12,2,39124,15,20.9,-1.300921,36.828195,-1.3882008,36.7699445,763,1580,66,4950
18903,21073,1787,3,Business,30,2,61824,30,2,61845,30,2,62277,30,2,63182,30,2,64292,9,23.8,-1.2859912,36.8756811,-1.2283403,36.8822756,397,1110,21,1337
18904,1623,3239,3,Personal,10,5,35136,10,5,35211,10,5,36279,10,5,36435,10,5,37494,11,13.3,-1.2836832,36.8306719,-1.23054,36.878262,648,1059,75,1224
18905,8588,2860,1,Personal,31,4,32864,31,4,32937,31,4,33091,31,4,33537,31,4,34508,7,17.4,-1.2605635,36.7985638,-1.287428,36.7800821,379,971,73,600
18906,14177,718,3,Business,10,1,46601,10,1,46731,10,1,47607,10,1,48478,10,1,49730,8,18.4,-1.2551895,36.7822034,-1.305146,36.830025,907,1252,130,1747
18907,23178,635,3,Business,7,2,55789,7,2,56006,7,2,57184,7,2,57658,7,2,58501,5,23.25888921888938,-1.2857764,36.8236622,-1.2602337,36.7990548,92,843,217,1652
18908,23858,635,3,Business,8,5,38382,8,5,38463,8,5,38733,8,5,40671,8,5,40677,3,24.2,-1.2602337,36.7990548,-1.272704,36.7931279,727,6,81,2208
18909,25401,2066,3,Business,31,2,40013,31,2,40153,31,2,40393,31,2,40502,31,2,41460,6,18.4,-1.316961,36.820337,-1.2979147,36.7857814,726,958,140,349
18910,8070,1361,1,Personal,14,4,49478,14,4,52465,14,4,52650,14,4,53147,14,4,56412,6,21.6,-1.2861765,36.8209086,-1.2948784,36.7766328,531,3265,2987,682
18911,5145,3569,3,Personal,12,3,33617,12,3,33947,12,3,35871,12,3,35967,12,3,38067,17,23.25888921888938,-1.2915317,36.8322227,-1.3858142,36.7641498,487,2100,330,2020
18912,9177,1329,3,Business,15,5,34491,15,5,34513,15,5,35042,15,5,35147,15,5,36289,10,19.1,-1.273056,36.811298,-1.3270347,36.8667362,338,1142,22,634
18913,3782,1329,3,Business,10,3,37881,10,3,38035,10,3,39348,10,3,41158,10,3,41342,12,27.9,-1.273056,36.811298,-1.3302996,36.8707935,855,184,154,3123
18914,10534,2330,3,Business,8,5,47895,8,5,48335,8,5,49573,8,5,49932,8,5,52648,11,27.3,-1.2921463,36.8029626,-1.2324923,36.8363775,660,2716,440,1597
18915,20905,2740,3,Personal,14,4,54370,14,4,56195,14,4,57574,14,4,58358,14,4,60624,11,21.5,-1.2638822,36.7896045,-1.3127304,36.8189817,791,2266,1825,2163
18916,566,496,3,Business,23,5,37843,23,5,37867,23,5,38622,23,5,39060,23,5,42002,23,24.3,-1.374163,36.913444,-1.2551895,36.7822034,880,2942,24,1193
18917,10803,1402,3,Business,3,3,29457,3,3,29623,3,3,30727,3,3,31200,3,3,33869,7,21.3,-1.2813012,36.8323962,-1.3024388,36.859699,119,2669,166,1577
18918,11177,3521,3,Business,1,1,48397,1,1,50678,1,1,51513,1,1,52353,1,1,53783,9,23.25888921888938,-1.233018,36.8004477,-1.2696908,36.81519,484,1430,2281,1675
18919,11660,426,3,Business,28,4,44153,28,4,44235,28,4,44968,28,4,45171,28,4,48409,17,23.25888921888938,-1.3323107,36.8692616,-1.2635744,36.781677,326,3238,82,936
18920,3099,2409,3,Personal,6,1,34380,6,1,34390,6,1,35842,6,1,36236,6,1,37961,11,15.1,-1.2990731,36.8488058,-1.2630521,36.8068019,402,1725,10,1846
18921,23579,3432,3,Business,24,4,52825,24,4,52880,24,4,54481,24,4,54963,24,4,59275,12,28.1,-1.3139898,36.8676986,-1.2672588,36.8000252,332,4312,55,2083
18922,12653,567,3,Business,16,2,46399,16,2,46457,16,2,48444,16,2,49055,16,2,50142,6,23.25888921888938,-1.2707179,36.7979713,-1.2963097,36.7688221,324,1087,58,2598
18923,15129,633,3,Business,12,6,45453,12,6,45503,12,6,45879,12,6,45969,12,6,46520,4,23.25888921888938,-1.3077869,36.8443207,-1.3004062,36.829741,518,551,50,466
18924,17043,393,3,Business,7,5,47061,7,5,47099,7,5,50605,7,5,50821,7,5,53426,11,23.25888921888938,-1.3228003,36.8306435,-1.2638185,36.7930057,155,2605,38,3722
18925,17331,2066,3,Business,1,3,50412,1,3,50648,1,3,51968,1,3,52150,1,3,53618,8,23.25888921888938,-1.279284,36.820813,-1.3270716,36.8406371,624,1468,236,1502
18926,12267,2069,3,Business,5,6,38864,5,6,38874,5,6,38940,5,6,39577,5,6,40670,6,22.4,-1.2296618,36.8438272,-1.228911,36.881876,477,1093,10,703
18927,22762,1346,3,Business,11,1,47683,11,1,47689,11,1,48145,11,1,48365,11,1,50184,19,18.2,-1.299813,36.7871392,-1.3700383,36.9190174,543,1819,6,676
18928,8818,346,3,Business,7,4,59703,7,4,59763,7,4,60250,7,4,60603,7,4,61159,1,29.6,-1.279395,36.825364,-1.28878,36.8168312,653,556,60,840
18929,21401,1478,3,Personal,18,5,49676,18,5,50975,18,5,54393,18,5,54610,18,5,57125,6,24.4,-1.2894847,36.7556088,-1.2545665,36.7597819,618,2515,1299,3635
18930,26696,3355,3,Business,13,5,43261,13,5,43353,13,5,44481,13,5,44989,13,5,45859,3,23.25888921888938,-1.314309,36.8392657,-1.3052491,36.8223899,939,870,92,1636
18931,20398,2587,3,Business,27,4,43083,27,4,43093,27,4,43222,27,4,44250,27,4,44683,1,22.9,-1.279395,36.825364,-1.28878,36.8168312,31,433,10,1157
18932,6750,478,3,Business,27,1,37250,27,1,37275,27,1,37493,27,1,37940,27,1,39489,15,20.7,-1.2551895,36.7822034,-1.3255466,36.7139,926,1549,25,665
18933,12040,393,3,Business,12,2,31094,12,2,31199,12,2,31867,12,2,32253,12,2,34124,11,20.7,-1.3167113,36.8301563,-1.2638185,36.7930057,728,1871,105,1054
18934,674,1502,3,Business,15,4,43133,15,4,43146,15,4,44514,15,4,44644,15,4,47733,17,24.2,-1.2232123,36.8932547,-1.2551895,36.7822034,812,3089,13,1498
18935,3218,1642,3,Business,24,3,51284,24,3,51301,24,3,51814,24,3,53428,24,3,55325,12,18.5,-1.2308211,36.8679041,-1.2728069,36.7962362,96,1897,17,2127
18936,6190,893,3,Business,8,2,51890,8,2,51998,8,2,52353,8,2,53017,8,2,54229,7,25.5,-1.2664491,36.8102685,-1.2847316,36.7658086,205,1212,108,1019
18937,22801,1500,3,Business,4,6,39172,4,6,39389,4,6,40076,4,6,40302,4,6,40900,6,23.25888921888938,-1.2770708,36.8231093,-1.2638185,36.7930057,161,598,217,913
18938,14708,450,1,Personal,23,1,36366,23,1,36385,23,1,36588,23,1,37035,23,1,37567,4,14.4,-1.2663778,36.8076024,-1.2562797,36.8075858,379,532,19,650
18939,16511,2436,3,Business,28,4,45052,28,4,45064,28,4,45078,28,4,45864,28,4,47451,15,23.7,-1.2551895,36.7822034,-1.335515,36.864137,26,1587,12,800
18940,11336,2866,3,Business,10,1,46394,10,1,46443,10,1,46921,10,1,47308,10,1,47821,4,23.6,-1.2551895,36.7822034,-1.2658335,36.8042867,215,513,49,865
18941,12489,2159,3,Business,23,2,55211,23,2,55366,23,2,55670,23,2,56882,23,2,58462,7,19.0,-1.304735,36.7846054,-1.2736241,36.8069298,903,1580,155,1516
18942,19002,1500,3,Business,12,2,41300,12,2,41308,12,2,41442,12,2,41663,12,2,42965,11,28.3,-1.2638185,36.7930057,-1.2610134,36.8506926,885,1302,8,355
18943,16453,2337,1,Personal,14,5,49832,14,5,49936,14,5,50533,14,5,50659,14,5,52366,10,27.0,-1.2321733,36.7974377,-1.2962535,36.8151842,726,1707,104,723
18944,28251,435,3,Business,7,5,45264,7,5,45521,7,5,46241,7,5,46490,7,5,47919,8,23.25888921888938,-1.2969741,36.7856612,-1.300921,36.828195,826,1429,257,969
18945,24439,432,3,Business,15,5,41991,15,5,42027,15,5,42366,15,5,43046,15,5,43716,3,26.5,-1.2948835,36.7830474,-1.3012008,36.764868,545,670,36,1019
18946,12851,2523,3,Business,11,2,35102,11,2,35163,11,2,35724,11,2,35838,11,2,38593,23,16.6,-1.2551895,36.7822034,-1.3532582,36.907305,778,2755,61,675
18947,17690,1043,2,Personal,13,1,40240,13,1,40582,13,1,41196,13,1,42704,13,1,45152,15,17.3,-1.2143387,36.7914548,-1.2876782,36.8285015,144,2448,342,2122
18948,16626,1148,3,Business,11,6,37953,11,6,37971,11,6,38565,11,6,39964,11,6,40155,2,20.8,-1.3100586,36.8500329,-1.3088186,36.8352514,179,191,18,1993
18949,14146,757,1,Personal,24,1,53656,24,1,53724,24,1,54954,24,1,55116,24,1,58723,6,23.25888921888938,-1.2943818,36.7858765,-1.2863371,36.8200261,328,3607,68,1392
18950,8504,393,3,Business,28,4,36776,28,4,36792,28,4,36817,28,4,37319,28,4,38501,11,19.6,-1.3167113,36.8301563,-1.2638185,36.7930057,809,1182,16,527
18951,2179,2869,3,Business,7,2,50659,7,2,51653,7,2,51862,7,2,54087,7,2,57203,10,23.25888921888938,-1.2584143,36.8048002,-1.3025826,36.7670807,263,3116,994,2434
18952,23820,2154,3,Business,21,5,38638,21,5,38752,21,5,39841,21,5,40164,21,5,42066,8,22.8,-1.2765736,36.8513646,-1.2613452,36.805508,150,1902,114,1412
18953,9923,265,3,Business,14,3,58309,14,3,58333,14,3,58982,14,3,59882,14,3,63210,19,23.4,-1.300921,36.828195,-1.3430735,36.7105064,532,3328,24,1549
18954,20290,2022,1,Personal,21,1,59985,21,1,59997,21,1,60137,21,1,60627,21,1,61454,6,23.25888921888938,-1.2633494,36.7959696,-1.2817125,36.8201761,207,827,12,630
18955,8421,666,2,Personal,9,6,40165,9,6,41945,9,6,42682,9,6,43076,9,6,43761,4,17.3,-1.2770071,36.832167,-1.2597777,36.823734,852,685,1780,1131
18956,1369,2330,3,Business,17,3,46725,17,3,46775,17,3,47260,17,3,47607,17,3,48657,9,23.25888921888938,-1.2645318,36.7981775,-1.2326041,36.8009029,953,1050,50,832
18957,4297,1506,1,Personal,25,2,66921,25,2,66927,25,2,67996,25,2,68344,25,2,72806,16,24.2,-1.2016352,36.8200903,-1.2611642,36.7949932,453,4462,6,1417
18958,14548,893,3,Business,24,2,49807,24,2,49853,24,2,49909,24,2,52624,24,2,53902,5,18.5,-1.2876365,36.816096,-1.2663194,36.809901,929,1278,46,2771
18959,11855,1839,3,Personal,8,5,64574,8,5,64582,8,5,64650,8,5,64993,8,5,65901,4,25.0,-1.2975066,36.7689423,-1.302725,36.734783,669,908,8,411
18960,10102,2965,3,Personal,18,4,29729,18,4,29799,18,4,30672,18,4,30867,18,4,31706,7,23.25888921888938,-1.2629461,36.7653137,-1.2760462,36.8074697,290,839,70,1068
18961,14484,3283,3,Business,6,3,31596,6,3,31614,6,3,31814,6,3,32942,6,3,33486,5,23.25888921888938,-1.2600926,36.8088685,-1.2628473,36.781805,72,544,18,1328
18962,8530,3201,3,Business,28,4,48278,28,4,48299,28,4,48304,28,4,48950,28,4,52974,17,27.6,-1.3165542,36.700067,-1.2584143,36.8048002,876,4024,21,651
18963,26873,1523,1,Personal,2,3,26255,2,3,27201,2,3,29644,2,3,29788,2,3,30967,3,18.1,-1.2676569,36.8018128,-1.273854,36.8003368,432,1179,946,2587
18964,11011,3222,3,Business,15,5,59902,15,5,59913,15,5,60068,15,5,60413,15,5,60873,3,27.9,-1.2551895,36.7822034,-1.25537,36.7756,690,460,11,500
18965,17440,111,3,Business,10,4,40689,10,4,40886,10,4,43966,10,4,44684,10,4,46907,7,24.6,-1.2551895,36.7822034,-1.2871938,36.8195031,831,2223,197,3798
18966,22177,3686,3,Business,30,2,52675,30,2,55641,30,2,55897,30,2,56274,30,2,58513,17,23.25888921888938,-1.2551895,36.7822034,-1.3310643,36.8884157,438,2239,2966,633
18967,19233,1482,3,Business,11,4,46158,11,4,46287,11,4,46608,11,4,46676,11,4,48637,17,24.1,-1.338579,36.8963038,-1.260232,36.807334,543,1961,129,389
18968,756,53,3,Business,3,1,32451,3,1,32541,3,1,32553,3,1,33474,3,1,33575,5,18.2,-1.2770708,36.8231093,-1.3004062,36.829741,70,101,90,933
18969,23279,2066,3,Business,5,3,42438,5,3,42479,5,3,43232,5,3,43548,5,3,46708,10,22.6,-1.3210189,36.8410551,-1.2790807,36.78259723,19,3160,41,1069
18970,11364,2789,3,Business,19,2,36320,19,2,36332,19,2,36686,19,2,36797,19,2,38058,8,23.25888921888938,-1.304735,36.7846054,-1.255956,36.772901,958,1261,12,465
18971,2167,2523,3,Business,20,2,60087,20,2,61457,20,2,61504,20,2,63024,20,2,66714,9,23.8,-1.2551895,36.7822034,-1.2941585,36.7947375,554,3690,1370,1567
18972,5743,3222,3,Business,8,5,52323,8,5,52397,8,5,53605,8,5,54156,8,5,57874,19,30.6,-1.2551895,36.7822034,-1.3253022,36.8803995,103,3718,74,1759
18973,8918,635,3,Business,30,4,54322,30,4,54335,30,4,54345,30,4,57467,30,4,57923,10,23.25888921888938,-1.3081376,36.8329772,-1.2602337,36.7990548,70,456,13,3132
18974,25032,393,3,Business,18,1,50585,18,1,50636,18,1,50674,18,1,51462,18,1,53518,14,29.6,-1.3167113,36.8301563,-1.306378,36.7519845,828,2056,51,826
18975,4498,3496,3,Business,13,5,53802,13,5,54086,13,5,54640,13,5,58909,13,5,59908,13,19.4,-1.332175,36.8819641,-1.300921,36.828195,192,999,284,4823
18976,19808,552,3,Business,16,1,44444,16,1,44463,16,1,44539,16,1,45534,16,1,47029,23,19.4,-1.3404187,36.7614685,-1.3562374,36.9042954,735,1495,19,1071
18977,26141,1926,3,Business,6,2,57847,6,2,59025,6,2,59831,6,2,60690,6,2,63136,10,23.25888921888938,-1.3332749,36.8708147,-1.2897368,36.8226783,612,2446,1178,1665
18978,908,3147,3,Business,12,5,46558,12,5,47198,12,5,49692,12,5,49775,12,5,52729,16,23.25888921888938,-1.3472066,36.7692638,-1.2546732,36.8086796,76,2954,640,2577
18979,15838,2216,3,Business,11,5,49695,11,5,49737,11,5,50380,11,5,50539,11,5,52162,8,26.3,-1.2551895,36.7822034,-1.2933017,36.8008304,660,1623,42,802
18980,15131,1955,3,Business,30,4,55246,30,4,55306,30,4,57564,30,4,58783,30,4,59860,7,23.25888921888938,-1.2897368,36.8226783,-1.2571472,36.7950633,673,1077,60,3477
18981,16690,136,3,Business,15,5,41674,15,5,41690,15,5,42116,15,5,43626,15,5,45165,15,25.7,-1.2874648,36.8271985,-1.3254522,36.7216584,703,1539,16,1936
18982,17345,53,3,Business,16,3,57044,16,3,57091,16,3,57101,16,3,58195,16,3,59425,8,27.0,-1.3167113,36.8301563,-1.2770708,36.8231093,515,1230,47,1104
18983,7705,635,3,Business,25,6,38955,25,6,39833,25,6,40748,25,6,41250,25,6,43967,13,23.25888921888938,-1.2602337,36.7990548,-1.3231725,36.8640177,617,2717,878,1417
18984,10454,3201,3,Business,5,2,53585,5,2,53616,5,2,54269,5,2,54638,5,2,56067,10,23.25888921888938,-1.303806,36.783041,-1.2584143,36.8048002,425,1429,31,1022
18985,23395,3283,3,Business,9,2,44461,9,2,44520,9,2,45010,9,2,45710,9,2,46242,5,21.9,-1.2600926,36.8088685,-1.2628473,36.781805,875,532,59,1190
18986,12312,2056,2,Personal,4,3,40474,4,3,40498,4,3,41385,4,3,41468,4,3,43138,11,17.2,-1.3036691,36.7526062,-1.2619538,36.8087637,449,1670,24,970
18987,3321,2150,3,Business,13,1,50783,13,1,50830,13,1,51262,13,1,53163,13,1,55681,9,19.6,-1.303596,36.778378,-1.344446,36.756597,140,2518,47,2333
18988,1858,1500,3,Business,3,1,40806,3,1,40824,3,1,41222,3,1,41442,3,1,43528,12,21.7,-1.2638185,36.7930057,-1.3167113,36.8301563,411,2086,18,618
18989,15116,2110,1,Personal,20,6,37640,20,6,37657,20,6,38673,20,6,39142,20,6,40760,15,25.6,-1.298752,36.735415,-1.2537505,36.8326484,565,1618,17,1485
18990,22352,2982,3,Business,6,3,59717,6,3,59755,6,3,59823,6,3,61081,6,3,64359,23,23.25888921888938,-1.300921,36.828195,-1.2588448,36.6907159,571,3278,38,1326
18991,13589,3291,3,Business,23,4,47657,23,4,47686,23,4,48754,23,4,49166,23,4,50191,5,24.4,-1.2628473,36.781805,-1.2600926,36.8088685,290,1025,29,1480
18992,7242,3300,3,Business,30,4,35309,30,4,36060,30,4,36302,30,4,36818,30,4,38243,9,19.6,-1.344446,36.756597,-1.303596,36.778378,815,1425,751,758
18993,4274,3380,3,Personal,9,2,42943,9,2,43004,9,2,43717,9,2,44795,9,2,45834,8,26.8,-1.2846475,36.8275903,-1.2963097,36.7688221,855,1039,61,1791
18994,22156,393,3,Business,10,4,51635,10,4,51665,10,4,51766,10,4,52185,10,4,52849,3,25.3,-1.3231001,36.8283559,-1.3004062,36.829741,523,664,30,520
18995,18018,391,3,Business,22,4,48317,22,4,48545,22,4,49399,22,4,49627,22,4,50888,5,26.2,-1.2602337,36.7990548,-1.2777924,36.8231577,114,1261,228,1082
18996,20590,1378,2,Personal,3,5,40571,3,5,40591,3,5,40869,3,5,41259,3,5,41938,3,21.3,-1.2628638,36.8070399,-1.2611642,36.7949932,882,679,20,668
18997,8895,3291,3,Business,4,2,42688,4,2,42726,4,2,42810,4,2,43465,4,2,43813,2,20.3,-1.266837,36.799249,-1.2600926,36.8088685,344,348,38,739
18998,10299,510,3,Business,25,4,52391,25,4,52472,25,4,53764,25,4,55285,25,4,58117,12,23.25888921888938,-1.290894,36.822971,-1.2860183,36.8975338,422,2832,81,2813
18999,24723,3698,3,Business,30,4,61285,30,4,61504,30,4,63383,30,4,63572,30,4,64636,11,23.25888921888938,-1.3244885,36.897792,-1.3975387,36.9377463,126,1064,219,2068
19000,5572,2576,3,Personal,24,5,32971,24,5,33048,24,5,34804,24,5,34934,24,5,38376,18,18.0,-1.3190988,36.8660397,-1.297131,36.7604242,68,3442,77,1886
19001,4541,1340,3,Business,28,3,37546,28,3,37596,28,3,38000,28,3,38759,28,3,40085,9,23.25888921888938,-1.2707179,36.7979713,-1.2602386,36.7503491,131,1326,50,1163
19002,12950,3201,3,Business,21,4,57355,21,4,57368,21,4,57747,21,4,58318,21,4,59147,7,30.8,-1.2584143,36.8048002,-1.2857671,36.7875614,858,829,13,950
19003,24786,3355,3,Business,4,4,29908,4,4,30081,4,4,31371,4,4,31546,4,4,32757,10,18.5,-1.3052491,36.8223899,-1.325086,36.887894,208,1211,173,1465
19004,16177,1108,3,Personal,26,2,56155,26,2,56235,26,2,57405,26,2,57915,26,2,58647,7,29.5,-1.2857521,36.8277457,-1.3210541,36.8169608,336,732,80,1680
19005,23459,248,3,Business,15,3,55968,15,3,55991,15,3,56518,15,3,56729,15,3,57914,7,25.8,-1.304735,36.7846054,-1.2703801,36.7985261,649,1185,23,738
19006,7780,797,3,Business,11,5,53179,11,5,54261,11,5,54643,11,5,55019,11,5,56060,7,22.6,-1.255956,36.789867,-1.2823851,36.8186472,101,1041,1082,758
19007,14461,393,3,Business,14,3,35825,14,3,39156,14,3,40036,14,3,40750,14,3,42658,10,24.8,-1.3177547,36.8303703,-1.2574219,36.7927073,649,1908,3331,1594
19008,23520,302,3,Business,12,5,58610,12,5,58705,12,5,58726,12,5,59414,12,5,60133,3,27.2,-1.2649605,36.7981777,-1.2682322,36.7935927,574,719,95,709
19009,9150,3560,3,Business,7,4,46964,7,4,47363,7,4,48180,7,4,48748,7,4,50376,8,30.9,-1.3014461,36.7661381,-1.279395,36.825364,763,1628,399,1385
19010,19059,296,3,Business,22,5,42281,22,5,42300,22,5,42835,22,5,43091,22,5,45549,20,21.5,-1.2579304,36.8019667,-1.3700383,36.9190174,192,2458,19,791
19011,20790,540,3,Business,28,4,42831,28,4,43362,28,4,44223,28,4,44310,28,4,45404,7,28.1,-1.2886385,36.8240195,-1.2551895,36.7822034,425,1094,531,948
19012,28030,1389,3,Business,7,5,59353,7,5,60710,7,5,61566,7,5,62930,7,5,65118,19,23.2,-1.2859912,36.8756811,-1.207546,36.7913976,685,2188,1357,2220
19013,27010,627,3,Business,16,2,53398,16,2,53410,16,2,53572,16,2,54321,16,2,55584,11,23.25888921888938,-1.2571472,36.7950633,-1.3108386,36.7555239,708,1263,12,911
19014,5931,1500,3,Business,27,3,55967,27,3,55991,27,3,56602,27,3,56907,27,3,57974,11,29.5,-1.3077869,36.8443207,-1.2638185,36.7930057,127,1067,24,916
19015,16044,2804,1,Business,11,5,35569,11,5,35982,11,5,36073,11,5,40021,11,5,40600,7,20.6,-1.2811695,36.8200313,-1.255956,36.789867,644,579,413,4039
19016,5303,2154,3,Business,24,4,49398,24,4,49484,24,4,50929,24,4,51877,24,4,52903,5,28.4,-1.290894,36.822971,-1.2765736,36.8513646,899,1026,86,2393
19017,13302,53,3,Business,18,1,52878,18,1,52966,18,1,53371,18,1,54390,18,1,55623,8,29.5,-1.3167113,36.8301563,-1.2770708,36.8231093,349,1233,88,1424
19018,13241,3091,3,Business,4,4,53105,4,4,53114,4,4,53570,4,4,53725,4,4,54566,2,24.7,-1.3012008,36.764868,-1.2952639,36.7562606,751,841,9,611
19019,9344,2423,3,Business,1,1,50111,1,1,50232,1,1,50956,1,1,51889,1,1,52869,8,23.25888921888938,-1.2551895,36.7822034,-1.2950408,36.8098172,907,980,121,1657
19020,22910,1280,3,Business,11,4,27822,11,4,27835,11,4,29601,11,4,31576,11,4,33887,18,18.7,-1.2551895,36.7822034,-1.3343129,36.8854175,478,2311,13,3741
19021,16503,718,3,Business,18,4,56309,18,4,56350,18,4,56580,18,4,56705,18,4,60581,10,26.7,-1.2551895,36.7822034,-1.3156452,36.815802,268,3876,41,355
19022,12117,2523,3,Business,21,4,43213,21,4,43248,21,4,43326,21,4,44352,21,4,46222,11,28.0,-1.2551895,36.7822034,-1.2310607,36.8035776,26,1870,35,1104
19023,1171,2532,3,Business,15,2,38467,15,2,38473,15,2,38484,15,2,39820,15,2,41196,12,24.5,-1.2571472,36.7950633,-1.329568,36.8520825,449,1376,6,1347
19024,19514,3264,3,Business,9,2,36236,9,2,36243,9,2,36283,9,2,36744,9,2,38237,24,20.7,-1.2551895,36.7822034,-1.1923911,36.9447333,291,1493,7,501
19025,18422,510,3,Business,11,3,51865,11,3,51872,11,3,51879,11,3,51953,11,3,53350,13,20.3,-1.2860183,36.8975338,-1.325469,36.862403,771,1397,7,81
19026,1793,53,3,Business,27,1,43943,27,1,43986,27,1,43994,27,1,46068,27,1,46364,5,20.7,-1.3004062,36.829741,-1.2770708,36.8231093,472,296,43,2082
19027,20843,136,3,Business,21,2,47445,21,2,48069,21,2,48340,21,2,48527,21,2,50102,14,22.5,-1.3254522,36.7216584,-1.2904993,36.8043877,207,1575,624,458
19028,4904,2102,3,Business,20,1,33468,20,1,33510,20,1,37132,20,1,37340,20,1,40147,15,18.9,-1.3323107,36.8692616,-1.2613768,36.8019418,25,2807,42,3830
19029,16771,3203,3,Business,23,1,39929,23,1,41115,23,1,42146,23,1,42756,23,1,43673,6,18.4,-1.2296618,36.8438272,-1.228911,36.881876,144,917,1186,1641
19030,11234,3599,3,Business,10,1,51817,10,1,52795,10,1,54409,10,1,55649,10,1,55679,7,18.4,-1.3302996,36.8707935,-1.3117442,36.8737871,376,30,978,2854
19031,22757,2190,3,Business,28,2,45909,28,2,45975,28,2,46596,28,2,47264,28,2,50033,28,21.1,-1.301953,36.788458,-1.1528493,36.9567638,548,2769,66,1289
19032,25001,136,3,Business,29,2,33024,29,2,33046,29,2,33053,29,2,33373,29,2,33497,1,18.3,-1.2654716,36.7983635,-1.2531983,36.8069669,793,124,22,327
19033,8183,928,3,Business,30,2,52962,30,2,60616,30,2,61393,30,2,63636,30,2,63638,8,23.25888921888938,-1.2551895,36.7822034,-1.2990401,36.8116114,953,2,7654,3020
19034,7236,1402,3,Business,26,2,42801,26,2,42835,26,2,43493,26,2,44843,26,2,45477,1,27.3,-1.290894,36.822971,-1.2813012,36.8323962,855,634,34,2008
19035,361,1133,3,Business,8,2,38375,8,2,38470,8,2,39972,8,2,40132,8,2,41743,6,23.2,-1.2929499,36.8180835,-1.2571472,36.7950633,150,1611,95,1662
19036,14444,2069,3,Business,20,3,54755,20,3,54790,20,3,55592,20,3,56456,20,3,57752,9,29.6,-1.265715,36.823815,-1.228911,36.881876,309,1296,35,1666
19037,7120,3639,1,Personal,18,6,39272,18,6,39340,18,6,42035,18,6,43358,18,6,45331,15,18.9,-1.3581835,36.7553227,-1.2765737,36.8175399,939,1973,68,4018
19038,6988,2312,2,Personal,12,6,61767,12,6,62259,12,6,63308,12,6,63670,12,6,64685,6,23.7,-1.2918164,36.8773248,-1.2962888,36.8892359,742,1015,492,1411
19039,23569,3494,3,Personal,18,3,59733,18,3,59834,18,3,61057,18,3,61240,18,3,62532,7,20.7,-1.2963097,36.7688221,-1.2842286,36.8150609,951,1292,101,1406
19040,18279,3689,3,Business,27,3,56268,27,3,56389,27,3,56466,27,3,57005,27,3,58372,7,29.0,-1.2527958,36.8003131,-1.225322,36.80855,547,1367,121,616
19041,24852,870,3,Personal,8,5,36866,8,5,36907,8,5,37450,8,5,38032,8,5,39765,13,23.25888921888938,-1.263419,36.8060348,-1.2810586,36.8838294,207,1733,41,1125
19042,18989,3062,3,Personal,8,2,64132,8,2,64349,8,2,65487,8,2,65965,8,2,67757,7,23.7,-1.2795819,36.8307141,-1.2765625,36.7809301,698,1792,217,1616
19043,19521,1578,3,Business,20,2,58211,20,2,61434,20,2,62012,20,2,62183,20,2,63872,16,23.7,-1.207546,36.7913976,-1.28878,36.8168312,903,1689,3223,749
19044,10037,970,3,Business,25,4,55820,25,4,55884,25,4,55951,25,4,56336,25,4,56349,1,23.25888921888938,-1.2551895,36.7822034,-1.2538731,36.7850223,258,13,64,452
19045,10599,343,3,Personal,29,2,27765,29,2,28739,29,2,30785,29,2,31286,29,2,32789,14,18.4,-1.1855066,36.8254646,-1.2638898,36.8223638,101,1503,974,2547
19046,1956,267,3,Personal,16,4,40458,16,4,40464,16,4,40662,16,4,40925,16,4,41386,4,14.7,-1.2833106,36.8240238,-1.266294,36.8057971,754,461,6,461
19047,15608,393,3,Business,22,5,46274,22,5,46288,22,5,46293,22,5,46865,22,5,47449,4,23.25888921888938,-1.3167113,36.8301563,-1.3004062,36.829741,111,584,14,577
19048,27637,2112,3,Business,26,2,59106,26,2,59282,26,2,61779,26,2,62133,26,2,64033,11,28.3,-1.2765736,36.8513646,-1.2156006,36.8916865,187,1900,176,2851
19049,14632,3491,3,Business,16,2,62859,16,2,62882,16,2,63441,16,2,63671,16,2,65269,10,24.9,-1.2883158,36.8199114,-1.2297202,36.8819507,89,1598,23,789
19050,27537,2956,3,Business,14,4,41265,14,4,41318,14,4,42331,14,4,42599,14,4,45547,5,25.2,-1.279395,36.825364,-1.2584143,36.8048002,106,2948,53,1281
19051,2082,552,3,Business,10,1,40923,10,1,41231,10,1,42363,10,1,43306,10,1,47358,18,18.3,-1.290894,36.822971,-1.3562374,36.9042954,271,4052,308,2075
19052,15880,659,2,Personal,9,6,38329,9,6,38482,9,6,39840,9,6,40399,9,6,42055,6,17.3,-1.2852584,36.8043641,-1.2670582,36.7680056,752,1656,153,1917
19053,20717,3426,3,Business,14,3,57248,14,3,57919,14,3,58556,14,3,59025,14,3,60338,8,25.7,-1.3014461,36.7661381,-1.2597529,36.806629,268,1313,671,1106
19054,20738,3686,3,Business,17,2,38378,17,2,38397,17,2,38659,17,2,39786,17,2,40592,4,19.2,-1.2551895,36.7822034,-1.2728058,36.8049903,74,806,19,1389
19055,22400,265,3,Business,6,1,54791,6,1,54989,6,1,55891,6,1,57654,6,1,58962,8,23.25888921888938,-1.3154845,36.7912475,-1.300921,36.828195,411,1308,198,2665
19056,26028,1133,3,Business,14,5,46705,14,5,46974,14,5,47136,14,5,47294,14,5,47846,4,24.5,-1.2738936,36.8035805,-1.2571472,36.7950633,85,552,269,320
19057,26643,2956,3,Business,12,5,51843,12,5,53386,12,5,53814,12,5,54464,12,5,55840,7,27.0,-1.225322,36.80855,-1.2584143,36.8048002,726,1376,1543,1078
19058,13343,1292,3,Business,17,4,46372,17,4,46396,17,4,46814,17,4,46987,17,4,47039,3,25.4,-1.2894456,36.7780947,-1.2897215,36.7945959,246,52,24,591
19059,6790,498,1,Personal,27,1,39261,27,1,39292,27,1,39835,27,1,40139,27,1,42542,21,24.2,-1.3046965,36.8016456,-1.16697,36.826728,397,2403,31,847
19060,360,1687,3,Business,27,2,47921,27,2,48094,27,2,48235,27,2,49124,27,2,52073,19,25.4,-1.2626574,36.8014034,-1.370436,36.7536015,40,2949,173,1030
19061,6213,892,2,Personal,21,5,46330,21,5,46378,21,5,47379,21,5,48511,21,5,50028,9,19.9,-1.2649605,36.7981777,-1.312475,36.8225778,754,1517,48,2133
19062,15625,3326,3,Business,8,1,36398,8,1,36411,8,1,36588,8,1,36938,8,1,37247,3,19.8,-1.2551895,36.7822034,-1.2560455,36.7800867,932,309,13,527
19063,27874,2523,3,Business,17,5,35388,17,5,35400,17,5,35503,17,5,36663,17,5,37471,4,23.25888921888938,-1.2551895,36.7822034,-1.2651643,36.8072214,373,808,12,1263
19064,21197,1245,3,Business,13,3,47073,13,3,47086,13,3,48135,13,3,52998,13,3,56716,19,27.3,-1.300921,36.828195,-1.3198615,36.7110323,519,3718,13,5912
19065,1153,1882,1,Business,4,4,32449,4,4,32564,4,4,33502,4,4,33587,4,4,34503,9,18.6,-1.2847654,36.820105,-1.3014461,36.7661381,754,916,115,1023
19066,3730,438,3,Personal,29,2,35394,29,2,35409,29,2,37037,29,2,37179,29,2,39236,4,16.8,-1.2559294,36.788465,-1.2578072,36.8167056,752,2057,15,1770
19067,23377,633,3,Business,20,3,52951,20,3,52970,20,3,52989,20,3,53269,20,3,53272,5,28.6,-1.3004062,36.829741,-1.3228003,36.8306435,39,3,19,299
19068,6629,2148,1,Personal,10,1,33316,10,1,33321,10,1,33780,10,1,35896,10,1,37231,12,18.3,-1.3261306,36.850596,-1.303596,36.778378,85,1335,5,2575
19069,21202,1637,3,Business,14,3,31406,14,3,31761,14,3,32019,14,3,32799,14,3,33043,2,18.5,-1.2615888,36.7928732,-1.2571472,36.7950633,708,244,355,1038
19070,1818,2069,3,Business,3,5,54911,3,5,55064,3,5,57593,3,5,58020,3,5,62188,16,23.25888921888938,-1.303596,36.778378,-1.228911,36.881876,155,4168,153,2956
19071,20761,2801,3,Business,21,1,50601,21,1,50669,21,1,52038,21,1,52122,21,1,53102,8,27.8,-1.3028118,36.8174764,-1.2674274,36.7870827,359,980,68,1453
19072,7464,1075,3,Business,12,2,50774,12,2,50831,12,2,51335,12,2,52367,12,2,52700,2,27.1,-1.2561334,36.7990458,-1.2527958,36.8003131,279,333,57,1536
19073,22198,2523,3,Business,10,1,37596,10,1,37630,10,1,38074,10,1,38380,10,1,39088,2,23.25888921888938,-1.2551895,36.7822034,-1.2557777,36.7994091,820,708,34,750
19074,20992,393,3,Business,30,2,57244,30,2,57848,30,2,57861,30,2,60812,30,2,60816,14,23.25888921888938,-1.3167113,36.8301563,-1.2991441,36.7528804,10,4,604,2964
19075,17206,1271,3,Business,4,4,37545,4,4,37576,4,4,38440,4,4,39728,4,4,41454,19,25.5,-1.3263105,36.8622904,-1.3107918,36.761794,130,1726,31,2152
19076,22004,3030,3,Business,23,2,56277,23,2,56380,23,2,58146,23,2,58480,23,2,60701,10,18.9,-1.2866012,36.8195691,-1.2598589,36.7470168,208,2221,103,2100
19077,27249,393,3,Business,3,5,56293,3,5,56429,3,5,56432,3,5,59286,3,5,59293,14,23.25888921888938,-1.3167113,36.8301563,-1.2991441,36.7528804,619,7,136,2857
19078,26334,265,3,Business,15,5,54538,15,5,55845,15,5,56410,15,5,56724,15,5,57785,4,18.0,-1.2880771,36.8269099,-1.300921,36.828195,709,1061,1307,879
19079,10335,3222,3,Business,8,5,52280,8,5,52322,8,5,52351,8,5,52848,8,5,54794,9,30.3,-1.2551895,36.7822034,-1.3049238,36.7841898,518,1946,42,526
19080,23974,496,3,Business,9,2,41358,9,2,41399,9,2,42106,9,2,42411,9,2,42997,3,27.1,-1.2551895,36.7822034,-1.273488,36.804158,695,586,41,1012
19081,10652,3214,3,Business,23,4,53031,23,4,53094,23,4,53103,23,4,54270,23,4,54275,2,24.6,-1.3030203,36.7902691,-1.289795,36.7957132,445,5,63,1176
19082,5170,3647,3,Business,15,4,49059,15,4,49185,15,4,50127,15,4,50289,15,4,52725,8,27.6,-1.272639,36.794723,-1.2653185,36.8358841,532,2436,126,1104
19083,13712,111,3,Business,7,3,38909,7,3,38961,7,3,39191,7,3,39371,7,3,42131,11,25.3,-1.2551895,36.7822034,-1.2432427,36.8642382,279,2760,52,410
19084,25096,1245,3,Business,12,5,27759,12,5,27766,12,5,27792,12,5,31399,12,5,32839,17,21.8,-1.300921,36.828195,-1.3198615,36.7110323,416,1440,7,3633
19085,17444,3291,3,Business,23,2,50176,23,2,50187,23,2,50336,23,2,50906,23,2,51947,2,23.25888921888938,-1.266837,36.799249,-1.2600926,36.8088685,155,1041,11,719
19086,6540,1329,3,Business,1,4,44405,1,4,44514,1,4,45085,1,4,45285,1,4,46186,5,23.25888921888938,-1.273056,36.811298,-1.293973,36.80169,674,901,109,771
19087,23370,3635,3,Business,1,4,57953,1,4,57979,1,4,58116,1,4,58646,1,4,59084,3,23.25888921888938,-1.2584143,36.8048002,-1.2615888,36.7928732,427,438,26,667
19088,6276,3275,1,Personal,6,3,55576,6,3,55898,6,3,56995,6,3,57550,6,3,59126,8,22.0,-1.2738167,36.8157821,-1.311943,36.8331134,621,1576,322,1652
19089,17523,302,3,Business,26,7,71244,26,7,71265,26,7,73106,26,7,73287,26,7,73849,2,19.5,-1.2649605,36.7981777,-1.252973,36.8165107,40,562,21,2022
19090,4785,393,3,Business,23,3,38987,23,3,38995,23,3,39176,23,3,40710,23,3,40711,5,23.25888921888938,-1.3167113,36.8301563,-1.3077869,36.8443207,523,1,8,1715
19091,25371,3225,1,Personal,2,2,53864,2,2,54092,2,2,54419,2,2,54562,2,2,55087,3,26.1,-1.2844516,36.8245932,-1.2940511,36.8219302,343,525,228,470
19092,12346,1075,3,Business,5,6,42235,5,6,42243,5,6,42251,5,6,42807,5,6,45157,12,22.5,-1.2285835,36.8826468,-1.2527958,36.8003131,557,2350,8,564
19093,7699,2330,3,Business,4,1,50149,4,1,50174,4,1,50448,4,1,50685,4,1,51300,4,28.7,-1.2642903,36.8002137,-1.265432,36.795034,79,615,25,511
19094,18015,1781,3,Business,6,3,54125,6,3,54720,6,3,55921,6,3,56563,6,3,59332,7,21.6,-1.2826317,36.8159429,-1.2579304,36.8019667,268,2769,595,1843
19095,6797,749,1,Personal,21,4,56482,21,4,56568,21,4,58201,21,4,59461,21,4,60903,8,22.5,-1.2635089,36.7887337,-1.304033,36.7848695,425,1442,86,2893
19096,25924,3621,3,Business,25,1,34882,25,1,34963,25,1,35235,25,1,35796,25,1,36621,7,21.3,-1.2836583,36.7886014,-1.2640571,36.7883547,156,825,81,833
19097,6885,2457,3,Business,26,5,49812,26,5,49955,26,5,50859,26,5,51116,26,5,53247,8,23.25888921888938,-1.2551895,36.7822034,-1.305716,36.809882,578,2131,143,1161
19098,7918,1809,3,Business,3,1,29326,3,1,31816,3,1,32998,3,1,34648,3,1,36645,10,18.5,-1.3100609,36.8205365,-1.2571472,36.7950633,338,1997,2490,2832
19099,13808,1874,3,Business,31,3,42756,31,3,43458,31,3,45847,31,3,45913,31,3,47178,7,24.7,-1.2782498,36.8251128,-1.2571472,36.7950633,775,1265,702,2455
19100,3343,3565,3,Business,8,4,54946,8,4,54987,8,4,56273,8,4,56629,8,4,58437,17,27.1,-1.2844665,36.7866113,-1.1985673,36.8363688,518,1808,41,1642
19101,22477,3565,3,Business,8,5,42832,8,5,42855,8,5,43237,8,5,43549,8,5,45531,21,24.0,-1.2844665,36.7866113,-1.391222,36.760676,368,1982,23,694
19102,23496,28,3,Business,26,4,33816,26,4,33831,26,4,34137,26,4,34464,26,4,36454,18,15.2,-1.299846,36.7940155,-1.347383,36.8790012,449,1990,15,633
19103,22888,1640,2,Personal,8,6,41263,8,6,41281,8,6,41379,8,6,44186,8,6,45299,17,22.2,-1.3172701,36.8661154,-1.3671327,36.7564238,765,1113,18,2905
19104,23251,265,3,Business,24,3,30769,24,3,30799,24,3,31948,24,3,32887,24,3,33957,7,23.25888921888938,-1.2960265,36.8780276,-1.300921,36.828195,263,1070,30,2088
19105,20376,1850,3,Business,2,2,48725,2,2,48793,2,2,50032,2,2,51368,2,2,52694,4,29.5,-1.2571472,36.7950633,-1.2889396,36.8155486,119,1326,68,2575
19106,27284,2030,3,Business,22,2,43436,22,2,43754,22,2,44609,22,2,44901,22,2,45607,3,24.2,-1.2963097,36.7688221,-1.295908,36.791433,862,706,318,1147
19107,5439,53,3,Business,23,5,37696,23,5,38756,23,5,38773,23,5,39917,23,5,42235,5,24.1,-1.3004062,36.829741,-1.2770708,36.8231093,748,2318,1060,1161
19108,8099,3182,2,Personal,4,5,82021,4,5,82762,4,5,83400,4,5,83621,4,5,83996,3,17.8,-1.3023009,36.7621432,-1.2901669,36.7685878,312,375,741,859
19109,6829,3496,3,Business,13,4,45616,13,4,45657,13,4,48501,13,4,49604,13,4,52763,23,22.6,-1.300921,36.828195,-1.1956524,36.9488069,925,3159,41,3947
19110,24643,2406,3,Business,3,1,38768,3,1,38890,3,1,40076,3,1,40160,3,1,41011,5,21.6,-1.3064585,36.8119065,-1.2867573,36.8126626,778,851,122,1270
19111,4813,738,3,Business,18,2,51065,18,2,51073,18,2,51344,18,2,51648,18,2,52911,5,27.2,-1.288148,36.7850276,-1.2869351,36.7425907,612,1263,8,575
19112,12778,2344,3,Business,11,1,44654,11,1,44708,11,1,44744,11,1,45679,11,1,47151,12,17.9,-1.2551895,36.7822034,-1.3275536,36.837167,379,1472,54,971
19113,13789,460,3,Personal,30,4,50373,30,4,50412,30,4,51977,30,4,52331,30,4,53335,5,23.25888921888938,-1.261647,36.798846,-1.2524976,36.8062935,221,1004,39,1919
19114,4326,393,3,Business,17,5,35000,17,5,35031,17,5,35224,17,5,36353,17,5,36888,4,23.25888921888938,-1.3167113,36.8301563,-1.3004062,36.829741,211,535,31,1322
19115,5363,1594,3,Business,10,5,54774,10,5,63773,10,5,64016,10,5,64394,10,5,65342,7,23.25888921888938,-1.2620912,36.8013562,-1.225322,36.80855,178,948,8999,621
19116,24148,136,3,Business,29,6,43582,29,6,43611,29,6,44176,29,6,44283,29,6,46374,16,25.2,-1.2652979,36.8000399,-1.3169591,36.7000029,263,2091,29,672
19117,20369,928,3,Business,30,2,59025,30,2,60683,30,2,61432,30,2,63582,30,2,63589,7,23.25888921888938,-1.2551895,36.7822034,-1.2936941,36.8156795,953,7,1658,2899
19118,22939,2192,1,Personal,1,1,56375,1,1,56393,1,1,56715,1,1,57182,1,1,60272,14,25.6,-1.2975066,36.7689423,-1.2481864,36.8644269,754,3090,18,789
19119,4694,1672,2,Personal,17,5,41151,17,5,41200,17,5,42109,17,5,42314,17,5,43962,5,17.8,-1.2804664,36.7701111,-1.2560455,36.7800867,882,1648,49,1114
19120,8833,567,3,Business,21,5,39669,21,5,39681,21,5,40216,21,5,40452,21,5,40928,2,20.2,-1.2982678,36.7578839,-1.2963097,36.7688221,79,476,12,771
19121,2912,3517,3,Business,5,2,38187,5,2,38509,5,2,41065,5,2,42637,5,2,44623,10,23.5,-1.300921,36.828195,-1.3231726,36.8916037,899,1986,322,4128
19122,24780,1993,2,Personal,31,5,43584,31,5,43619,31,5,44523,31,5,45065,31,5,45920,10,17.1,-1.2871938,36.8195031,-1.2467896,36.8698733,865,855,35,1446
19123,24010,685,3,Business,22,3,51661,22,3,51944,22,3,52064,22,3,54093,22,3,54984,4,24.3,-1.265432,36.795034,-1.2619756,36.800139,436,891,283,2149
19124,14028,1724,3,Business,8,4,56058,8,4,56440,8,4,59955,8,4,60375,8,4,61406,6,25.4,-1.2551895,36.7822034,-1.2655306,36.828148,646,1031,382,3935
19125,12420,1271,3,Business,19,2,54427,19,2,54452,19,2,55055,19,2,55205,19,2,56248,8,29.2,-1.3244885,36.897792,-1.2875442,36.891335,675,1043,25,753
19126,19019,2763,3,Business,24,3,50571,24,3,50586,24,3,50679,24,3,50915,24,3,51833,8,23.25888921888938,-1.2551895,36.7822034,-1.2934638,36.7668028,422,918,15,329
19127,8951,1471,3,Business,3,1,43683,3,1,43840,3,1,44559,3,1,44627,3,1,47218,5,21.6,-1.2551895,36.7822034,-1.2684319,36.8165853,194,2591,157,787
19128,7112,2982,3,Business,14,2,53433,14,2,57199,14,2,57533,14,2,58284,14,2,59466,7,23.25888921888938,-1.300921,36.828195,-1.325469,36.862403,675,1182,3766,1085
19129,24228,1329,3,Business,2,5,60705,2,5,61781,2,5,62506,2,5,62581,2,5,68972,5,24.1,-1.273056,36.811298,-1.283016,36.8019595,287,6391,1076,800
19130,8894,2330,3,Business,22,5,36718,22,5,37204,22,5,38429,22,5,38723,22,5,40279,8,23.25888921888938,-1.2873232,36.7658572,-1.293082,36.8278578,828,1556,486,1519
19131,21967,393,3,Business,11,2,36810,11,2,36860,11,2,36871,11,2,37638,11,2,38874,11,16.5,-1.3228003,36.8306435,-1.2638185,36.7930057,891,1236,50,778
19132,13973,3222,3,Business,8,5,40018,8,5,40033,8,5,40479,8,5,40567,8,5,43653,17,28.3,-1.2551895,36.7822034,-1.2977643,36.8844591,25,3086,15,534
19133,8522,1363,3,Business,12,2,54981,12,2,55004,12,2,55468,12,2,56847,12,2,56852,5,27.0,-1.3004062,36.829741,-1.3228003,36.8306435,523,5,23,1843
19134,8040,357,3,Business,13,2,41865,13,2,42167,13,2,43050,13,2,43279,13,2,45264,4,22.3,-1.2945179,36.7685349,-1.298419,36.7908721,533,1985,302,1112
19135,9241,2150,3,Business,6,3,49303,6,3,50080,6,3,50884,6,3,52340,6,3,53803,15,22.0,-1.265715,36.823815,-1.344446,36.756597,852,1463,777,2260
19136,10119,2713,2,Personal,2,3,32275,2,3,32580,2,3,33590,2,3,33991,2,3,37303,7,18.1,-1.2669636,36.8353831,-1.29912,36.8180616,906,3312,305,1411
19137,11231,265,3,Business,23,4,43137,23,4,43177,23,4,44141,23,4,44745,23,4,46508,9,18.4,-1.300921,36.828195,-1.2557724,36.8295219,929,1763,40,1568
19138,12292,635,3,Business,11,4,37224,11,4,37232,11,4,37299,11,4,37700,11,4,38716,8,22.0,-1.2602337,36.7990548,-1.292188,36.764855,831,1016,8,468
19139,7713,2016,1,Personal,13,5,67346,13,5,67363,13,5,68009,13,5,68307,13,5,70572,19,19.0,-1.2821569,36.7984426,-1.1871375,36.8480466,806,2265,17,944
19140,18126,1703,3,Personal,4,3,35982,4,3,44190,4,3,44816,4,3,45262,4,3,46348,3,17.2,-1.2806884,36.8204868,-1.2896399,36.8124498,79,1086,8208,1072
19141,27596,393,3,Business,7,5,42351,7,5,42400,7,5,42411,7,5,46463,7,5,46469,14,23.25888921888938,-1.3228003,36.8306435,-1.2991441,36.7528804,855,6,49,4063
19142,772,517,3,Business,4,3,49755,4,3,51936,4,3,52168,4,3,56812,4,3,56904,10,18.5,-1.3177547,36.8303703,-1.2574219,36.7927073,927,92,2181,4876
19143,19493,413,1,Personal,11,2,47895,11,2,48236,11,2,50038,11,2,51100,11,2,51959,9,25.4,-1.289195,36.7817368,-1.3173869,36.8112044,933,859,341,2864
19144,12799,186,1,Business,24,5,43252,24,5,43257,24,5,43976,24,5,44420,24,5,45496,3,21.2,-1.2890399,36.8164942,-1.2994217,36.8009779,498,1076,5,1163
19145,7773,2020,1,Personal,21,7,45620,21,7,46590,21,7,49414,21,7,49699,21,7,53220,21,27.2,-1.392306,36.734044,-1.3014817,36.7907294,647,3521,970,3109
19146,2078,2373,1,Personal,16,4,56809,16,4,56830,16,4,57876,16,4,59484,16,4,63951,15,19.1,-1.2868838,36.8284259,-1.3326173,36.7146233,711,4467,21,2654
19147,5655,2309,2,Personal,1,1,53207,1,1,55225,1,1,56044,1,1,57412,1,1,59608,20,25.6,-1.308177,36.879807,-1.2248308,36.8012573,584,2196,2018,2187
19148,7730,661,3,Business,29,4,34852,29,4,34858,29,4,34910,29,4,34991,29,4,37797,20,18.7,-1.3244885,36.897792,-1.2963097,36.7688221,164,2806,6,133
19149,2761,2523,3,Business,4,2,39253,4,2,39270,4,2,39311,4,2,39499,4,2,40285,3,20.4,-1.2551895,36.7822034,-1.2629594,36.8077626,829,786,17,229
19150,10953,1831,3,Business,24,3,49822,24,3,50011,24,3,51137,24,3,51255,24,3,54514,21,18.3,-1.3562374,36.9042954,-1.2571472,36.7950633,283,3259,189,1244
19151,20774,904,3,Business,25,4,54214,25,4,54408,25,4,55458,25,4,56577,25,4,57416,5,21.0,-1.259697,36.802203,-1.2663722,36.8207422,544,839,194,2169
19152,14930,81,3,Business,20,4,41403,20,4,41411,20,4,41535,20,4,41893,20,4,42189,2,22.2,-1.259697,36.800664,-1.2641496,36.7914139,720,296,8,482
19153,17706,3557,3,Business,28,3,57785,28,3,57815,28,3,59147,28,3,59325,28,3,61092,10,23.25888921888938,-1.317411,36.818222,-1.2546732,36.8086796,343,1767,30,1510
19154,3461,811,2,Personal,23,1,39629,23,1,39706,23,1,40225,23,1,40629,23,1,42448,7,18.7,-1.2963097,36.7688221,-1.2864674,36.820262,229,1819,77,923
19155,19628,2200,3,Business,24,6,40119,24,6,41820,24,6,42649,24,6,43079,24,6,45305,9,23.9,-1.290894,36.822971,-1.2765492,36.7669809,477,2226,1701,1259
19156,12818,1899,3,Business,24,4,41046,24,4,41181,24,4,43395,24,4,43744,24,4,44937,14,21.2,-1.303596,36.778378,-1.331619,36.847976,543,1193,135,2563
19157,344,577,3,Personal,14,5,31402,14,5,31424,14,5,32146,14,5,33552,14,5,34361,1,18.1,-1.2614346,36.8283124,-1.2626954,36.8273738,882,809,22,2128
19158,27320,164,3,Personal,1,5,38155,1,5,39085,1,5,41173,1,5,43024,1,5,44778,20,26.3,-1.1993973,36.9299368,-1.2752846,36.8027022,75,1754,930,3939
19159,26769,3614,2,Personal,8,1,45153,8,1,45184,8,1,45919,8,1,46605,8,1,47529,11,24.3,-1.2546637,36.8248917,-1.2100548,36.7809686,427,924,31,1421
19160,1727,2335,3,Business,23,3,42863,23,3,42879,23,3,43635,23,3,43737,23,3,46407,22,23.25888921888938,-1.2551895,36.7822034,-1.3562374,36.9042954,932,2670,16,858
19161,7813,3331,3,Business,15,2,35458,15,2,35472,15,2,35489,15,2,35807,15,2,36723,5,20.5,-1.2551895,36.7822034,-1.2731645,36.7900343,518,916,14,335
19162,10229,393,3,Business,3,3,60173,3,3,60193,3,3,60200,3,3,61254,3,3,63233,11,27.4,-1.3167113,36.8301563,-1.2638185,36.7930057,223,1979,20,1061
19163,15204,3264,3,Business,15,4,46317,15,4,46368,15,4,46699,15,4,46908,15,4,47350,3,24.4,-1.2551895,36.7822034,-1.2642333,36.7795483,290,442,51,540
19164,22881,3669,3,Business,8,2,52477,8,2,52763,8,2,53188,8,2,53599,8,2,55582,14,25.1,-1.2615888,36.7928732,-1.3246123,36.7902267,539,1983,286,836
19165,185,3519,1,Personal,13,6,65640,13,6,65713,13,6,66437,13,6,66632,13,6,67645,5,26.6,-1.2817426,36.7846148,-1.289498,36.818878,956,1013,73,919
19166,17455,1340,3,Business,26,2,45118,26,2,45190,26,2,45494,26,2,47222,26,2,47719,3,26.4,-1.253966,36.7987692,-1.2707179,36.7979713,205,497,72,2032
19167,22092,3426,3,Business,1,4,44725,1,4,44978,1,4,48402,1,4,48712,1,4,51529,3,23.25888921888938,-1.3014461,36.7661381,-1.2974961,36.7812824,86,2817,253,3734
19168,12905,552,3,Business,20,4,45717,20,4,45753,20,4,47496,20,4,47621,20,4,50412,20,22.4,-1.2584143,36.8048002,-1.3632162,36.9108253,496,2791,36,1868
19169,23633,635,3,Business,10,1,48615,10,1,49698,10,1,52157,10,1,53396,10,1,56427,28,18.3,-1.2847613,36.967084,-1.2602337,36.7990548,581,3031,1083,3698
19170,18374,2931,3,Business,15,2,51419,15,2,51433,15,2,52010,15,2,53446,15,2,56026,23,24.6,-1.3433181,36.9138018,-1.2452664,36.8028541,504,2580,14,2013
19171,26488,1148,3,Business,11,5,51940,11,5,52795,11,5,54190,11,5,55518,11,5,57864,15,22.5,-1.3100586,36.8500329,-1.2294985,36.8775495,482,2346,855,2723
19172,24902,393,3,Business,17,3,53401,17,3,53421,17,3,53950,17,3,54541,17,3,55890,10,28.4,-1.3177547,36.8303703,-1.2574219,36.7927073,731,1349,20,1120
19173,28092,635,3,Business,5,3,39889,5,3,40260,5,3,40623,5,3,40742,5,3,45100,7,22.2,-1.2599563,36.7993439,-1.3016417,36.8271679,436,4358,371,482
19174,13838,633,3,Business,12,1,36038,12,1,36064,12,1,37356,12,1,37663,12,1,39072,4,19.5,-1.3077869,36.8443207,-1.3004062,36.829741,95,1409,26,1599
19175,2903,2008,3,Business,31,2,47513,31,2,47588,31,2,48227,31,2,48807,31,2,49753,5,21.9,-1.2508229,36.7895263,-1.2638898,36.8223638,882,946,75,1219
19176,8684,198,3,Business,4,1,29671,4,1,30709,4,1,32729,4,1,32848,4,1,34728,13,18.2,-1.3396256,36.8863135,-1.3008471,36.8099068,618,1880,1038,2139
19177,16142,2587,3,Business,3,5,34149,3,5,34356,3,5,35179,3,5,35431,3,5,35511,3,17.3,-1.2720269,36.8174107,-1.2885529,36.8160141,79,80,207,1075
19178,2232,391,3,Business,3,3,34873,3,3,35849,3,3,36920,3,3,37419,3,3,40462,15,21.2,-1.177202,36.8351183,-1.2784063,36.8222933,102,3043,976,1570
19179,19894,478,3,Business,8,5,40907,8,5,40955,8,5,41664,8,5,42025,8,5,42485,4,28.3,-1.2551895,36.7822034,-1.2657464,36.7801144,269,460,48,1070
19180,6195,136,3,Business,7,2,41295,7,2,42281,7,2,43276,7,2,43530,7,2,46051,18,23.25888921888938,-1.3254522,36.7216584,-1.2518057,36.7997135,831,2521,986,1249
19181,23785,3420,3,Business,27,3,34288,27,3,34302,27,3,34868,27,3,35085,27,3,36498,6,21.2,-1.3046007,36.8211743,-1.275885,36.8066908,448,1413,14,783
19182,9702,3291,3,Business,9,4,44735,9,4,44948,9,4,45849,9,4,46440,9,4,48103,12,23.25888921888938,-1.331619,36.847976,-1.2600926,36.8088685,328,1663,213,1492
19183,26021,3080,3,Business,21,2,39906,21,2,40003,21,2,40252,21,2,41144,21,2,42453,8,22.3,-1.2551895,36.7822034,-1.2862436,36.791017,138,1309,97,1141
19184,8159,2517,1,Personal,31,4,56693,31,4,56804,31,4,57986,31,4,58386,31,4,60085,8,22.7,-1.2624061,36.7953252,-1.2930073,36.7788188,844,1699,111,1582
19185,9371,2241,1,Personal,6,4,37975,6,4,38031,6,4,38528,6,4,39434,6,4,40674,9,22.2,-1.2782261,36.8225009,-1.255513,36.752422,726,1240,56,1403
19186,27881,769,1,Personal,15,2,59915,15,2,60018,15,2,61392,15,2,61853,15,2,62671,7,23.5,-1.2988291,36.7795686,-1.3104077,36.804355,865,818,103,1835
19187,15513,3462,1,Personal,4,3,34735,4,3,34791,4,3,36348,4,3,36480,4,3,37509,5,14.8,-1.255683,36.813771,-1.2677689,36.7857969,808,1029,56,1689
19188,12579,186,3,Business,22,5,32280,22,5,32405,22,5,35061,22,5,35223,22,5,37817,23,22.0,-1.3700383,36.9190174,-1.2571472,36.7950633,863,2594,125,2818
19189,17217,391,3,Business,16,2,46510,16,2,47612,16,2,49011,16,2,49415,16,2,52620,15,27.3,-1.319613,36.711055,-1.2784063,36.8222933,328,3205,1102,1803
19190,23915,2412,3,Business,5,2,59336,5,2,59670,5,2,60614,5,2,64774,5,2,64874,11,23.25888921888938,-1.279395,36.825364,-1.2283403,36.8822756,119,100,334,5104
19191,15136,3355,3,Business,15,3,56716,15,3,56870,15,3,57631,15,3,58833,15,3,61377,9,25.9,-1.290894,36.822971,-1.2859912,36.8756811,907,2544,154,1963
19192,26541,1075,3,Business,18,1,45815,18,1,45849,18,1,46042,18,1,47407,18,1,47826,2,27.9,-1.2571472,36.7950633,-1.2527958,36.8003131,131,419,34,1558
19193,21042,103,3,Business,27,6,45344,27,6,46587,27,6,49332,27,6,49635,27,6,51157,13,23.25888921888938,-1.2907037,36.9164122,-1.286553,36.8273374,895,1522,1243,3048
19194,8783,824,3,Business,26,1,55803,26,1,55842,26,1,56942,26,1,57252,26,1,60032,32,22.4,-1.207546,36.7913976,-1.3169591,36.7000029,403,2780,39,1410
19195,4253,3621,3,Business,15,4,56753,15,4,56818,15,4,57271,15,4,57583,15,4,58674,5,27.4,-1.2836583,36.7886014,-1.290724,36.81947,510,1091,65,765
19196,23987,2276,2,Personal,7,1,32424,7,1,32557,7,1,32846,7,1,33429,7,1,33803,4,18.6,-1.2832116,36.788102,-1.2874711,36.7646208,813,374,133,872
19197,16062,1502,3,Business,15,5,62308,15,5,62425,15,5,62779,15,5,62992,15,5,64335,6,27.9,-1.2232123,36.8932547,-1.1898857,36.9103054,291,1343,117,567
19198,20704,2587,3,Business,13,4,50724,13,4,50814,13,4,51673,13,4,52044,13,4,53730,5,22.9,-1.28878,36.8168312,-1.2922364,36.7895538,819,1686,90,1230
19199,21024,3201,3,Business,23,4,49102,23,4,49156,23,4,50288,23,4,50631,23,4,51829,4,24.8,-1.2584143,36.8048002,-1.2736095,36.8011282,783,1198,54,1475
19200,22900,2066,3,Business,9,1,44739,9,1,44879,9,1,45477,9,1,46032,9,1,47226,11,20.1,-1.316961,36.820337,-1.362319,36.743983,650,1194,140,1153
19201,597,2824,1,Personal,6,6,43334,6,6,43351,6,6,44040,6,6,44202,6,6,45557,4,24.3,-1.2924639,36.7795798,-1.3090343,36.7662134,247,1355,17,851
19202,14682,633,3,Business,13,3,43368,13,3,43433,13,3,44460,13,3,44603,13,3,45559,6,25.0,-1.3083266,36.8494756,-1.3004062,36.829741,260,956,65,1170
19203,21744,999,1,Personal,7,4,48245,7,4,48550,7,4,51192,7,4,51796,7,4,52997,5,20.3,-1.2853965,36.8183118,-1.2852142,36.7940293,844,1201,305,3246
19204,27065,2789,3,Business,28,4,51765,28,4,51793,28,4,52675,28,4,54475,28,4,55252,3,27.3,-1.2929747,36.7646358,-1.304735,36.7846054,682,777,28,2682
19205,1130,2216,3,Business,2,3,50832,2,3,53357,2,3,54660,2,3,54737,2,3,56813,15,26.0,-1.2867627,36.883446,-1.2854174,36.7951152,576,2076,2525,1380
19206,24413,847,3,Business,8,3,43921,8,3,44181,8,3,45445,8,3,46187,8,3,48060,13,23.25888921888938,-1.3298648,36.8774718,-1.287353,36.826992,705,1873,260,2006
19207,1604,3291,3,Business,4,2,33832,4,2,35994,4,2,36982,4,2,37364,4,2,38461,4,16.0,-1.272828,36.816608,-1.2600926,36.8088685,477,1097,2162,1370
19208,26281,42,3,Business,10,1,51801,10,1,52187,10,1,52696,10,1,53421,10,1,53915,2,23.25888921888938,-1.25537,36.7756,-1.2560455,36.7800867,742,494,386,1234
19209,9967,1271,3,Business,4,2,35932,4,2,37046,4,2,38263,4,2,38644,4,2,41149,24,19.7,-1.3244885,36.897792,-1.2830073,36.7662294,741,2505,1114,1598
19210,17082,1004,3,Business,30,2,51624,30,2,51769,30,2,52389,30,2,52673,30,2,54762,9,23.25888921888938,-1.3250048,36.8697188,-1.333148,36.922453,378,2089,145,904
19211,24326,1033,3,Personal,13,3,60597,13,3,60837,13,3,61675,13,3,62986,13,3,64698,11,26.0,-1.2326041,36.8009029,-1.2086859,36.859699,247,1712,240,2149
19212,25504,2828,3,Business,27,3,57022,27,3,57042,27,3,58130,27,3,58297,27,3,62516,22,29.7,-1.2615888,36.7928732,-1.3981712,36.7673241,147,4219,20,1255
19213,5589,3201,3,Business,18,1,37761,18,1,37784,18,1,38441,18,1,38759,18,1,39163,1,23.25888921888938,-1.2649605,36.7981777,-1.2632534,36.7993427,100,404,23,975
19214,24022,176,1,Personal,24,4,54829,24,4,61490,24,4,63014,24,4,64039,24,4,64799,3,21.3,-1.2864298,36.8224345,-1.2666695,36.8328283,752,760,6661,2549
19215,18586,897,2,Personal,5,2,38762,5,2,38831,5,2,39350,5,2,39852,5,2,41914,9,21.4,-1.2795796,36.819062,-1.2295075,36.8016971,949,2062,69,1021
19216,26257,2523,3,Business,22,4,52106,22,4,52353,22,4,54048,22,4,54206,22,4,55386,8,26.2,-1.2551895,36.7822034,-1.2904793,36.7716096,941,1180,247,1853
19217,21801,1233,3,Personal,22,2,47407,22,2,48247,22,2,48524,22,2,49650,22,2,50860,6,25.7,-1.2825816,36.8092346,-1.25537,36.7756,487,1210,840,1403
19218,21756,3565,3,Business,9,6,35257,9,6,35282,9,6,35757,9,6,36526,9,6,38127,19,19.9,-1.2844665,36.7866113,-1.3146822,36.8900627,862,1601,25,1244
19219,17644,1329,3,Business,1,1,53066,1,1,53147,1,1,53589,1,1,53696,1,1,56049,12,23.25888921888938,-1.273056,36.811298,-1.2231711,36.8680113,166,2353,81,549
19220,3465,3292,1,Personal,27,4,32404,27,4,32477,27,4,33370,27,4,33821,27,4,35062,8,18.9,-1.3044313,36.818504,-1.2538731,36.7850223,167,1241,73,1344
19221,26147,2154,3,Business,10,1,29753,10,1,30199,10,1,32283,10,1,32632,10,1,35294,5,16.7,-1.2765736,36.8513646,-1.2869041,36.8240057,271,2662,446,2433
19222,19731,2187,3,Business,24,5,47442,24,5,48010,24,5,48145,24,5,49125,24,5,50615,5,22.9,-1.28878,36.8168312,-1.312469,36.815177,320,1490,568,1115
19223,14293,2701,3,Business,23,4,42158,23,4,42251,23,4,42631,23,4,42827,23,4,47145,17,23.2,-1.2765736,36.8513646,-1.3705766,36.9120742,404,4318,93,576
19224,16985,53,3,Business,27,3,34037,27,3,34120,27,3,34459,27,3,36625,27,3,36998,5,23.25888921888938,-1.3004062,36.829741,-1.2770708,36.8231093,436,373,83,2505
19225,24388,496,3,Business,9,2,41185,9,2,42678,9,2,43225,9,2,43366,9,2,46971,7,22.0,-1.2551895,36.7822034,-1.2889024,36.8187402,268,3605,1493,688
19226,6233,53,3,Business,21,4,32847,21,4,32861,21,4,33248,21,4,35389,21,4,36272,4,18.9,-1.3004062,36.829741,-1.29508,36.796863,311,883,14,2528
19227,19198,53,3,Business,1,4,42378,1,4,42386,1,4,42394,1,4,44533,1,4,46358,19,23.25888921888938,-1.3177547,36.8303703,-1.3192789,36.7112991,619,1825,8,2147
19228,2656,3217,3,Business,26,4,49614,26,4,49718,26,4,51887,26,4,52052,26,4,53092,4,21.8,-1.225322,36.80855,-1.214328,36.7911903,519,1040,104,2334
19229,13073,2030,3,Business,18,2,51524,18,2,51546,18,2,51556,18,2,51700,18,2,53129,3,25.4,-1.2963097,36.7688221,-1.295908,36.791433,220,1429,22,154
19230,21168,3300,3,Business,28,2,50570,28,2,50645,28,2,51361,28,2,51764,28,2,52911,8,23.4,-1.2663631,36.8163329,-1.303596,36.778378,706,1147,75,1119
19231,5482,868,3,Business,7,2,41319,7,2,41524,7,2,42428,7,2,42817,7,2,43508,5,23.0,-1.2600926,36.8088685,-1.265715,36.823815,105,691,205,1293
19232,5436,2869,3,Business,18,4,30097,18,4,30117,18,4,31289,18,4,32233,18,4,34185,3,23.25888921888938,-1.3025826,36.7670807,-1.2763494,36.7671783,155,1952,20,2116
19233,5937,1500,3,Business,16,2,31508,16,2,31751,16,2,32251,16,2,33608,16,2,34688,8,23.25888921888938,-1.3004062,36.829741,-1.2638185,36.7930057,843,1080,243,1857
19234,11652,1500,3,Business,14,2,41531,14,2,41562,14,2,41616,14,2,42976,14,2,43062,8,23.25888921888938,-1.3004062,36.829741,-1.2638185,36.7930057,137,86,31,1414
19235,25923,2885,1,Personal,20,4,60324,20,4,60344,20,4,60659,20,4,61389,20,4,62504,6,24.8,-1.2671296,36.8125772,-1.29817,36.8001417,612,1115,20,1045
19236,1610,28,3,Business,20,5,35133,20,5,35179,20,5,35943,20,5,36336,20,5,37029,7,14.6,-1.299846,36.7940155,-1.2783772,36.8201617,752,693,46,1157
19237,2154,928,3,Business,24,5,49252,24,5,49286,24,5,50213,24,5,50633,24,5,53078,7,23.1,-1.2551895,36.7822034,-1.290724,36.81947,204,2445,34,1347
19238,13957,3561,3,Personal,24,5,33126,24,5,33213,24,5,33946,24,5,34193,24,5,35199,5,15.7,-1.2658315,36.809049,-1.2807298,36.8299116,194,1006,87,980
19239,15532,3222,3,Business,21,2,31513,21,2,31525,21,2,31567,21,2,31987,21,2,33318,9,23.25888921888938,-1.2551895,36.7822034,-1.3034286,36.826553,155,1331,12,462
19240,17265,3647,3,Business,21,4,51899,21,4,51945,21,4,53578,21,4,53763,21,4,55596,8,30.9,-1.272639,36.794723,-1.2960064,36.7582367,682,1833,46,1818
19241,21136,3338,3,Business,26,2,53019,26,2,53042,26,2,53212,26,2,54799,26,2,56110,9,31.2,-1.3014461,36.7661381,-1.2551895,36.7822034,187,1311,23,1757
19242,16063,2069,3,Business,29,5,39237,29,5,43839,29,5,44590,29,5,45473,29,5,47829,6,26.8,-1.2296618,36.8438272,-1.228911,36.881876,519,2356,4602,1634
19243,22498,2423,3,Business,6,4,39589,6,4,39621,6,4,40208,6,4,40269,6,4,41822,14,24.3,-1.2551895,36.7822034,-1.329568,36.8520825,764,1553,32,648
19244,2184,2188,2,Personal,25,3,53051,25,3,53084,25,3,54352,25,3,55272,25,3,56636,8,17.5,-1.2970279,36.761356,-1.269534,36.80697,754,1364,33,2188
19245,10778,1502,3,Business,9,2,49550,9,2,50796,9,2,53752,9,2,53976,9,2,54233,7,30.8,-1.2232123,36.8932547,-1.2525335,36.8751139,300,257,1246,3180
19246,6106,970,3,Business,24,4,40832,24,4,40879,24,4,41008,24,4,41204,24,4,42957,10,24.7,-1.2551895,36.7822034,-1.312469,36.815177,828,1753,47,325
19247,14481,3565,3,Business,27,6,40267,27,6,40287,27,6,40934,27,6,46339,27,6,49075,23,23.25888921888938,-1.2844665,36.7866113,-1.2843119,36.9079841,648,2736,20,6052
19248,11361,2956,3,Business,2,2,47583,2,2,47868,2,2,50680,2,2,50804,2,2,52381,10,29.6,-1.2584143,36.8048002,-1.3129578,36.8463197,660,1577,285,2936
19249,12060,2066,3,Business,28,4,59708,28,4,60427,28,4,61603,28,4,61753,28,4,64558,8,27.9,-1.3210189,36.8410551,-1.270518,36.8349244,343,2805,719,1326
19250,311,2200,3,Business,30,2,36732,30,2,39832,30,2,41650,30,2,41798,30,2,42342,2,22.5,-1.28878,36.8168312,-1.290894,36.822971,895,544,3100,1966
19251,3293,3147,3,Business,12,2,45449,12,2,45496,12,2,48136,12,2,48630,12,2,49322,4,24.7,-1.3472066,36.7692638,-1.3205111,36.7801016,328,692,47,3134
19252,1473,3647,3,Business,4,2,62331,4,2,62361,4,2,62883,4,2,63257,4,2,63505,2,22.2,-1.272639,36.794723,-1.2741728,36.7969108,486,248,30,896
19253,7049,432,3,Business,20,3,60062,20,3,60279,20,3,61027,20,3,61427,20,3,62906,8,27.4,-1.3012008,36.764868,-1.2551895,36.7822034,523,1479,217,1148
19254,14171,2523,3,Business,29,1,50334,29,1,50395,29,1,50812,29,1,51028,29,1,53370,8,23.25888921888938,-1.2551895,36.7822034,-1.295156,36.8094306,161,2342,61,633
19255,20083,552,3,Business,11,5,34801,11,5,36147,11,5,37967,11,5,38313,11,5,41845,17,21.2,-1.3632162,36.9108253,-1.291768,36.8297208,332,3532,1346,2166
19256,24521,2030,3,Business,21,2,51957,21,2,52000,21,2,52652,21,2,52806,21,2,53303,2,24.8,-1.2839651,36.7891704,-1.295908,36.791433,277,497,43,806
19257,19697,2200,3,Business,8,4,42942,8,4,43063,8,4,44691,8,4,45128,8,4,47904,7,26.3,-1.290894,36.822971,-1.2546732,36.7923244,512,2776,121,2065
19258,19933,1245,3,Business,20,1,30463,20,1,31388,20,1,33994,20,1,34938,20,1,37098,14,14.2,-1.3882008,36.7699445,-1.3198615,36.7110323,939,2160,925,3550
19259,27656,467,3,Business,10,5,43351,10,5,43379,10,5,43648,10,5,44326,10,5,45391,3,23.25888921888938,-1.304735,36.7846054,-1.2850048,36.7923379,468,1065,28,947
19260,10741,1705,3,Business,15,4,44175,15,4,44192,15,4,44395,15,4,44502,15,4,47746,17,24.2,-1.2551895,36.7822034,-1.3393558,36.8982418,283,3244,17,310
19261,26180,393,3,Business,2,2,32204,2,2,35289,2,2,36880,2,2,38077,2,2,38873,4,26.0,-1.3167113,36.8301563,-1.3004062,36.829741,92,796,3085,2788
19262,2702,1225,2,Personal,17,2,31183,17,2,33536,17,2,34598,17,2,35012,17,2,38907,23,14.6,-1.3700383,36.9190174,-1.297651,36.7918392,668,3895,2353,1476
19263,6368,265,3,Business,20,5,55446,20,5,58314,20,5,58328,20,5,59545,20,5,61058,7,20.1,-1.300921,36.828195,-1.2908072,36.7860517,890,1513,2868,1231
19264,14908,3560,3,Business,28,4,55433,28,4,55581,28,4,57769,28,4,58477,28,4,60052,5,27.5,-1.279395,36.825364,-1.307241,36.8302368,96,1575,148,2896
19265,19706,136,3,Business,14,2,38912,14,2,38933,14,2,39495,14,2,40482,14,2,42560,20,23.25888921888938,-1.2943371,36.8267,-1.3254522,36.7216584,622,2078,21,1549
19266,6624,2030,3,Business,17,1,30371,17,1,30411,17,1,33248,17,1,33810,17,1,34867,3,18.8,-1.2963097,36.7688221,-1.295908,36.791433,267,1057,40,3399
19267,1028,1340,3,Business,8,5,61614,8,5,61997,8,5,62229,8,5,62392,8,5,63189,3,27.9,-1.2707179,36.7979713,-1.2734594,36.8170558,829,797,383,395
19268,14073,136,3,Business,18,1,31904,18,1,32262,18,1,33682,18,1,33943,18,1,34892,17,21.3,-1.3254522,36.7216584,-1.3233496,36.8139159,170,949,358,1681
19269,19576,70,2,Personal,24,1,34747,24,1,34770,24,1,34974,24,1,35258,24,1,37210,8,15.4,-1.2959749,36.7770396,-1.2824911,36.8218042,281,1952,23,488
19270,11044,867,3,Business,15,5,26533,15,5,27276,15,5,28573,15,5,29881,15,5,31199,10,19.1,-1.2996533,36.8292629,-1.2991441,36.7528804,177,1318,743,2605
19271,23261,37,3,Business,13,3,44020,13,3,44635,13,3,45359,13,3,45704,13,3,47379,11,24.9,-1.3263105,36.8622904,-1.2933789,36.8087535,114,1675,615,1069
19272,12773,412,3,Business,3,1,52809,3,1,52822,3,1,52848,3,1,53831,3,1,53841,2,23.4,-1.2600926,36.8088685,-1.266837,36.799249,574,10,13,1009
19273,5584,682,2,Personal,29,6,46448,29,6,46615,29,6,47154,29,6,47674,29,6,48527,5,24.9,-1.3052672,36.7538539,-1.2947685,36.7785834,565,853,167,1059
19274,4902,2150,3,Business,14,1,44111,14,1,45061,14,1,45414,14,1,46226,14,1,48734,11,23.6,-1.307143,36.825009,-1.344446,36.756597,837,2508,950,1165
19275,20804,2523,3,Business,19,2,36916,19,2,37081,19,2,37483,19,2,37796,19,2,40588,10,20.9,-1.2551895,36.7822034,-1.3073569,36.8202163,147,2792,165,715
19276,27335,517,3,Business,31,5,43198,31,5,43381,31,5,43388,31,5,45194,31,5,45498,4,21.9,-1.3228003,36.8306435,-1.3004062,36.829741,349,304,183,1813
19277,17903,1591,2,Personal,25,6,44357,25,6,44388,25,6,45213,25,6,45659,25,6,46223,3,23.25888921888938,-1.301893,36.815245,-1.292943,36.808292,85,564,31,1271
19278,5598,2219,3,Business,30,2,48880,30,2,49483,30,2,50165,30,2,50404,30,2,51343,6,23.25888921888938,-1.2946359,36.8352718,-1.3272104,36.8528418,404,939,603,921
19279,4917,633,3,Business,26,2,45430,26,2,45460,26,2,45748,26,2,46736,26,2,47235,4,26.1,-1.3077869,36.8443207,-1.3004062,36.829741,895,499,30,1276
19280,23844,3686,3,Business,21,4,35034,21,4,35213,21,4,35806,21,4,36434,21,4,37209,7,19.0,-1.2551895,36.7822034,-1.2653185,36.8358841,31,775,179,1221
19281,21390,2676,3,Business,8,2,38967,8,2,39034,8,2,40316,8,2,40377,8,2,42434,3,21.2,-1.2631674,36.793583,-1.262492,36.800973,733,2057,67,1343
19282,4322,14,2,Personal,30,3,45193,30,3,46600,30,3,47288,30,3,47808,30,3,50095,5,22.4,-1.3070122,36.8287218,-1.2916556,36.8262516,100,2287,1407,1208
19283,13868,2289,3,Business,4,1,45681,4,1,45756,4,1,46000,4,1,46067,4,1,47021,9,25.8,-1.2551895,36.7822034,-1.301809,36.75643,269,954,75,311
19284,27042,393,3,Business,30,5,28542,30,5,39166,30,5,39292,30,5,40171,30,5,41618,4,23.9,-1.3177547,36.8303703,-1.3004062,36.829741,523,1447,10624,1005
19285,4288,3688,3,Business,11,2,53438,11,2,53577,11,2,53759,11,2,54142,11,2,54632,2,21.3,-1.2551895,36.7822034,-1.2567464,36.7915273,161,490,139,565
19286,845,214,1,Personal,10,2,34734,10,2,34785,10,2,37078,10,2,37420,10,2,40063,12,16.2,-1.2004859,36.7782049,-1.2616213,36.8221128,802,2643,51,2635
19287,4421,1502,3,Business,25,4,34498,25,4,35249,25,4,35302,25,4,36522,25,4,37434,9,16.2,-1.2566586,36.7929682,-1.2343087,36.84749,704,912,751,1273
19288,8912,2330,3,Business,12,2,45636,12,2,45672,12,2,47748,12,2,47864,12,2,48800,8,28.0,-1.3015197,36.7658456,-1.2671943,36.8062533,327,936,36,2192
19289,27454,1471,3,Business,30,2,40248,30,2,40558,30,2,44012,30,2,45046,30,2,48736,9,23.25888921888938,-1.2551895,36.7822034,-1.3081376,36.8329772,394,3690,310,4488
19290,22343,439,3,Business,8,4,49452,8,4,49528,8,4,49898,8,4,50477,8,4,52482,14,27.1,-1.2696824,36.8026164,-1.3323107,36.8692616,449,2005,76,949
19291,23336,3149,3,Business,20,3,42776,20,3,42805,20,3,42811,20,3,44111,20,3,44286,6,20.2,-1.3004062,36.829741,-1.3177547,36.8303703,397,175,29,1306
19292,7968,1544,3,Business,3,1,58622,3,1,61046,3,1,62698,3,1,63359,3,1,64004,2,17.6,-1.288565,36.8413257,-1.2885029,36.825605,158,645,2424,2313
19293,22150,393,3,Business,25,5,44608,25,5,48534,25,5,49146,25,5,49570,25,5,51923,14,23.3,-1.3177547,36.8303703,-1.306378,36.7519845,432,2353,3926,1036
19294,10529,661,3,Business,7,6,50630,7,6,50707,7,6,51332,7,6,52331,7,6,53134,4,21.5,-1.2963097,36.7688221,-1.2950044,36.7512209,327,803,77,1624
19295,18204,3091,3,Business,28,5,57834,28,5,57867,28,5,58667,28,5,59140,28,5,61805,23,25.2,-1.207546,36.7913976,-1.3014461,36.7661381,685,2665,33,1273
19296,13012,1502,3,Business,7,5,45827,7,5,45845,7,5,46319,7,5,46852,7,5,51639,23,25.2,-1.2232123,36.8932547,-1.3226302,36.8719901,12,4787,18,1007
19297,24570,2523,3,Business,2,3,46340,2,3,46482,2,3,46979,2,3,47587,2,3,48376,10,23.9,-1.2551895,36.7822034,-1.2287282,36.8115304,427,789,142,1105
19298,14455,1402,3,Business,31,5,51428,31,5,51519,31,5,51541,31,5,54930,31,5,54935,2,24.8,-1.2813012,36.8323962,-1.2882073,36.8237673,458,5,91,3411
19299,7984,1271,3,Business,9,5,46121,9,5,46597,9,5,47759,9,5,49000,9,5,51773,27,26.3,-1.3244885,36.897792,-1.3201913,36.7047971,625,2773,476,2403
19300,15178,3222,3,Business,28,2,46144,28,2,46222,28,2,46550,28,2,47266,28,2,49864,8,21.1,-1.2551895,36.7822034,-1.295156,36.8094306,154,2598,78,1044
19301,11872,635,3,Business,6,4,37271,6,4,37297,6,4,37305,6,4,41529,6,4,41560,8,19.6,-1.300921,36.828195,-1.2674338,36.7941791,855,31,26,4232
19302,1951,1810,1,Personal,24,4,41378,24,4,42875,24,4,43809,24,4,44083,24,4,45168,6,21.0,-1.3233586,36.8143566,-1.2854453,36.8188363,808,1085,1497,1208
19303,478,3686,3,Business,13,3,59147,13,3,59167,13,3,59344,13,3,59978,13,3,61178,9,27.6,-1.2551895,36.7822034,-1.2945128,36.8396881,177,1200,20,811
19304,25935,2987,3,Business,28,2,53529,28,2,53549,28,2,54194,28,2,54287,28,2,55412,11,19.4,-1.270212,36.8210877,-1.2156006,36.8916865,4,1125,20,738
19305,14581,1642,3,Business,25,2,55005,25,2,55026,25,2,55432,25,2,55737,25,2,56306,3,27.2,-1.2672782,36.8041436,-1.2726506,36.7960153,434,569,21,711
19306,10910,1271,3,Business,6,3,44286,6,3,44409,6,3,45989,6,3,49560,6,3,52328,17,27.7,-1.2285995,36.9012372,-1.3244885,36.897792,75,2768,123,5151
19307,19278,633,3,Business,4,5,38760,4,5,38767,4,5,38771,4,5,40003,4,5,40005,6,17.4,-1.3004062,36.829741,-1.3228003,36.8306435,515,2,7,1236
19308,17947,3560,3,Business,6,1,57597,6,1,57604,6,1,58287,6,1,58680,6,1,60157,19,24.4,-1.3705766,36.9120742,-1.279395,36.825364,406,1477,7,1076
19309,3625,265,3,Business,28,3,37515,28,3,39387,28,3,40191,28,3,40484,28,3,41945,6,23.25888921888938,-1.300921,36.828195,-1.2937829,36.8043644,114,1461,1872,1097
19310,10006,1075,3,Business,18,4,42491,18,4,42520,18,4,42922,18,4,43435,18,4,44055,3,23.25888921888938,-1.2527958,36.8003131,-1.2551895,36.7822034,484,620,29,915
19311,20032,3283,3,Business,18,6,45520,18,6,45582,18,6,46044,18,6,47233,18,6,48058,5,21.0,-1.2600926,36.8088685,-1.2628473,36.781805,191,825,62,1651
19312,21992,517,3,Business,31,5,58095,31,5,58223,31,5,59175,31,5,60670,31,5,60671,11,23.8,-1.3228003,36.8306435,-1.2638185,36.7930057,863,1,128,2447
19313,11698,59,3,Business,23,2,59187,23,2,59947,23,2,60543,23,2,61169,23,2,63096,6,23.25888921888938,-1.290894,36.822971,-1.2571472,36.7950633,855,1927,760,1222
19314,26155,1342,3,Business,6,2,41586,6,2,41674,6,2,43768,6,2,44542,6,2,46057,10,24.9,-1.2584143,36.8048002,-1.3025826,36.7670807,412,1515,88,2868
19315,15459,3647,3,Business,2,3,45460,2,3,45542,2,3,45868,2,3,46139,2,3,47179,7,23.8,-1.272639,36.794723,-1.2612277,36.8318549,337,1040,82,597
19316,25402,1195,3,Business,5,5,43546,5,5,43564,5,5,45271,5,5,46333,5,5,48508,6,24.4,-1.2922966,36.8374042,-1.3228003,36.8306435,910,2175,18,2769
19317,24289,3291,3,Business,25,5,37591,25,5,38654,25,5,39863,25,5,40320,25,5,41298,5,26.3,-1.2783849,36.8163445,-1.2600926,36.8088685,26,978,1063,1666
19318,18510,2143,3,Business,20,2,49852,20,2,50333,20,2,51214,20,2,51433,20,2,52062,3,23.8,-1.2985252,36.7842707,-1.3039706,36.7688174,952,629,481,1100
19319,7021,393,3,Business,27,3,37643,27,3,37687,27,3,37695,27,3,38376,27,3,38856,4,26.0,-1.3167113,36.8301563,-1.3004062,36.829741,901,480,44,689
19320,26703,3745,3,Personal,28,1,42173,28,1,42457,28,1,43101,28,1,43269,28,1,45222,11,22.6,-1.2450467,36.7544464,-1.2741728,36.7969108,103,1953,284,812
19321,26820,540,3,Business,23,1,34983,23,1,35012,23,1,35620,23,1,35838,23,1,36571,4,14.4,-1.2551895,36.7822034,-1.2753109,36.8130185,519,733,29,826
19322,16918,136,3,Business,22,5,55899,22,5,55922,22,5,56627,22,5,56750,22,5,58539,14,27.2,-1.3254522,36.7216584,-1.2902869,36.8085396,622,1789,23,828
19323,8017,552,3,Business,15,5,59352,15,5,59365,15,5,59369,15,5,60019,15,5,61593,7,27.6,-1.3562374,36.9042954,-1.335477,36.9308297,519,1574,13,654
19324,11792,3222,3,Business,4,2,43336,4,2,44318,4,2,45017,4,2,45180,4,2,47120,7,19.7,-1.2551895,36.7822034,-1.2388691,36.7579496,547,1940,982,862
19325,26473,285,1,Personal,16,1,58816,16,1,58899,16,1,59372,16,1,59822,16,1,61009,11,23.25888921888938,-1.2862987,36.7674295,-1.3194988,36.7966681,312,1187,83,923
19326,27331,1578,3,Business,5,3,30620,5,3,34940,5,3,35822,5,3,37377,5,3,38834,9,17.9,-1.28878,36.8168312,-1.2413316,36.8785525,477,1457,4320,2437
19327,4458,1075,3,Business,2,2,44884,2,2,44900,2,2,45256,2,2,45529,2,2,46015,2,26.1,-1.2527958,36.8003131,-1.2571472,36.7950633,484,486,16,629
19328,4302,1363,3,Business,15,5,32080,15,5,32295,15,5,33312,15,5,34139,15,5,34878,5,20.1,-1.3004062,36.829741,-1.3083266,36.8494756,448,739,215,1844
19329,10203,2674,3,Personal,7,1,38494,7,1,38573,7,1,39181,7,1,39409,7,1,40558,15,24.6,-1.2611916,36.8444489,-1.191947,36.934836,932,1149,79,836
19330,13293,1500,3,Business,6,3,47248,6,3,47272,6,3,47365,6,3,49242,6,3,50822,8,23.25888921888938,-1.3004062,36.829741,-1.2638185,36.7930057,154,1580,24,1970
19331,14648,2457,3,Business,26,5,45333,26,5,46428,26,5,46818,26,5,47200,26,5,48384,8,23.25888921888938,-1.2551895,36.7822034,-1.2904049,36.8055154,726,1184,1095,772
19332,8182,2154,3,Business,28,4,59425,28,4,59794,28,4,61564,28,4,62172,28,4,64052,13,23.25888921888938,-1.2765736,36.8513646,-1.2860372,36.7549573,752,1880,369,2378
19333,4357,2658,3,Business,10,3,59347,10,3,59486,10,3,61609,10,3,62014,10,3,65266,8,27.3,-1.2813012,36.8323962,-1.2963097,36.7688221,660,3252,139,2528
19334,5006,972,3,Business,19,1,51640,19,1,56227,19,1,56483,19,1,56794,19,1,58684,14,25.4,-1.2862033,36.8152966,-1.2927792,36.9053492,403,1890,4587,567
19335,14849,188,1,Personal,20,5,61159,20,5,61309,20,5,61785,20,5,63093,20,5,64140,8,19.9,-1.2824911,36.8218042,-1.3078624,36.7697658,812,1047,150,1784
19336,25112,3291,3,Business,16,6,56988,16,6,57027,16,6,57743,16,6,60338,16,6,60343,8,27.5,-1.303596,36.778378,-1.2600926,36.8088685,267,5,39,3311
19337,24644,871,2,Personal,7,2,56588,7,2,56611,7,2,57253,7,2,57467,7,2,58640,9,25.0,-1.2865508,36.8238701,-1.2315181,36.8140543,414,1173,23,856
19338,20833,153,1,Personal,25,2,43167,25,2,43446,25,2,44002,25,2,44693,25,2,45593,9,23.9,-1.2862252,36.8234218,-1.2315379,36.8156795,522,900,279,1247
19339,23648,893,3,Business,28,3,36845,28,3,36868,28,3,37116,28,3,37319,28,3,39477,8,20.3,-1.2663194,36.809901,-1.301953,36.788458,727,2158,23,451
19340,10530,346,3,Business,8,5,40860,8,5,41361,8,5,41619,8,5,42033,8,5,42042,2,28.4,-1.2813012,36.8323962,-1.28878,36.8168312,266,9,501,672
19341,12337,3647,3,Business,7,5,57267,7,5,57903,7,5,58526,7,5,58757,7,5,60853,6,26.6,-1.272639,36.794723,-1.3004846,36.7901591,920,2096,636,854
19342,15840,510,3,Business,22,1,41752,22,1,41793,22,1,42862,22,1,42971,22,1,45182,22,24.9,-1.2860183,36.8975338,-1.225322,36.80855,96,2211,41,1178
19343,12554,517,3,Business,22,4,37341,22,4,37359,22,4,37362,22,4,39238,22,4,41177,14,22.4,-1.3177547,36.8303703,-1.306378,36.7519845,515,1939,18,1879
19344,20456,3559,1,Personal,1,5,43431,1,5,43465,1,5,44812,1,5,45444,1,5,46882,9,22.7,-1.2788235,36.7876985,-1.3090663,36.8136865,755,1438,34,1979
19345,20583,1471,3,Business,7,4,54762,7,4,54788,7,4,54793,7,4,55573,7,4,55580,5,31.1,-1.2551895,36.7822034,-1.2592947,36.7698085,523,7,26,785
19346,8990,2701,3,Business,27,2,35479,27,2,36032,27,2,36638,27,2,36748,27,2,40705,9,18.9,-1.2765736,36.8513646,-1.2475028,36.8774697,434,3957,553,716
19347,7638,2212,3,Business,17,3,35438,17,3,35485,17,3,36007,17,3,36087,17,3,36664,5,20.9,-1.2646084,36.8028645,-1.2425149,36.7890137,453,577,47,602
19348,27901,2587,3,Business,21,5,39420,21,5,39627,21,5,39950,21,5,40541,21,5,40743,1,22.6,-1.279395,36.825364,-1.28878,36.8168312,819,202,207,914
19349,6114,2412,3,Business,20,2,57515,20,2,58136,20,2,58258,20,2,58410,20,2,60078,14,23.8,-1.2297202,36.8819507,-1.3024794,36.8228284,685,1668,621,274
19350,5376,2066,3,Business,8,5,50030,8,5,50094,8,5,50739,8,5,51024,8,5,53060,18,27.0,-1.3210189,36.8410551,-1.3987598,36.7677036,267,2036,64,930
19351,24364,3080,3,Business,19,1,27884,19,1,27896,19,1,27907,19,1,30072,19,1,31110,9,19.4,-1.2624935,36.8434339,-1.2551895,36.7822034,143,1038,12,2176
19352,21322,1927,3,Business,1,5,51786,1,5,51888,1,5,53244,1,5,53704,1,5,55666,17,28.7,-1.3472066,36.7692638,-1.2551895,36.7822034,267,1962,102,1816
19353,174,1809,3,Business,16,2,54863,16,2,55883,16,2,56608,16,2,57654,16,2,59088,8,27.3,-1.3052491,36.8223899,-1.2646084,36.8028645,263,1434,1020,1771
19354,10954,1081,3,Business,13,3,51560,13,3,51880,13,3,51901,13,3,52353,13,3,53636,10,27.0,-1.2551895,36.7822034,-1.3004846,36.7901591,523,1283,320,473
19355,7943,3565,3,Business,7,5,33443,7,5,33458,7,5,33465,7,5,34151,7,5,35907,16,20.7,-1.2844665,36.7866113,-1.1992502,36.8294932,886,1756,15,693
19356,14771,567,3,Business,10,5,59067,10,5,59535,10,5,60554,10,5,60848,10,5,61890,6,23.25888921888938,-1.3038156,36.8122733,-1.2963097,36.7688221,161,1042,468,1313
19357,6715,1959,3,Business,11,1,45292,11,1,45320,11,1,45634,11,1,45774,11,1,47507,15,26.8,-1.2551895,36.7822034,-1.2343236,36.8861,411,1733,28,454
19358,12921,1578,3,Business,19,3,44037,19,3,44339,19,3,45152,19,3,45261,19,3,48316,15,22.3,-1.28878,36.8168312,-1.216682,36.9085778,899,3055,302,922
19359,18563,2436,3,Business,8,4,54485,8,4,54988,8,4,55479,8,4,56071,8,4,56621,3,27.1,-1.262073,36.7986087,-1.2551895,36.7822034,222,550,503,1083
19360,14144,2208,2,Personal,20,5,34605,20,5,34632,20,5,35258,20,5,35570,20,5,36133,3,14.5,-1.2738167,36.8157821,-1.2874292,36.823314,456,563,27,938
19361,22077,1512,1,Personal,5,5,63289,5,5,63394,5,5,65741,5,5,65894,5,5,68037,13,24.6,-1.2880229,36.7892191,-1.2330694,36.745451,383,2143,105,2500
19362,8753,20,3,Business,5,1,33001,5,1,34257,5,1,34614,5,1,35029,5,1,37012,5,18.7,-1.2628638,36.8070399,-1.2929499,36.8180835,268,1983,1256,772
19363,26586,1721,3,Business,2,4,39177,2,4,39196,2,4,39639,2,4,39986,2,4,41384,12,23.25888921888938,-1.2551895,36.7822034,-1.3239488,36.8316835,411,1398,19,790
19364,23482,2112,3,Business,29,1,60115,29,1,60395,29,1,62525,29,1,63224,29,1,66438,30,23.4,-1.3169591,36.7000029,-1.2156006,36.8916865,644,3214,280,2829
19365,11493,1280,3,Business,18,4,52022,18,4,52058,18,4,52362,18,4,53069,18,4,54054,8,23.25888921888938,-1.2551895,36.7822034,-1.2903865,36.7957267,322,985,36,1011
19366,7377,3372,3,Business,10,2,41085,10,2,41135,10,2,41484,10,2,42104,10,2,43945,18,20.3,-1.2969741,36.7856612,-1.214328,36.7911903,101,1841,50,969
19367,1351,246,3,Business,15,6,36546,15,6,36575,15,6,36862,15,6,36970,15,6,38198,9,17.8,-1.3052491,36.8223899,-1.2584143,36.8048002,31,1228,29,395
19368,25447,2509,3,Business,27,4,39872,27,4,39897,27,4,41922,27,4,42553,27,4,43845,16,23.0,-1.2302228,36.8692935,-1.2571472,36.7950633,62,1292,25,2656
19369,19431,2876,1,Personal,12,5,45480,12,5,45549,12,5,45789,12,5,45884,12,5,46474,6,24.5,-1.2684239,36.7952462,-1.2944292,36.7793569,875,590,69,335
19370,17552,635,3,Business,27,6,32489,27,6,32803,27,6,32807,27,6,34769,27,6,35620,8,23.25888921888938,-1.300921,36.828195,-1.2602337,36.7990548,61,851,314,1966
19371,5419,2330,3,Business,2,2,62285,2,2,62303,2,2,62766,2,2,64225,2,2,64402,9,28.6,-1.2642903,36.8002137,-1.3015197,36.7658456,318,177,18,1922
19372,19079,868,3,Business,1,5,37349,1,5,38846,1,5,38977,1,5,40012,1,5,41372,8,26.3,-1.303596,36.778378,-1.265715,36.823815,210,1360,1497,1166
19373,5524,909,3,Business,15,5,57563,15,5,58445,15,5,60650,15,5,61461,15,5,62611,8,27.7,-1.225322,36.80855,-1.255392,36.792539,52,1150,882,3016
19374,9253,795,3,Personal,17,4,60582,17,4,60640,17,4,61663,17,4,61898,17,4,63109,12,26.1,-1.3104734,36.7363698,-1.3637665,36.7269036,74,1211,58,1258
19375,25998,3396,3,Business,16,2,69933,16,2,69945,16,2,70353,16,2,71108,16,2,73012,2,23.25888921888938,-1.2963097,36.7688221,-1.301809,36.75643,197,1904,12,1163
19376,5844,2956,3,Business,28,4,56595,28,4,56612,28,4,56760,28,4,57614,28,4,59396,6,29.9,-1.290894,36.822971,-1.2584143,36.8048002,913,1782,17,1002
19377,20672,1333,2,Personal,18,5,45419,18,5,45523,18,5,46413,18,5,46750,18,5,49629,21,21.2,-1.2223457,36.8904633,-1.2927531,36.7651386,105,2879,104,1227
19378,8450,3710,3,Business,27,2,35508,27,2,41182,27,2,41383,27,2,42012,27,2,44749,7,24.0,-1.2551895,36.7822034,-1.2897399,36.8270975,268,2737,5674,830
19379,4509,3621,3,Business,1,1,52830,1,1,52897,1,1,54031,1,1,54177,1,1,55059,5,25.5,-1.2836583,36.7886014,-1.2802803,36.8271747,456,882,67,1280
19380,15993,3689,3,Business,20,4,58823,20,4,58856,20,4,60506,20,4,60610,20,4,61538,3,22.9,-1.2527958,36.8003131,-1.2551895,36.7822034,228,928,33,1754
19381,1852,186,3,Business,10,5,32770,10,5,32857,10,5,38692,10,5,39117,10,5,40972,6,23.25888921888938,-1.2571472,36.7950633,-1.2904016,36.8226303,582,1855,87,6260
19382,18954,1358,3,Personal,12,2,45255,12,2,45385,12,2,46280,12,2,46791,12,2,47838,10,28.0,-1.2927064,36.8328855,-1.2315379,36.8156795,906,1047,130,1406
19383,9377,2523,3,Business,8,1,44801,8,1,44823,8,1,45070,8,1,45667,8,1,47169,8,27.8,-1.2551895,36.7822034,-1.2913246,36.8019522,958,1502,22,844
19384,23668,2987,3,Business,15,3,43754,15,3,43782,15,3,44442,15,3,44879,15,3,46411,7,18.1,-1.270212,36.8210877,-1.3043821,36.7840586,519,1532,28,1097
19385,9829,947,2,Personal,8,2,31961,8,2,31978,8,2,33044,8,2,33355,8,2,35358,14,23.25888921888938,-1.287428,36.7800821,-1.2696795,36.8640088,942,2003,17,1377
19386,3664,517,3,Business,4,2,41230,4,2,42436,4,2,42625,4,2,42782,4,2,45098,14,19.5,-1.3177547,36.8303703,-1.306378,36.7519845,523,2316,1206,346
19387,3446,3647,3,Business,7,4,45316,7,4,45404,7,4,46462,7,4,46599,7,4,48518,13,24.1,-1.272639,36.794723,-1.3017227,36.8561319,426,1919,88,1195
19388,17339,3404,3,Business,2,3,51844,2,3,51872,2,3,52067,2,3,52346,2,3,54274,5,25.9,-1.2584143,36.8048002,-1.279395,36.825364,134,1928,28,474
19389,8254,1953,3,Personal,14,1,58111,14,1,58606,14,1,60383,14,1,60678,14,1,62901,11,23.4,-1.2802576,36.8246917,-1.2833564,36.7419746,101,2223,495,2072
19390,14655,1724,3,Business,18,2,57406,18,2,57436,18,2,57664,18,2,59657,18,2,60194,2,23.25888921888938,-1.2584143,36.8048002,-1.2690013,36.8092872,875,537,30,2221
19391,12592,2423,3,Business,19,3,53482,19,3,57832,19,3,58267,19,3,58714,19,3,59907,8,24.4,-1.2551895,36.7822034,-1.2967702,36.8040381,920,1193,4350,882
19392,23079,2896,3,Business,21,3,31993,21,3,32032,21,3,32974,21,3,33661,21,3,36319,12,17.0,-1.3338005,36.863026,-1.2944363,36.7983424,114,2658,39,1629
19393,7937,269,3,Business,7,1,38630,7,1,38721,7,1,39526,7,1,39739,7,1,40987,5,24.8,-1.3076234,36.8393399,-1.3226302,36.8719901,543,1248,91,1018
19394,28106,3080,3,Business,26,5,54861,26,5,54926,26,5,56464,26,5,56709,26,5,59159,8,23.25888921888938,-1.2551895,36.7822034,-1.285928,36.788122,660,2450,65,1783
19395,2695,475,3,Business,7,4,45652,7,4,45857,7,4,46535,7,4,49369,7,4,49750,7,31.2,-1.2571472,36.7950633,-1.2965824,36.8153022,653,381,205,3512
19396,9397,136,3,Business,26,5,52076,26,5,52724,26,5,53948,26,5,54146,26,5,55992,8,23.25888921888938,-1.3326173,36.7146233,-1.3025826,36.7670807,593,1846,648,1422
19397,15294,2140,1,Personal,24,5,39334,24,5,39357,24,5,40031,24,5,40116,24,5,40938,5,21.1,-1.2545163,36.8243717,-1.2653429,36.7995556,698,822,23,759
19398,5259,2457,3,Business,18,2,39908,18,2,39925,18,2,39998,18,2,40331,18,2,40940,2,23.25888921888938,-1.2551895,36.7822034,-1.2677753,36.7998955,575,609,17,406
19399,22476,393,3,Business,16,3,51914,16,3,51927,16,3,51941,16,3,54947,16,3,55723,4,27.1,-1.3167113,36.8301563,-1.3004062,36.829741,80,776,13,3020
19400,1459,3674,3,Business,8,5,52131,8,5,52224,8,5,54428,8,5,55887,8,5,58339,9,27.0,-1.2551895,36.7822034,-1.2974988,36.7956306,322,2452,93,3663
19401,5675,1179,3,Business,25,5,40832,25,5,41032,25,5,41718,25,5,42697,25,5,44947,21,26.2,-1.3700383,36.9190174,-1.2917868,36.7872675,457,2250,200,1665
19402,17736,2989,3,Business,18,4,51760,18,4,51767,18,4,51826,18,4,53218,18,4,54775,12,26.7,-1.290894,36.822971,-1.3472066,36.7692638,531,1557,7,1451
19403,7065,60,3,Business,26,5,46075,26,5,46814,26,5,49488,26,5,49582,26,5,53518,21,23.25888921888938,-1.344446,36.756597,-1.2296618,36.8438272,867,3936,739,2768
19404,2584,2544,3,Personal,2,2,44703,2,2,44828,2,2,45087,2,2,45616,2,2,47518,19,26.2,-1.2580991,36.7941519,-1.3287648,36.7445732,575,1902,125,788
19405,1934,1486,1,Personal,17,4,55311,17,4,58847,17,4,58892,17,4,59762,17,4,63160,5,21.8,-1.2864733,36.8239937,-1.3149257,36.8441635,644,3398,3536,915
19406,3524,2330,3,Business,16,3,39043,16,3,39113,16,3,39832,16,3,40759,16,3,41582,8,22.7,-1.2642903,36.8002137,-1.3040812,36.7924217,764,823,70,1646
19407,1709,393,3,Business,5,2,37647,5,2,37682,5,2,37710,5,2,38124,5,2,39835,14,23.7,-1.3167113,36.8301563,-1.306378,36.7519845,523,1711,35,442
19408,14769,3331,3,Business,27,2,33902,27,2,33976,27,2,34162,27,2,34592,27,2,36555,18,18.6,-1.2551895,36.7822034,-1.3254432,36.8951705,449,1963,74,616
19409,24151,1705,3,Business,9,4,53272,9,4,53311,9,4,53645,9,4,53989,9,4,55319,8,25.6,-1.2551895,36.7822034,-1.2900272,36.7935096,415,1330,39,678
19410,14807,1500,3,Business,14,5,50974,14,5,51419,14,5,51896,14,5,51999,14,5,55188,11,23.7,-1.3077869,36.8443207,-1.2574219,36.7927073,914,3189,445,580
19411,3253,2956,3,Business,4,1,54383,4,1,54679,4,1,55612,4,1,55985,4,1,57278,10,23.25888921888938,-1.2584143,36.8048002,-1.2413316,36.8785525,953,1293,296,1306
19412,18617,1976,3,Business,11,4,59193,11,4,59232,11,4,59655,11,4,59814,11,4,60924,7,24.1,-1.257028,36.7810435,-1.2979634,36.7719936,38,1110,39,582
19413,10896,2869,3,Business,3,1,46942,3,1,47052,3,1,47387,3,1,48009,3,1,48978,3,21.4,-1.3025826,36.7670807,-1.2763494,36.7671783,870,969,110,957
19414,23468,2587,3,Business,31,4,37678,31,4,37968,31,4,38724,31,4,39730,31,4,40475,5,26.6,-1.2620912,36.8013562,-1.28878,36.8168312,489,745,290,1762
19415,19303,3426,3,Business,17,4,32310,17,4,32361,17,4,32748,17,4,33339,17,4,33388,2,23.25888921888938,-1.3012008,36.764868,-1.2949439,36.7604214,322,49,51,978
19416,25688,3647,3,Business,16,2,49930,16,2,49944,16,2,51928,16,2,52107,16,2,53951,11,23.25888921888938,-1.272639,36.794723,-1.314291,36.8478646,448,1844,14,2163
19417,16737,3688,3,Business,22,4,60436,22,4,60657,22,4,63421,22,4,63807,22,4,65034,6,24.0,-1.2551895,36.7822034,-1.2655306,36.828148,547,1227,221,3150
19418,14690,1500,3,Business,12,5,40005,12,5,40026,12,5,40478,12,5,40969,12,5,42337,9,26.3,-1.2638185,36.7930057,-1.3004062,36.829741,161,1368,21,943
19419,26713,3436,3,Personal,15,2,43171,15,2,43190,15,2,43598,15,2,43971,15,2,45106,9,24.1,-1.2915129,36.7699971,-1.3034072,36.8218035,246,1135,19,781
19420,22618,3647,3,Business,23,4,43486,23,4,43935,23,4,44427,23,4,44878,23,4,45409,4,23.2,-1.272639,36.794723,-1.2569503,36.7834728,484,531,449,943
19421,1363,1329,3,Business,16,6,52531,16,6,52544,16,6,52632,16,6,52712,16,6,53312,3,23.25888921888938,-1.273056,36.811298,-1.2649605,36.7981777,622,600,13,168
19422,27733,478,3,Business,24,5,31757,24,5,31802,24,5,32865,24,5,35400,24,5,37745,20,18.2,-1.1671421,36.8314458,-1.2551895,36.7822034,740,2345,45,3598
19423,5851,1932,3,Business,2,1,45692,2,1,45743,2,1,46178,2,1,47151,2,1,47689,2,19.4,-1.2874711,36.7646208,-1.2985987,36.7809119,192,538,51,1408
19424,14124,302,3,Business,1,5,51865,1,5,52066,1,5,52461,1,5,53340,1,5,53981,4,32.0,-1.2649605,36.7981777,-1.2684319,36.8165853,383,641,201,1274
19425,21046,1329,3,Business,7,5,65411,7,5,65670,7,5,65759,7,5,66143,7,5,67598,6,21.7,-1.273056,36.811298,-1.2832105,36.7777664,75,1455,259,473
19426,2461,1682,1,Personal,9,2,42731,9,2,42892,9,2,44073,9,2,45519,9,2,46180,5,21.8,-1.288167,36.8181484,-1.2942764,36.7969749,565,661,161,2627
19427,19124,2308,3,Business,3,3,45229,3,3,46179,3,3,49473,3,3,51328,3,3,53324,12,26.6,-1.2556139,36.9759716,-1.3160977,36.9131642,836,1996,950,5149
19428,18652,3291,3,Business,4,6,37682,4,6,37764,4,6,38195,4,6,38776,4,6,40356,12,23.25888921888938,-1.228911,36.881876,-1.2600926,36.8088685,75,1580,82,1012
19429,10167,2412,3,Business,15,5,67178,15,5,67262,15,5,67692,15,5,68477,15,5,70167,11,27.6,-1.290894,36.822971,-1.2283403,36.8822756,448,1690,84,1215
19430,9211,3064,3,Business,8,4,57420,8,4,58004,8,4,58462,8,4,58545,8,4,59730,9,27.2,-1.2571472,36.7950633,-1.2942232,36.7900236,596,1185,584,541
19431,25898,2216,3,Business,19,2,40338,19,2,40364,19,2,40584,19,2,40693,19,2,41818,7,26.7,-1.2551895,36.7822034,-1.2887816,36.8088885,854,1125,26,329
19432,2252,3300,3,Business,8,6,39846,8,6,39894,8,6,41702,8,6,42076,8,6,43700,8,19.9,-1.2663631,36.8163329,-1.303596,36.778378,109,1624,48,2182
19433,17827,1244,3,Business,28,4,40051,28,4,40137,28,4,41034,28,4,41690,28,4,42925,11,27.9,-1.331619,36.847976,-1.303596,36.778378,675,1235,86,1553
19434,3661,1899,3,Business,26,4,33687,26,4,33712,26,4,34581,26,4,34781,26,4,35296,6,15.4,-1.318062,36.849326,-1.331619,36.847976,726,515,25,1069
19435,11503,393,3,Business,29,1,39143,29,1,39197,29,1,40135,29,1,41374,29,1,41377,4,23.25888921888938,-1.3167113,36.8301563,-1.3004062,36.829741,99,3,54,2177
19436,20525,517,3,Business,2,3,42590,2,3,42597,2,3,42605,2,3,42891,2,3,43495,4,24.0,-1.3167113,36.8301563,-1.3004062,36.829741,523,604,7,294
19437,9430,3517,3,Business,26,5,59159,26,5,59244,26,5,61323,26,5,61480,26,5,63660,18,23.25888921888938,-1.3139989,36.841878,-1.3882008,36.7699445,710,2180,85,2236
19438,14723,393,3,Business,19,2,53736,19,2,53748,19,2,53799,19,2,55894,19,2,55896,4,30.1,-1.3167113,36.8301563,-1.3004062,36.829741,555,2,12,2146
19439,9547,2212,3,Business,13,3,39293,13,3,39309,13,3,39619,13,3,40127,13,3,41227,5,24.8,-1.2571472,36.7950633,-1.2425149,36.7890137,778,1100,16,818
19440,14396,3661,3,Business,22,2,45804,22,2,45992,22,2,47903,22,2,47973,22,2,48785,6,24.2,-1.2134646,36.8755266,-1.2413316,36.8785525,111,812,188,1981
19441,23452,1500,3,Business,17,3,31091,17,3,31199,17,3,32060,17,3,34944,17,3,36272,8,23.25888921888938,-1.3004062,36.829741,-1.2638185,36.7930057,8,1328,108,3745
19442,23059,1471,3,Business,16,3,47271,16,3,47301,16,3,47760,16,3,47975,16,3,49432,9,22.9,-1.2551895,36.7822034,-1.2972916,36.7880497,88,1457,30,674
19443,24019,1340,3,Business,7,2,54651,7,2,55064,7,2,55283,7,2,55416,7,2,57676,7,24.8,-1.2707179,36.7979713,-1.2819626,36.7540971,937,2260,413,352
19444,11193,253,1,Personal,29,2,25861,29,2,25882,29,2,26545,29,2,26719,29,2,27765,10,11.2,-1.3043649,36.7816132,-1.263483,36.8005343,103,1046,21,837
19445,13403,1453,1,Business,6,1,59632,6,1,59658,6,1,60312,6,1,60690,6,1,62014,8,22.5,-1.3025826,36.7670807,-1.3169591,36.7000029,770,1324,26,1032
19446,4717,2200,3,Business,14,2,54037,14,2,54243,14,2,55148,14,2,55782,14,2,56779,4,23.9,-1.2765736,36.8513646,-1.290894,36.822971,213,997,206,1539
19447,19854,393,3,Business,18,5,30885,18,5,30935,18,5,32339,18,5,34911,18,5,34914,11,20.0,-1.3167113,36.8301563,-1.2574219,36.7927073,436,3,50,3976
19448,22558,2064,2,Personal,4,1,40312,4,1,40339,4,1,41401,4,1,41829,4,1,42929,8,20.9,-1.2627824,36.7964192,-1.2959613,36.7684114,101,1100,27,1490
19449,1307,3339,3,Business,5,1,35327,5,1,35416,5,1,35767,5,1,36243,5,1,37877,9,18.4,-1.2551895,36.7822034,-1.2904477,36.7912763,770,1634,89,827
19450,1483,187,3,Business,16,3,52661,16,3,52670,16,3,52737,16,3,53421,16,3,55298,17,26.8,-1.3169591,36.7000029,-1.2551895,36.7822034,404,1877,9,751
19451,19908,1961,3,Business,27,1,44767,27,1,44802,27,1,46717,27,1,47350,27,1,49911,19,20.6,-1.331619,36.847976,-1.3188359,36.7038526,25,2561,35,2548
19452,2186,1125,1,Personal,17,3,32674,17,3,33232,17,3,34032,17,3,34320,17,3,35234,4,21.2,-1.270563,36.817397,-1.2892697,36.8154514,268,914,558,1088
19453,20465,1934,2,Personal,15,3,67136,15,3,67161,15,3,67882,15,3,68583,15,3,69754,4,21.1,-1.2559294,36.788465,-1.2664882,36.8033374,857,1171,25,1422
19454,6955,350,1,Personal,28,1,43061,28,1,43086,28,1,43268,28,1,43453,28,1,43980,3,22.9,-1.2990606,36.8033028,-1.3043649,36.7816132,676,527,25,367
19455,2164,2183,3,Business,26,1,33446,26,1,34923,26,1,35041,26,1,36172,26,1,38341,8,17.7,-1.2551895,36.7822034,-1.2939912,36.8161329,74,2169,1477,1249
19456,25142,3557,3,Business,11,4,43711,11,4,43773,11,4,44149,11,4,45081,11,4,45389,3,25.7,-1.2538609,36.7932126,-1.2546732,36.8086796,484,308,62,1308
19457,12171,635,3,Business,17,4,55452,17,4,56799,17,4,58091,17,4,58964,17,4,60922,17,27.8,-1.177202,36.8351183,-1.2599563,36.7993439,445,1958,1347,2165
19458,7462,467,3,Business,14,2,29490,14,2,29556,14,2,30264,14,2,30521,14,2,33265,12,23.25888921888938,-1.304735,36.7846054,-1.313266,36.6935289,177,2744,66,965
19459,3380,1340,3,Business,25,5,39997,25,5,40101,25,5,41037,25,5,41161,25,5,42804,9,26.5,-1.2707179,36.7979713,-1.3142269,36.839245,660,1643,104,1060
19460,10237,552,3,Business,19,2,59340,19,2,59499,19,2,60859,19,2,61221,19,2,63843,17,19.8,-1.2873639,36.8256076,-1.3632162,36.9108253,340,2622,159,1722
19461,17164,53,3,Business,9,2,34350,9,2,34552,9,2,35087,9,2,35368,9,2,36484,5,20.6,-1.3004062,36.829741,-1.2770708,36.8231093,709,1116,202,816
19462,3826,136,3,Business,3,1,44210,3,1,44260,3,1,45523,3,1,46705,3,1,49168,20,20.3,-1.3326173,36.7146233,-1.3330427,36.8635157,350,2463,50,2445
19463,6402,2767,3,Business,12,3,35808,12,3,35826,12,3,35894,12,3,35963,12,3,37578,4,21.5,-1.257773,36.795486,-1.24757,36.7626328,382,1615,18,137
19464,7316,1075,3,Business,13,3,47592,13,3,47607,13,3,48332,13,3,48784,13,3,49378,3,29.0,-1.2527958,36.8003131,-1.2551895,36.7822034,205,594,15,1177
19465,4632,136,3,Business,18,2,54216,18,2,54226,18,2,54486,18,2,54774,18,2,58917,16,27.5,-1.3326173,36.7146233,-1.263987,36.798891,644,4143,10,548
19466,27226,173,3,Business,24,3,58807,24,3,58877,24,3,59216,24,3,59464,24,3,60480,3,18.6,-1.2993231,36.7753372,-1.2846105,36.7881574,548,1016,70,587
19467,20971,635,3,Business,1,1,55724,1,1,60154,1,1,60549,1,1,61537,1,1,62858,8,27.5,-1.300921,36.828195,-1.2602337,36.7990548,691,1321,4430,1383
19468,26855,1304,3,Business,13,2,40458,13,2,40535,13,2,40652,13,2,41760,13,2,42660,5,22.4,-1.3332749,36.8708147,-1.3083777,36.8590077,487,900,77,1225
19469,5468,3222,3,Business,4,4,54209,4,4,54226,4,4,54383,4,4,54552,4,4,54755,3,27.5,-1.2551895,36.7822034,-1.2560455,36.7800867,690,203,17,326
19470,25907,3213,1,Personal,15,3,44299,15,3,44313,15,3,44821,15,3,45031,15,3,46163,7,18.1,-1.3007534,36.7964576,-1.269656,36.767011,754,1132,14,718
19471,15752,1953,3,Personal,5,6,39811,5,6,39844,5,6,40668,5,6,42875,5,6,44080,7,22.6,-1.2802576,36.8246917,-1.2915307,36.7905865,742,1205,33,3031
19472,21734,3269,1,Personal,5,4,65098,5,4,66436,5,4,67523,5,4,68517,5,4,70903,13,20.6,-1.2409807,36.8144219,-1.3039695,36.7838267,808,2386,1338,2081
19473,9537,3744,3,Business,11,2,53607,11,2,53729,11,2,54645,11,2,55009,11,2,56144,6,22.2,-1.267229,36.806399,-1.2807336,36.7791105,646,1135,122,1280
19474,20954,1746,3,Business,4,2,51017,4,2,53297,4,2,53879,4,2,55390,4,2,56300,5,20.2,-1.2914365,36.8580531,-1.2801014,36.8210423,208,910,2280,2093
19475,6814,552,3,Business,24,5,51352,24,5,51413,24,5,52376,24,5,54882,24,5,56418,13,23.1,-1.2860183,36.8975338,-1.3632162,36.9108253,621,1536,61,3469
19476,8770,1363,3,Business,31,3,56452,31,3,56498,31,3,56652,31,3,56926,31,3,57552,6,27.0,-1.3004062,36.829741,-1.3177547,36.8303703,408,626,46,428
19477,10333,2100,3,Business,27,4,46077,27,4,46109,27,4,47039,27,4,47561,27,4,48735,6,23.0,-1.28878,36.8168312,-1.2765736,36.8513646,933,1174,32,1452
19478,14318,1085,3,Business,29,1,52418,29,1,52616,29,1,53363,29,1,53570,29,1,55007,6,24.6,-1.2628638,36.8070399,-1.2877501,36.8146599,684,1437,198,954
19479,19507,1715,3,Business,16,1,32762,16,1,32901,16,1,33370,16,1,33567,16,1,34662,7,14.6,-1.2608993,36.799246,-1.2892435,36.8221852,808,1095,139,666
19480,24055,1516,2,Personal,19,5,51741,19,5,58351,19,5,58375,19,5,59451,19,5,61050,9,27.5,-1.2795261,36.8260185,-1.2972892,36.7499229,857,1599,6610,1100
19481,26618,198,3,Business,19,3,46320,19,3,46345,19,3,47601,19,3,47830,19,3,50400,17,22.2,-1.3396256,36.8863135,-1.2568001,36.8215083,822,2570,25,1485
19482,18019,1790,3,Business,26,1,49139,26,1,49182,26,1,49469,26,1,49743,26,1,50716,6,22.0,-1.2852584,36.8043641,-1.2637057,36.80517,167,973,43,561
19483,16981,3718,3,Business,15,4,34515,15,4,35353,15,4,36849,15,4,37093,15,4,38539,5,19.8,-1.2650027,36.8126242,-1.2906618,36.8131222,247,1446,838,1740
19484,9255,2209,3,Business,4,1,35446,4,1,38166,4,1,38358,4,1,38785,4,1,39742,7,21.0,-1.2624632,36.8405321,-1.3034167,36.8197498,852,957,2720,619
19485,16549,671,1,Personal,6,4,43963,6,4,44381,6,4,46090,6,4,46715,6,4,47778,8,22.1,-1.2343087,36.84749,-1.2855799,36.8176209,882,1063,418,2334
19486,3388,2154,3,Business,24,1,50198,24,1,50203,24,1,50632,24,1,51329,24,1,52503,6,24.9,-1.2859912,36.8756811,-1.2765736,36.8513646,26,1174,5,1126
19487,3024,1527,3,Business,20,1,36025,20,1,36055,20,1,36195,20,1,36826,20,1,37652,5,19.1,-1.3004062,36.829741,-1.3228003,36.8306435,591,826,30,771
19488,5753,2794,3,Personal,12,5,46297,12,5,46379,12,5,47047,12,5,48293,12,5,49422,10,26.6,-1.284289,36.822292,-1.2482781,36.884092,341,1129,82,1914
19489,1986,435,3,Business,3,1,40170,3,1,41279,3,1,43832,3,1,45452,3,1,48449,27,21.7,-1.1621358,36.9528801,-1.300921,36.828195,815,2997,1109,4173
19490,12270,2330,3,Business,9,5,45389,9,5,45391,9,5,45631,9,5,45720,9,5,48165,23,25.6,-1.3376825,36.7575489,-1.2284323,36.8757058,62,2445,2,329
19491,26261,3560,3,Business,15,4,52074,15,4,52168,15,4,52544,15,4,53171,15,4,54453,11,27.4,-1.2283403,36.8822756,-1.279395,36.825364,237,1282,94,1003
19492,7172,393,3,Business,14,5,36025,14,5,36050,14,5,36239,14,5,38383,14,5,38386,14,21.8,-1.3228003,36.8306435,-1.2991441,36.7528804,863,3,25,2333
19493,11115,635,3,Business,26,3,40719,26,3,40893,26,3,41265,26,3,43806,26,3,44593,7,24.2,-1.3016417,36.8271679,-1.2599563,36.7993439,179,787,174,2913
19494,4250,1329,3,Business,23,3,38890,23,3,39012,23,3,39682,23,3,40314,23,3,41009,5,21.7,-1.273056,36.811298,-1.2840354,36.7867427,888,695,122,1302
19495,14965,3295,3,Business,22,3,32357,22,3,32467,22,3,32645,22,3,33366,22,3,35535,22,19.0,-1.2571472,36.7950633,-1.354539,36.9056204,576,2169,110,899
19496,16649,892,2,Personal,14,5,44107,14,5,44280,14,5,45236,14,5,45586,14,5,45981,2,24.5,-1.306735,36.8256226,-1.312475,36.8225778,844,395,173,1306
19497,12527,868,3,Business,14,2,57945,14,2,57968,14,2,58307,14,2,58614,14,2,59643,5,23.25888921888938,-1.2600926,36.8088685,-1.265715,36.823815,697,1029,23,646
19498,12971,214,3,Personal,24,1,40503,24,1,40591,24,1,41688,24,1,42134,24,1,43359,6,22.7,-1.2612801,36.7870625,-1.2616213,36.8221128,882,1225,88,1543
19499,20691,144,3,Personal,26,2,44306,26,2,44325,26,2,44352,26,2,44802,26,2,46706,6,26.3,-1.2658335,36.8042867,-1.2961939,36.7837661,758,1904,19,477
19500,9267,867,3,Business,27,2,59165,27,2,59357,27,2,59365,27,2,59466,27,2,60644,9,25.8,-1.2574219,36.7927073,-1.306378,36.7519845,649,1178,192,109
19501,20921,136,3,Business,27,1,36836,27,1,38214,27,1,39708,27,1,40110,27,1,41651,9,23.8,-1.3169591,36.7000029,-1.3025826,36.7670807,100,1541,1378,1896
19502,23794,552,3,Business,28,5,40318,28,5,40450,28,5,40788,28,5,40911,28,5,42861,17,23.6,-1.279395,36.825364,-1.3632162,36.9108253,456,1950,132,461
19503,25527,2219,3,Business,15,1,43007,15,1,43024,15,1,44083,15,1,44169,15,1,45136,6,23.25888921888938,-1.2946359,36.8352718,-1.3272104,36.8528418,206,967,17,1145
19504,17014,2412,3,Business,31,1,47289,31,1,47930,31,1,48438,31,1,49048,31,1,49944,3,23.9,-1.2156006,36.8916865,-1.2285835,36.8826468,199,896,641,1118
19505,25673,1398,3,Business,6,3,30336,6,3,30392,6,3,30721,6,3,31883,6,3,33332,10,23.25888921888938,-1.2615584,36.8149506,-1.2945179,36.7685349,698,1449,56,1491
19506,25960,816,3,Business,22,2,57096,22,2,57729,22,2,58601,22,2,58934,22,2,62373,7,25.6,-1.290894,36.822971,-1.2551895,36.7822034,332,3439,633,1205
19507,25431,2112,3,Business,6,4,51064,6,4,53516,6,4,55107,6,4,59890,6,4,61044,12,22.6,-1.290894,36.822971,-1.2156006,36.8916865,150,1154,2452,6374
19508,3155,2528,3,Business,26,2,52353,26,2,52367,26,2,52546,26,2,53067,26,2,53595,3,30.8,-1.2584143,36.8048002,-1.2551895,36.7822034,411,528,14,700
19509,3688,3560,3,Business,24,1,40396,24,1,40610,24,1,41345,24,1,41550,24,1,45370,2,22.7,-1.279395,36.825364,-1.281754,36.8324229,275,3820,214,940
19510,22295,1075,3,Business,21,5,51272,21,5,51474,21,5,52135,21,5,52260,21,5,53010,3,24.4,-1.2527958,36.8003131,-1.2551895,36.7822034,191,750,202,786
19511,15727,3599,3,Business,29,4,39245,29,4,40285,29,4,42777,29,4,45199,29,4,45554,15,21.5,-1.3302996,36.8707935,-1.3132709,36.9127044,794,355,1040,4914
19512,939,3115,3,Business,12,1,34894,12,1,37524,12,1,37605,12,1,38353,12,1,39296,8,24.0,-1.2593294,36.7183756,-1.2963097,36.7688221,105,943,2630,829
19513,24939,2279,3,Business,28,5,45471,28,5,46979,28,5,48989,28,5,50603,28,5,53708,20,25.3,-1.1708105,36.8336102,-1.2571472,36.7950633,882,3105,1508,3624
19514,12257,2042,3,Business,29,1,36578,29,1,36598,29,1,36604,29,1,36711,29,1,38900,17,19.2,-1.2860183,36.8975338,-1.2857671,36.7875614,466,2189,20,113
19515,27744,3283,3,Business,1,5,43117,1,5,44281,1,5,45265,1,5,45730,1,5,46547,5,26.5,-1.2600926,36.8088685,-1.2628473,36.781805,290,817,1164,1449
19516,16115,2330,3,Business,20,3,57870,20,3,57899,20,3,57962,20,3,58436,20,3,61134,17,28.5,-1.2649605,36.7981777,-1.3340505,36.7119038,914,2698,29,537
19517,14029,3246,3,Business,20,2,52806,20,2,52816,20,2,53270,20,2,53983,20,2,57200,21,23.9,-1.3165542,36.700067,-1.2925919,36.8170577,64,3217,10,1167
19518,4459,3593,1,Personal,2,4,36546,2,4,36649,2,4,37387,2,4,38313,2,4,40742,7,22.3,-1.2913246,36.8019522,-1.2619756,36.800139,700,2429,103,1664
19519,12237,3355,3,Business,6,4,45694,6,4,49570,6,4,50078,6,4,52031,6,4,53543,6,23.25888921888938,-1.2743819,36.8130914,-1.3052491,36.8223899,878,1512,3876,2461
19520,20565,393,3,Business,13,4,43470,13,4,43474,13,4,43481,13,4,43797,13,4,45770,14,22.2,-1.3167113,36.8301563,-1.306378,36.7519845,523,1973,4,323
19521,26796,3355,3,Business,16,3,39027,16,3,41483,16,3,42380,16,3,44200,16,3,47353,13,23.9,-1.3562374,36.9042954,-1.3052491,36.8223899,711,3153,2456,2717
19522,18860,3560,3,Business,21,4,59567,21,4,59798,21,4,60299,21,4,60428,21,4,62162,5,23.25888921888938,-1.279395,36.825364,-1.307241,36.8302368,448,1734,231,630
19523,23728,3283,3,Business,17,3,52374,17,3,52666,17,3,52842,17,3,53400,17,3,53781,5,23.25888921888938,-1.266837,36.799249,-1.2628473,36.781805,383,381,292,734
19524,6543,3291,3,Business,10,1,39032,10,1,39849,10,1,41016,10,1,41410,10,1,42540,11,23.5,-1.2296618,36.8438272,-1.2600926,36.8088685,626,1130,817,1561
19525,13091,3689,3,Business,10,1,36473,10,1,36482,10,1,36907,10,1,38057,10,1,38429,2,23.7,-1.2571472,36.7950633,-1.2527958,36.8003131,720,372,9,1575
19526,2195,2982,3,Business,13,4,53074,13,4,53204,13,4,55046,13,4,55574,13,4,57652,14,22.9,-1.300921,36.828195,-1.2163391,36.8404088,340,2078,130,2370
19527,8240,3232,3,Business,18,4,33621,18,4,34448,18,4,34803,18,4,34871,18,4,36300,6,20.7,-1.2551895,36.7822034,-1.2881035,36.8142095,467,1429,827,423
19528,15208,2412,3,Business,8,1,31562,8,1,31596,8,1,32558,8,1,33305,8,1,36774,12,19.7,-1.2852569,36.8976121,-1.2297202,36.8819507,532,3469,34,1709
19529,12160,2152,2,Personal,5,6,47910,5,6,48543,5,6,49168,5,6,49473,5,6,50767,9,23.6,-1.2718504,36.8246277,-1.3202198,36.8026069,479,1294,633,930
19530,6269,393,3,Business,2,2,39500,2,2,39721,2,2,40478,2,2,41052,2,2,43475,6,26.4,-1.3167113,36.8301563,-1.3077869,36.8443207,343,2423,221,1331
19531,26974,3064,3,Business,23,5,38223,23,5,38281,23,5,38538,23,5,38618,23,5,39967,20,24.2,-1.2571472,36.7950633,-1.2110432,36.9114173,387,1349,58,337
19532,1648,1642,3,Business,28,6,39764,28,6,39774,28,6,39800,28,6,41592,28,6,42028,5,23.9,-1.2862269,36.7841601,-1.2728069,36.7962362,74,436,10,1818
19533,8532,3291,3,Business,23,2,45445,23,2,46690,23,2,47483,23,2,49013,23,2,50184,9,23.25888921888938,-1.307143,36.825009,-1.2600926,36.8088685,168,1171,1245,2323
19534,23232,1683,3,Business,14,2,56678,14,2,56783,14,2,58184,14,2,58888,14,2,59721,5,23.8,-1.278525,36.8265351,-1.2765334,36.8015051,213,833,105,2105
19535,624,3339,3,Business,27,3,36659,27,3,36700,27,3,36937,27,3,37192,27,3,38755,8,23.25888921888938,-1.2551895,36.7822034,-1.2962618,36.7929334,85,1563,41,492
19536,4230,1346,3,Business,21,1,39007,21,1,39020,21,1,39052,21,1,39334,21,1,41029,6,25.6,-1.2917868,36.7872675,-1.2695287,36.7981777,676,1695,13,314
19537,11646,517,3,Business,3,1,56404,3,1,56550,3,1,56608,3,1,57072,3,1,58587,11,23.3,-1.3228003,36.8306435,-1.2638185,36.7930057,158,1515,146,522
19538,321,635,3,Business,4,2,31774,4,2,31791,4,2,32636,4,2,32944,4,2,33601,6,16.7,-1.2890254,36.7990753,-1.2599563,36.7993439,726,657,17,1153
19539,27348,3487,3,Business,4,6,39872,4,6,39921,4,6,40201,4,6,40572,4,6,41574,5,23.25888921888938,-1.2591019,36.800577,-1.279395,36.825364,843,1002,49,651
19540,26730,2454,3,Business,27,2,54908,27,2,55705,27,2,56834,27,2,58587,27,2,61433,7,25.7,-1.2733047,36.8109744,-1.2993231,36.7753372,725,2846,797,2882
19541,21288,303,3,Business,10,1,50710,10,1,56203,10,1,56990,10,1,57743,10,1,60446,11,18.6,-1.2857524,36.8196806,-1.2245407,36.7583778,265,2703,5493,1540
19542,2503,451,3,Personal,18,2,33328,18,2,33345,18,2,33801,18,2,34073,18,2,35589,10,16.3,-1.2945179,36.7685349,-1.2736466,36.8164042,612,1516,17,728
19543,21204,2030,3,Business,29,2,49290,29,2,49663,29,2,51300,29,2,51581,29,2,53641,9,23.7,-1.3261259,36.904086,-1.3328365,36.8715943,304,2060,373,1918
19544,4465,1880,3,Business,13,4,54377,13,4,54410,13,4,55214,13,4,55758,13,4,56394,3,23.0,-1.2571472,36.7950633,-1.2608816,36.7824431,770,636,33,1348
19545,12645,393,3,Business,1,5,34823,1,5,37061,1,5,37554,1,5,38190,1,5,39056,4,26.6,-1.3167113,36.8301563,-1.3004062,36.829741,436,866,2238,1129
19546,23722,2956,3,Business,10,5,56558,10,5,56660,10,5,57044,10,5,57228,10,5,59063,4,23.25888921888938,-1.2584143,36.8048002,-1.2551895,36.7822034,96,1835,102,568
19547,22694,269,3,Business,6,4,59367,6,4,59471,6,4,59762,6,4,61221,6,4,63801,9,22.4,-1.3332749,36.8708147,-1.3562374,36.9042954,447,2580,104,1750
19548,27805,28,3,Business,26,1,44665,26,1,44684,26,1,47021,26,1,48840,26,1,52925,15,22.1,-1.2450667,36.8823827,-1.2917868,36.7872675,408,4085,19,4156
19549,4771,3201,3,Business,23,5,41681,23,5,42405,23,5,42458,23,5,44620,23,5,46842,6,24.0,-1.2584143,36.8048002,-1.2967702,36.8040381,101,2222,724,2215
19550,15342,517,3,Business,29,3,56408,29,3,56542,29,3,56879,29,3,57234,29,3,58490,11,20.9,-1.3228003,36.8306435,-1.2638185,36.7930057,158,1256,134,692
19551,23218,2763,3,Business,30,4,43592,30,4,43639,30,4,43659,30,4,44865,30,4,47794,14,20.5,-1.2551895,36.7822034,-1.3015998,36.8764939,446,2929,47,1226
19552,14276,2869,3,Business,15,5,48535,15,5,48570,15,5,49464,15,5,50090,15,5,51253,9,17.6,-1.2551895,36.7822034,-1.3025826,36.7670807,825,1163,35,1520
19553,15295,2195,3,Business,15,1,46667,15,1,46692,15,1,47178,15,1,47938,15,1,50800,16,23.25888921888938,-1.303596,36.778378,-1.228911,36.881876,154,2862,25,1246
19554,17555,393,3,Business,4,1,30154,4,1,30177,4,1,30323,4,1,30731,4,1,32590,14,21.8,-1.3167113,36.8301563,-1.306378,36.7519845,523,1859,23,554
19555,3970,2726,3,Personal,9,3,44701,9,3,44759,9,3,45336,9,3,45735,9,3,48726,21,25.2,-1.2812624,36.7714609,-1.306416,36.9168202,800,2991,58,976
19556,1992,2106,3,Personal,1,1,45287,1,1,46049,1,1,46619,1,1,47972,1,1,50352,18,24.2,-1.2840605,36.8191699,-1.1803358,36.8856922,832,2380,762,1923
19557,8194,2620,2,Personal,28,1,62234,28,1,63219,28,1,64566,28,1,64642,28,1,66752,12,22.3,-1.3681253,36.9155298,-1.3326788,36.8790255,494,2110,985,1423
19558,17180,3517,3,Business,11,2,34255,11,2,35602,11,2,36812,11,2,38031,11,2,39947,15,19.4,-1.300921,36.828195,-1.3882008,36.7699445,849,1916,1347,2429
19559,19382,391,3,Business,26,2,43906,26,2,43917,26,2,44154,26,2,44695,26,2,45322,5,27.5,-1.2602337,36.7990548,-1.2867454,36.8259017,456,627,11,778
19560,236,496,3,Business,13,4,40940,13,4,41160,13,4,41949,13,4,42258,13,4,44806,9,21.9,-1.2551895,36.7822034,-1.2346243,36.8109003,787,2548,220,1098
19561,18686,2821,2,Personal,13,4,29117,13,4,29486,13,4,31017,13,4,31182,13,4,33314,14,18.4,-1.3299022,36.7256127,-1.2981625,36.8130142,288,2132,369,1696
19562,26724,393,3,Business,11,1,51432,11,1,51543,11,1,51912,11,1,52427,11,1,54196,14,29.0,-1.3167113,36.8301563,-1.2991441,36.7528804,650,1769,111,884
19563,8873,1850,3,Business,18,1,44468,18,1,44491,18,1,44503,18,1,45591,18,1,45594,3,26.9,-1.2551895,36.7822034,-1.2636814,36.8029965,320,3,23,1100
19564,25035,265,3,Business,5,1,40489,5,1,40860,5,1,42372,5,1,42480,5,1,43834,7,24.4,-1.2962832,36.7849683,-1.300921,36.828195,248,1354,371,1620
19565,15976,3621,3,Business,15,1,40709,15,1,40722,15,1,40932,15,1,41164,15,1,42956,12,23.25888921888938,-1.2836583,36.7886014,-1.2998685,36.8643907,363,1792,13,442
19566,5182,1363,3,Business,6,4,58214,6,4,58348,6,4,59151,6,4,64161,6,4,64165,10,21.7,-1.3004062,36.829741,-1.2991441,36.7528804,271,4,134,5813
19567,4497,3091,3,Business,14,5,55278,14,5,55421,14,5,55455,14,5,56615,14,5,58076,9,23.1,-1.3012008,36.764868,-1.290894,36.822971,36,1461,143,1194
19568,7218,435,3,Business,7,5,43817,7,5,49136,7,5,50722,7,5,50885,7,5,52962,12,23.25888921888938,-1.2784722,36.7556652,-1.300921,36.828195,342,2077,5319,1749
19569,10570,2730,1,Personal,6,3,59994,6,3,60667,6,3,61719,6,3,61871,6,3,63960,5,20.1,-1.2824911,36.8218042,-1.2790653,36.7907262,531,2089,673,1204
19570,10735,1724,3,Business,23,1,51390,23,1,51403,23,1,51727,23,1,51909,23,1,53509,15,23.25888921888938,-1.2551895,36.7822034,-1.3272857,36.8748204,616,1600,13,506
19571,2055,2069,3,Business,30,3,55779,30,3,55834,30,3,56718,30,3,58286,30,3,59146,10,29.2,-1.228911,36.881876,-1.265715,36.823815,75,860,55,2452
19572,5976,2801,3,Business,21,3,40149,21,3,40203,21,3,40452,21,3,40590,21,3,42157,8,22.1,-1.2595422,36.7871178,-1.2925919,36.8170577,274,1567,54,387
19573,18484,1146,3,Business,22,3,57383,22,3,57601,22,3,57987,22,3,58811,22,3,59484,5,24.3,-1.3004062,36.829741,-1.3083266,36.8494756,211,673,218,1210
19574,16387,2982,3,Business,6,3,49400,6,3,49830,6,3,49843,6,3,51341,6,3,53329,18,27.6,-1.300921,36.828195,-1.177202,36.8351183,445,1988,430,1511
19575,25187,2112,3,Business,25,4,45681,25,4,48408,25,4,48576,25,4,49112,25,4,50092,12,23.25888921888938,-1.28878,36.8168312,-1.2156006,36.8916865,411,980,2727,704
19576,20294,1304,3,Business,18,4,42477,18,4,42516,18,4,42648,18,4,42927,18,4,45016,13,25.5,-1.3226302,36.8719901,-1.269534,36.80697,532,2089,39,411
19577,25959,816,3,Business,20,3,45511,20,3,45886,20,3,46969,20,3,47606,20,3,49828,6,26.2,-1.2527958,36.8003131,-1.290894,36.822971,569,2222,375,1720
19578,25771,546,2,Personal,20,1,38629,20,1,38820,20,1,39250,20,1,39422,20,1,40169,5,20.2,-1.2547104,36.7530824,-1.237705,36.7663283,932,747,191,602
19579,16970,2200,3,Business,19,5,48052,19,5,48077,19,5,48368,19,5,49256,19,5,51559,12,27.2,-1.225322,36.80855,-1.290894,36.822971,383,2303,25,1179
19580,15900,867,3,Business,17,5,39027,17,5,39065,17,5,39206,17,5,41401,17,5,43106,10,23.25888921888938,-1.3004062,36.829741,-1.2991441,36.7528804,690,1705,38,2336
19581,18419,1500,3,Business,28,5,29735,28,5,30198,28,5,31359,28,5,32054,28,5,32980,8,19.3,-1.3004062,36.829741,-1.2574219,36.7927073,436,926,463,1856
19582,8262,635,3,Business,12,2,52222,12,2,52386,12,2,52939,12,2,54033,12,2,55083,6,23.25888921888938,-1.3081376,36.8329772,-1.3229345,36.8566974,154,1050,164,1647
19583,14126,3521,3,Business,15,1,38568,15,1,38585,15,1,38939,15,1,39236,15,1,39576,1,23.25888921888938,-1.2723298,36.8037146,-1.2696908,36.81519,710,340,17,651
19584,3569,2838,1,Personal,7,4,43348,7,4,43451,7,4,44869,7,4,45147,7,4,46953,11,17.2,-1.2248308,36.8012573,-1.2795261,36.8260185,808,1806,103,1696
19585,10894,3283,3,Business,29,3,46596,29,3,46631,29,3,46966,29,3,47265,29,3,48082,5,23.25888921888938,-1.266837,36.799249,-1.2628473,36.781805,183,817,35,634
19586,17768,3040,1,Personal,9,7,40266,9,7,40286,9,7,42965,9,7,43206,9,7,46038,19,23.7,-1.2248308,36.8012573,-1.3319467,36.7766998,934,2832,20,2920
19587,12421,3586,3,Business,22,5,52372,22,5,52616,22,5,52735,22,5,52928,22,5,57233,9,31.0,-1.2854453,36.8188363,-1.2675334,36.7658246,521,4305,244,312
19588,633,3222,3,Business,29,4,36806,29,4,36971,29,4,39519,29,4,39660,29,4,45381,10,21.7,-1.2551895,36.7822034,-1.2287282,36.8115304,257,5721,165,2689
19589,27998,867,3,Business,26,2,35842,26,2,35854,26,2,35879,26,2,36448,26,2,38136,14,22.0,-1.3077869,36.8443207,-1.2991441,36.7528804,901,1688,12,594
19590,25827,2776,3,Personal,15,6,47590,15,6,47655,15,6,49386,15,6,49993,15,6,50716,5,26.1,-1.2918688,36.7603541,-1.2762513,36.7964048,722,723,65,2338
19591,25745,510,3,Business,31,4,58631,31,4,58643,31,4,58648,31,4,58736,31,4,59756,11,22.9,-1.2860183,36.8975338,-1.2413316,36.8785525,771,1020,12,93
19592,1918,3689,3,Business,16,5,70579,16,5,71323,16,5,72340,16,5,72867,16,5,74676,9,20.1,-1.3014461,36.7661381,-1.2527958,36.8003131,554,1809,744,1544
19593,22560,265,3,Business,18,2,33701,18,2,35048,18,2,36634,18,2,37331,18,2,38758,7,19.5,-1.268589,36.800623,-1.300921,36.828195,819,1427,1347,2283
19594,8652,37,3,Business,13,3,60678,13,3,60716,13,3,62020,13,3,63722,13,3,63724,15,27.6,-1.3263105,36.8622904,-1.3472066,36.7692638,411,2,38,3006
19595,23457,2987,3,Business,26,3,53797,26,3,53992,26,3,54914,26,3,55347,26,3,57451,4,26.9,-1.270212,36.8210877,-1.260232,36.807334,383,2104,195,1355
19596,3067,3599,3,Business,13,4,53245,13,4,53267,13,4,53595,13,4,56148,13,4,57618,14,22.9,-1.3302996,36.8707935,-1.2485879,36.8018025,891,1470,22,2881
19597,3595,3175,3,Business,2,5,58603,2,5,58701,2,5,59290,2,5,60177,2,5,62293,16,23.9,-1.2217966,36.917575,-1.2947307,36.8457384,217,2116,98,1476
19598,21987,3599,3,Business,29,4,38571,29,4,38595,29,4,39587,29,4,40919,29,4,43329,14,21.3,-1.3302996,36.8707935,-1.2622933,36.8303558,419,2410,24,2324
19599,7632,3355,3,Business,22,2,53747,22,2,53778,22,2,55401,22,2,57004,22,2,58958,13,21.3,-1.2297202,36.8745508,-1.3052491,36.8223899,771,1954,31,3226
19600,14192,635,3,Business,7,1,35517,7,1,36436,7,1,39721,7,1,40144,7,1,42294,21,24.6,-1.3882008,36.7699445,-1.2599563,36.7993439,878,2150,919,3708
19601,20730,1500,3,Business,23,4,36509,23,4,36595,23,4,36843,23,4,36907,23,4,37724,9,23.25888921888938,-1.2638185,36.7930057,-1.3004062,36.829741,193,817,86,312
19602,17392,136,3,Business,6,3,54064,6,3,54157,6,3,55139,6,3,55512,6,3,58681,30,27.6,-1.3094447,36.9107706,-1.3254522,36.7216584,404,3169,93,1355
19603,26995,1363,3,Business,28,2,54546,28,2,54574,28,2,54608,28,2,55318,28,2,57652,3,19.4,-1.3004062,36.829741,-1.2996681,36.8068413,672,2334,28,744
19604,26475,2330,3,Business,20,1,59158,20,1,59168,20,1,59420,20,1,59603,20,1,61134,13,20.6,-1.2915247,36.8055757,-1.3270197,36.7037303,932,1531,10,435
19605,20613,2523,3,Business,22,3,35048,22,3,35083,22,3,35360,22,3,35799,22,3,37312,16,18.6,-1.2551895,36.7822034,-1.3312488,36.8801409,205,1513,35,716
19606,21066,3560,3,Business,28,1,47776,28,1,47840,28,1,49186,28,1,49280,28,1,50609,8,26.1,-1.279395,36.825364,-1.2914687,36.7692172,862,1329,64,1440
19607,17864,3629,3,Personal,1,1,29969,1,1,29992,1,1,30852,1,1,30988,1,1,33958,11,18.4,-1.2852951,36.8133853,-1.22589,36.7822548,761,2970,23,996
19608,7007,1882,1,Business,4,2,26821,4,2,27042,4,2,29538,4,2,29990,4,2,32151,12,16.3,-1.2956882,36.7861845,-1.3169591,36.7000029,328,2161,221,2948
19609,21933,868,3,Business,20,4,39027,20,4,39097,20,4,40294,20,4,41004,20,4,42093,6,22.1,-1.300722,36.816865,-1.265715,36.823815,407,1089,70,1907
19610,13449,3064,3,Business,9,2,55930,9,2,56150,9,2,56274,9,2,56973,9,2,61531,5,30.7,-1.2571472,36.7950633,-1.2788257,36.82877,668,4558,220,823
19611,10268,3362,1,Personal,16,1,49241,16,1,49283,16,1,49776,16,1,50027,16,1,53876,14,22.4,-1.2765492,36.7669809,-1.3083777,36.8590077,228,3849,42,744
19612,20832,1415,2,Personal,23,3,47499,23,3,47698,23,3,50383,23,3,50518,23,3,54780,11,22.3,-1.2252107,36.8300026,-1.263194,36.797624,742,4262,199,2820
19613,10417,868,3,Business,13,4,35037,13,4,35612,13,4,35758,13,4,36069,13,4,36766,5,18.1,-1.2600926,36.8088685,-1.265715,36.823815,937,697,575,457
19614,25242,635,3,Business,27,6,40111,27,6,40202,27,6,40901,27,6,42073,27,6,43614,10,23.25888921888938,-1.3081376,36.8329772,-1.2602337,36.7990548,309,1541,91,1871
19615,4971,1584,3,Business,6,2,46129,6,2,46141,6,2,46475,6,2,46899,6,2,48442,7,25.2,-1.2969741,36.7856612,-1.2715686,36.8023526,829,1543,12,758
19616,15383,1500,3,Business,15,3,35908,15,3,36233,15,3,36661,15,3,36789,15,3,37950,9,23.25888921888938,-1.2638185,36.7930057,-1.3004062,36.829741,161,1161,325,556
19617,19927,510,3,Business,7,1,34489,7,1,34498,7,1,36085,7,1,37930,7,1,39271,13,24.6,-1.2283403,36.8822756,-1.2860183,36.8975338,351,1341,9,3432
19618,6371,3506,3,Personal,19,2,45642,19,2,45688,19,2,46363,19,2,46535,19,2,47210,4,23.25888921888938,-1.2563531,36.7896742,-1.2551895,36.7822034,148,675,46,847
19619,13575,2360,3,Business,7,4,38639,7,4,38653,7,4,38847,7,4,41368,7,4,42032,3,24.1,-1.2584143,36.8048002,-1.2615888,36.7928732,953,664,14,2715
19620,6648,1304,3,Business,28,1,50106,28,1,50882,28,1,51011,28,1,51405,28,1,52204,10,24.7,-1.2909536,36.8407162,-1.2553615,36.7895376,379,799,776,523
19621,7071,1724,3,Business,7,1,44989,7,1,45060,7,1,45629,7,1,46147,7,1,47456,7,24.7,-1.2551895,36.7822034,-1.2875845,36.8135104,268,1309,71,1087
19622,14477,432,3,Business,16,4,35688,16,4,35730,16,4,36066,16,4,36576,16,4,37761,10,23.25888921888938,-1.3012008,36.764868,-1.3002554,36.8256566,377,1185,42,846
19623,16067,3621,3,Business,2,6,52627,2,6,53013,2,6,54275,2,6,54501,2,6,56681,15,30.9,-1.2836583,36.7886014,-1.2285835,36.8826468,25,2180,386,1488
19624,3464,661,3,Business,11,4,48971,11,4,49377,11,4,49424,11,4,50227,11,4,51905,17,26.5,-1.2482465,36.8889062,-1.2963097,36.7688221,293,1678,406,850
19625,22414,2330,3,Business,30,4,63630,30,4,63775,30,4,64446,30,4,65297,30,4,67133,12,23.25888921888938,-1.2642903,36.8002137,-1.2284323,36.8757058,567,1836,145,1522
19626,4982,136,3,Business,9,4,59125,9,4,60238,9,4,60853,9,4,60915,9,4,62250,9,23.25888921888938,-1.3165104,36.7077726,-1.3009676,36.7657189,829,1335,1113,677
19627,1181,3599,3,Business,31,3,44066,31,3,46396,31,3,46976,31,3,47747,31,3,49141,14,24.7,-1.3302996,36.8707935,-1.3374736,36.9207076,62,1394,2330,1351
19628,19136,733,3,Business,28,4,42423,28,4,42438,28,4,42596,28,4,42992,28,4,47037,15,23.8,-1.2551895,36.7822034,-1.207546,36.7913976,579,4045,15,554
19629,5474,627,3,Business,29,1,32820,29,1,32948,29,1,35494,29,1,35593,29,1,39086,10,18.8,-1.2551895,36.7822034,-1.2299678,36.8153079,948,3493,128,2645
19630,6038,1719,3,Business,29,3,33024,29,3,33268,29,3,35502,29,3,35908,29,3,37937,12,17.9,-1.353975,36.7263802,-1.2963097,36.7688221,572,2029,244,2640
19631,3645,2933,2,Personal,28,5,34397,28,5,34445,28,5,35680,28,5,36092,28,5,37383,6,20.4,-1.2721028,36.7953485,-1.288002,36.827379,208,1291,48,1647
19632,3093,2804,3,Business,17,3,58990,17,3,58997,17,3,59007,17,3,59201,17,3,61456,15,28.3,-1.2551895,36.7822034,-1.207546,36.7913976,789,2255,7,204
19633,6836,1568,3,Business,28,1,51633,28,1,52121,28,1,53793,28,1,54621,28,1,57683,6,26.4,-1.2897368,36.8226783,-1.3271374,36.8495534,669,3062,488,2500
19634,15328,1920,3,Business,2,5,62127,2,5,62678,2,5,62850,2,5,62940,2,5,64471,10,24.1,-1.2551895,36.7822034,-1.2982578,36.8443952,237,1531,551,262
19635,7127,2344,3,Business,5,2,51581,5,2,51605,5,2,51649,5,2,52090,5,2,53968,15,22.7,-1.2553615,36.7895376,-1.3319467,36.7766998,101,1878,24,485
19636,12456,136,3,Business,7,1,36561,7,1,36585,7,1,37986,7,1,38377,7,1,39927,11,25.0,-1.2965045,36.7913036,-1.3165104,36.7077726,337,1550,24,1792
19637,18138,2701,3,Business,18,2,47045,18,2,47084,18,2,47150,18,2,48795,18,2,49315,10,27.5,-1.2765736,36.8513646,-1.2571472,36.7950633,179,520,39,1711
19638,1645,1217,3,Personal,11,5,51741,11,5,51785,11,5,53130,11,5,54363,11,5,57954,32,26.3,-1.2175583,36.884343,-1.398531,36.767365,268,3591,44,2578
19639,4052,302,3,Business,23,6,45862,23,6,45971,23,6,46429,23,6,47050,23,6,50228,8,26.3,-1.2649605,36.7981777,-1.3117749,36.82246,928,3178,109,1079
19640,22643,1209,3,Business,24,3,53335,24,3,54515,24,3,54551,24,3,54927,24,3,55903,6,23.25888921888938,-1.3004062,36.829741,-1.2703478,36.8106896,921,976,1180,412
19641,10023,3194,3,Business,19,5,60048,19,5,60102,19,5,60135,19,5,60682,19,5,62779,6,24.4,-1.263987,36.798891,-1.2854174,36.7951152,875,2097,54,580
19642,19827,2439,3,Business,22,4,36422,22,4,36462,22,4,36845,22,4,37483,22,4,38784,14,19.8,-1.2615888,36.7928732,-1.2297202,36.8819507,31,1301,40,1021
19643,12975,1507,2,Personal,12,2,50981,12,2,51741,12,2,53782,12,2,54747,12,2,55336,5,23.0,-1.281068,36.817578,-1.2659149,36.8054322,616,589,760,3006
19644,25063,393,3,Business,25,2,39175,25,2,39183,25,2,39317,25,2,41682,25,2,44811,14,24.0,-1.3177547,36.8303703,-1.306378,36.7519845,731,3129,8,2499
19645,5901,2956,3,Business,22,5,52952,22,5,53162,22,5,54520,22,5,54882,22,5,55786,6,27.3,-1.2584143,36.8048002,-1.2854151,36.8233848,489,904,210,1720
19646,11059,2627,3,Business,11,2,44674,11,2,44823,11,2,45115,11,2,46276,11,2,48571,17,19.6,-1.3472066,36.7692638,-1.2571472,36.7950633,205,2295,149,1453
19647,21085,2154,3,Business,13,4,47013,13,4,47055,13,4,47513,13,4,48210,13,4,49429,13,22.2,-1.2156006,36.8916865,-1.2765736,36.8513646,60,1219,42,1155
19648,6691,1502,3,Business,20,3,44687,20,3,44742,20,3,50142,20,3,50926,20,3,52855,11,28.4,-1.2859912,36.8756811,-1.2232123,36.8932547,900,1929,55,6184
19649,9118,1329,3,Business,18,2,69209,18,2,69235,18,2,69664,18,2,69884,18,2,70276,4,23.8,-1.273056,36.811298,-1.2615888,36.7928732,427,392,26,649
19650,27302,3145,3,Business,27,2,41889,27,2,42275,27,2,42869,27,2,43039,27,2,46736,7,23.9,-1.272639,36.794723,-1.2981625,36.8130142,726,3697,386,764
19651,22437,627,3,Business,4,4,42124,4,4,42159,4,4,42360,4,4,43286,4,4,44172,7,23.25888921888938,-1.2571472,36.7950633,-1.2876155,36.7868444,882,886,35,1127
19652,26799,2000,3,Business,1,4,51173,1,4,52621,1,4,52764,1,4,53030,1,4,54008,7,23.25888921888938,-1.2551895,36.7822034,-1.2934657,36.8212737,477,978,1448,409
19653,7054,2801,3,Business,20,2,29394,20,2,29429,20,2,32554,20,2,32855,20,2,34447,10,19.1,-1.2595422,36.7871178,-1.2996681,36.8068413,228,1592,35,3426
19654,14342,2640,3,Personal,7,2,59592,7,2,59711,7,2,60145,7,2,60519,7,2,65501,4,22.8,-1.2920693,36.8026415,-1.2795197,36.8168287,519,4982,119,808
19655,24516,2587,3,Business,26,3,34338,26,3,34415,26,3,35083,26,3,35230,26,3,36143,5,19.2,-1.2584143,36.8048002,-1.28878,36.8168312,847,913,77,815
19656,2882,2200,3,Business,3,2,51355,3,2,52214,3,2,52653,3,2,52908,3,2,54567,7,20.1,-1.290894,36.822971,-1.2551895,36.7822034,88,1659,859,694
19657,20728,2154,3,Business,8,2,52366,8,2,52624,8,2,53413,8,2,53721,8,2,54518,9,25.4,-1.2765736,36.8513646,-1.2413316,36.8785525,383,797,258,1097
19658,13271,2457,3,Business,8,3,54739,8,3,54754,8,3,55274,8,3,55754,8,3,56563,4,25.6,-1.2551895,36.7822034,-1.269534,36.80697,636,809,15,1000
19659,20019,1768,3,Personal,30,4,51520,30,4,51572,30,4,52890,30,4,53358,30,4,56981,8,23.25888921888938,-1.2750257,36.8157165,-1.2977326,36.7711606,539,3623,52,1786
19660,17889,928,3,Business,1,2,39703,1,2,39744,1,2,41093,1,2,41653,1,2,43492,10,21.8,-1.255956,36.789867,-1.3064585,36.8119065,479,1839,41,1909
19661,2889,3518,3,Business,20,1,34587,20,1,34620,20,1,34974,20,1,36873,20,1,37937,7,14.1,-1.2551895,36.7822034,-1.2821883,36.8269611,449,1064,33,2253
19662,16607,265,3,Business,6,4,38991,6,4,39019,6,4,40364,6,4,44514,6,4,45627,14,22.1,-1.2813289,36.7549034,-1.300921,36.828195,116,1113,28,5495
19663,12682,540,3,Business,9,2,33004,9,2,33024,9,2,33027,9,2,34069,9,2,34504,5,20.9,-1.2551895,36.7822034,-1.270054,36.815164,291,435,20,1045
19664,12335,2066,3,Business,15,1,35168,15,1,35229,15,1,35708,15,1,36143,15,1,36886,5,23.25888921888938,-1.316961,36.820337,-1.2942764,36.7969749,720,743,61,914
19665,4017,552,3,Business,6,5,42902,6,5,42929,6,5,43233,6,5,45852,6,5,47035,17,20.3,-1.2816234,36.8239846,-1.3632162,36.9108253,397,1183,27,2923
19666,5766,3686,3,Business,22,5,51850,22,5,52345,22,5,52830,22,5,53373,22,5,54438,9,31.0,-1.2551895,36.7822034,-1.2955334,36.7742857,247,1065,495,1028
19667,17749,1469,3,Business,7,4,52101,7,4,52119,7,4,52463,7,4,53238,7,4,54416,8,27.8,-1.2551895,36.7822034,-1.3040024,36.808297,267,1178,18,1119
19668,25076,1336,3,Business,29,1,57323,29,1,58483,29,1,59294,29,1,59501,29,1,61139,2,24.3,-1.2891922,36.825189,-1.2761677,36.81855,522,1638,1160,1018
19669,9318,2587,3,Business,7,4,44988,7,4,45129,7,4,45928,7,4,46146,7,4,47412,5,24.2,-1.2765736,36.8513646,-1.28878,36.8168312,513,1266,141,1017
19670,4078,3647,3,Business,12,5,59755,12,5,59886,12,5,60452,12,5,60723,12,5,62055,5,26.4,-1.272639,36.794723,-1.2857524,36.8196806,506,1332,131,837
19671,284,1856,3,Business,15,3,54993,15,3,55030,15,3,55415,15,3,56507,15,3,57097,4,21.7,-1.273009,36.802807,-1.2866012,36.8195691,281,590,37,1477
19672,20069,393,3,Business,4,2,41185,4,2,41207,4,2,41215,4,2,41366,4,2,43796,11,20.4,-1.3228003,36.8306435,-1.2638185,36.7930057,39,2430,22,159
19673,19597,2956,3,Business,25,1,50038,25,1,50099,25,1,50794,25,1,50868,25,1,51298,2,30.2,-1.2584143,36.8048002,-1.2620912,36.8013562,318,430,61,769
19674,20073,2216,3,Business,5,5,48804,5,5,48836,5,5,49201,5,5,49592,5,5,49928,2,27.6,-1.2551895,36.7822034,-1.2668093,36.7966542,952,336,32,756
19675,15288,2383,3,Business,21,1,38056,21,1,38094,21,1,38317,21,1,38533,21,1,40174,7,25.3,-1.2608993,36.799246,-1.2989934,36.8136694,205,1641,38,439
19676,25615,633,3,Business,26,2,41701,26,2,41730,26,2,42057,26,2,42263,26,2,43671,11,23.25888921888938,-1.2991441,36.7528804,-1.3004062,36.829741,494,1408,29,533
19677,12608,3404,3,Business,23,3,59495,23,3,59559,23,3,59949,23,3,60350,23,3,61307,5,24.3,-1.2584143,36.8048002,-1.279395,36.825364,490,957,64,791
19678,20324,393,3,Business,28,5,27964,28,5,35671,28,5,35816,28,5,36706,28,5,37158,4,20.7,-1.3177547,36.8303703,-1.3004062,36.829741,731,452,7707,1035
19679,18945,3186,3,Business,29,5,50533,29,5,51821,29,5,52661,29,5,52898,29,5,53805,5,28.9,-1.2980229,36.78865,-1.2949455,36.8195238,564,907,1288,1077
19680,2806,186,3,Business,26,5,53566,26,5,54452,26,5,54651,26,5,54835,26,5,55983,8,23.25888921888938,-1.279478,36.8304521,-1.2571472,36.7950633,237,1148,886,383
19681,15896,136,3,Business,29,4,59047,29,4,59074,29,4,59624,29,4,60564,29,4,61409,4,20.8,-1.2965045,36.7913036,-1.3009676,36.7657189,427,845,27,1490
19682,27332,2216,3,Business,8,4,44807,8,4,46937,8,4,47599,8,4,48873,8,4,50982,20,27.4,-1.2551895,36.7822034,-1.3251247,36.8995926,932,2109,2130,1936
19683,2779,3769,3,Personal,17,1,38432,17,1,38514,17,1,39573,17,1,39850,17,1,40740,9,25.2,-1.2967404,36.7361755,-1.2796191,36.7995343,88,890,82,1336
19684,8679,635,3,Business,21,4,51549,21,4,51563,21,4,51580,21,4,52455,21,4,53492,10,31.1,-1.3081376,36.8329772,-1.2602337,36.7990548,459,1037,14,892
19685,10766,2466,1,Personal,3,4,35767,3,4,36225,3,4,36972,3,4,37845,3,4,40057,7,17.5,-1.2877645,36.8378535,-1.2562366,36.8038565,549,2212,458,1620
19686,21098,1687,3,Business,13,3,50707,13,3,50720,13,3,51098,13,3,51828,13,3,52726,7,29.3,-1.2626574,36.8014034,-1.3014732,36.7781201,622,898,13,1108
19687,7581,3149,3,Business,14,3,52637,14,3,53112,14,3,53393,14,3,55801,14,3,56266,6,25.9,-1.3004062,36.829741,-1.3177547,36.8303703,744,465,475,2689
19688,10162,3074,3,Business,26,6,53272,26,6,53322,26,6,54123,26,6,55696,26,6,56446,5,28.1,-1.3097597,36.8316597,-1.31471,36.8110941,925,750,50,2374
19689,9027,3465,3,Business,15,3,34573,15,3,34584,15,3,34598,15,3,35175,15,3,36008,4,23.25888921888938,-1.2551895,36.7822034,-1.2728058,36.8049903,291,833,11,591
19690,27738,1500,3,Business,16,2,31598,16,2,31616,16,2,31648,16,2,34922,16,2,36081,10,23.25888921888938,-1.2991441,36.7528804,-1.2638185,36.7930057,855,1159,18,3306
19691,1746,2200,3,Business,26,1,41272,26,1,43381,26,1,44789,26,1,46526,26,1,48561,3,22.8,-1.290894,36.822971,-1.3012619,36.8213697,614,2035,2109,3145
19692,26510,1363,3,Business,7,4,51056,7,4,51118,7,4,51121,7,4,52497,7,4,52857,7,27.5,-1.3004062,36.829741,-1.2616841,36.801999,137,360,62,1379
19693,1342,760,3,Business,4,2,56241,4,2,57239,4,2,58426,4,2,58694,4,2,60411,5,22.5,-1.2736695,36.8028996,-1.3023305,36.8260519,539,1717,998,1455
19694,20200,2627,3,Business,11,2,53865,11,2,53951,11,2,54523,11,2,59822,11,2,62203,20,21.1,-1.2571472,36.7950633,-1.3632162,36.9108253,828,2381,86,5871
19695,9764,2086,1,Personal,23,6,40031,23,6,40073,23,6,40657,23,6,41221,23,6,42062,5,23.25888921888938,-1.2994194,36.7647917,-1.301278,36.7934817,208,841,42,1148
19696,902,3291,3,Business,15,3,51544,15,3,52840,15,3,53685,15,3,54851,15,3,56067,9,21.7,-1.307143,36.825009,-1.2600926,36.8088685,179,1216,1296,2011
19697,20018,2271,3,Business,19,2,46352,19,2,46398,19,2,46766,19,2,46965,19,2,48556,14,27.5,-1.265715,36.823815,-1.293515,36.897607,110,1591,46,567
19698,28155,60,3,Business,28,2,41691,28,2,41713,28,2,41791,28,2,42149,28,2,42930,7,21.2,-1.2663631,36.8163329,-1.22978,36.836215,341,781,22,436
19699,6035,3647,3,Business,29,1,53205,29,1,53262,29,1,53880,29,1,54257,29,1,54722,4,23.25888921888938,-1.272639,36.794723,-1.2609186,36.7938342,315,465,57,995
19700,9905,1500,3,Business,22,3,43356,22,3,43459,22,3,43816,22,3,45755,22,3,45818,7,23.1,-1.2638185,36.7930057,-1.2770708,36.8231093,436,63,103,2296
19701,2681,187,3,Business,3,6,51880,3,6,51991,3,6,52112,3,6,54977,3,6,56643,8,22.4,-1.3027293,36.7661974,-1.3165542,36.700067,774,1666,111,2986
19702,18995,701,3,Personal,13,4,52495,13,4,52507,13,4,52921,13,4,53255,13,4,54963,14,22.3,-1.2946581,36.7792921,-1.3231725,36.8640177,205,1708,12,748
19703,5325,2271,3,Business,25,3,40997,25,3,41009,25,3,41015,25,3,42122,25,3,43557,11,23.25888921888938,-1.331619,36.847976,-1.293515,36.897607,900,1435,12,1113
19704,21421,265,3,Business,21,1,62374,21,1,62389,21,1,62629,21,1,63299,21,1,67602,27,23.25888921888938,-1.300921,36.828195,-1.2500868,37.0109232,116,4303,15,910
19705,11706,1424,3,Business,28,5,53336,28,5,53431,28,5,53901,28,5,54325,28,5,55761,14,25.6,-1.30157,36.7871,-1.329424,36.862726,100,1436,95,894
19706,12864,1271,3,Business,14,4,38269,14,4,38287,14,4,38570,14,4,39074,14,4,41582,24,23.9,-1.3244885,36.897792,-1.3107918,36.761794,411,2508,18,787
19707,6671,1062,3,Business,12,1,62200,12,1,62793,12,1,63994,12,1,64222,12,1,66933,11,23.6,-1.238874,36.807889,-1.2967702,36.8040381,108,2711,593,1429
19708,19823,3554,3,Personal,17,3,38161,17,3,38169,17,3,38224,17,3,40434,17,3,42720,18,25.3,-1.2861765,36.8209086,-1.335477,36.9308297,942,2286,8,2265
19709,17162,2039,2,Personal,29,5,57435,29,5,57653,29,5,60559,29,5,60660,29,5,62125,7,20.4,-1.2755226,36.7811904,-1.2649605,36.7981777,536,1465,218,3007
19710,20641,2132,3,Business,7,4,32756,7,4,32778,7,4,33159,7,4,35281,7,4,36946,12,19.3,-1.2384056,36.8718698,-1.295748,36.834246,75,1665,22,2503
19711,505,1221,3,Personal,1,3,40136,1,3,40185,1,3,40754,1,3,41745,1,3,44485,18,19.9,-1.2614329,36.8094365,-1.1800438,36.885823,107,2740,49,1560
19712,2811,3355,3,Business,3,5,46640,3,5,46644,3,5,46661,3,5,46935,3,5,48157,6,21.5,-1.3052491,36.8223899,-1.2721466,36.8155359,293,1222,4,291
19713,16474,722,3,Business,28,1,48310,28,1,48369,28,1,48459,28,1,50121,28,1,52176,9,26.3,-1.32943,36.894243,-1.3251409,36.8869345,800,2055,59,1752
19714,21692,393,3,Business,23,2,32216,23,2,32230,23,2,32244,23,2,37699,23,2,37701,14,23.25888921888938,-1.3167113,36.8301563,-1.2991441,36.7528804,10,2,14,5469
19715,1062,1687,3,Business,21,1,40051,21,1,40089,21,1,41615,21,1,41898,21,1,44537,16,19.9,-1.2883354,36.81648846,-1.3194525,36.6983896,455,2639,38,1809
19716,8597,1809,3,Business,22,2,55928,22,2,55951,22,2,56274,22,2,56981,22,2,57313,2,25.5,-1.2584143,36.8048002,-1.2571472,36.7950633,167,332,23,1030
19717,1866,3686,3,Business,25,2,41109,25,2,41191,25,2,42207,25,2,42464,25,2,44768,13,23.9,-1.2551895,36.7822034,-1.3318059,36.8359596,279,2304,82,1273
19718,27748,1209,3,Business,17,4,47848,17,4,49229,17,4,50255,17,4,51206,17,4,51534,4,28.0,-1.3077869,36.8443207,-1.3004062,36.829741,714,328,1381,1977
19719,16375,1250,1,Personal,11,4,54798,11,4,56164,11,4,56860,11,4,57081,11,4,58441,10,26.6,-1.2619924,36.8226673,-1.2675334,36.7658246,406,1360,1366,917
19720,25043,3491,3,Business,22,2,56525,22,2,56532,22,2,56725,22,2,57051,22,2,61744,14,25.8,-1.2285835,36.8826468,-1.3244885,36.897792,882,4693,7,519
19721,12381,1800,1,Personal,7,1,35332,7,1,35662,7,1,36063,7,1,36748,7,1,37903,10,18.5,-1.3250048,36.8697188,-1.285029,36.824926,478,1155,330,1086
19722,9674,248,3,Business,30,2,32671,30,2,32715,30,2,33703,30,2,34086,30,2,35051,8,23.25888921888938,-1.304735,36.7846054,-1.3112499,36.8278836,177,965,44,1371
19723,3791,1329,3,Business,24,5,59018,24,5,62796,24,5,64951,24,5,65809,24,5,67525,11,20.0,-1.273056,36.811298,-1.3170774,36.856955,427,1716,3778,3013
19724,19971,2106,1,Personal,2,6,47204,2,6,47255,2,6,48947,2,6,49840,2,6,52578,21,24.1,-1.3285987,36.9037428,-1.1985673,36.8363688,765,2738,51,2585
19725,2818,3404,3,Business,22,6,51980,22,6,52310,22,6,52373,22,6,53825,22,6,54436,5,26.0,-1.2584143,36.8048002,-1.279395,36.825364,779,611,330,1515
19726,20881,2924,2,Personal,4,6,31641,4,6,31666,4,6,33749,4,6,35566,4,6,37447,15,15.7,-1.2827651,36.8433831,-1.2606665,36.7473715,95,1881,25,3900
19727,4868,540,3,Business,23,5,43842,23,5,43914,23,5,44756,23,5,45161,23,5,45723,3,24.2,-1.2571472,36.7950633,-1.2753109,36.8130185,840,562,72,1247
19728,27667,2706,3,Personal,23,1,54921,23,1,54940,23,1,55386,23,1,55473,23,1,57175,3,23.25888921888938,-1.2603014,36.8069828,-1.2606445,36.8185586,519,1702,19,533
19729,14990,496,3,Business,12,2,39911,12,2,39956,12,2,40595,12,2,40834,12,2,43155,11,24.3,-1.2551895,36.7822034,-1.3004371,36.743036,328,2321,45,878
19730,27189,1882,3,Business,23,5,69240,23,5,69710,23,5,70907,23,5,71311,23,5,72811,5,20.4,-1.2958783,36.7928125,-1.287781,36.817866,554,1500,470,1601
19731,14061,3201,3,Business,29,6,49519,29,6,49585,29,6,50387,29,6,51499,29,6,51504,5,26.5,-1.263709,36.8293799,-1.2584143,36.8048002,845,5,66,1914
19732,1568,393,3,Business,8,2,56396,8,2,56684,8,2,56750,8,2,57679,8,2,59487,14,25.2,-1.3167113,36.8301563,-1.2991441,36.7528804,188,1808,288,995
19733,12636,2503,2,Business,11,5,47183,11,5,47250,11,5,47575,11,5,47837,11,5,49309,8,20.6,-1.255956,36.789867,-1.2858511,36.7946184,729,1472,67,587
19734,907,186,3,Business,16,3,36653,16,3,36695,16,3,37481,16,3,37819,16,3,38613,7,19.8,-1.2825816,36.8092346,-1.2571472,36.7950633,26,794,42,1124
19735,18424,3686,3,Business,5,2,54124,5,2,54148,5,2,54350,5,2,55619,5,2,56683,8,23.25888921888938,-1.2551895,36.7822034,-1.2947279,36.780382,885,1064,24,1471
19736,26886,242,3,Business,3,4,44619,3,4,44643,3,4,46606,3,4,46709,3,4,46715,3,21.8,-1.255956,36.789867,-1.25537,36.7756,408,6,24,2066
19737,26845,393,3,Business,14,1,55521,14,1,56364,14,1,56380,14,1,59772,14,1,59782,4,23.2,-1.3177547,36.8303703,-1.3004062,36.829741,515,10,843,3408
19738,5806,252,3,Personal,27,1,57582,27,1,57592,27,1,58152,27,1,59023,27,1,60458,5,23.2,-1.2615888,36.7928732,-1.2598849,36.8219979,868,1435,10,1431
19739,14262,1976,3,Business,7,3,36635,7,3,36651,7,3,36806,7,3,37204,7,3,39121,24,23.25888921888938,-1.257028,36.7810435,-1.3632421,36.9183909,387,1917,16,553
19740,13125,2212,3,Business,4,2,57772,4,2,58415,4,2,58707,4,2,59231,4,2,62016,13,22.3,-1.2571472,36.7950633,-1.302453,36.8668919,162,2785,643,816
19741,7238,2987,3,Business,19,1,37717,19,1,41606,19,1,42005,19,1,42877,19,1,44190,12,24.6,-1.3271374,36.8495534,-1.2649605,36.7981777,675,1313,3889,1271
19742,25132,792,2,Personal,24,2,36426,24,2,36435,24,2,36529,24,2,37359,24,2,37965,3,14.1,-1.2738167,36.8157821,-1.2617458,36.8251441,88,606,9,924
19743,27754,2934,1,Personal,5,4,57492,5,4,57854,5,4,58531,5,4,58659,5,4,60248,10,22.0,-1.2560222,36.7886679,-1.299313,36.7831488,726,1589,362,805
19744,25328,1724,3,Business,15,1,47754,15,1,47797,15,1,48349,15,1,48732,15,1,49954,11,23.25888921888938,-1.2941648,36.7977315,-1.32189,36.8589727,263,1222,43,935
19745,22354,1743,2,Personal,25,6,41938,25,6,42690,25,6,44952,25,6,45370,25,6,47130,18,23.25888921888938,-1.300215,36.6942878,-1.267756,36.794266,832,1760,752,2680
19746,15117,3686,3,Business,22,5,56875,22,5,56963,22,5,57979,22,5,58059,22,5,61125,11,27.1,-1.2551895,36.7822034,-1.3233496,36.8139159,928,3066,88,1096
19747,4776,928,3,Business,27,3,32790,27,3,32853,27,3,32866,27,3,34834,27,3,35480,6,23.25888921888938,-1.2571472,36.7950633,-1.2857671,36.7875614,446,646,63,1981
19748,925,1372,3,Business,18,4,61848,18,4,61916,18,4,63130,18,4,63567,18,4,65092,12,23.25888921888938,-1.3193233,36.840991,-1.3472066,36.7692638,154,1525,68,1651
19749,23726,3149,3,Business,7,2,42275,7,2,42311,7,2,42855,7,2,44079,7,2,45638,10,23.25888921888938,-1.3167113,36.8301563,-1.2690834,36.7994156,910,1559,36,1768
19750,1341,2066,3,Business,24,3,57852,24,3,57878,24,3,58412,24,3,58600,24,3,61841,18,23.25888921888938,-1.3210189,36.8410551,-1.215326,36.8919938,233,3241,26,722
19751,5923,3560,3,Business,23,6,57230,23,6,57528,23,6,57577,23,6,58065,23,6,58469,1,23.25888921888938,-1.28878,36.8168312,-1.279395,36.825364,763,404,298,537
19752,19713,496,3,Business,12,1,55996,12,1,56115,12,1,56419,12,1,56984,12,1,59028,22,26.9,-1.2571472,36.7950633,-1.374163,36.913444,770,2044,119,869
19753,3285,2207,3,Business,12,2,50652,12,2,50762,12,2,53009,12,2,53611,12,2,55033,5,23.25888921888938,-1.2897399,36.8270975,-1.2696908,36.81519,448,1422,110,2849
19754,22285,2490,2,Personal,9,2,39114,9,2,42275,9,2,43073,9,2,43602,9,2,44687,6,22.0,-1.253621,36.7991917,-1.2896399,36.8124498,38,1085,3161,1327
19755,12050,1075,3,Business,3,1,51162,3,1,52547,3,1,53369,3,1,55847,3,1,56327,6,23.3,-1.2886923,36.8241519,-1.2527958,36.8003131,291,480,1385,3300
19756,4428,2344,3,Business,26,2,58264,26,2,58285,26,2,58381,26,2,60862,26,2,61919,7,28.6,-1.2571472,36.7950633,-1.2857247,36.7894293,445,1057,21,2577
19757,10747,186,3,Business,14,5,53249,14,5,53296,14,5,53755,14,5,54309,14,5,55050,7,22.9,-1.2825816,36.8092346,-1.2571472,36.7950633,788,741,47,1013
19758,20703,2763,3,Business,13,3,34546,13,3,34630,13,3,35283,13,3,35407,13,3,36161,5,20.0,-1.2551895,36.7822034,-1.2711982,36.8240199,318,754,84,777
19759,14294,517,3,Business,29,3,54018,29,3,54172,29,3,54188,29,3,55512,29,3,56882,11,21.0,-1.3228003,36.8306435,-1.2638185,36.7930057,349,1370,154,1340
19760,17584,3355,3,Business,4,1,50109,4,1,50165,4,1,50760,4,1,51492,4,1,52381,6,28.8,-1.3052491,36.8223899,-1.2897215,36.7945959,210,889,56,1327
19761,8133,635,3,Business,13,4,43424,13,4,43451,13,4,43475,13,4,45298,13,4,46308,10,22.1,-1.300921,36.828195,-1.2602337,36.7990548,595,1010,27,1847
19762,4479,2330,3,Business,13,3,37945,13,3,38006,13,3,38531,13,3,39145,13,3,40404,10,23.25888921888938,-1.2649605,36.7981777,-1.3015197,36.7658456,318,1259,61,1139
19763,19512,393,3,Business,19,3,47501,19,3,51199,19,3,51652,19,3,52862,19,3,53756,5,24.3,-1.3167113,36.8301563,-1.3077869,36.8443207,914,894,3698,1663
19764,23545,2532,3,Business,6,4,37769,6,4,38778,6,4,40095,6,4,40711,6,4,42460,14,24.2,-1.2551895,36.7822034,-1.329568,36.8520825,48,1749,1009,1933
19765,15525,3035,3,Business,2,6,36843,2,6,36880,2,6,37573,2,6,38557,2,6,39001,2,27.4,-1.2969741,36.7856612,-1.2963097,36.7688221,88,444,37,1677
19766,438,3291,3,Business,14,4,39951,14,4,39969,14,4,40763,14,4,41588,14,4,42843,12,23.9,-1.228911,36.881876,-1.2600926,36.8088685,260,1255,18,1619
19767,26828,2330,3,Business,29,3,54851,29,3,55134,29,3,56026,29,3,56704,29,3,58606,11,21.1,-1.2915247,36.8055757,-1.2687407,36.7373043,429,1902,283,1570
19768,7272,1502,3,Business,7,4,53916,7,4,59863,7,4,61019,7,4,61845,7,4,64584,14,29.4,-1.207546,36.7913976,-1.2232123,36.8932547,830,2739,5947,1982
19769,15707,2069,3,Business,28,4,43762,28,4,44700,28,4,46491,28,4,46720,28,4,49586,12,23.7,-1.2600926,36.8088685,-1.228911,36.881876,306,2866,938,2020
19770,9088,3320,3,Business,29,4,54642,29,4,54855,29,4,54868,29,4,55921,29,4,57232,9,24.9,-1.3080092,36.8284543,-1.2708331,36.7904193,268,1311,213,1066
19771,22689,733,3,Business,5,2,38625,5,2,38654,5,2,39199,5,2,39360,5,2,40933,15,23.4,-1.2551895,36.7822034,-1.207546,36.7913976,40,1573,29,706
19772,22878,3355,3,Business,10,5,48004,10,5,48022,10,5,49158,10,5,50068,10,5,52447,17,21.9,-1.2154586,36.8830064,-1.3052491,36.8223899,415,2379,18,2046
19773,20172,435,3,Business,24,5,37032,24,5,37046,24,5,37371,24,5,37898,24,5,40177,16,18.1,-1.300921,36.828195,-1.2094552,36.8073286,158,2279,14,852
19774,26466,1075,3,Business,14,4,45864,14,4,45965,14,4,46375,14,4,46977,14,4,47228,1,25.2,-1.2649605,36.7981777,-1.2527958,36.8003131,807,251,101,1012
19775,20616,1271,3,Business,14,3,45042,14,3,45966,14,3,46965,14,3,47386,14,3,49081,27,24.7,-1.3949989,36.7654761,-1.3244885,36.897792,179,1695,924,1420
19776,9452,2627,3,Business,9,3,52104,9,3,52120,9,3,52794,9,3,53041,9,3,54157,2,25.2,-1.2584143,36.8048002,-1.2571472,36.7950633,801,1116,16,921
19777,23683,393,3,Business,6,1,47542,6,1,47611,6,1,48665,6,1,49751,6,1,49779,4,23.25888921888938,-1.3167113,36.8301563,-1.3004062,36.829741,328,28,69,2140
19778,21247,3181,3,Personal,11,4,34953,11,4,35191,11,4,35416,11,4,36470,11,4,37071,6,18.5,-1.299787,36.8335941,-1.3233955,36.8562944,179,601,238,1279
19779,17208,1471,3,Business,13,3,39817,13,3,40040,13,3,40246,13,3,40502,13,3,41852,9,24.8,-1.2551895,36.7822034,-1.301796,36.8012024,933,1350,223,462
19780,24970,2008,3,Business,17,5,35974,17,5,36049,17,5,36425,17,5,38702,17,5,39031,17,23.25888921888938,-1.2508229,36.7895263,-1.1723835,36.7587976,953,329,75,2653
19781,24196,2801,3,Business,7,3,37620,7,3,39029,7,3,39874,7,3,41112,7,3,41750,4,25.1,-1.2809847,36.8274169,-1.2696908,36.81519,909,638,1409,2083
19782,376,3547,3,Business,8,1,43190,8,1,43224,8,1,43956,8,1,44207,8,1,46649,22,27.8,-1.2761408,36.7710839,-1.3160977,36.9131642,217,2442,34,983
19783,13450,666,2,Personal,8,5,47192,8,5,47869,8,5,48670,8,5,50483,8,5,51671,9,21.6,-1.2770071,36.832167,-1.330692,36.84115,360,1188,677,2614
19784,17084,3496,3,Business,2,3,41248,2,3,41253,2,3,41259,2,3,43328,2,3,44882,15,24.2,-1.300921,36.828195,-1.3882008,36.7699445,120,1554,5,2075
19785,15510,2463,2,Personal,25,2,38320,25,2,38334,25,2,38360,25,2,41709,25,2,42414,14,24.0,-1.3007646,36.8387542,-1.2433667,36.7609493,41,705,14,3375
19786,14940,1443,1,Personal,20,4,36094,20,4,36125,20,4,37816,20,4,38405,20,4,40900,15,24.4,-1.2131531,36.8334735,-1.301894,36.830993,532,2495,31,2280
19787,17856,20,3,Business,25,4,57293,25,4,57566,25,4,58400,25,4,58987,25,4,61375,18,23.25888921888938,-1.2628638,36.8070399,-1.3390024,36.8746657,276,2388,273,1421
19788,17996,2064,2,Personal,24,4,38663,24,4,38674,24,4,39232,24,4,39408,24,4,39890,5,21.2,-1.263894,36.77163,-1.2743552,36.811436,116,482,11,734
19789,22711,1500,3,Business,26,2,39679,26,2,39702,26,2,39891,26,2,40267,26,2,41484,9,26.0,-1.2638185,36.7930057,-1.3004062,36.829741,154,1217,23,565
19790,710,1502,3,Business,13,7,39488,13,7,40445,13,7,41143,13,7,41773,13,7,43617,14,23.8,-1.225322,36.80855,-1.2237773,36.8861711,101,1844,957,1328
19791,14982,265,3,Business,1,5,55746,1,5,55851,1,5,57001,1,5,57236,1,5,58417,3,28.6,-1.300921,36.828195,-1.3204504,36.8406383,362,1181,105,1385
19792,11470,1036,1,Personal,11,4,45017,11,4,45028,11,4,45397,11,4,45939,11,4,46527,4,23.9,-1.2658335,36.8042867,-1.2655306,36.828148,795,588,11,911
19793,17848,1329,3,Business,28,3,37456,28,3,37630,28,3,38161,28,3,38485,28,3,41710,4,23.25888921888938,-1.273056,36.811298,-1.2877501,36.8146599,829,3225,174,855
19794,21052,978,1,Personal,31,4,47647,31,4,49183,31,4,49877,31,4,50877,31,4,52072,6,23.1,-1.3084067,36.8345014,-1.276395,36.825707,116,1195,1536,1694
19795,10528,1341,3,Business,5,2,42594,5,2,42651,5,2,43015,5,2,43747,5,2,45531,13,21.4,-1.303596,36.778378,-1.331619,36.847976,379,1784,57,1096
19796,9115,1389,3,Business,28,4,58675,28,4,59078,28,4,59116,28,4,61359,28,4,64330,15,27.9,-1.290894,36.822971,-1.207546,36.7913976,19,2971,403,2281
19797,1548,3379,3,Personal,3,5,44382,3,5,44412,3,5,44884,3,5,46517,3,5,48242,10,21.4,-1.2985032,36.7821448,-1.2754091,36.8529305,722,1725,30,2105
19798,18944,3372,3,Business,7,4,45893,7,4,46049,7,4,47582,7,4,47886,7,4,49490,16,16.8,-1.304033,36.7848695,-1.2297202,36.8745508,543,1604,156,1837
19799,3576,478,3,Business,29,3,42659,29,3,42696,29,3,43358,29,3,45790,29,3,46139,7,18.3,-1.2924188,36.8024393,-1.2571472,36.7950633,217,349,37,3094
19800,7555,909,3,Business,29,1,57973,29,1,58089,29,1,58802,29,1,59069,29,1,61326,7,23.25888921888938,-1.207546,36.7913976,-1.225322,36.80855,733,2257,116,980
19801,16826,1363,3,Business,14,5,41079,14,5,41304,14,5,42688,14,5,42767,14,5,43496,5,21.6,-1.3004062,36.829741,-1.3083266,36.8494756,267,729,225,1463
19802,19654,1063,2,Personal,24,5,39805,24,5,39849,24,5,40339,24,5,40941,24,5,42272,7,21.0,-1.2707373,36.805441,-1.2929577,36.7955434,754,1331,44,1092
19803,19023,246,3,Business,28,1,42692,28,1,44149,28,1,44810,28,1,45618,28,1,48654,17,22.7,-1.2156006,36.8916865,-1.2584143,36.8048002,101,3036,1457,1469
19804,26794,2470,1,Personal,8,1,37244,8,1,37477,8,1,38508,8,1,38802,8,1,40323,8,24.7,-1.317337,36.82698,-1.3323107,36.8692616,648,1521,233,1325
19805,2198,2263,1,Personal,7,2,56702,7,2,58793,7,2,59567,7,2,59933,7,2,61484,6,23.2,-1.3302996,36.8707935,-1.318049,36.8556554,848,1551,2091,1140
19806,506,3355,3,Business,21,1,44712,21,1,44844,21,1,46908,21,1,46971,21,1,48530,13,19.8,-1.3052491,36.8223899,-1.2413316,36.8785525,102,1559,132,2127
19807,12946,2828,3,Business,29,4,43901,29,4,43985,29,4,44203,29,4,44420,29,4,44866,3,21.7,-1.2584143,36.8048002,-1.2615888,36.7928732,574,446,84,435
19808,20378,1205,3,Business,26,2,57431,26,2,57682,26,2,58227,26,2,58529,26,2,59700,3,30.8,-1.2495931,36.8065087,-1.2628937,36.798537,484,1171,251,847
19809,23597,3291,3,Business,26,2,34582,26,2,34615,26,2,35828,26,2,36882,26,2,37824,4,22.0,-1.265715,36.823815,-1.2600926,36.8088685,309,942,33,2267
19810,22953,2112,3,Business,24,4,50059,24,4,50078,24,4,50832,24,4,51130,24,4,53993,17,28.2,-1.2232123,36.8932547,-1.2551895,36.7822034,104,2863,19,1052
19811,13694,60,3,Business,3,4,43270,3,4,44563,3,4,45243,3,4,46771,3,4,47794,10,23.4,-1.2600926,36.8088685,-1.22978,36.836215,14,1023,1293,2208
19812,1343,2866,3,Business,26,3,52147,26,3,52156,26,3,52308,26,3,52434,26,3,53535,3,27.1,-1.2584143,36.8048002,-1.2551895,36.7822034,881,1101,9,278
19813,7416,2789,3,Business,25,4,30240,25,4,30546,25,4,31478,25,4,32027,25,4,32200,2,23.25888921888938,-1.3035165,36.7910264,-1.304735,36.7846054,678,173,306,1481
19814,25584,1502,3,Business,18,2,58364,18,2,58579,18,2,58581,18,2,60664,18,2,62603,13,23.6,-1.2584143,36.8048002,-1.2232123,36.8932547,874,1939,215,2085
19815,26418,2102,3,Business,9,5,55121,9,5,55413,9,5,56296,9,5,56953,9,5,60280,15,26.3,-1.3323107,36.8692616,-1.2613768,36.8019418,914,3327,292,1540
19816,6632,2303,2,Business,2,2,38956,2,2,38972,2,2,39303,2,2,40115,2,2,41036,7,20.8,-1.2562823,36.7741174,-1.249986,36.7863906,38,921,16,1143
19817,23863,1899,3,Business,27,1,49668,27,1,49697,27,1,49721,27,1,50751,27,1,51559,7,23.2,-1.307143,36.825009,-1.331619,36.847976,686,808,29,1054
19818,3512,760,3,Business,3,1,46299,3,1,46402,3,1,47047,3,1,47853,3,1,52359,18,21.4,-1.2736695,36.8028996,-1.338558,36.9215488,829,4506,103,1451
19819,23093,3491,3,Business,6,4,50883,6,4,51078,6,4,51115,6,4,52859,6,4,53839,12,23.6,-1.2927792,36.9053492,-1.2297202,36.8819507,589,980,195,1781
19820,2094,1245,3,Business,14,5,44158,14,5,44191,14,5,44725,14,5,45723,14,5,49504,25,21.7,-1.300921,36.828195,-1.3526635,36.6646172,654,3781,33,1532
19821,15227,779,1,Personal,25,2,43950,25,2,44037,25,2,44934,25,2,46831,25,2,48264,8,24.0,-1.2658335,36.8042867,-1.2905113,36.7591138,467,1433,87,2794
19822,33,633,3,Business,15,5,29869,15,5,29889,15,5,29891,15,5,30043,15,5,31938,8,19.4,-1.3004062,36.829741,-1.2638185,36.7930057,10,1895,20,154
19823,23632,2673,3,Business,9,3,47952,9,3,48063,9,3,48141,9,3,48593,9,3,51962,9,21.2,-1.2865096,36.8169364,-1.264384,36.7674128,345,3369,111,530
19824,13068,3070,3,Business,17,5,47802,17,5,47837,17,5,47897,17,5,48774,17,5,50334,14,23.25888921888938,-1.2653676,36.7911012,-1.3127834,36.8696399,829,1560,35,937
19825,4036,3194,3,Business,1,5,45796,1,5,46311,1,5,47981,1,5,49204,1,5,50813,5,28.7,-1.2571472,36.7950633,-1.2802084,36.8196685,489,1609,515,2893
19826,25543,516,3,Business,7,5,55544,7,5,55889,7,5,56041,7,5,56269,7,5,58931,15,23.25888921888938,-1.2551895,36.7822034,-1.3190988,36.8660397,582,2662,345,380
19827,20226,1850,3,Business,16,2,56310,16,2,56452,16,2,58244,16,2,58361,16,2,59477,7,27.2,-1.2551895,36.7822034,-1.2897399,36.8270975,208,1116,142,1909
19828,19761,2801,3,Business,26,3,51091,26,3,56185,26,3,57869,26,3,58283,26,3,58993,7,27.2,-1.281577,36.7938293,-1.2595422,36.7871178,875,710,5094,2098
19829,10903,3718,3,Business,9,5,44798,9,5,45496,9,5,46274,9,5,46398,9,5,48808,8,25.5,-1.2650027,36.8126242,-1.2973168,36.7760143,512,2410,698,902
19830,13635,2956,3,Business,25,4,43011,25,4,43089,25,4,43366,25,4,43588,25,4,44456,9,20.1,-1.2584143,36.8048002,-1.2692149,36.74492,726,868,78,499
19831,22363,393,3,Business,7,4,52675,7,4,52780,7,4,53467,7,4,54336,7,4,55056,4,27.8,-1.3167113,36.8301563,-1.3004062,36.829741,523,720,105,1556
19832,26755,1244,3,Business,6,2,42044,6,2,45984,6,2,49067,6,2,49919,6,2,51086,11,27.3,-1.331619,36.847976,-1.303596,36.778378,179,1167,3940,3935
19833,9332,3599,3,Business,26,5,50571,26,5,51981,26,5,53444,26,5,53691,26,5,57581,14,23.25888921888938,-1.3302996,36.8707935,-1.2515637,36.8119508,675,3890,1410,1710
19834,12224,3108,3,Business,9,5,43153,9,5,43225,9,5,43254,9,5,46041,9,5,49136,15,25.5,-1.2551895,36.7822034,-1.3348111,36.8614787,107,3095,72,2816
19835,19653,1781,1,Business,22,3,64251,22,3,64454,22,3,65662,22,3,67083,22,3,70027,19,23.0,-1.3206929,36.8621776,-1.2239216,36.8792146,272,2944,203,2629
19836,20825,2523,3,Business,30,4,53503,30,4,53599,30,4,53776,30,4,54171,30,4,56355,9,20.9,-1.2551895,36.7822034,-1.2977565,36.8025534,574,2184,96,572
19837,28015,2869,3,Business,21,4,33326,21,4,33336,21,4,35416,21,4,35700,21,4,38588,20,21.6,-1.2283403,36.8822756,-1.3014461,36.7661381,442,2888,10,2364
19838,22236,3234,3,Business,11,3,57754,11,3,57863,11,3,58268,11,3,58721,11,3,60938,6,20.7,-1.2664428,36.809453,-1.2859331,36.7865464,312,2217,109,858
19839,2093,1245,3,Business,19,3,48183,19,3,48219,19,3,49107,19,3,50276,19,3,52911,20,24.4,-1.300921,36.828195,-1.3494207,36.7025413,958,2635,36,2057
19840,14552,812,1,Personal,11,5,51413,11,5,52191,11,5,53308,11,5,54221,11,5,54739,5,22.5,-1.2855799,36.8176209,-1.2681867,36.8148322,813,518,778,2030
19841,2733,635,3,Business,11,2,57755,11,2,58147,11,2,58744,11,2,58845,11,2,60263,9,21.2,-1.300921,36.828195,-1.2643174,36.7794769,583,1418,392,698
19842,6225,3295,3,Business,8,5,48740,8,5,52777,8,5,53264,8,5,57329,8,5,59438,21,30.6,-1.2571472,36.7950633,-1.3987598,36.7677036,404,2109,4037,4552
19843,10870,3688,3,Business,15,5,46999,15,5,47028,15,5,48611,15,5,49057,15,5,50768,16,28.2,-1.2551895,36.7822034,-1.215326,36.8919938,200,1711,29,2029
19844,16327,635,3,Business,8,1,32981,8,1,33010,8,1,33285,8,1,35130,8,1,38108,19,22.1,-1.300921,36.828195,-1.1942397,36.8554738,329,2978,29,2120
19845,21053,2956,3,Business,3,1,32833,3,1,32876,3,1,33377,3,1,33694,3,1,35219,9,18.6,-1.2584143,36.8048002,-1.2624329,36.7525813,407,1525,43,818
19846,15040,393,3,Business,8,3,32774,8,3,32825,8,3,32831,8,3,35240,8,3,35245,4,23.25888921888938,-1.3167113,36.8301563,-1.3004062,36.829741,239,5,51,2415
19847,9196,2946,2,Personal,19,2,33090,19,2,33693,19,2,34439,19,2,34587,19,2,36789,9,15.6,-1.2749662,36.7658781,-1.2611578,36.8145307,89,2202,603,894
19848,20253,111,3,Business,24,4,46169,24,4,46367,24,4,47319,24,4,47500,24,4,49530,9,24.7,-1.2551895,36.7822034,-1.3080696,36.8237191,755,2030,198,1133
19849,17941,421,1,Business,1,1,45363,1,1,45383,1,1,45480,1,1,45638,1,1,47254,7,24.0,-1.2975066,36.7689423,-1.303217,36.731467,532,1616,20,255
19850,4444,1207,3,Business,19,1,38788,19,1,38810,19,1,39863,19,1,41303,19,1,43716,23,24.6,-1.207546,36.7913976,-1.2745321,36.765088,940,2413,22,2493
19851,10531,517,3,Business,31,5,57461,31,5,57775,31,5,59102,31,5,62122,31,5,62723,14,23.6,-1.3228003,36.8306435,-1.2991441,36.7528804,436,601,314,4347
19852,3043,351,3,Personal,6,4,40175,6,4,40289,6,4,41574,6,4,42164,6,4,42928,5,21.8,-1.3052285,36.79390121,-1.2929577,36.7955434,447,764,114,1875
19853,6545,2523,3,Business,21,5,53835,21,5,53854,21,5,54013,21,5,54163,21,5,54680,3,24.7,-1.2551895,36.7822034,-1.2546732,36.8086796,658,517,19,309
19854,23005,635,3,Business,13,4,32214,13,4,32442,13,4,38018,13,4,39684,13,4,40838,10,22.1,-1.300921,36.828195,-1.2602337,36.7990548,787,1154,228,7242
19855,18380,2933,2,Personal,29,7,51264,29,7,51290,29,7,52745,29,7,53686,29,7,54662,7,23.1,-1.311208,36.778743,-1.2721028,36.7953485,465,976,26,2396
19856,9536,2069,3,Business,12,1,37306,12,1,37503,12,1,38653,12,1,39293,12,1,40475,9,23.6,-1.272828,36.816608,-1.228911,36.881876,649,1182,197,1790
19857,20543,1687,3,Business,24,3,52355,24,3,52392,24,3,52832,24,3,52925,24,3,54070,4,23.25888921888938,-1.2627937,36.8156957,-1.2732803,36.7940377,16,1145,37,533
19858,6698,1887,1,Personal,3,3,34440,3,3,34460,3,3,36144,3,3,36318,3,3,36967,3,18.5,-1.27876,36.812651,-1.2732412,36.8117677,88,649,20,1858
19859,9785,868,3,Business,30,5,60916,30,5,61316,30,5,61827,30,5,62286,30,5,62967,4,22.2,-1.266837,36.799249,-1.265715,36.823815,279,681,400,970
19860,20864,3354,3,Business,8,5,45489,8,5,45706,8,5,46883,8,5,47002,8,5,49213,18,28.2,-1.2571472,36.7950633,-1.2738108,36.9167268,343,2211,217,1296
19861,23965,552,3,Business,25,4,35796,25,4,35822,25,4,35871,25,4,36385,25,4,38793,22,16.3,-1.2551895,36.7822034,-1.3562374,36.9042954,171,2408,26,563
19862,25020,868,3,Business,28,2,40029,28,2,42223,28,2,43751,28,2,44581,28,2,48564,14,17.5,-1.293515,36.897607,-1.265715,36.823815,810,3983,2194,2358
19863,536,3766,2,Personal,20,5,54168,20,5,54175,20,5,55212,20,5,55335,20,5,56058,4,20.6,-1.2765533,36.8290863,-1.2670213,36.7994482,616,723,7,1160
19864,25852,131,2,Personal,8,2,40044,8,2,41177,8,2,42364,8,2,43537,8,2,44542,8,21.5,-1.2868838,36.8284259,-1.3206842,36.8362301,101,1005,1133,2360
19865,21411,265,3,Business,25,4,44583,25,4,48260,25,4,48897,25,4,49073,25,4,50518,8,23.25888921888938,-1.303407,36.7762303,-1.300921,36.828195,548,1445,3677,813
19866,3713,778,3,Business,30,3,35857,30,3,36180,30,3,36862,30,3,37880,30,3,39328,7,19.5,-1.2839186,36.8222431,-1.2535486,36.7933541,101,1448,323,1700
19867,22752,3521,3,Business,8,1,32233,8,1,32284,8,1,33026,8,1,33743,8,1,34603,7,19.9,-1.2956517,36.8036292,-1.2696908,36.81519,105,860,51,1459
19868,2238,3291,3,Business,13,3,40532,13,3,40549,13,3,41037,13,3,42021,13,3,43790,12,24.8,-1.228911,36.881876,-1.2600926,36.8088685,199,1769,17,1472
19869,7432,478,3,Business,8,5,44966,8,5,45145,8,5,45704,8,5,46880,8,5,48095,8,24.4,-1.2551895,36.7822034,-1.3045333,36.8228072,79,1215,179,1735
19870,8871,1927,3,Business,13,3,61394,13,3,61438,13,3,62302,13,3,63733,13,3,66392,23,27.6,-1.2285835,36.8826468,-1.3472066,36.7692638,76,2659,44,2295
19871,5412,2011,1,Personal,2,4,42243,2,4,42308,2,4,43068,2,4,43393,2,4,45371,10,22.4,-1.3199853,36.843423,-1.2753109,36.8130185,85,1978,65,1085
19872,9595,3686,3,Business,11,3,60595,11,3,60720,11,3,61268,11,3,61698,11,3,63181,10,20.2,-1.2551895,36.7822034,-1.3068448,36.8348641,770,1483,125,978
19873,1228,3647,3,Business,13,2,37879,13,2,37938,13,2,38518,13,2,38818,13,2,40953,25,22.5,-1.272639,36.794723,-1.1567082,36.9618034,648,2135,59,880
19874,19584,2066,3,Business,25,6,50432,25,6,50471,25,6,51675,25,6,52073,25,6,52883,6,23.25888921888938,-1.3270716,36.8406371,-1.3206958,36.8769553,2,810,39,1602
19875,10898,3625,1,Personal,16,4,53429,16,4,53474,16,4,54667,16,4,55094,16,4,56929,16,18.9,-1.2725144,36.8272178,-1.356804,36.746196,414,1835,45,1620
19876,11986,2216,3,Business,15,3,33469,15,3,33508,15,3,34025,15,3,34289,15,3,38431,9,16.4,-1.2551895,36.7822034,-1.2946558,36.7908316,933,4142,39,781
19877,21673,726,3,Personal,20,3,48859,20,3,48906,20,3,49056,20,3,49667,20,3,50744,4,28.5,-1.2836657,36.7666744,-1.2757858,36.7886841,217,1077,47,761
19878,21224,3655,1,Personal,4,4,59134,4,4,59317,4,4,60127,4,4,60582,4,4,61724,4,23.25888921888938,-1.2913598,36.8025568,-1.3043649,36.7816132,597,1142,183,1265
19879,11866,2523,3,Business,27,1,40754,27,1,41010,27,1,41180,27,1,41514,27,1,43769,13,20.6,-1.2551895,36.7822034,-1.3024388,36.859699,875,2255,256,504
19880,2472,1209,3,Business,14,2,30331,14,2,30369,14,2,31221,14,2,36144,14,2,36701,4,23.25888921888938,-1.3077869,36.8443207,-1.3004062,36.829741,448,557,38,5775
19881,8303,2405,1,Personal,10,1,34282,10,1,34296,10,1,34611,10,1,35401,10,1,37521,16,18.0,-1.2960265,36.8780276,-1.2551895,36.7822034,848,2120,14,1105
19882,7829,733,3,Business,18,1,45935,18,1,45996,18,1,46527,18,1,47202,18,1,48288,3,26.9,-1.2551895,36.7822034,-1.2692689,36.8055169,279,1086,61,1206
19883,16587,1684,1,Personal,14,5,41513,14,5,41524,14,5,41682,14,5,44281,14,5,46162,6,24.5,-1.2740396,36.7993518,-1.2933789,36.8087535,832,1881,11,2757
19884,2745,517,3,Business,31,5,49543,31,5,49686,31,5,49891,31,5,52003,31,5,52005,4,24.7,-1.3228003,36.8306435,-1.3004062,36.829741,619,2,143,2317
19885,25821,2599,1,Business,26,4,58715,26,4,58834,26,4,59974,26,4,60514,26,4,61735,7,19.5,-1.2867454,36.8259017,-1.2560455,36.7800867,250,1221,119,1680
19886,9348,2289,3,Business,20,4,52368,20,4,52387,20,4,53004,20,4,54745,20,4,55647,21,28.2,-1.2571472,36.7950633,-1.343439,36.912065,405,902,19,2358
19887,1310,1014,1,Business,13,6,74970,13,6,75062,13,6,75790,13,6,76237,13,6,79763,5,22.3,-1.3043821,36.7840586,-1.2830073,36.7662294,299,3526,92,1175
19888,28156,3647,3,Business,11,2,58511,11,2,59571,11,2,60646,11,2,60975,11,2,63226,10,21.2,-1.272639,36.794723,-1.2461233,36.7674785,404,2251,1060,1404
19889,27103,3718,3,Business,13,2,40177,13,2,41538,13,2,42572,13,2,42768,13,2,43687,3,22.2,-1.2650027,36.8126242,-1.265432,36.795034,528,919,1361,1230
19890,20135,1584,3,Business,30,5,33451,30,5,36345,30,5,36496,30,5,38744,30,5,40028,8,23.5,-1.304033,36.7848695,-1.2654095,36.7973495,19,1284,2894,2399
19891,5961,913,3,Personal,4,4,45051,4,4,45155,4,4,45670,4,4,45958,4,4,46956,6,25.5,-1.2692689,36.8055169,-1.3034413,36.7770106,903,998,104,803
19892,12111,392,1,Business,9,3,62787,9,3,65672,9,3,65950,9,3,67394,9,3,69855,14,21.5,-1.2297202,36.8745508,-1.255956,36.789867,633,2461,2885,1722
19893,11070,3647,3,Business,27,2,56028,27,2,56077,27,2,56766,27,2,57193,27,2,58813,17,25.4,-1.272639,36.794723,-1.207546,36.7913976,222,1620,49,1116
19894,12673,2216,3,Business,29,2,36905,29,2,37143,29,2,37410,29,2,38186,29,2,38754,4,21.6,-1.2553615,36.7895376,-1.269534,36.80697,103,568,238,1043
19895,8620,615,3,Business,31,5,38743,31,5,38758,31,5,39353,31,5,39530,31,5,40866,9,21.9,-1.2802043,36.7650079,-1.3066143,36.8161046,761,1336,15,772
19896,24181,3647,3,Business,22,4,63389,22,4,63506,22,4,64230,22,4,64454,22,4,65547,5,24.1,-1.272639,36.794723,-1.2654594,36.8216832,531,1093,117,948
19897,22793,2509,3,Business,8,4,54506,8,4,54731,8,4,55433,8,4,55588,8,4,56354,4,27.3,-1.2571472,36.7950633,-1.2825816,36.8092346,338,766,225,857
19898,22779,2034,2,Personal,24,1,34346,24,1,34360,24,1,35485,24,1,36287,24,1,38440,17,15.6,-1.1992343,36.7884894,-1.290499,36.784363,764,2153,14,1927
19899,24523,2587,3,Business,15,1,54645,15,1,55036,15,1,55978,15,1,56908,15,1,59893,7,23.25888921888938,-1.28878,36.8168312,-1.2551895,36.7822034,58,2985,391,1872
19900,627,3239,3,Personal,8,2,37676,8,2,39095,8,2,39995,8,2,40342,8,2,41223,9,21.3,-1.276154,36.8224165,-1.2477465,36.8783014,669,881,1419,1247
19901,15147,2985,2,Personal,14,5,39019,14,5,39027,14,5,40216,14,5,40299,14,5,40954,3,24.4,-1.2222689,36.8549337,-1.22966,36.84401,933,655,8,1272
19902,22594,142,3,Business,14,4,27371,14,4,27420,14,4,28497,14,4,29436,14,4,30713,9,18.0,-1.2679057,36.8180272,-1.2963097,36.7688221,452,1277,49,2016
19903,17964,3300,3,Business,8,3,38685,8,3,38728,8,3,39480,8,3,40620,8,3,41576,8,22.1,-1.307143,36.825009,-1.303596,36.778378,179,956,43,1892
19904,27444,661,3,Business,29,2,53394,29,2,54085,29,2,55013,29,2,56339,29,2,57502,4,23.9,-1.2950044,36.7512209,-1.2963097,36.7688221,312,1163,691,2254
19905,24836,2685,1,Personal,5,2,49537,5,2,49827,5,2,50273,5,2,50732,5,2,52204,9,22.5,-1.29362,36.78745,-1.2646974,36.8051788,474,1472,290,905
19906,21861,1927,3,Business,23,2,44253,23,2,44269,23,2,46013,23,2,46124,23,2,47725,12,23.25888921888938,-1.279395,36.825364,-1.3472066,36.7692638,411,1601,16,1855
19907,15791,2330,3,Business,26,6,34994,26,6,35005,26,6,37112,26,6,37481,26,6,40417,19,20.5,-1.185943,36.9276394,-1.2671943,36.8062533,209,2936,11,2476
19908,4062,3557,3,Business,4,4,55142,4,4,55474,4,4,56170,4,4,56450,4,4,57764,7,24.9,-1.2925919,36.8170577,-1.2546732,36.8086796,74,1314,332,976
19909,25965,722,3,Business,14,4,55042,14,4,55315,14,4,56346,14,4,56855,14,4,62180,19,27.7,-1.32943,36.894243,-1.2655306,36.828148,64,5325,273,1540
19910,22335,3283,3,Business,30,2,54881,30,2,55340,30,2,55896,30,2,56181,30,2,57445,7,23.25888921888938,-1.303596,36.778378,-1.2628473,36.781805,548,1264,459,841
19911,15438,2587,3,Business,9,6,33589,9,6,33612,9,6,33844,9,6,35032,9,6,39057,12,20.0,-1.2859912,36.8756811,-1.28878,36.8168312,771,4025,23,1420
19912,6630,1280,3,Business,17,4,29620,17,4,29644,17,4,31000,17,4,31369,17,4,32592,4,23.25888921888938,-1.2551895,36.7822034,-1.2650877,36.8147644,362,1223,24,1725
19913,6502,970,3,Business,17,1,59009,17,1,59103,17,1,59412,17,1,59740,17,1,60450,4,22.6,-1.2551895,36.7822034,-1.2693662,36.8085295,685,710,94,637
19914,14543,1447,2,Personal,14,4,33088,14,4,33341,14,4,35984,14,4,36327,14,4,37609,8,15.3,-1.2838392,36.8842742,-1.2332122,36.8733172,812,1282,253,2986
19915,19631,3355,3,Business,15,3,46474,15,3,46486,15,3,47224,15,3,47928,15,3,48594,4,18.3,-1.291768,36.8297208,-1.3052491,36.8223899,234,666,12,1442
19916,16288,393,3,Business,21,4,36421,21,4,36433,21,4,36440,21,4,37519,21,4,37982,4,18.8,-1.3167113,36.8301563,-1.3004062,36.829741,111,463,12,1086
19917,16748,2200,3,Business,7,4,45589,7,4,45601,7,4,45665,7,4,46512,7,4,46909,1,27.8,-1.2813012,36.8323962,-1.290894,36.822971,686,397,12,911
19918,18005,498,1,Personal,20,7,45724,20,7,46812,20,7,47959,20,7,48239,20,7,48866,3,20.0,-1.3046965,36.8016456,-1.3131897,36.8180215,956,627,1088,1427
19919,20154,3201,3,Business,30,5,29751,30,5,29775,30,5,31518,30,5,32151,30,5,33238,7,18.9,-1.225322,36.80855,-1.2584143,36.8048002,101,1087,24,2376
19920,22486,3718,3,Business,4,2,59224,4,2,59249,4,2,59805,4,2,59962,4,2,60896,5,22.3,-1.2906618,36.8131222,-1.2650027,36.8126242,762,934,25,713
19921,9110,867,3,Business,29,1,52447,29,1,52511,29,1,52739,29,1,54475,29,1,55777,10,23.25888921888938,-1.2996533,36.8292629,-1.2991441,36.7528804,245,1302,64,1964
19922,25512,816,3,Business,3,5,41993,3,5,42027,3,5,42812,3,5,43196,3,5,44045,4,21.4,-1.2765736,36.8513646,-1.290894,36.822971,857,849,34,1169
19923,4310,3091,3,Business,16,4,55879,16,4,55922,16,4,57779,16,4,58749,16,4,60730,4,23.25888921888938,-1.290894,36.822971,-1.2965842,36.8234722,106,1981,43,2827
19924,26507,1556,3,Business,26,1,33349,26,1,33450,26,1,33485,26,1,34378,26,1,37362,14,18.0,-1.2551895,36.7822034,-1.2297202,36.8819507,387,2984,101,928
19925,14063,391,3,Business,13,1,38510,13,1,40596,13,1,41281,13,1,41987,13,1,43964,6,17.4,-1.3223238,36.8320056,-1.2857574,36.8295667,213,1977,2086,1391
19926,15619,2066,3,Business,16,2,65266,16,2,66319,16,2,66940,16,2,67632,16,2,68880,8,25.1,-1.316961,36.820337,-1.2724885,36.7856999,449,1248,1053,1313
19927,4614,2523,3,Business,31,4,45882,31,4,45896,31,4,45925,31,4,46518,31,4,48443,13,26.6,-1.2551895,36.7822034,-1.31553,36.863732,770,1925,14,622
19928,20521,646,3,Personal,21,5,53780,21,5,54901,21,5,56755,21,5,57077,21,5,57661,3,24.6,-1.2733047,36.8109744,-1.284289,36.822292,456,584,1121,2176
19929,13613,3507,3,Personal,23,1,36252,23,1,36270,23,1,37359,23,1,37717,23,1,39515,15,14.4,-1.2944628,36.7522739,-1.3266433,36.832018,465,1798,18,1447
19930,25740,2982,3,Business,6,3,35039,6,3,35332,6,3,36375,6,3,37847,6,3,39640,15,23.25888921888938,-1.2675613,36.8133001,-1.177202,36.8351183,205,1793,293,2515
19931,11766,3578,3,Business,3,1,40380,3,1,40492,3,1,41433,3,1,42235,3,1,44522,7,21.5,-1.2878913,36.8089253,-1.2527958,36.8003131,228,2287,112,1743
19932,6975,3127,3,Business,19,2,53581,19,2,53643,19,2,56658,19,2,57331,19,2,58666,4,29.8,-1.2964348,36.8182757,-1.2918246,36.801585,62,1335,62,3688
19933,23419,868,3,Business,15,3,42955,15,3,42976,15,3,44738,15,3,45759,15,3,46193,6,23.25888921888938,-1.3033561,36.8163631,-1.265715,36.823815,61,434,21,2783
19934,26164,1271,3,Business,5,4,59845,5,4,60049,5,4,60927,5,4,61734,5,4,64179,19,20.5,-1.3244885,36.897792,-1.2905046,36.7828277,621,2445,204,1685
19935,22172,3091,3,Business,13,5,57404,13,5,57427,13,5,57451,13,5,59834,13,5,61546,18,19.1,-1.2297202,36.8819507,-1.3014461,36.7661381,886,1712,23,2407
19936,9090,2412,3,Business,5,5,29329,5,5,29342,5,5,31142,5,5,32502,5,5,32839,3,20.0,-1.2232123,36.8932547,-1.2283403,36.8822756,291,337,13,3160
19937,2874,3647,3,Business,7,3,46429,7,3,46484,7,3,47092,7,3,47429,7,3,48105,3,25.1,-1.272639,36.794723,-1.2674482,36.8076994,646,676,55,945
19938,12422,2368,3,Personal,26,4,59675,26,4,59783,26,4,60216,26,4,61078,26,4,61874,7,19.8,-1.3175119,36.8058513,-1.2764851,36.8007126,88,796,108,1295
19939,23471,2350,1,Personal,24,4,37504,24,4,37649,24,4,37995,24,4,38382,24,4,39318,9,21.4,-1.3114711,36.8088708,-1.2745107,36.7974503,735,936,145,733
19940,8782,3674,3,Business,26,2,40204,26,2,40238,26,2,40773,26,2,40949,26,2,41859,4,26.4,-1.2551895,36.7822034,-1.2663525,36.8128337,49,910,34,711
19941,26492,2330,3,Business,28,4,55074,28,4,55155,28,4,57411,28,4,57594,28,4,58559,8,29.9,-1.3328934,36.7112141,-1.3015197,36.7658456,226,965,81,2439
19942,4882,1471,3,Business,10,5,46087,10,5,46343,10,5,46417,10,5,48230,10,5,49846,15,23.25888921888938,-1.2285835,36.8826468,-1.3077163,36.8043786,102,1616,256,1887
19943,24049,393,3,Business,30,5,38555,30,5,40379,30,5,40386,30,5,42009,30,5,43213,10,23.5,-1.3177547,36.8303703,-1.2574219,36.7927073,39,1204,1824,1630
19944,21563,868,3,Business,27,6,44804,27,6,44924,27,6,45466,27,6,46486,27,6,46489,6,23.25888921888938,-1.3033561,36.8163631,-1.265715,36.823815,19,3,120,1562
19945,26872,111,3,Business,12,5,50728,12,5,50884,12,5,51590,12,5,52107,12,5,53353,10,23.25888921888938,-1.2551895,36.7822034,-1.2998419,36.8440241,843,1246,156,1223
19946,3919,893,3,Business,7,4,46402,7,4,46454,7,4,47288,7,4,47487,7,4,48116,8,27.7,-1.2663194,36.809901,-1.2455906,36.8174969,315,629,52,1033
19947,15869,1500,3,Business,22,5,37200,22,5,37253,22,5,37423,22,5,38642,22,5,39570,5,28.7,-1.2638185,36.7930057,-1.2614075,36.8140444,343,928,53,1389
19948,13950,3091,3,Business,30,5,47399,30,5,47404,30,5,47408,30,5,48150,30,5,48883,4,23.7,-1.3012008,36.764868,-1.2980272,36.7838837,786,733,5,746
19949,26480,478,3,Business,19,3,40974,19,3,43567,19,3,44776,19,3,44888,19,3,45865,4,22.3,-1.2844516,36.8245932,-1.2571472,36.7950633,660,977,2593,1321
19950,15028,2719,1,Business,5,3,51615,5,3,51812,5,3,52669,5,3,53577,5,3,54438,7,23.7,-1.3323107,36.8692616,-1.3244885,36.897792,330,861,197,1765
19951,18334,1271,3,Business,6,5,46851,6,5,46882,6,5,47662,6,5,48215,6,5,50303,16,20.2,-1.3205669,36.8362168,-1.2598589,36.7470168,791,2088,31,1333
19952,13295,3635,1,Business,4,4,53042,4,4,53078,4,4,53935,4,4,54002,4,4,54567,3,25.0,-1.2584143,36.8048002,-1.2615888,36.7928732,72,565,36,924
19953,22442,817,3,Personal,8,3,43975,8,3,43990,8,3,44677,8,3,44959,8,3,45976,6,22.0,-1.2636814,36.8029965,-1.2894633,36.764223,932,1017,15,969
19954,11276,2066,3,Business,1,3,57687,1,3,57748,1,3,58944,1,3,59136,1,3,62805,17,24.1,-1.316961,36.820337,-1.2541369,36.7564045,672,3669,61,1388
19955,8117,1730,1,Personal,9,4,43162,9,4,43262,9,4,43950,9,4,44408,9,4,45145,5,23.7,-1.263453,36.7955612,-1.2795197,36.8168287,857,737,100,1146
19956,15034,2756,3,Business,17,3,55022,17,3,55589,17,3,56132,17,3,56207,17,3,57924,6,23.25888921888938,-1.2814609,36.8265932,-1.2879691,36.7803495,790,1717,567,618
19957,20429,2987,3,Business,3,1,36606,3,1,36905,3,1,38938,3,1,39165,3,1,40582,3,22.1,-1.270212,36.8210877,-1.2870774,36.8259832,531,1417,299,2260
19958,9863,402,3,Business,21,2,66097,21,2,66257,21,2,67140,21,2,67203,21,2,69152,6,24.1,-1.2527958,36.8003131,-1.290894,36.822971,139,1949,160,946
19959,19244,2504,3,Business,28,2,42902,28,2,42907,28,2,43738,28,2,44281,28,2,44787,5,17.4,-1.328259,36.860975,-1.3332749,36.8708147,213,506,5,1374
19960,14956,2159,3,Business,20,4,49212,20,4,49227,20,4,49574,20,4,55282,20,4,56665,11,28.1,-1.304735,36.7846054,-1.3112651,36.8495898,882,1383,15,6055
19961,21271,633,3,Business,1,5,48460,1,5,48533,1,5,49095,1,5,49182,1,5,49687,4,31.7,-1.3077869,36.8443207,-1.3004062,36.829741,728,505,73,649
19962,18784,1131,3,Business,30,4,58262,30,4,58262,30,4,58283,30,4,59874,30,4,60119,13,23.25888921888938,-1.2156006,36.8916865,-1.207546,36.7913976,193,245,0,1612
19963,20122,1500,3,Business,27,2,46957,27,2,56165,27,2,57529,27,2,57795,27,2,58831,10,25.8,-1.2991441,36.7528804,-1.2574219,36.7927073,958,1036,9208,1630
19964,22300,1807,3,Business,29,3,37057,29,3,37072,29,3,37964,29,3,38132,29,3,39013,5,18.5,-1.2682478,36.8072852,-1.2640571,36.7883547,400,881,15,1060
19965,15480,3554,3,Personal,24,4,44346,24,4,44402,24,4,45264,24,4,46888,24,4,49869,14,21.0,-1.2656584,36.8096257,-1.3301799,36.8575241,479,2981,56,2486
19966,23943,3647,3,Business,14,2,55547,14,2,55568,14,2,56339,14,2,56730,14,2,57331,4,23.25888921888938,-1.2762743,36.8152789,-1.272639,36.794723,770,601,21,1162
19967,25812,2523,3,Business,6,3,45767,6,3,45777,6,3,45900,6,3,46183,6,3,48193,17,22.6,-1.2551895,36.7822034,-1.3117864,36.6973045,576,2010,10,406
19968,25411,2523,3,Business,2,2,32927,2,2,32981,2,2,33109,2,2,33493,2,2,35149,9,20.4,-1.2551895,36.7822034,-1.3015661,36.8239003,177,1656,54,512
19969,7604,2896,3,Business,22,4,54684,22,4,56156,22,4,58423,22,4,59514,22,4,61339,12,26.6,-1.3338005,36.863026,-1.2715686,36.8023526,882,1825,1472,3358
19970,9586,1249,3,Business,1,1,61127,1,1,61143,1,1,61402,1,1,63613,1,1,63614,11,27.4,-1.3681253,36.9155298,-1.3189252,36.8617269,613,1,16,2470
19971,12387,265,3,Business,3,5,36586,3,5,37114,3,5,39900,3,5,40733,3,5,43599,4,23.25888921888938,-1.300921,36.828195,-1.2788182,36.8206683,155,2866,528,3619
19972,16075,3232,3,Business,25,4,60976,25,4,61006,25,4,61107,25,4,62134,25,4,63991,16,23.25888921888938,-1.2551895,36.7822034,-1.2156006,36.8916865,137,1857,30,1128
19973,5566,1461,2,Personal,3,5,31587,3,5,31620,3,5,32124,3,5,32398,3,5,33766,13,17.3,-1.2720769,36.8180604,-1.3099584,36.7323644,414,1368,33,778
19974,26699,136,3,Business,6,2,63581,6,2,63589,6,2,63676,6,2,64038,6,2,67288,18,23.25888921888938,-1.3326173,36.7146233,-1.256958,36.8144929,45,3250,8,449
19975,22227,3326,3,Business,13,4,58418,13,4,58495,13,4,58814,13,4,59486,13,4,61673,8,23.0,-1.2551895,36.7822034,-1.292278,36.797718,259,2187,77,991
19976,22965,2066,3,Business,1,5,42105,1,5,42190,1,5,42695,1,5,43025,1,5,43966,7,28.7,-1.3210189,36.8410551,-1.3429626,36.8816956,411,941,85,835
19977,1722,265,3,Business,20,2,45922,20,2,46148,20,2,47657,20,2,48746,20,2,51555,7,24.0,-1.2600932,36.8041689,-1.300921,36.828195,916,2809,226,2598
19978,4727,2700,1,Business,16,6,55411,16,6,55470,16,6,55827,16,6,56450,16,6,57031,8,23.1,-1.255956,36.772901,-1.2780963,36.8274099,925,581,59,980
19979,18834,1850,3,Business,13,1,55020,13,1,55099,13,1,55559,13,1,56865,13,1,57382,7,23.25888921888938,-1.2571472,36.7950633,-1.3047132,36.8089553,106,517,79,1766
19980,17207,1329,3,Business,16,6,56168,16,6,56242,16,6,56840,16,6,57171,16,6,58394,7,23.25888921888938,-1.273056,36.811298,-1.3112893,36.8201664,461,1223,74,929
19981,11458,2373,1,Personal,28,4,39525,28,4,39562,28,4,41003,28,4,41068,28,4,43635,22,23.25888921888938,-1.2789537,36.8286392,-1.228357,36.6708601,494,2567,37,1506
19982,14903,1271,3,Business,13,3,36557,13,3,36565,13,3,36571,13,3,38606,13,3,39389,15,24.8,-1.3244885,36.897792,-1.2224188,36.8868824,874,783,8,2041
19983,22708,733,3,Business,9,2,57065,9,2,57156,9,2,58304,9,2,58372,9,2,62788,8,30.7,-1.2551895,36.7822034,-1.2915263,36.7950075,523,4416,91,1216
19984,19989,393,3,Business,18,4,35480,18,4,35491,18,4,35498,18,4,36344,18,4,38241,14,23.25888921888938,-1.3167113,36.8301563,-1.2991441,36.7528804,349,1897,11,853
19985,28001,3686,3,Business,3,5,56967,3,5,57156,3,5,57512,3,5,57637,3,5,58474,4,23.25888921888938,-1.2551895,36.7822034,-1.25896,36.8016691,206,837,189,481
19986,17125,3647,3,Business,2,2,44982,2,2,46678,2,2,47873,2,2,48444,2,2,50327,7,26.3,-1.272639,36.794723,-1.282772,36.8259993,96,1883,1696,1766
19987,679,2688,2,Personal,14,1,63511,14,1,63993,14,1,64938,14,1,65042,14,1,65374,4,23.2,-1.2914606,36.7712107,-1.271983,36.796063,919,332,482,1049
19988,22038,184,1,Personal,9,1,59740,9,1,59803,9,1,60233,9,1,61154,9,1,62047,6,20.4,-1.2879697,36.8020506,-1.3240024,36.8119022,312,893,63,1351
19989,23125,3681,1,Personal,6,5,56752,6,5,56762,6,5,57220,6,5,58127,6,5,62156,19,22.4,-1.2945798,36.7737755,-1.2145231,36.8944761,192,4029,10,1365
19990,17058,426,3,Business,25,2,44985,25,2,44992,25,2,45775,25,2,46051,25,2,47983,15,23.7,-1.3323107,36.8692616,-1.2969741,36.7856612,543,1932,7,1059
19991,3240,2931,3,Business,21,2,33297,21,2,33353,21,2,33750,21,2,33857,21,2,36714,15,23.25888921888938,-1.2452664,36.8028541,-1.3231725,36.8640177,547,2857,56,504
19992,19752,3017,3,Business,21,2,73792,21,2,80939,21,2,81276,21,2,81452,21,2,81552,5,16.0,-1.299313,36.7831488,-1.307198,36.7502243,517,100,7147,513
19993,8937,2216,3,Business,1,4,46781,1,4,46812,1,4,47325,1,4,47539,1,4,49285,18,23.25888921888938,-1.2551895,36.7822034,-1.2198413,36.9054958,470,1746,31,727
19994,19044,635,3,Business,24,5,30204,24,5,30217,24,5,30512,24,5,30989,24,5,32684,10,15.9,-1.2599563,36.7993439,-1.3000862,36.7512967,116,1695,13,772
19995,9303,53,3,Business,28,4,36566,28,4,36613,28,4,37361,28,4,37720,28,4,39236,11,19.7,-1.2991441,36.7528804,-1.2770708,36.8231093,156,1516,47,1107
19996,4715,201,3,Business,20,1,51664,20,1,51800,20,1,52175,20,1,52814,20,1,54562,7,23.25888921888938,-1.2897368,36.8226783,-1.2571472,36.7950633,659,1748,136,1014
19997,574,436,1,Personal,31,4,38733,31,4,38741,31,4,39210,31,4,39915,31,4,41704,19,21.9,-1.2946528,36.8153656,-1.351703,36.907065,101,1789,8,1174
19998,8599,2207,3,Business,22,5,44663,22,5,44763,22,5,45786,22,5,46413,22,5,47146,2,28.6,-1.2682478,36.8072852,-1.2696908,36.81519,448,733,100,1650
19999,22465,2987,3,Business,15,1,55343,15,1,56094,15,1,56539,15,1,57532,15,1,58417,4,23.25888921888938,-1.270212,36.8210877,-1.260232,36.807334,519,885,751,1438
20000,7954,1188,1,Personal,4,1,36867,4,1,36919,4,1,37291,4,1,37405,4,1,38296,8,18.0,-1.2791714,36.8255997,-1.3277532,36.8297901,360,891,52,486
20001,1654,393,3,Business,29,5,50152,29,5,50174,29,5,51020,29,5,51682,29,5,53364,8,29.1,-1.3167113,36.8301563,-1.2770708,36.8231093,910,1682,22,1508
20002,19192,1107,2,Personal,16,4,52272,16,4,52287,16,4,52755,16,4,53077,16,4,55703,11,18.9,-1.2728058,36.8049903,-1.3339461,36.8219129,409,2626,15,790
20003,16385,2330,3,Business,1,1,53161,1,1,53295,1,1,54182,1,1,54389,1,1,56200,11,23.25888921888938,-1.293082,36.8278578,-1.233018,36.8004477,272,1811,134,1094
20004,684,136,3,Business,13,2,55179,13,2,55640,13,2,56353,13,2,56795,13,2,58248,8,26.1,-1.3014461,36.7661381,-1.3326173,36.7146233,612,1453,461,1155
20005,23341,2377,3,Personal,9,6,36302,9,6,36357,9,6,36815,9,6,37506,9,6,38352,4,20.9,-1.3083443,36.833289,-1.3173869,36.8112044,956,846,55,1149
20006,21681,1047,3,Personal,5,5,37125,5,5,38228,5,5,38786,5,5,38895,5,5,39942,9,23.7,-1.3077869,36.8443207,-1.269534,36.80697,178,1047,1103,667
20007,1639,3283,3,Business,20,1,48809,20,1,48876,20,1,49350,20,1,50325,20,1,51134,5,23.25888921888938,-1.2600926,36.8088685,-1.2628473,36.781805,183,809,67,1449
20008,8130,391,3,Business,15,1,58268,15,1,59227,15,1,59466,15,1,60452,15,1,62191,5,23.25888921888938,-1.2599563,36.7993439,-1.2784063,36.8222933,88,1739,959,1225
20009,23418,2763,3,Business,9,4,56111,9,4,57143,9,4,57214,9,4,57599,9,4,59962,8,23.25888921888938,-1.2551895,36.7822034,-1.2934638,36.7668028,177,2363,1032,456
20010,6779,1816,1,Business,16,1,52931,16,1,52963,16,1,53533,16,1,53631,16,1,54415,5,22.4,-1.296684,36.770172,-1.3028391,36.7951112,140,784,32,668
20011,23560,3147,3,Business,20,2,54925,20,2,58112,20,2,58541,20,2,58751,20,2,61698,17,23.8,-1.3472066,36.7692638,-1.2551895,36.7822034,875,2947,3187,639
20012,23657,2154,3,Business,14,4,47082,14,4,49102,14,4,50014,14,4,51391,14,4,51876,6,27.7,-1.2859912,36.8756811,-1.2765736,36.8513646,377,485,2020,2289
20013,12640,3222,3,Business,25,1,35543,25,1,35564,25,1,35765,25,1,35870,25,1,37194,10,23.25888921888938,-1.2551895,36.7822034,-1.3108783,36.8392726,958,1324,21,306
20014,26776,393,3,Business,10,4,36880,10,4,36915,10,4,37050,10,4,37471,10,4,38906,11,19.3,-1.3167113,36.8301563,-1.2574219,36.7927073,523,1435,35,556
20015,16405,1329,3,Business,9,6,41397,9,6,41427,9,6,43261,9,6,43406,9,6,45093,14,24.9,-1.273056,36.811298,-1.3446058,36.7605178,660,1687,30,1979
20016,3244,640,3,Business,17,1,36931,17,1,36962,17,1,37215,17,1,37702,17,1,40159,10,18.3,-1.304033,36.7848695,-1.2625087,36.8263725,409,2457,31,740
20017,24750,2030,3,Business,18,4,56609,18,4,57369,18,4,58529,18,4,58692,18,4,59400,3,23.25888921888938,-1.304735,36.7846054,-1.295908,36.791433,548,708,760,1323
20018,1244,3647,3,Business,27,3,60681,27,3,60729,27,3,61449,27,3,61714,27,3,62933,7,27.6,-1.272639,36.794723,-1.3039771,36.8187071,669,1219,48,985
20019,2442,1721,3,Business,30,2,46878,30,2,47615,30,2,50508,30,2,50572,30,2,51970,9,23.25888921888938,-1.2551895,36.7822034,-1.304023,36.788389,938,1398,737,2957
20020,11096,2532,3,Business,18,1,33420,18,1,33609,18,1,33658,18,1,33815,18,1,34746,8,14.8,-1.2551895,36.7822034,-1.2941849,36.7895754,379,931,189,206
20021,6994,1687,3,Business,20,2,35272,20,2,37290,20,2,39835,20,2,39935,20,2,41617,4,19.6,-1.2626574,36.8014034,-1.2895261,36.8164407,585,1682,2018,2645
20022,28058,3686,3,Business,2,5,52749,2,5,52804,2,5,53015,2,5,53372,2,5,53949,4,25.3,-1.2551895,36.7822034,-1.2737013,36.8069122,720,577,55,568
20023,24758,633,3,Business,20,3,55482,20,3,55518,20,3,55612,20,3,56233,20,3,56802,4,28.5,-1.3077869,36.8443207,-1.3004062,36.829741,576,569,36,715
20024,23721,1500,3,Business,16,2,39928,16,2,43706,16,2,44327,16,2,46660,16,2,47841,8,23.25888921888938,-1.3004062,36.829741,-1.2638185,36.7930057,843,1181,3778,2954
20025,2374,3345,1,Personal,7,6,56017,7,6,56055,7,6,56205,7,6,56994,7,6,57898,6,21.3,-1.3043821,36.7840586,-1.269974,36.7753728,449,904,38,939
20026,23321,1544,3,Business,10,1,57251,10,1,58895,10,1,60157,10,1,60477,10,1,65114,11,18.9,-1.2791224,36.8306878,-1.2805395,36.890386,821,4637,1644,1582
20027,14111,1502,3,Business,25,1,64599,25,1,64632,25,1,64916,25,1,65311,25,1,66896,13,27.4,-1.2527958,36.8003131,-1.2232123,36.8932547,72,1585,33,679
20028,16028,2514,3,Business,26,5,33066,26,5,33124,26,5,33435,26,5,33848,26,5,34123,1,23.25888921888938,-1.266294,36.8057971,-1.2684667,36.8002891,875,275,58,724
20029,18919,2423,3,Business,9,2,53632,9,2,53675,9,2,54782,9,2,54945,9,2,55539,4,22.6,-1.2551895,36.7822034,-1.2753109,36.8130185,38,594,43,1270
20030,27417,635,3,Business,10,1,37703,10,1,37746,10,1,38016,10,1,42125,10,1,43284,8,23.6,-1.3016417,36.8271679,-1.2599563,36.7993439,849,1159,43,4379
20031,3976,1874,3,Business,20,2,41731,20,2,42142,20,2,42527,20,2,42965,20,2,45095,8,19.6,-1.2571472,36.7950633,-1.2964591,36.7776175,268,2130,411,823
20032,20991,1721,3,Business,25,5,33088,25,5,33161,25,5,34704,25,5,35672,25,5,37137,6,20.9,-1.2551895,36.7822034,-1.2560865,36.829677,489,1465,73,2511
20033,15948,3398,3,Business,6,4,58056,6,4,63053,6,4,63700,6,4,64266,6,4,66634,17,22.8,-1.3169591,36.7000029,-1.259919,36.808244,187,2368,4997,1213
20034,6282,635,3,Business,25,6,37974,25,6,37997,25,6,38907,25,6,39622,25,6,40709,5,23.25888921888938,-1.2780878,36.8469436,-1.3081376,36.8329772,158,1087,23,1625
20035,8995,989,2,Personal,7,5,58878,7,5,58899,7,5,59414,7,5,59757,7,5,60968,14,22.0,-1.2936372,36.7698422,-1.2950846,36.6860688,644,1211,21,858
20036,27273,1244,3,Business,13,6,33823,13,6,33851,13,6,34408,13,6,35644,13,6,37217,16,19.8,-1.228911,36.881876,-1.303596,36.778378,8,1573,28,1793
20037,27005,393,3,Business,30,2,35016,30,2,35035,30,2,35333,30,2,36575,30,2,37079,6,23.25888921888938,-1.3167113,36.8301563,-1.3077869,36.8443207,843,504,19,1540
20038,18218,1075,3,Business,21,4,43247,21,4,43296,21,4,44029,21,4,44370,21,4,45594,6,25.1,-1.2527958,36.8003131,-1.2629461,36.7653137,138,1224,49,1074
20039,2828,2801,3,Business,27,3,44694,27,3,44716,27,3,45189,27,3,45441,27,3,47014,11,25.9,-1.2674274,36.7870827,-1.3090727,36.8315262,177,1573,22,725
20040,4487,1724,3,Business,25,4,31399,25,4,31427,25,4,32104,25,4,32322,25,4,33241,8,23.25888921888938,-1.2907854,36.7774108,-1.2551895,36.7822034,663,919,28,895
20041,8402,2801,3,Business,4,2,45434,4,2,47908,4,2,47912,4,2,50016,4,2,51089,10,24.0,-1.307726,36.839117,-1.2595422,36.7871178,813,1073,2474,2108
20042,18303,1966,3,Business,12,3,37910,12,3,38761,12,3,39497,12,3,42242,12,3,44388,11,19.5,-1.3700383,36.9190174,-1.3239211,36.8707656,436,2146,851,3481
20043,20595,2030,3,Business,20,3,46275,20,3,46381,20,3,47270,20,3,48352,20,3,48749,1,20.4,-1.289498,36.818878,-1.2814452,36.8253735,5,397,106,1971
20044,24426,1148,3,Business,25,2,52717,25,2,52789,25,2,53569,25,2,54490,25,2,56129,11,27.3,-1.3100586,36.8500329,-1.2748221,36.7817865,753,1639,72,1701
20045,15689,1754,3,Business,28,4,36733,28,4,36739,28,4,36744,28,4,37013,28,4,37967,12,23.25888921888938,-1.2860183,36.8975338,-1.325469,36.862403,408,954,6,274
20046,3676,2306,3,Business,6,3,39519,6,3,39594,6,3,41072,6,3,41458,6,3,43226,13,22.5,-1.2271998,36.8084905,-1.2945128,36.8396881,937,1768,75,1864
20047,10288,429,3,Personal,29,5,52790,29,5,52906,29,5,54107,29,5,54266,29,5,56846,11,21.2,-1.2633494,36.7959696,-1.3258649,36.8000584,208,2580,116,1360
20048,14876,2330,3,Business,10,5,58988,10,5,59207,10,5,60101,10,5,61284,10,5,62484,6,23.25888921888938,-1.2645318,36.7981775,-1.2464559,36.8169857,126,1200,219,2077
20049,27677,1856,3,Business,16,3,44405,16,3,44725,16,3,47108,16,3,47428,16,3,48931,6,23.8,-1.273009,36.802807,-1.2930705,36.8279433,100,1503,320,2703
20050,21965,3565,3,Business,27,7,57041,27,7,57954,27,7,59381,27,7,60359,27,7,61939,16,21.9,-1.214328,36.7911903,-1.2844665,36.7866113,103,1580,913,2405
20051,16714,1471,3,Business,15,5,44974,15,5,44986,15,5,45725,15,5,45973,15,5,51780,3,26.6,-1.2551895,36.7822034,-1.2652279,36.8020159,290,5807,12,987
20052,20065,970,3,Business,13,4,36704,13,4,36737,13,4,36998,13,4,37070,13,4,38377,3,18.3,-1.2551895,36.7822034,-1.2629594,36.8077626,362,1307,33,333
20053,4086,3517,3,Business,29,5,37682,29,5,38107,29,5,39520,29,5,40810,29,5,42923,24,26.8,-1.300921,36.828195,-1.2573831,36.9830159,411,2113,425,2703
20054,7603,2190,3,Business,10,5,59983,10,5,60003,10,5,60051,10,5,60940,10,5,63450,20,21.0,-1.301953,36.788458,-1.3664581,36.9177807,215,2510,20,937
20055,4034,2454,3,Business,19,3,43555,19,3,43596,19,3,43654,19,3,45500,19,3,45804,4,23.25888921888938,-1.2804664,36.7701111,-1.2993231,36.7753372,179,304,41,1904
20056,16854,3291,3,Business,20,3,56336,20,3,57044,20,3,57581,20,3,58734,20,3,59337,4,29.4,-1.272828,36.816608,-1.2600926,36.8088685,780,603,708,1690
20057,8307,781,3,Business,28,5,38926,28,5,38948,28,5,39292,28,5,39875,28,5,41350,8,24.9,-1.2696908,36.81519,-1.322064,36.817157,726,1475,22,927
20058,3947,1209,3,Business,9,6,30842,9,6,30854,9,6,30980,9,6,32178,9,6,32593,4,19.9,-1.3228003,36.8306435,-1.3004062,36.829741,523,415,12,1324
20059,14980,3283,3,Business,17,3,55692,17,3,55756,17,3,56865,17,3,57295,17,3,58157,6,23.25888921888938,-1.272828,36.816608,-1.2628473,36.781805,161,862,64,1539
20060,23249,1363,3,Business,28,2,54948,28,2,56059,28,2,56090,28,2,56285,28,2,58108,3,23.7,-1.3004062,36.829741,-1.281223,36.8239,686,1823,1111,226
20061,18922,3320,3,Business,2,5,50922,2,5,51830,2,5,51833,2,5,52641,2,5,53594,8,25.0,-1.3080092,36.8284543,-1.271823,36.789215,874,953,908,811
20062,5933,2007,1,Business,22,5,39262,22,5,39422,22,5,41394,22,5,41946,22,5,43279,7,21.9,-1.282543,36.824618,-1.2579304,36.8019667,124,1333,160,2524
20063,24823,533,3,Business,24,1,35818,24,1,35828,24,1,35984,24,1,36405,24,1,36898,6,15.6,-1.2551895,36.7822034,-1.2765492,36.7669809,38,493,10,577
20064,26101,1531,1,Personal,16,2,66376,16,2,66431,16,2,67371,16,2,67705,16,2,70597,14,25.2,-1.2547265,36.7540908,-1.3106473,36.7308954,116,2892,55,1274
20065,20967,265,3,Business,16,2,40944,16,2,41008,16,2,41667,16,2,41823,16,2,43129,8,23.7,-1.29276,36.783799,-1.300921,36.828195,62,1306,64,815
20066,11374,2701,3,Business,22,4,35630,22,4,36180,22,4,37931,22,4,39057,22,4,40994,5,22.4,-1.290894,36.822971,-1.2765736,36.8513646,247,1937,550,2877
20067,6507,136,3,Business,23,5,46461,23,5,47896,23,5,48603,23,5,48726,23,5,50866,22,26.3,-1.3326173,36.7146233,-1.3332749,36.8708147,219,2140,1435,830
20068,21611,649,1,Business,19,4,40493,19,4,40553,19,4,40869,19,4,41786,19,4,42570,9,20.1,-1.3034396,36.8329998,-1.2551895,36.7822034,629,784,60,1233
20069,2942,2102,3,Business,28,2,51852,28,2,51947,28,2,52812,28,2,52949,28,2,55474,16,23.4,-1.3323107,36.8692616,-1.2581932,36.8152763,233,2525,95,1002
20070,14747,2439,1,Business,5,2,58851,5,2,59167,5,2,59364,5,2,59796,5,2,62900,7,21.3,-1.2805198,36.8277612,-1.2615888,36.7928732,925,3104,316,629
20071,3912,909,3,Business,29,6,55907,29,6,55948,29,6,56481,29,6,57144,29,6,58410,11,26.7,-1.28878,36.8168312,-1.225322,36.80855,489,1266,41,1196
20072,9667,3689,3,Business,26,1,57141,26,1,57515,26,1,57701,26,1,58021,26,1,59154,3,22.2,-1.2527958,36.8003131,-1.2551895,36.7822034,216,1133,374,506
20073,15910,296,3,Business,8,5,46729,8,5,46835,8,5,49286,8,5,49566,8,5,52489,9,27.3,-1.2976854,36.7753586,-1.2571472,36.7950633,244,2923,106,2731
20074,18997,2112,3,Business,24,1,38029,24,1,38048,24,1,39231,24,1,40073,24,1,40687,4,22.4,-1.2297202,36.8819507,-1.2156006,36.8916865,320,614,19,2025
20075,22009,3331,3,Business,11,2,39508,11,2,47584,11,2,49746,11,2,49841,11,2,52192,10,22.5,-1.2551895,36.7822034,-1.2363748,36.8177502,755,2351,8076,2257
20076,12574,2982,3,Business,7,3,34132,7,3,34142,7,3,34155,7,3,36960,7,3,37179,16,23.25888921888938,-1.300921,36.828195,-1.2155671,36.8898931,70,219,10,2818
20077,115,1898,3,Personal,18,4,51865,18,4,51926,18,4,52413,18,4,53887,18,4,55177,11,26.9,-1.2988291,36.7795686,-1.3181843,36.8394827,568,1290,61,1961
20078,18947,867,3,Business,9,6,32717,9,6,32775,9,6,33962,9,6,34657,9,6,36438,10,20.2,-1.3004062,36.829741,-1.2991441,36.7528804,468,1781,58,1882
20079,5127,1280,3,Business,6,3,44392,6,3,44457,6,3,45800,6,3,45936,6,3,48706,9,23.25888921888938,-1.2551895,36.7822034,-1.287079,36.7811277,817,2770,65,1479
20080,16495,2714,1,Personal,11,1,61045,11,1,61239,11,1,62824,11,1,63234,11,1,65193,12,20.9,-1.3043821,36.7840586,-1.3518598,36.7324661,614,1959,194,1995
20081,9697,1882,1,Business,1,6,33308,1,6,33348,1,6,34078,1,6,34378,1,6,36421,17,15.0,-1.2268871,36.8073946,-1.2156006,36.8916865,453,2043,40,1030
20082,25912,2982,3,Business,10,5,48709,10,5,48876,10,5,48915,10,5,51666,10,5,54351,14,23.25888921888938,-1.300921,36.828195,-1.221085,36.8587279,661,2685,167,2790
20083,13642,2523,3,Business,6,4,34854,6,4,35102,6,4,38158,6,4,38898,6,4,43019,16,24.2,-1.2551895,36.7822034,-1.3194518,36.869396,101,4121,248,3796
20084,20618,1787,3,Business,4,1,47595,4,1,48112,4,1,48733,4,1,49264,4,1,50590,11,23.25888921888938,-1.2793686,36.8259233,-1.2283403,36.8822756,341,1326,517,1152
20085,23738,633,3,Business,7,4,32414,7,4,32443,7,4,33467,7,4,33675,7,4,34805,4,23.25888921888938,-1.3077869,36.8443207,-1.3004062,36.829741,106,1130,29,1232
20086,21577,3295,3,Business,21,3,57468,21,3,57727,21,3,57789,21,3,58400,21,3,59566,5,23.3,-1.2571472,36.7950633,-1.2645258,36.7683387,227,1166,259,673
20087,28194,2523,3,Business,22,4,51926,22,4,52284,22,4,52287,22,4,52919,22,4,53445,5,26.3,-1.2551895,36.7822034,-1.2585695,36.7697546,450,526,358,635
20088,563,2509,3,Business,4,5,44223,4,5,44239,4,5,44241,4,5,44814,4,5,49412,20,17.5,-1.2571472,36.7950633,-1.3700383,36.9190174,932,4598,16,575
20089,15965,2803,3,Business,5,5,33081,5,5,33947,5,5,34514,5,5,35444,5,5,36027,3,17.7,-1.2765736,36.8513646,-1.2689599,36.8398401,584,583,866,1497
20090,10492,1148,3,Business,8,5,52830,8,5,52919,8,5,53346,8,5,53668,8,5,54837,5,27.2,-1.3100586,36.8500329,-1.2960687,36.8167909,148,1169,89,749
20091,20932,1183,3,Personal,25,5,55483,25,5,55493,25,5,55609,25,5,56301,25,5,57645,12,29.3,-1.2551895,36.7822034,-1.320157,36.830887,871,1344,10,808
20092,9704,3582,3,Business,8,1,53311,8,1,53590,8,1,53847,8,1,54761,8,1,55644,10,29.5,-1.2384056,36.8718698,-1.2629818,36.8135865,75,883,279,1171
20093,2105,296,1,Personal,9,1,43728,9,1,43766,9,1,44029,9,1,44381,9,1,46060,7,20.1,-1.2772632,36.7922251,-1.2962731,36.8111863,334,1679,38,615
20094,27136,3115,3,Business,6,1,67672,6,1,67691,6,1,68138,6,1,70034,6,1,70697,2,23.25888921888938,-1.2969741,36.7856612,-1.2963097,36.7688221,155,663,19,2343
20095,12344,1746,3,Business,22,3,55730,22,3,55905,22,3,58565,22,3,60344,22,3,62111,8,23.0,-1.2893219,36.8401475,-1.296797,36.7764525,452,1767,175,4439
20096,6533,133,1,Personal,25,6,42516,25,6,42519,25,6,43086,25,6,43559,25,6,44611,4,23.25888921888938,-1.2678814,36.8157574,-1.2728069,36.7962362,882,1052,3,1040
20097,12418,2412,3,Business,8,3,50669,8,3,50726,8,3,51214,8,3,51752,8,3,55728,23,23.25888921888938,-1.339046,36.762596,-1.2283403,36.8822756,533,3976,57,1026
20098,5178,2454,3,Business,22,2,52041,22,2,52186,22,2,53384,22,2,53620,22,2,55637,15,25.4,-1.2219929,36.8349924,-1.2993231,36.7753372,660,2017,145,1434
20099,219,3674,3,Business,26,2,35404,26,2,35482,26,2,36328,26,2,36513,26,2,38070,6,23.25888921888938,-1.2551895,36.7822034,-1.2765641,36.793782,829,1557,78,1031
20100,21039,2212,3,Business,28,3,35504,28,3,36960,28,3,37765,28,3,38367,28,3,39746,7,23.25888921888938,-1.2544652,36.7599194,-1.2571472,36.7950633,268,1379,1456,1407
20101,25491,1336,3,Business,27,3,49860,27,3,50091,27,3,50821,27,3,54917,27,3,54931,9,29.4,-1.2885029,36.825605,-1.3263105,36.8622904,613,14,231,4826
20102,23634,1245,3,Business,31,5,48514,31,5,54774,31,5,54778,31,5,57301,31,5,57706,19,24.6,-1.300921,36.828195,-1.3198615,36.7110323,41,405,6260,2527
20103,21456,835,3,Business,9,2,38146,9,2,38156,9,2,38734,9,2,38837,9,2,40837,20,27.2,-1.2917868,36.7872675,-1.3700383,36.9190174,548,2000,10,681
20104,8906,2358,4,Business,5,5,43796,5,5,43904,5,5,44730,5,5,46163,5,5,47359,5,23.8,-1.302222,36.75873,-1.2812549,36.7236622,565,1196,108,2259
20105,26273,1304,3,Business,17,4,53447,17,4,53492,17,4,54164,17,4,54542,17,4,55065,3,23.9,-1.2626906,36.7827022,-1.2655477,36.8001682,742,523,45,1050
20106,7246,265,3,Business,22,5,40882,22,5,40892,22,5,40925,22,5,45256,22,5,45673,13,23.25888921888938,-1.300921,36.828195,-1.2353665,36.8128044,137,417,10,4364
20107,1296,867,3,Business,28,3,35740,28,3,36176,28,3,36530,28,3,36984,28,3,39847,14,20.2,-1.306378,36.7519845,-1.3177547,36.8303703,523,2863,436,808
20108,11433,391,3,Business,7,4,50461,7,4,50952,7,4,54546,7,4,55934,7,4,57278,5,31.1,-1.300921,36.828195,-1.2867454,36.8259017,590,1344,491,4982
20109,28035,419,3,Business,7,4,45443,7,4,45835,7,4,46460,7,4,47975,7,4,49346,7,24.3,-1.2571472,36.7950633,-1.3012173,36.8093987,576,1371,392,2140
20110,22828,173,3,Business,12,1,34986,12,1,35013,12,1,35131,12,1,35568,12,1,35790,2,19.2,-1.303806,36.783041,-1.2993231,36.7753372,786,222,27,555
20111,17115,1798,3,Business,28,5,52449,28,5,52930,28,5,53261,28,5,53655,28,5,58095,31,25.4,-1.2615888,36.7928732,-1.1055559,36.6402664,449,4440,481,725
20112,5619,1809,3,Business,23,5,51455,23,5,51517,23,5,53070,23,5,53860,23,5,58671,15,26.4,-1.2571472,36.7950633,-1.3463042,36.768164,383,4811,62,2343
20113,19969,635,3,Business,24,3,43448,24,3,43774,24,3,45186,24,3,47457,24,3,50109,7,19.7,-1.3016417,36.8271679,-1.2599563,36.7993439,722,2652,326,3683
20114,8217,3066,1,Personal,14,1,36775,14,1,36814,14,1,36866,14,1,38039,14,1,39144,10,22.8,-1.2791763,36.8257709,-1.2945319,36.7618945,100,1105,39,1225
20115,4601,1721,3,Business,3,1,54882,3,1,54953,3,1,55369,3,1,55836,3,1,57513,14,23.2,-1.2551895,36.7822034,-1.2558721,36.7101188,856,1677,71,883
20116,26737,2801,3,Business,8,3,51030,8,3,51138,8,3,51580,8,3,51962,8,3,52849,8,23.25888921888938,-1.2653185,36.8358841,-1.2674274,36.7870827,338,887,108,824
20117,20404,3727,3,Business,7,4,56712,7,4,56756,7,4,57269,7,4,57522,7,4,59047,8,31.1,-1.2963097,36.7688221,-1.2600616,36.7870182,698,1525,44,766
20118,4340,1725,1,Business,2,4,51051,2,4,51144,2,4,51627,2,4,51753,2,4,52816,5,26.3,-1.2652108,36.8056075,-1.2903067,36.8151026,754,1063,93,609
20119,26591,3647,3,Business,15,5,32949,15,5,32992,15,5,34831,15,5,34893,15,5,39289,18,20.4,-1.272639,36.794723,-1.3073803,36.6825842,4,4396,43,1901
20120,27671,592,1,Personal,12,4,54982,12,4,55240,12,4,55286,12,4,56982,12,4,60689,11,21.5,-1.2884354,36.7606766,-1.3100117,36.8226483,672,3707,258,1742
20121,22777,1927,3,Business,2,2,46675,2,2,46690,2,2,47305,2,2,47462,2,2,49902,20,26.2,-1.3472066,36.7692638,-1.2927792,36.9053492,763,2440,15,772
20122,9659,2763,3,Business,9,4,58872,9,4,58896,9,4,59535,9,4,59970,9,4,61147,7,23.2,-1.2551895,36.7822034,-1.2885417,36.8100523,229,1177,24,1074
20123,8087,633,3,Business,22,5,48263,22,5,48298,22,5,48301,22,5,49941,22,5,49945,9,30.9,-1.2638185,36.7930057,-1.3004062,36.829741,515,4,35,1643
20124,7507,1846,2,Personal,19,5,37523,19,5,37607,19,5,38084,19,5,39475,19,5,42186,4,24.8,-1.2699049,36.8081403,-1.289498,36.818878,268,2711,84,1868
20125,8106,2150,3,Business,1,3,44090,1,3,44099,1,3,44295,1,3,44636,1,3,45789,12,20.1,-1.331619,36.847976,-1.344446,36.756597,414,1153,9,537
20126,3705,2701,3,Business,2,2,56501,2,2,57079,2,2,59195,2,2,60005,2,2,62941,4,23.4,-1.281754,36.8324229,-1.2765736,36.8513646,612,2936,578,2926
20127,4584,1372,3,Business,19,2,39248,19,2,39306,19,2,39815,19,2,40084,19,2,42407,29,26.4,-1.3193233,36.840991,-1.1729239,36.9666617,404,2323,58,778
20128,27722,3097,3,Personal,7,1,30316,7,1,31244,7,1,33644,7,1,34109,7,1,37222,29,21.5,-1.4242042,36.717817,-1.2795044,36.7849319,559,3113,928,2865
20129,10122,2551,1,Personal,13,1,38625,13,1,38681,13,1,39409,13,1,39862,13,1,41232,10,17.0,-1.2789537,36.8286392,-1.2833608,36.7577466,249,1370,56,1181
20130,26112,2154,3,Business,16,4,32724,16,4,33024,16,4,33548,16,4,33619,16,4,34506,8,23.25888921888938,-1.2571472,36.7950633,-1.2765736,36.8513646,576,887,300,595
20131,1664,2154,3,Business,16,3,30874,16,3,30886,16,3,31147,16,3,31344,16,3,32321,7,20.0,-1.2885529,36.8160141,-1.2626906,36.7827022,79,977,12,458
20132,5186,1363,3,Business,4,2,32884,4,2,34482,4,2,34926,4,2,34988,4,2,36199,3,16.5,-1.3004062,36.829741,-1.2929499,36.8180835,158,1211,1598,506
20133,2297,1500,3,Business,24,4,56857,24,4,56915,24,4,57094,24,4,57708,24,4,59211,11,28.5,-1.3228003,36.8306435,-1.2574219,36.7927073,523,1503,58,793
20134,16192,2123,1,Personal,9,6,50274,9,6,50324,9,6,51880,9,6,52191,9,6,56354,20,19.2,-1.2770766,36.8196194,-1.3929388,36.7601639,852,4163,50,1867
20135,16331,3491,3,Business,22,5,35378,22,5,35407,22,5,36392,22,5,37053,22,5,39519,21,22.2,-1.2283403,36.8822756,-1.3104734,36.7363698,75,2466,29,1646
20136,150,3462,1,Personal,11,3,34577,11,3,34632,11,3,35323,11,3,35394,11,3,37685,6,15.1,-1.255683,36.813771,-1.2842863,36.7951109,427,2291,55,762
20137,5654,2874,2,Personal,23,4,63917,23,4,63921,23,4,64511,23,4,64750,23,4,68273,24,20.0,-1.2250582,36.8639193,-1.3561488,36.7589267,213,3523,4,829
20138,27349,1502,3,Business,31,4,52949,31,4,53859,31,4,54689,31,4,54863,31,4,55432,5,22.9,-1.2156006,36.8916865,-1.2294985,36.8775495,742,569,910,1004
20139,8142,3599,3,Business,12,3,38660,12,3,43112,12,3,43693,12,3,44324,12,3,45407,11,19.5,-1.3302996,36.8707935,-1.3136452,36.7974014,675,1083,4452,1212
20140,13949,265,3,Business,16,6,43884,16,6,43900,16,6,44275,16,6,44345,16,6,46430,6,25.7,-1.300921,36.828195,-1.2666309,36.8358454,206,2085,16,445
20141,26636,363,1,Personal,16,3,36719,16,3,37590,16,3,38661,16,3,39039,16,3,40491,9,24.0,-1.3314048,36.8229367,-1.2658315,36.809049,100,1452,871,1449
20142,20783,393,3,Business,8,3,36261,8,3,36296,8,3,36652,8,3,37849,8,3,38089,4,23.25888921888938,-1.3167113,36.8301563,-1.3004062,36.829741,411,240,35,1553
20143,16680,1927,3,Business,17,5,51350,17,5,51364,17,5,51777,17,5,52554,17,5,54653,22,23.25888921888938,-1.3472066,36.7692638,-1.3103985,36.9114173,533,2099,14,1190
20144,3120,3091,1,Business,6,1,53152,6,1,53204,6,1,54892,6,1,55354,6,1,56664,8,24.4,-1.3014461,36.7661381,-1.2977705,36.8134139,327,1310,52,2150
20145,6776,2559,3,Personal,31,4,62162,31,4,62303,31,4,64018,31,4,64310,31,4,67046,15,27.4,-1.3008819,36.7612515,-1.2192191,36.8055632,269,2736,141,2007
20146,1521,2701,3,Business,6,5,55340,6,5,56004,6,5,56545,6,5,57096,6,5,58572,5,22.7,-1.2527958,36.8003131,-1.279395,36.825364,159,1476,664,1092
20147,1792,177,3,Personal,22,5,45117,22,5,45163,22,5,46266,22,5,47354,22,5,49441,17,21.9,-1.2749662,36.7658781,-1.2677304,36.8779867,620,2087,46,2191
20148,3884,2829,3,Business,6,4,36187,6,4,36220,6,4,37536,6,4,37627,6,4,38552,6,16.1,-1.2571472,36.7950633,-1.2925919,36.8170577,573,925,33,1407
20149,27960,3674,3,Business,18,5,58502,18,5,58790,18,5,58909,18,5,59002,18,5,60680,11,27.2,-1.2551895,36.7822034,-1.2343087,36.84749,279,1678,288,212
20150,1336,3560,3,Business,15,3,33149,15,3,33176,15,3,33656,15,3,34162,15,3,34349,1,23.25888921888938,-1.290894,36.822971,-1.279395,36.825364,812,187,27,986
20151,17766,1851,3,Personal,2,4,45066,2,4,45104,2,4,46111,2,4,48399,2,4,52184,22,22.4,-1.2765689,36.8406151,-1.3149338,36.7135703,174,3785,38,3295
20152,14872,3283,3,Business,14,4,45573,14,4,45667,14,4,46257,14,4,47008,14,4,47893,6,25.0,-1.272828,36.816608,-1.2628473,36.781805,268,885,94,1341
20153,6958,2982,3,Business,31,3,57152,31,3,57157,31,3,57268,31,3,57698,31,3,62306,18,27.2,-1.177202,36.8351183,-1.300921,36.828195,573,4608,5,541
20154,27951,517,3,Business,3,1,45555,3,1,45598,3,1,46481,3,1,46988,3,1,47560,4,21.4,-1.3228003,36.8306435,-1.3004062,36.829741,2,572,43,1390
20155,20247,1473,3,Business,9,5,42544,9,5,42586,9,5,44374,9,5,45860,9,5,47964,21,25.6,-1.3700383,36.9190174,-1.3025667,36.7803495,699,2104,42,3274
20156,27636,3727,3,Business,22,3,46761,22,3,46890,22,3,47816,22,3,48015,22,3,48667,2,23.0,-1.2963097,36.7688221,-1.3044204,36.7882822,269,652,129,1125
20157,3215,3688,3,Business,11,2,53534,11,2,53615,11,2,53765,11,2,54133,11,2,56970,12,21.4,-1.2551895,36.7822034,-1.3104734,36.7363698,161,2837,81,518
20158,8723,1271,3,Business,10,1,54095,10,1,55181,10,1,57459,10,1,58628,10,1,61176,27,18.9,-1.3244885,36.897792,-1.3204931,36.7043102,12,2548,1086,3447
20159,15446,970,3,Business,11,1,52448,11,1,55233,11,1,55805,11,1,55928,11,1,56967,8,28.1,-1.2551895,36.7822034,-1.2852,36.82397,210,1039,2785,695
20160,9581,2701,3,Business,19,1,37607,19,1,37734,19,1,38245,19,1,38373,19,1,39561,7,24.9,-1.2765736,36.8513646,-1.2597529,36.806629,817,1188,127,639
20161,19570,1927,3,Business,24,6,62711,24,6,64109,24,6,65348,24,6,66300,24,6,67281,10,22.4,-1.305399,36.8221849,-1.3463042,36.768164,276,981,1398,2191
20162,178,1205,3,Business,12,5,44909,12,5,45202,12,5,45777,12,5,46411,12,5,49527,9,24.6,-1.257309,36.8060084,-1.2950737,36.7648455,578,3116,293,1209
20163,12079,3444,1,Personal,20,4,38357,20,4,38489,20,4,39214,20,4,39426,20,4,42575,7,24.4,-1.263419,36.8060348,-1.2951297,36.8335521,565,3149,132,937
20164,27243,53,3,Business,3,1,41081,3,1,41497,3,1,42265,3,1,43744,3,1,44801,5,21.5,-1.3004062,36.829741,-1.2770708,36.8231093,158,1057,416,2247
20165,10882,2369,3,Personal,13,3,33246,13,3,33257,13,3,34109,13,3,34187,13,3,35047,6,16.1,-1.2661264,36.8030359,-1.2857671,36.7875614,635,860,11,930
20166,18481,517,3,Business,5,6,39466,5,6,39479,5,6,39602,5,6,39812,5,6,40306,4,22.5,-1.3177547,36.8303703,-1.3004062,36.829741,543,494,13,333
20167,5383,393,3,Business,2,5,39697,2,5,41260,2,5,42901,2,5,43021,2,5,45578,14,23.3,-1.3177547,36.8303703,-1.306378,36.7519845,731,2557,1563,1761
20168,8557,2112,3,Business,14,3,47676,14,3,50811,14,3,50838,14,3,51527,14,3,53507,17,25.5,-1.2156006,36.8916865,-1.2551895,36.7822034,447,1980,3135,716
20169,18164,1642,3,Business,21,4,35111,21,4,35140,21,4,35834,21,4,36661,21,4,37724,5,21.7,-1.2726506,36.7960153,-1.2808159,36.8160545,76,1063,29,1521
20170,4663,2436,3,Business,5,1,59496,5,1,59556,5,1,60393,5,1,61280,5,1,61854,3,24.3,-1.262073,36.7986087,-1.2551895,36.7822034,858,574,60,1724
20171,7776,2956,3,Business,14,4,56966,14,4,57091,14,4,57295,14,4,57493,14,4,57648,3,27.7,-1.2584143,36.8048002,-1.2551895,36.7822034,793,155,125,402
20172,2595,2931,3,Business,28,1,61603,28,1,61609,28,1,61626,28,1,61878,28,1,65361,22,25.4,-1.174484,36.914608,-1.2452664,36.8028541,428,3483,6,269
20173,4121,3272,2,Personal,17,5,55770,17,5,55876,17,5,56179,17,5,56415,17,5,57462,5,20.1,-1.2696341,36.8042045,-1.2577628,36.835733,754,1047,106,539
20174,14765,2532,3,Business,10,5,57627,10,5,59329,10,5,60196,10,5,60605,10,5,62057,6,23.25888921888938,-1.2571472,36.7950633,-1.2824911,36.8218042,491,1452,1702,1276
20175,18094,3547,3,Business,13,2,39576,13,2,39620,13,2,40208,13,2,42016,13,2,45399,13,22.5,-1.3270716,36.8406371,-1.2800648,36.762267,31,3383,44,2396
20176,25809,265,3,Business,27,4,52542,27,4,52553,27,4,53624,27,4,54221,27,4,55578,7,23.8,-1.2609397,36.8010827,-1.300921,36.828195,275,1357,11,1668
20177,2917,3080,3,Business,8,5,51653,8,5,51690,8,5,52904,8,5,53519,8,5,54146,5,30.2,-1.2551895,36.7822034,-1.2644443,36.7734547,452,627,37,1829
20178,18521,761,3,Business,12,5,39985,12,5,39995,12,5,41360,12,5,41477,12,5,42325,7,26.6,-1.2693102,36.7981777,-1.298762,36.7636456,649,848,10,1482
20179,17309,868,3,Business,9,2,37176,9,2,37209,9,2,37468,9,2,37731,9,2,39688,7,20.9,-1.2628473,36.781805,-1.265715,36.823815,570,1957,33,522
20180,10502,590,3,Business,25,4,47953,25,4,48365,25,4,50264,25,4,50950,25,4,52234,4,21.0,-1.2743555,36.799393,-1.257773,36.795486,112,1284,412,2585
20181,19502,1113,1,Personal,13,6,52867,13,6,52924,13,6,52995,13,6,54302,13,6,55361,13,27.9,-1.263987,36.798891,-1.2156006,36.8916865,100,1059,57,1378
20182,6347,1882,3,Business,2,4,55581,2,4,56626,2,4,57681,2,4,58471,2,4,59838,8,23.25888921888938,-1.3014461,36.7661381,-1.323615,36.700475,599,1367,1045,1845
20183,22981,624,3,Business,27,2,53417,27,2,53442,27,2,53915,27,2,56179,27,2,57612,21,25.7,-1.344446,36.756597,-1.22978,36.836215,541,1433,25,2737
20184,3313,1715,3,Business,29,2,53385,29,2,53540,29,2,54921,29,2,55031,29,2,56747,3,23.6,-1.253966,36.7987692,-1.2654447,36.7978671,749,1716,155,1491
20185,3066,1705,3,Business,7,1,52214,7,1,52221,7,1,52332,7,1,52823,7,1,55031,15,26.6,-1.2551895,36.7822034,-1.2022306,36.7893305,72,2208,7,602
20186,17341,1484,3,Business,7,1,53518,7,1,53572,7,1,53634,7,1,53798,7,1,55600,8,20.3,-1.255956,36.789867,-1.2935303,36.7988142,95,1802,54,226
20187,5884,3454,1,Personal,6,3,60925,6,3,61559,6,3,62435,6,3,62883,6,3,64719,11,20.0,-1.2879431,36.8270069,-1.2624366,36.7632187,742,1836,634,1324
20188,24057,2150,3,Business,2,2,51987,2,2,52043,2,2,53722,2,2,53973,2,2,55890,15,26.2,-1.2872344,36.7773949,-1.344446,36.756597,38,1917,56,1930
20189,4279,136,3,Business,22,5,51915,22,5,52013,22,5,52735,22,5,53169,22,5,54681,13,27.5,-1.3254522,36.7216584,-1.290641,36.812941,959,1512,98,1156
20190,10854,53,3,Business,28,5,47274,28,5,47383,28,5,47676,28,5,48620,28,5,49424,5,23.6,-1.3004062,36.829741,-1.2770708,36.8231093,656,804,109,1237
20191,21662,2649,3,Business,3,1,57324,3,1,57404,3,1,57527,3,1,58431,3,1,59980,12,23.0,-1.2752846,36.8027022,-1.2049641,36.8173887,25,1549,80,1027
20192,5900,3547,3,Business,8,3,35780,8,3,38234,8,3,39429,8,3,40014,8,3,42304,18,23.25888921888938,-1.3189252,36.8617269,-1.2856319,36.7672998,11,2290,2454,1780
20193,25953,2684,1,Personal,10,3,56240,10,3,56281,10,3,57840,10,3,57994,10,3,59305,14,24.7,-1.2429937,36.8754167,-1.2966203,36.817837,217,1311,41,1713
20194,17300,2258,3,Business,11,5,46808,11,5,46813,11,5,47959,11,5,48234,11,5,50786,20,20.9,-1.2646084,36.8028645,-1.3700383,36.9190174,734,2552,5,1421
20195,9354,1370,3,Personal,18,1,46201,18,1,46263,18,1,46960,18,1,47400,18,1,48962,11,27.8,-1.261692,36.80161,-1.32671,36.8600138,219,1562,62,1137
20196,3786,1558,3,Personal,21,4,59597,21,4,60447,21,4,60781,21,4,61853,21,4,64184,6,19.9,-1.2696088,36.8257411,-1.278067,36.783487,638,2331,850,1406
20197,20117,635,3,Business,9,3,38408,9,3,38714,9,3,39045,9,3,41967,9,3,43178,8,25.3,-1.3016417,36.8271679,-1.2599563,36.7993439,926,1211,306,3253
20198,16605,46,3,Business,8,3,36258,8,3,36533,8,3,37547,8,3,38190,8,3,39097,6,23.25888921888938,-1.28523,36.8248292,-1.2996396,36.8520799,291,907,275,1657
20199,2156,3623,1,Personal,23,1,42261,23,1,42295,23,1,42787,23,1,42895,23,1,44060,4,18.7,-1.265007,36.8149619,-1.2840013,36.823108,329,1165,34,600
20200,11648,1954,3,Business,6,3,54561,6,3,54680,6,3,55438,6,3,56082,6,3,57270,5,21.6,-1.289498,36.818878,-1.2944081,36.7897046,752,1188,119,1402
20201,589,633,3,Business,18,1,49488,18,1,49628,18,1,49633,18,1,49936,18,1,50459,4,29.7,-1.3077869,36.8443207,-1.3004062,36.829741,206,523,140,308
20202,7363,3308,1,Personal,2,3,65957,2,3,66316,2,3,67903,2,3,68024,2,3,70280,11,18.2,-1.231492,36.804054,-1.256688,36.772448,103,2256,359,1708
20203,16752,635,3,Business,8,4,57309,8,4,57468,8,4,57926,8,4,58735,8,4,59057,2,27.2,-1.263753,36.80779,-1.2602337,36.7990548,519,322,159,1267
20204,13041,2112,3,Business,24,4,66413,24,4,67425,24,4,68539,24,4,70545,24,4,71736,14,20.8,-1.207546,36.7913976,-1.2156006,36.8916865,607,1191,1012,3120
20205,19826,1849,3,Business,5,3,36611,5,3,36907,5,3,40002,5,3,40199,5,3,41306,8,22.4,-1.2551895,36.7822034,-1.290894,36.822971,928,1107,296,3292
20206,25213,2304,3,Personal,26,2,35855,26,2,37314,26,2,39095,26,2,39161,26,2,41609,20,23.25888921888938,-1.2035228,36.7772505,-1.2963097,36.7688221,101,2448,1459,1847
20207,13360,569,3,Personal,16,1,34070,16,1,34078,16,1,35585,16,1,35689,16,1,37092,14,14.7,-1.308819,36.8421201,-1.2981752,36.7578336,951,1403,8,1611
20208,12212,1502,3,Business,6,3,49429,6,3,49471,6,3,49575,6,3,49663,6,3,51806,13,23.25888921888938,-1.2527958,36.8003131,-1.2232123,36.8932547,210,2143,42,192
20209,16611,3201,3,Business,7,4,39941,7,4,39982,7,4,40221,7,4,41831,7,4,41985,1,27.4,-1.2571472,36.7950633,-1.2584143,36.8048002,205,154,41,1849
20210,3558,1244,3,Business,13,6,49287,13,6,49570,13,6,51759,13,6,52957,13,6,53873,8,27.7,-1.272828,36.816608,-1.303596,36.778378,363,916,283,3387
20211,8129,3689,3,Business,15,4,43750,15,4,44948,15,4,46529,15,4,46829,15,4,47327,3,24.2,-1.2527958,36.8003131,-1.2551895,36.7822034,125,498,1198,1881
20212,25921,1792,3,Business,11,1,57159,11,1,57533,11,1,58380,11,1,58820,11,1,60918,15,29.0,-1.2809121,36.7852524,-1.2470928,36.8939232,545,2098,374,1287
20213,11148,393,3,Business,6,3,46931,6,3,46989,6,3,48198,6,3,49294,6,3,51430,14,27.5,-1.3167113,36.8301563,-1.306378,36.7519845,559,2136,58,2305
20214,27829,1850,3,Business,28,1,42195,28,1,42232,28,1,42501,28,1,42938,28,1,44494,4,23.7,-1.2551895,36.7822034,-1.2750247,36.7981039,647,1556,37,706
20215,25524,2781,3,Personal,23,3,73854,23,3,73928,23,3,74852,23,3,75005,23,3,76825,16,21.3,-1.296599,36.7629672,-1.2235201,36.8020608,711,1820,74,1077
20216,18798,1927,3,Business,8,3,50296,8,3,50321,8,3,50330,8,3,52566,8,3,53947,19,23.25888921888938,-1.3562374,36.9042954,-1.3472066,36.7692638,272,1381,25,2245
20217,21961,2070,3,Business,22,2,42345,22,2,42394,22,2,42571,22,2,43105,22,2,45981,17,24.1,-1.29237,36.8241297,-1.3361484,36.9161128,101,2876,49,711
20218,22669,53,3,Business,28,4,51614,28,4,52056,28,4,53204,28,4,53771,28,4,54830,5,27.3,-1.2770708,36.8231093,-1.29508,36.796863,126,1059,442,1715
20219,24846,567,3,Business,22,5,40162,22,5,40190,22,5,40291,22,5,40667,22,5,42490,8,23.25888921888938,-1.2963097,36.7688221,-1.2753109,36.8130185,354,1823,28,477
20220,1807,1642,3,Business,2,4,52528,2,4,52583,2,4,53135,2,4,53558,2,4,54671,5,26.2,-1.2876365,36.816096,-1.2728069,36.7962362,616,1113,55,975
20221,15999,733,3,Business,17,3,56676,17,3,57085,17,3,57115,17,3,59945,17,3,61722,8,23.25888921888938,-1.2878913,36.8089253,-1.2551895,36.7822034,613,1777,409,2860
20222,14524,804,2,Personal,8,1,51229,8,1,51338,8,1,51889,8,1,52556,8,1,53423,7,24.7,-1.2959783,36.7860021,-1.302625,36.8247507,612,867,109,1218
20223,12822,393,3,Business,30,2,34452,30,2,34473,30,2,34477,30,2,38849,30,2,38853,14,23.25888921888938,-1.3167113,36.8301563,-1.2991441,36.7528804,39,4,21,4376
20224,5009,2600,2,Personal,22,3,48998,22,3,49024,22,3,49548,22,3,50426,22,3,51842,8,25.5,-1.2654199,36.8008276,-1.27339,36.7712735,882,1416,26,1402
20225,8989,3194,3,Business,14,4,46385,14,4,47745,14,4,50663,14,4,50777,14,4,51469,3,28.1,-1.2551895,36.7822034,-1.2599805,36.7988014,38,692,1360,3032
20226,6314,1329,3,Business,4,5,33995,4,5,35145,4,5,37651,4,5,38201,4,5,38818,4,17.3,-1.273056,36.811298,-1.284835,36.8152125,489,617,1150,3056
20227,10806,2585,2,Personal,12,4,70716,12,4,70792,12,4,71489,12,4,72277,12,4,74425,12,18.3,-1.2745187,36.7876436,-1.2593592,36.7775322,101,2148,76,1485
20228,14003,1471,3,Business,9,5,59945,9,5,60462,9,5,60978,9,5,61826,9,5,63596,9,24.9,-1.2551895,36.7822034,-1.2917868,36.7872675,536,1770,517,1364
20229,2466,830,3,Business,25,4,62878,25,4,62892,25,4,62969,25,4,63396,25,4,64649,9,23.25888921888938,-1.2551895,36.7822034,-1.29381,36.7685631,45,1253,14,504
20230,731,635,3,Business,26,1,51165,26,1,51505,26,1,51930,26,1,52123,26,1,53723,13,22.3,-1.2599563,36.7993439,-1.3221141,36.8636835,878,1600,340,618
20231,19128,417,1,Personal,2,6,43733,2,6,43777,2,6,43816,2,6,44352,2,6,46325,13,23.7,-1.267691,36.793649,-1.2108499,36.7819362,379,1973,44,575
20232,25949,393,3,Business,26,5,28268,26,5,28278,26,5,28289,26,5,33078,26,5,33451,4,23.25888921888938,-1.3177547,36.8303703,-1.3004062,36.829741,97,373,10,4800
20233,16148,391,3,Business,29,1,51164,29,1,51419,29,1,52086,29,1,53664,29,1,53668,5,23.25888921888938,-1.2784063,36.8222933,-1.3081376,36.8329772,843,4,255,2245
20234,231,3761,3,Personal,27,1,57652,27,1,58336,27,1,59340,27,1,62196,27,1,62198,7,23.25888921888938,-1.2888734,36.8268027,-1.2615888,36.7928732,193,2,684,3860
20235,2422,1482,3,Business,12,3,41165,12,3,41776,12,3,42700,12,3,43320,12,3,46700,12,19.6,-1.2079306,36.7705377,-1.2573921,36.7992507,959,3380,611,1544
20236,11800,2008,3,Business,4,4,56919,4,4,57238,4,4,57724,4,4,58243,4,4,59855,7,27.1,-1.2508229,36.7895263,-1.285244,36.832159,907,1612,319,1005
20237,8218,2801,3,Business,20,1,43253,20,1,43292,20,1,43568,20,1,44037,20,1,45250,11,23.25888921888938,-1.2674274,36.7870827,-1.3108386,36.7555239,438,1213,39,745
20238,22171,635,3,Business,19,3,47100,19,3,47114,19,3,47952,19,3,48068,19,3,51366,26,22.0,-1.2847613,36.967084,-1.2599563,36.7993439,551,3298,14,954
20239,11971,2523,3,Business,31,4,50636,31,4,50693,31,4,51524,31,4,51956,31,4,53860,5,28.8,-1.2551895,36.7822034,-1.2657456,36.8087424,75,1904,57,1263
20240,26802,3201,3,Business,25,1,40872,25,1,40913,25,1,41230,25,1,42143,25,1,42585,2,25.4,-1.2584143,36.8048002,-1.2561334,36.7990458,547,442,41,1230
20241,11894,2304,1,Personal,8,3,50431,8,3,50483,8,3,51487,8,3,51629,8,3,55109,12,26.0,-1.2963097,36.7688221,-1.3549418,36.7280528,903,3480,52,1146
20242,12514,1235,1,Personal,28,5,38186,28,5,38262,28,5,38972,28,5,39752,28,5,41645,12,24.9,-1.2884799,36.8217918,-1.2203755,36.8165711,208,1893,76,1490
20243,11899,1976,3,Business,5,1,38132,5,1,38161,5,1,38489,5,1,38921,5,1,39849,15,24.3,-1.257028,36.7810435,-1.2461449,36.8640088,45,928,29,760
20244,15017,2627,3,Business,14,5,41931,14,5,41962,14,5,42206,14,5,42833,14,5,42973,2,21.9,-1.2584143,36.8048002,-1.2571472,36.7950633,607,140,31,871
20245,12334,2330,3,Business,7,5,40193,7,5,42364,7,5,42381,7,5,42710,7,5,45627,23,25.3,-1.3376825,36.7575489,-1.2524916,36.8656196,648,2917,2171,346
20246,26351,867,3,Business,19,1,32468,19,1,32486,19,1,33703,19,1,34470,19,1,36210,11,19.3,-1.306378,36.7519845,-1.2996533,36.8292629,258,1740,18,1984
20247,12494,633,3,Business,6,3,58141,6,3,58230,6,3,58809,6,3,59366,6,3,60502,11,27.6,-1.2991441,36.7528804,-1.3004062,36.829741,576,1136,89,1136
20248,24725,970,3,Business,18,4,49754,18,4,49765,18,4,49849,18,4,50133,18,4,50765,4,23.25888921888938,-1.2551895,36.7822034,-1.2566689,36.7796952,349,632,11,368
20249,22532,3214,3,Business,30,2,33683,30,2,33732,30,2,33755,30,2,34469,30,2,35492,8,23.25888921888938,-1.289795,36.7957132,-1.2566586,36.7929682,613,1023,49,737
20250,6292,393,3,Business,29,5,51713,29,5,51737,29,5,51745,29,5,52144,29,5,53843,11,29.0,-1.3167113,36.8301563,-1.2638185,36.7930057,349,1699,24,407
20251,3428,867,3,Business,8,2,50618,8,2,50652,8,2,51387,8,2,51470,8,2,53392,14,25.1,-1.3077869,36.8443207,-1.2991441,36.7528804,254,1922,34,818
20252,7991,1246,3,Business,11,5,30478,11,5,30486,11,5,30507,11,5,31541,11,5,32104,2,21.2,-1.2571472,36.7950633,-1.2682478,36.8072852,409,563,8,1055
20253,12901,3355,3,Business,17,2,29162,17,2,29233,17,2,30730,17,2,30896,17,2,34278,8,14.3,-1.3052491,36.8223899,-1.31032,36.8730683,890,3382,71,1663
20254,21187,2032,3,Personal,19,2,39080,19,2,39189,19,2,40243,19,2,40779,19,2,42306,11,27.6,-1.275931,36.8516227,-1.2234518,36.8811525,377,1527,109,1590
20255,11717,873,1,Personal,27,4,36988,27,4,37290,27,4,38133,27,4,38625,27,4,41338,5,22.8,-1.3075266,36.8292369,-1.2890374,36.8165815,328,2713,302,1335
20256,6401,53,3,Business,28,4,40641,28,4,40696,28,4,42067,28,4,43106,28,4,44296,5,23.6,-1.3004062,36.829741,-1.2770708,36.8231093,489,1190,55,2410
20257,16927,393,3,Business,11,2,41844,11,2,41866,11,2,41977,11,2,42509,11,2,43869,11,19.3,-1.3228003,36.8306435,-1.2638185,36.7930057,35,1360,22,643
20258,22676,1384,3,Business,9,4,49720,9,4,49765,9,4,50367,9,4,51241,9,4,53205,13,23.25888921888938,-1.2517448,36.7924971,-1.2985024,36.8669301,484,1964,45,1476
20259,14711,2559,3,Personal,13,1,41294,13,1,41425,13,1,41664,13,1,45132,13,1,47859,16,23.25888921888938,-1.2948887,36.7683938,-1.2196224,36.7881376,855,2727,131,3707
20260,22066,2330,3,Business,8,3,44584,8,3,44672,8,3,46392,8,3,46720,8,3,48381,13,23.25888921888938,-1.2291477,36.8440295,-1.1926151,36.9347904,7,1661,88,2048
20261,24593,2193,3,Personal,6,3,54662,6,3,54738,6,3,55161,6,3,55343,6,3,56124,7,23.25888921888938,-1.317337,36.82698,-1.2768326,36.8073804,195,781,76,605
20262,8293,2271,3,Business,19,3,50265,19,3,50277,19,3,50312,19,3,50565,19,3,52725,16,24.5,-1.293515,36.897607,-1.2752846,36.8027022,925,2160,12,288
20263,18629,2801,3,Business,13,3,33453,13,3,33481,13,3,34215,13,3,34390,13,3,36525,23,20.3,-1.2674274,36.7870827,-1.3546228,36.9013783,690,2135,28,909
20264,16382,2028,1,Personal,1,1,50071,1,1,50319,1,1,51126,1,1,51623,1,1,53512,6,25.6,-1.312469,36.815177,-1.2765737,36.8175399,612,1889,248,1304
20265,7281,2008,3,Business,10,1,61240,10,1,61881,10,1,64864,10,1,65237,10,1,67655,7,19.0,-1.2508229,36.7895263,-1.2858501,36.8306293,773,2418,641,3356
20266,17727,393,3,Business,29,5,31179,29,5,31192,29,5,31578,29,5,32203,29,5,33683,11,20.8,-1.3167113,36.8301563,-1.2638185,36.7930057,933,1480,13,1011
20267,23396,510,3,Business,29,2,56589,29,2,56792,29,2,56800,29,2,57336,29,2,58543,12,23.6,-1.2860183,36.8975338,-1.3332749,36.8708147,397,1207,203,544
20268,11246,814,3,Business,26,2,52013,26,2,52029,26,2,52255,26,2,53782,26,2,58769,14,23.25888921888938,-1.2551895,36.7822034,-1.3332749,36.8708147,908,4987,16,1753
20269,6703,393,3,Business,25,2,44332,25,2,44344,25,2,45058,25,2,45937,25,2,46806,6,23.9,-1.3177547,36.8303703,-1.3077869,36.8443207,39,869,12,1593
20270,17048,2946,2,Personal,5,4,35139,5,4,35149,5,4,35950,5,4,36109,5,4,38366,8,23.25888921888938,-1.2749662,36.7658781,-1.2806592,36.8298077,844,2257,10,960
20271,23461,1724,3,Business,7,4,57063,7,4,57109,7,4,58086,7,4,58188,7,4,59737,8,31.3,-1.2907854,36.7774108,-1.2551895,36.7822034,123,1549,46,1079
20272,12419,190,3,Business,11,2,53951,11,2,55757,11,2,56174,11,2,56821,11,2,57668,11,22.4,-1.2707373,36.805441,-1.3270347,36.8667362,878,847,1806,1064
20273,25180,3326,3,Business,23,4,45345,23,4,45370,23,4,45987,23,4,46360,23,4,50541,7,23.2,-1.2551895,36.7822034,-1.2989287,36.8163082,155,4181,25,990
20274,15006,20,3,Business,1,1,34921,1,1,34943,1,1,37200,1,1,37279,1,1,39453,27,21.4,-1.413547,36.9550764,-1.2628638,36.8070399,863,2174,22,2336
20275,24133,3621,3,Business,13,3,52375,13,3,52423,13,3,52960,13,3,53421,13,3,55103,9,29.4,-1.2836583,36.7886014,-1.2700382,36.8426718,206,1682,48,998
20276,24536,3688,3,Business,13,3,60317,13,3,60383,13,3,60725,13,3,61526,13,3,61530,3,25.8,-1.2551895,36.7822034,-1.25537,36.7756,764,4,66,1143
20277,23917,2330,3,Business,13,1,42469,13,1,42501,13,1,42535,13,1,42996,13,1,43996,8,23.25888921888938,-1.2124582,36.802894,-1.2536275,36.7987932,843,1000,32,495
20278,10764,1527,3,Business,9,2,52530,9,2,52546,9,2,52800,9,2,53698,9,2,55217,9,30.8,-1.2638185,36.7930057,-1.3004062,36.829741,796,1519,16,1152
20279,4054,2344,3,Business,14,4,45985,14,4,47449,14,4,48286,14,4,48630,14,4,51860,8,23.6,-1.2551895,36.7822034,-1.2475788,36.8215438,210,3230,1464,1181
20280,15629,2933,2,Personal,5,3,57928,5,3,58158,5,3,59157,5,3,59840,5,3,61646,5,22.1,-1.2721028,36.7953485,-1.2947685,36.7785834,848,1806,230,1682
20281,27561,3222,3,Business,3,3,34952,3,3,34962,3,3,35495,3,3,35845,3,3,37975,8,21.5,-1.2551895,36.7822034,-1.295156,36.8094306,177,2130,10,883
20282,23998,2330,3,Business,11,1,55692,11,1,55880,11,1,55884,11,1,56454,11,1,57637,7,29.0,-1.2325706,36.8083923,-1.2649605,36.7981777,206,1183,188,574
20283,27910,3266,3,Business,30,1,34248,30,1,34805,30,1,34862,30,1,35891,30,1,37871,15,16.3,-1.3495948,36.7190665,-1.2885417,36.8100523,726,1980,557,1086
20284,19178,3091,3,Business,5,3,43990,5,3,44827,5,3,45171,5,3,45929,5,3,49129,6,22.4,-1.3025826,36.7670807,-1.2694398,36.7624483,210,3200,837,1102
20285,14373,907,2,Personal,31,4,31680,31,4,31713,31,4,32573,31,4,32684,31,4,33189,3,17.6,-1.2913246,36.8019522,-1.299846,36.7940155,698,505,33,971
20286,16471,700,3,Business,19,6,39221,19,6,44349,19,6,44704,19,6,44817,19,6,47855,8,25.1,-1.2786912,36.8265105,-1.3010773,36.7752554,235,3038,5128,468
20287,7395,1995,3,Business,11,5,49096,11,5,49272,11,5,49814,11,5,50246,11,5,51452,9,22.6,-1.255956,36.789867,-1.2765736,36.8513646,742,1206,176,974
20288,12022,2289,3,Business,18,2,32823,18,2,33025,18,2,33300,18,2,33975,18,2,36833,7,19.6,-1.2551895,36.7822034,-1.2887216,36.8087323,47,2858,202,950
20289,17436,970,3,Business,15,3,35287,15,3,35394,15,3,36117,15,3,36688,15,3,38650,8,23.25888921888938,-1.2571472,36.7950633,-1.312469,36.815177,344,1962,107,1294
20290,24746,3701,3,Business,13,4,41314,13,4,41403,13,4,42497,13,4,44194,13,4,47268,12,22.0,-1.3104734,36.7363698,-1.2612574,36.7879622,441,3074,89,2791
20291,22947,3283,3,Business,27,3,49765,27,3,49791,27,3,50475,27,3,50899,27,3,52127,6,29.6,-1.272828,36.816608,-1.2628473,36.781805,660,1228,26,1108
20292,19399,3426,3,Business,31,3,31778,31,3,31837,31,3,32686,31,3,33298,31,3,35262,11,19.3,-1.3472066,36.7692638,-1.3025826,36.7670807,559,1964,59,1461
20293,26109,828,2,Personal,14,4,45901,14,4,46134,14,4,47060,14,4,47508,14,4,48068,4,19.0,-1.2889037,36.7677152,-1.2817426,36.7846148,312,560,233,1374
20294,2244,3291,3,Business,20,2,53004,20,2,53032,20,2,53676,20,2,54895,20,2,55992,2,24.1,-1.2673935,36.8030328,-1.2600926,36.8088685,467,1097,28,1863
20295,4935,2069,3,Business,8,2,61568,8,2,61691,8,2,62399,8,2,63241,8,2,64374,9,23.3,-1.265715,36.823815,-1.228911,36.881876,427,1133,123,1550
20296,24386,3689,3,Business,6,3,66886,6,3,68951,6,3,69125,6,3,69487,6,3,69858,1,19.8,-1.2649605,36.7981777,-1.2601709,36.8002238,103,371,2065,536
20297,8897,478,3,Business,8,5,46001,8,5,49064,8,5,49571,8,5,49766,8,5,51073,8,27.2,-1.2551895,36.7822034,-1.2990813,36.8034213,727,1307,3063,702
20298,12804,3201,3,Business,14,3,56474,14,3,56665,14,3,56714,14,3,57354,14,3,58139,4,25.7,-1.264272,36.7978791,-1.2731645,36.7900343,651,785,191,689
20299,27333,2509,3,Business,11,2,54386,11,2,54484,11,2,55080,11,2,55319,11,2,56896,14,25.7,-1.2571472,36.7950633,-1.2156006,36.8916865,415,1577,98,835
20300,27311,2154,3,Business,15,3,49202,15,3,49231,15,3,49864,15,3,50307,15,3,51336,5,25.7,-1.279395,36.825364,-1.2765736,36.8513646,20,1029,29,1076
20301,5292,517,3,Business,29,3,31155,29,3,31173,29,3,31205,29,3,33722,29,3,33725,11,17.9,-1.3228003,36.8306435,-1.2638185,36.7930057,515,3,18,2549
20302,6880,393,3,Business,17,5,43333,17,5,43397,17,5,44741,17,5,45772,17,5,48898,14,23.25888921888938,-1.3167113,36.8301563,-1.2991441,36.7528804,2,3126,64,2375
20303,1842,2066,3,Business,15,3,52589,15,3,52645,15,3,52821,15,3,53017,15,3,54661,11,21.4,-1.316961,36.820337,-1.2618539,36.7772405,393,1644,56,372
20304,9040,2159,3,Business,14,2,60683,14,2,60738,14,2,61473,14,2,63693,14,2,65250,9,23.2,-1.2654879,36.7984789,-1.304735,36.7846054,213,1557,55,2955
20305,1355,49,3,Business,21,5,58978,21,5,60404,21,5,60823,21,5,60909,21,5,60914,2,22.9,-1.2790196,36.8160867,-1.2906502,36.814118,300,5,1426,505
20306,15032,1834,3,Business,16,1,59886,16,1,59975,16,1,59981,16,1,60629,16,1,62750,6,23.25888921888938,-1.2643683,36.7777614,-1.2693102,36.7981777,908,2121,89,654
20307,24633,2289,3,Business,27,2,36510,27,2,36534,27,2,37561,27,2,37766,27,2,41076,21,18.6,-1.2551895,36.7822034,-1.364627,36.7410927,799,3310,24,1232
20308,5729,3723,1,Personal,15,1,38530,15,1,38550,15,1,38866,15,1,39109,15,1,39772,7,23.25888921888938,-1.300722,36.816865,-1.2628638,36.8070399,726,663,20,559
20309,1596,633,3,Business,21,1,51063,21,1,53792,21,1,53890,21,1,54317,21,1,56077,12,27.6,-1.2991441,36.7528804,-1.3004062,36.829741,436,1760,2729,525
20310,23853,1787,3,Business,16,4,50284,16,4,50420,16,4,54031,16,4,55122,16,4,56399,11,23.25888921888938,-1.279395,36.825364,-1.2283403,36.8822756,907,1277,136,4702
20311,211,2033,2,Personal,4,6,36760,4,6,36796,4,6,37568,4,6,38406,4,6,39524,8,19.9,-1.251921,36.828379,-1.2513591,36.7947674,427,1118,36,1610
20312,27389,2330,3,Business,17,5,48310,17,5,48390,17,5,49429,17,5,49832,17,5,51203,14,23.25888921888938,-1.2925641,36.8976449,-1.3798085,36.9290528,856,1371,80,1442
20313,5256,237,3,Business,13,1,52908,13,1,52924,13,1,53079,13,1,53485,13,1,54979,10,23.25888921888938,-1.2551895,36.7822034,-1.305247,36.7956382,422,1494,16,561
20314,23331,323,1,Business,7,5,33993,7,5,34007,7,5,34651,7,5,36426,7,5,37724,18,18.2,-1.2854453,36.8188363,-1.3632162,36.9108253,74,1298,14,2419
20315,12464,909,3,Business,15,5,50597,15,5,50659,15,5,51495,15,5,53241,15,5,55537,14,17.7,-1.2156006,36.8916865,-1.225322,36.80855,238,2296,62,2582
20316,21415,2539,3,Business,9,5,43434,9,5,43489,9,5,43953,9,5,44222,9,5,46092,5,25.6,-1.2969741,36.7856612,-1.2930037,36.8126474,282,1870,55,733
20317,19315,2582,3,Business,15,5,37069,15,5,38062,15,5,38296,15,5,38759,15,5,39790,9,26.2,-1.327371,36.840591,-1.2703801,36.7985261,411,1031,993,697
20318,27088,3689,3,Business,18,4,45392,18,4,48327,18,4,48615,18,4,52108,18,4,52900,5,26.8,-1.28878,36.8168312,-1.2527958,36.8003131,19,792,2935,3781
20319,24281,2582,3,Business,10,1,59694,10,1,60947,10,1,61935,10,1,62152,10,1,63329,9,18.7,-1.2551895,36.7822034,-1.2985642,36.7707474,112,1177,1253,1205
20320,26547,868,3,Business,2,6,43198,2,6,47871,2,6,49168,2,6,50081,2,6,51692,14,31.2,-1.293515,36.897607,-1.265715,36.823815,411,1611,4673,2210
20321,12091,3287,3,Business,14,5,41255,14,5,41271,14,5,41963,14,5,43869,14,5,46172,18,21.7,-1.2452664,36.8028541,-1.3169591,36.7000029,45,2303,16,2598
20322,3546,478,3,Business,30,2,38692,30,2,39066,30,2,39953,30,2,40285,30,2,42523,7,23.25888921888938,-1.2551895,36.7822034,-1.2885417,36.8100523,598,2238,374,1219
20323,19982,3222,3,Business,29,4,36888,29,4,36945,29,4,37384,29,4,37487,29,4,38002,4,18.7,-1.2551895,36.7822034,-1.2698539,36.8013674,822,515,57,542
20324,17453,53,3,Business,28,4,42618,28,4,42679,28,4,43118,28,4,44572,28,4,44574,5,27.8,-1.3004062,36.829741,-1.2770708,36.8231093,953,2,61,1893
20325,22015,666,2,Personal,24,4,38645,24,4,38808,24,4,40719,24,4,40919,24,4,41820,5,21.4,-1.2770071,36.832167,-1.262423,36.8016471,844,901,163,2111
20326,10500,3222,3,Business,5,1,52721,5,1,52730,5,1,52926,5,1,53357,5,1,54335,7,25.8,-1.2551895,36.7822034,-1.2545163,36.8243717,795,978,9,627
20327,16060,3322,1,Personal,20,3,50136,20,3,50167,20,3,50790,20,3,51038,20,3,52278,9,23.0,-1.2535486,36.7933541,-1.2966822,36.7878163,116,1240,31,871
20328,24950,3434,3,Business,23,2,39984,23,2,40118,23,2,41081,23,2,42380,23,2,45000,16,18.2,-1.2969741,36.7856612,-1.2482465,36.8889062,268,2620,134,2262
20329,20257,3599,3,Business,31,3,44182,31,3,45057,31,3,46415,31,3,49619,31,3,50895,12,26.8,-1.3302996,36.8707935,-1.2874367,36.8804447,427,1276,875,4562
20330,16040,3399,3,Personal,17,5,76394,17,5,77574,17,5,78582,17,5,79086,17,5,79833,9,16.7,-1.2513529,36.752172,-1.2948887,36.7683938,874,747,1180,1512
20331,15565,893,3,Business,3,1,44800,3,1,44978,3,1,44986,3,1,45821,3,1,47574,7,21.5,-1.2663194,36.809901,-1.3001909,36.8163627,876,1753,178,843
20332,13696,1237,1,Personal,2,2,56437,2,2,56621,2,2,57247,2,2,59756,2,2,60722,3,23.4,-1.2599563,36.7993439,-1.2741728,36.7969108,802,966,184,3135
20333,6301,233,1,Personal,5,4,34031,5,4,34404,5,4,34527,5,4,35542,5,4,36366,7,23.25888921888938,-1.2897399,36.8270975,-1.2561914,36.7946542,208,824,373,1138
20334,14337,393,3,Business,26,5,50389,26,5,50463,26,5,52229,26,5,53937,26,5,55980,14,23.25888921888938,-1.3177547,36.8303703,-1.306378,36.7519845,583,2043,74,3474
20335,8339,3525,3,Business,7,2,45016,7,2,47752,7,2,48408,7,2,48702,7,2,50805,23,23.25888921888938,-1.3700383,36.9190174,-1.2571472,36.7950633,233,2103,2736,950
20336,16787,248,3,Business,21,4,45982,21,4,46013,21,4,46411,21,4,46637,21,4,48298,10,25.1,-1.304735,36.7846054,-1.3264988,36.7108709,545,1661,31,624
20337,27104,517,3,Business,18,5,51010,18,5,53383,18,5,53528,18,5,57152,18,5,57538,5,24.5,-1.3004062,36.829741,-1.3177547,36.8303703,56,386,2373,3769
20338,7170,1850,3,Business,18,1,44509,18,1,44634,18,1,44976,18,1,46882,18,1,46899,8,26.8,-1.2551895,36.7822034,-1.3047132,36.8089553,498,17,125,2248
20339,18125,111,3,Business,10,5,40025,10,5,40218,10,5,40225,10,5,40885,10,5,42958,12,23.25888921888938,-1.2551895,36.7822034,-1.318049,36.8556554,843,2073,193,667
20340,3563,3080,3,Business,24,2,58975,24,2,58986,24,2,59401,24,2,59615,24,2,61193,4,18.7,-1.2551895,36.7822034,-1.2699442,36.8206553,519,1578,11,629
20341,16715,2050,1,Personal,7,1,36816,7,1,36856,7,1,37310,7,1,37736,7,1,37960,2,18.2,-1.2982033,36.8092632,-1.285495,36.7981347,100,224,40,880
20342,13509,1402,3,Business,19,2,39836,19,2,39870,19,2,41227,19,2,42162,19,2,42310,1,26.5,-1.290894,36.822971,-1.2813012,36.8323962,462,148,34,2292
20343,24316,346,3,Business,15,1,56928,15,1,57012,15,1,57542,15,1,58289,15,1,59477,11,23.25888921888938,-1.2413316,36.8785525,-1.28878,36.8168312,709,1188,84,1277
20344,6294,419,3,Business,25,1,51299,25,1,51323,25,1,51347,25,1,52274,25,1,59124,20,27.9,-1.2571472,36.7950633,-1.3700383,36.9190174,647,6850,24,951
20345,20665,783,2,Personal,16,2,49288,16,2,49898,16,2,50747,16,2,50871,16,2,52100,13,27.2,-1.2963367,36.8116871,-1.2380935,36.8072947,726,1229,610,973
20346,18762,3701,3,Business,8,3,56011,8,3,56034,8,3,56397,8,3,56457,8,3,57787,8,23.25888921888938,-1.2612574,36.7879622,-1.300722,36.816865,520,1330,23,423
20347,4461,3432,3,Business,4,6,37673,4,6,38311,4,6,39325,4,6,40058,4,6,42539,21,23.25888921888938,-1.2672588,36.8000252,-1.3130876,36.6806488,675,2481,638,1747
20348,21018,1080,1,Personal,28,4,57397,28,4,57401,28,4,58189,28,4,58524,28,4,60609,15,23.25888921888938,-1.2735236,36.7992196,-1.2129741,36.7888112,895,2085,4,1123
20349,14099,3283,3,Business,6,3,56893,6,3,57201,6,3,58180,6,3,58827,6,3,59654,7,27.4,-1.2783849,36.8163445,-1.2628473,36.781805,156,827,308,1626
20350,19249,107,1,Personal,6,1,55220,6,1,55306,6,1,56264,6,1,56409,6,1,57808,9,24.7,-1.29276,36.783799,-1.3134524,36.8064495,722,1399,86,1103
20351,21898,296,3,Business,16,2,30725,16,2,30777,16,2,31304,16,2,32191,16,2,33382,8,23.25888921888938,-1.2571472,36.7950633,-1.2976854,36.7753586,96,1191,52,1414
20352,1716,3108,3,Business,29,5,50964,29,5,51439,29,5,52502,29,5,52627,29,5,57652,14,21.1,-1.2551895,36.7822034,-1.3164474,36.8575861,88,5025,475,1188
20353,23715,3426,3,Business,7,3,61023,7,3,61116,7,3,62299,7,3,62695,7,3,63879,5,25.3,-1.3014461,36.7661381,-1.2896933,36.7929035,920,1184,93,1579
20354,148,20,3,Business,18,4,54521,18,4,56523,18,4,60829,18,4,61530,18,4,64847,27,23.25888921888938,-1.413547,36.9550764,-1.2628638,36.8070399,539,3317,2002,5007
20355,23937,3767,1,Personal,12,2,51475,12,2,51529,12,2,52404,12,2,52533,12,2,53813,11,23.1,-1.308819,36.8421201,-1.2649783,36.8071436,726,1280,54,1004
20356,15019,3517,3,Business,9,2,41334,9,2,41345,9,2,41348,9,2,41816,9,2,43752,16,27.1,-1.3882008,36.7699445,-1.300921,36.828195,871,1936,11,471
20357,21647,517,3,Business,16,6,34951,16,6,34965,16,6,34972,16,6,37882,16,6,37886,14,20.4,-1.3167113,36.8301563,-1.306378,36.7519845,39,4,14,2917
20358,1032,2063,3,Business,25,1,31777,25,1,31830,25,1,32449,25,1,33259,25,1,34395,8,21.0,-1.2577289,36.7410772,-1.2551895,36.7822034,655,1136,53,1429
20359,4983,972,3,Business,23,5,44709,23,5,44726,23,5,44851,23,5,45427,23,5,47585,21,24.0,-1.2862033,36.8152966,-1.3606809,36.9427964,456,2158,17,701
20360,13212,3686,3,Business,22,2,51487,22,2,51521,22,2,51533,22,2,53504,22,2,54255,3,21.4,-1.2626906,36.7827022,-1.2607765,36.8080021,51,751,34,1983
20361,5094,3326,3,Business,8,5,46918,8,5,47556,8,5,48560,8,5,48907,8,5,50966,19,27.4,-1.2551895,36.7822034,-1.3244885,36.897792,281,2059,638,1351
20362,27095,2066,3,Business,6,4,47066,6,4,47158,6,4,47866,6,4,47957,6,4,48433,3,21.9,-1.316961,36.820337,-1.3044313,36.818504,844,476,92,799
20363,11316,2586,1,Personal,28,1,45226,28,1,45698,28,1,46401,28,1,46497,28,1,47279,6,22.6,-1.2819626,36.7540971,-1.2879437,36.7923297,46,782,472,799
20364,11790,1363,3,Business,27,2,42007,27,2,42365,27,2,42375,27,2,42616,27,2,43593,5,24.0,-1.3004062,36.829741,-1.2976559,36.7914147,539,977,358,251
20365,864,202,1,Personal,15,6,38144,15,6,38162,15,6,38907,15,6,39034,15,6,40395,12,23.25888921888938,-1.3178524,36.7139804,-1.3222489,36.7867025,288,1361,18,872
20366,22906,1391,1,Personal,25,1,61441,25,1,61507,25,1,61972,25,1,62285,25,1,62900,5,23.25888921888938,-1.250142,36.788155,-1.2764851,36.8007126,351,615,66,778
20367,19416,1578,3,Business,27,2,38213,27,2,39586,27,2,40603,27,2,41030,27,2,41493,2,24.0,-1.290894,36.822971,-1.28878,36.8168312,456,463,1373,1444
20368,18707,914,3,Business,24,3,55450,24,3,55470,24,3,55487,24,3,56094,24,3,57438,11,23.25888921888938,-1.2670213,36.7994482,-1.3270716,36.8406371,81,1344,20,624
20369,27940,2523,3,Business,29,3,41152,29,3,41167,29,3,41233,29,3,41711,29,3,42875,4,23.25888921888938,-1.2551895,36.7822034,-1.2689015,36.7986106,161,1164,15,544
20370,15261,2112,3,Business,29,3,65115,29,3,67833,29,3,68588,29,3,68847,29,3,69463,4,19.3,-1.2297202,36.8819507,-1.2156006,36.8916865,384,616,2718,1014
20371,10087,1642,3,Business,6,3,52626,6,3,55531,6,3,56573,6,3,57240,6,3,59058,5,23.25888921888938,-1.2797536,36.8223726,-1.2726506,36.7960153,436,1818,2905,1709
20372,27781,142,3,Business,13,2,30698,13,2,32202,13,2,34086,13,2,34166,13,2,34796,6,19.9,-1.2857723,36.8088058,-1.2963097,36.7688221,486,630,1504,1964
20373,10248,2412,3,Business,11,1,36083,11,1,36208,11,1,37153,11,1,37363,11,1,38410,10,14.5,-1.2873639,36.8256076,-1.2297202,36.8745508,752,1047,125,1155
20374,18568,2693,1,Personal,19,5,49324,19,5,50074,19,5,50624,19,5,51214,19,5,51931,4,27.5,-1.2521181,36.8104419,-1.2609186,36.7938342,467,717,750,1140
20375,18555,1191,1,Personal,23,4,39497,23,4,39756,23,4,41160,23,4,41675,23,4,42379,4,18.3,-1.3282758,36.8590281,-1.32589,36.831679,777,704,259,1919
20376,2639,3339,3,Business,14,4,55400,14,4,55458,14,4,56837,14,4,57022,14,4,58258,2,27.5,-1.2551895,36.7822034,-1.2566586,36.7929682,660,1236,58,1564
20377,22942,393,3,Business,11,2,35963,11,2,35993,11,2,36118,11,2,36526,11,2,38702,13,16.6,-1.3228003,36.8306435,-1.2991441,36.7528804,36,2176,30,533
20378,15724,909,3,Business,11,1,52076,11,1,52287,11,1,52777,11,1,52959,11,1,54361,14,28.2,-1.2156006,36.8916865,-1.225322,36.80855,199,1402,211,672
20379,26661,1205,3,Business,16,2,54959,16,2,54985,16,2,55571,16,2,56240,16,2,56971,3,23.25888921888938,-1.2495931,36.8065087,-1.2549259,36.7919494,858,731,26,1255
20380,4289,53,3,Business,4,2,50241,4,2,50927,4,2,52580,4,2,54627,4,2,55816,5,22.7,-1.3004062,36.829741,-1.2770708,36.8231093,42,1189,686,3700
20381,4828,868,3,Business,30,4,33624,30,4,34156,30,4,34765,30,4,36182,30,4,36184,9,19.3,-1.2296618,36.8438272,-1.265715,36.823815,740,2,532,2026
20382,24120,3686,3,Business,17,2,38400,17,2,38434,17,2,38764,17,2,39310,17,2,40018,6,18.9,-1.2551895,36.7822034,-1.2707742,36.7578609,116,708,34,876
20383,24378,391,3,Business,2,4,32444,2,4,32505,2,4,33232,2,4,35835,2,4,37162,16,23.25888921888938,-1.2089042,36.7699002,-1.2867454,36.8259017,193,1327,61,3330
20384,913,868,3,Business,23,1,60897,23,1,61014,23,1,62571,23,1,64272,23,1,64828,5,19.0,-1.2600926,36.8088685,-1.265715,36.823815,174,556,117,3258
20385,25711,2289,3,Business,25,5,42488,25,5,42517,25,5,43094,25,5,43271,25,5,44411,8,20.9,-1.2553615,36.7895376,-1.2956951,36.8129242,742,1140,29,754
20386,23291,2066,3,Business,25,4,56792,25,4,57008,25,4,57509,25,4,57684,25,4,59108,9,20.9,-1.316961,36.820337,-1.25454,36.83922,257,1424,216,676
20387,21453,517,3,Business,30,4,54463,30,4,54553,30,4,56651,30,4,58272,30,4,61561,11,23.25888921888938,-1.3228003,36.8306435,-1.2638185,36.7930057,459,3289,90,3719
20388,47,53,3,Business,7,2,33638,7,2,33656,7,2,34219,7,2,36754,7,2,37793,5,16.7,-1.3004062,36.829741,-1.2770708,36.8231093,208,1039,18,3098
20389,16226,2956,3,Business,11,1,35698,11,1,35842,11,1,37513,11,1,37972,11,1,39094,14,26.4,-1.207546,36.7913976,-1.2584143,36.8048002,764,1122,144,2130
20390,22870,1245,3,Business,29,1,56159,29,1,56266,29,1,57725,29,1,59029,29,1,60052,13,23.25888921888938,-1.300921,36.828195,-1.335145,36.7393222,341,1023,107,2763
20391,10581,2195,1,Business,15,6,32154,15,6,32362,15,6,32729,15,6,33233,15,6,34069,10,17.7,-1.265715,36.823815,-1.3313643,36.8577422,882,836,208,871
20392,23392,1159,1,Personal,20,1,40089,20,1,40135,20,1,41375,20,1,42168,20,1,43803,13,20.3,-1.3034318,36.7520402,-1.3068448,36.8348641,402,1635,46,2033
20393,1814,2801,3,Business,14,3,36507,14,3,36518,14,3,36531,14,3,36743,14,3,38391,14,18.5,-1.3288576,36.8465936,-1.2595422,36.7871178,387,1648,11,225
20394,4674,3091,3,Business,21,2,43005,21,2,43041,21,2,43636,21,2,43832,21,2,45271,9,19.6,-1.264272,36.7978791,-1.3014461,36.7661381,452,1439,36,791
20395,10329,2464,3,Business,3,1,57896,3,1,58515,3,1,59422,3,1,59607,3,1,60357,7,17.6,-1.279395,36.825364,-1.2551895,36.7822034,344,750,619,1092
20396,13388,2763,3,Business,16,3,40531,16,3,40583,16,3,41076,16,3,42521,16,3,44334,12,22.7,-1.3215394,36.836621,-1.2551895,36.7822034,523,1813,52,1938
20397,196,435,3,Business,30,4,43127,30,4,43179,30,4,43792,30,4,44002,30,4,45761,13,23.25888921888938,-1.2569714,36.7799637,-1.300921,36.828195,533,1759,52,823
20398,24324,496,3,Business,7,4,33440,7,4,33567,7,4,35320,7,4,35390,7,4,37438,3,14.2,-1.2553615,36.7895376,-1.2595467,36.8113044,131,2048,127,1823
20399,826,972,3,Business,26,3,32512,26,3,32806,26,3,33441,26,3,33679,26,3,34777,9,19.2,-1.2862033,36.8152966,-1.2953212,36.7632608,726,1098,294,873
20400,21378,281,2,Personal,13,1,45156,13,1,45188,13,1,45865,13,1,46023,13,1,47283,8,17.0,-1.2996373,36.7693721,-1.2795796,36.819062,229,1260,32,835
20401,20696,868,3,Business,13,6,39691,13,6,39705,13,6,40268,13,6,41146,13,6,42916,19,25.9,-1.3181159,36.7101559,-1.265715,36.823815,291,1770,14,1441
20402,2947,3175,3,Business,9,5,40071,9,5,40104,9,5,40792,9,5,41382,9,5,41830,4,25.5,-1.255956,36.772901,-1.2681004,36.7952081,518,448,33,1278
20403,8681,1425,3,Business,7,4,42389,7,4,42411,7,4,43172,7,4,43467,7,4,45580,4,27.7,-1.2803877,36.8300596,-1.3004062,36.829741,590,2113,22,1056
20404,26258,1899,3,Business,25,1,50823,25,1,50864,25,1,50869,25,1,51527,25,1,52461,11,23.25888921888938,-1.272828,36.816608,-1.331619,36.847976,406,934,41,663
20405,10975,635,3,Business,29,2,32566,29,2,33049,29,2,33715,29,2,36312,29,2,37667,8,16.4,-1.3016417,36.8271679,-1.2668093,36.7966542,888,1355,483,3263
20406,14813,2987,3,Business,8,4,38992,8,4,40289,8,4,40862,8,4,40940,8,4,41576,3,26.4,-1.270212,36.8210877,-1.2649605,36.7981777,517,636,1297,651
20407,10394,2195,3,Business,13,1,53403,13,1,53620,13,1,55938,13,1,56568,13,1,57837,6,23.25888921888938,-1.2296618,36.8438272,-1.228911,36.881876,787,1269,217,2948
20408,6096,53,3,Business,24,5,43114,24,5,43545,24,5,44425,24,5,45296,24,5,46752,8,21.4,-1.3167113,36.8301563,-1.2770708,36.8231093,2,1456,431,1751
20409,27679,391,3,Business,26,2,37121,26,2,37476,26,2,38043,26,2,38205,26,2,40369,5,27.3,-1.2602337,36.7990548,-1.2867454,36.8259017,76,2164,355,729
20410,21893,646,3,Personal,27,4,52285,27,4,52567,27,4,53653,27,4,54090,27,4,54802,3,25.3,-1.3272709,36.711442,-1.306004,36.707987,565,712,282,1523
20411,5334,346,3,Business,28,4,59309,28,4,59420,28,4,60422,28,4,61018,28,4,62759,5,25.5,-1.2527958,36.8003131,-1.28878,36.8168312,177,1741,111,1598
20412,11731,2066,3,Business,2,4,60716,2,4,60830,2,4,61563,2,4,61779,2,4,63172,9,23.25888921888938,-1.3210189,36.8410551,-1.2684319,36.8165853,709,1393,114,949
20413,12625,3201,3,Business,18,1,58890,18,1,58958,18,1,59909,18,1,60388,18,1,62001,3,28.6,-1.2584143,36.8048002,-1.2551895,36.7822034,647,1613,68,1430
20414,1841,496,3,Business,15,5,46247,15,5,46272,15,5,46374,15,5,46882,15,5,49090,13,26.0,-1.2551895,36.7822034,-1.3024388,36.859699,926,2208,25,610
20415,3260,929,2,Personal,19,3,50501,19,3,50517,19,3,51094,19,3,51664,19,3,52929,9,25.5,-1.2563755,36.8215762,-1.2873232,36.7658572,263,1265,16,1147
20416,13190,2330,3,Business,13,3,41102,13,3,41118,13,3,41322,13,3,41523,13,3,43471,12,24.6,-1.3443583,36.7571528,-1.2915247,36.8055757,798,1948,16,405
20417,4315,1280,3,Business,30,2,38933,30,2,39500,30,2,39790,30,2,40700,30,2,44012,8,23.25888921888938,-1.2551895,36.7822034,-1.2993556,36.8146776,291,3312,567,1200
20418,20109,1797,2,Personal,13,1,61449,13,1,61529,13,1,61714,13,1,62843,13,1,63548,5,19.4,-1.2827576,36.7830241,-1.2971379,36.8019794,228,705,80,1314
20419,22746,193,2,Personal,18,5,34888,18,5,34975,18,5,36065,18,5,36483,18,5,37163,6,17.6,-1.2562249,36.7868661,-1.2698168,36.7421898,216,680,87,1508
20420,10656,3291,3,Business,28,2,48206,28,2,48361,28,2,49954,28,2,51234,28,2,53599,18,23.5,-1.3393547,36.8910035,-1.2600926,36.8088685,674,2365,155,2873
20421,7328,111,3,Business,2,4,55670,2,4,55726,2,4,56307,2,4,56636,2,4,59016,10,26.2,-1.2551895,36.7822034,-1.3156452,36.815802,882,2380,56,910
20422,3475,2828,1,Business,20,5,66216,20,5,66741,20,5,67509,20,5,67871,20,5,69487,9,20.1,-1.305399,36.8221849,-1.328751,36.8818019,549,1616,525,1130
20423,3711,868,3,Business,22,2,52910,22,2,53086,22,2,53147,22,2,55281,22,2,56185,10,25.5,-1.228911,36.881876,-1.265715,36.823815,75,904,176,2195
20424,6160,890,3,Personal,2,1,52597,2,1,52825,2,1,53622,2,1,54529,2,1,56362,12,20.2,-1.2658315,36.809049,-1.3400922,36.7839494,379,1833,228,1704
20425,4342,1181,3,Personal,19,2,51477,19,2,51541,19,2,53173,19,2,53483,19,2,55633,9,29.2,-1.2597436,36.8282526,-1.2258409,36.7786803,63,2150,64,1942
20426,2103,2587,3,Business,27,3,55270,27,3,56493,27,3,59939,27,3,60952,27,3,62333,3,27.5,-1.2994772,36.804825,-1.28878,36.8168312,668,1381,1223,4459
20427,10206,2956,3,Business,11,4,53932,11,4,53964,11,4,54772,11,4,55572,11,4,57996,17,26.9,-1.323615,36.700475,-1.2584143,36.8048002,691,2424,32,1608
20428,26976,1976,3,Business,21,4,38453,21,4,38487,21,4,38876,21,4,38986,21,4,40519,7,25.1,-1.257028,36.7810435,-1.2778153,36.7955703,523,1533,34,499
20429,700,955,2,Personal,6,1,59798,6,1,59929,6,1,61804,6,1,63720,6,1,64456,5,22.3,-1.2901786,36.824294,-1.2579172,36.7938337,857,736,131,3791
20430,22627,972,3,Business,29,1,38664,29,1,38691,29,1,39175,29,1,39241,29,1,40876,10,23.25888921888938,-1.2862033,36.8152966,-1.3211235,36.7765164,250,1635,27,550
20431,17915,3401,1,Personal,27,4,45216,27,4,45243,27,4,45400,27,4,45995,27,4,46642,2,22.9,-1.2685424,36.8156049,-1.2697141,36.7981777,280,647,27,752
20432,610,3560,3,Business,25,1,42119,25,1,42151,25,1,42970,25,1,43057,25,1,45586,5,25.7,-1.2765736,36.8513646,-1.279395,36.825364,686,2529,32,906
20433,22716,2408,3,Personal,25,1,55126,25,1,55197,25,1,55439,25,1,56176,25,1,59165,6,23.25888921888938,-1.2972835,36.809687,-1.2655477,36.8001682,192,2989,71,979
20434,16993,2041,1,Business,6,3,48230,6,3,48973,6,3,49104,6,3,49250,6,3,49255,3,21.6,-1.290894,36.822971,-1.2677588,36.8169359,714,5,743,277
20435,4165,3291,3,Business,27,1,39358,27,1,39377,27,1,39866,27,1,40951,27,1,42179,11,20.9,-1.303596,36.778378,-1.2600926,36.8088685,708,1228,19,1574
20436,17668,1207,3,Business,11,1,43805,11,1,43813,11,1,44820,11,1,45225,11,1,47094,20,24.1,-1.2156719,36.7990906,-1.2745321,36.765088,932,1869,8,1412
20437,4933,2763,3,Business,22,5,46179,22,5,46199,22,5,46812,22,5,47080,22,5,48984,13,23.25888921888938,-1.2551895,36.7822034,-1.326825,36.864345,452,1904,20,881
20438,10996,1698,3,Personal,12,2,55628,12,2,56435,12,2,57516,12,2,57639,12,2,59164,7,23.1,-1.2622227,36.795888,-1.298988,36.81075,898,1525,807,1204
20439,9749,2627,3,Business,23,5,36624,23,5,37339,23,5,38361,23,5,39055,23,5,41966,17,24.1,-1.3472066,36.7692638,-1.2571472,36.7950633,254,2911,715,1716
20440,21607,1705,3,Business,11,1,33328,11,1,33490,11,1,33727,11,1,34106,11,1,34901,8,17.8,-1.2551895,36.7822034,-1.2714995,36.8375733,576,795,162,616
20441,17382,909,3,Business,5,2,50485,5,2,50623,5,2,52234,5,2,53196,5,2,54484,8,23.25888921888938,-1.2287314,36.8367354,-1.225322,36.80855,8,1288,138,2573
20442,6618,868,3,Business,25,4,47379,25,4,48239,25,4,49445,25,4,49948,25,4,50794,5,23.25888921888938,-1.2600926,36.8088685,-1.265715,36.823815,709,846,860,1709
20443,19191,868,3,Business,12,2,52016,12,2,52182,12,2,53980,12,2,54288,12,2,55058,7,26.9,-1.2628473,36.781805,-1.265715,36.823815,79,770,166,2106
20444,10516,1544,3,Business,16,4,39877,16,4,39930,16,4,40512,16,4,40907,16,4,41771,3,23.25888921888938,-1.2851603,36.8249667,-1.2625042,36.812478,843,864,53,977
20445,20886,2701,3,Business,1,4,39748,1,4,40267,1,4,41353,1,4,42932,1,4,44348,6,23.25888921888938,-1.28878,36.8168312,-1.2765736,36.8513646,477,1416,519,2665
20446,10092,1502,3,Business,8,2,48609,8,2,48667,8,2,49291,8,2,49709,8,2,51842,13,25.4,-1.2527958,36.8003131,-1.2232123,36.8932547,715,2133,58,1042
20447,27578,3291,3,Business,12,2,41009,12,2,41055,12,2,43528,12,2,44376,12,2,45677,12,28.1,-1.228911,36.881876,-1.2600926,36.8088685,75,1301,46,3321
20448,6295,3661,3,Business,6,4,34060,6,4,34123,6,4,35502,6,4,35840,6,4,37917,15,16.0,-1.2132866,36.8678274,-1.3090727,36.8315262,291,2077,63,1717
20449,14159,2896,3,Business,10,6,42929,10,6,43027,10,6,44781,10,6,45059,10,6,49590,18,23.9,-1.3338005,36.863026,-1.2336076,36.8336102,114,4531,98,2032
20450,14557,190,3,Business,12,3,54844,12,3,54844,12,3,56422,12,3,58759,12,3,61734,9,21.2,-1.2897399,36.8270975,-1.3270347,36.8667362,573,2975,0,3915
20451,6960,1920,3,Business,28,3,27079,28,3,27152,28,3,28048,28,3,28333,28,3,29931,15,20.6,-1.2551895,36.7822034,-1.3221141,36.8636835,205,1598,73,1181
20452,23138,2949,3,Personal,24,1,51724,24,1,51735,24,1,52040,24,1,52273,24,1,53571,10,23.25888921888938,-1.3080793,36.7505396,-1.2882073,36.8237673,85,1298,11,538
20453,13910,3353,1,Personal,11,2,38235,11,2,38316,11,2,39461,11,2,39783,11,2,41010,9,24.1,-1.2248308,36.8012573,-1.275941,36.8074434,857,1227,81,1467
20454,19281,1970,1,Personal,29,6,40719,29,6,40771,29,6,41216,29,6,44986,29,6,45639,6,25.2,-1.3099295,36.8436807,-1.2862033,36.8152966,74,653,52,4215
20455,10270,3283,3,Business,10,4,46848,10,4,50457,10,4,51781,10,4,52078,10,4,53483,7,25.0,-1.2783849,36.8163445,-1.2628473,36.781805,553,1405,3609,1621
20456,20309,3264,3,Business,13,4,52130,13,4,52273,13,4,53110,13,4,53324,13,4,56086,24,22.4,-1.2551895,36.7822034,-1.364732,36.658943,846,2762,143,1051
20457,9374,496,3,Business,22,4,33541,22,4,33578,22,4,33772,22,4,34092,22,4,34195,2,19.6,-1.2551895,36.7822034,-1.2561334,36.7990458,803,103,37,514
20458,28145,2801,3,Business,14,1,48805,14,1,48851,14,1,50718,14,1,50785,14,1,52210,7,25.5,-1.2879652,36.8203441,-1.2595422,36.7871178,432,1425,46,1934
20459,11480,53,3,Business,16,6,37371,16,6,37468,16,6,37932,16,6,39273,16,6,40249,5,25.5,-1.3004062,36.829741,-1.2770708,36.8231093,674,976,97,1805
20460,6060,2701,3,Business,6,3,40135,6,3,40587,6,3,40950,6,3,41258,6,3,42112,5,22.5,-1.279395,36.825364,-1.2765736,36.8513646,953,854,452,671
20461,3282,868,3,Business,18,2,39381,18,2,41148,18,2,41148,18,2,42548,18,2,44276,8,23.25888921888938,-1.303596,36.778378,-1.265715,36.823815,770,1728,1767,1400
20462,810,3201,3,Business,18,4,56666,18,4,56712,18,4,58199,18,4,58558,18,4,58799,2,23.25888921888938,-1.2584143,36.8048002,-1.2591019,36.800577,394,241,46,1846
20463,27815,136,3,Business,10,1,46517,10,1,46571,10,1,46679,10,1,47304,10,1,47804,1,18.7,-1.2654716,36.7983635,-1.2531983,36.8069669,547,500,54,733
20464,10626,901,1,Personal,18,3,34259,18,3,40880,18,3,41790,18,3,41965,18,3,44193,17,20.0,-1.3688433,36.7402114,-1.2962832,36.7849683,74,2228,6621,1085
20465,5326,2523,3,Business,11,2,38045,11,2,40275,11,2,40436,11,2,40534,11,2,42050,8,19.2,-1.2551895,36.7822034,-1.29387,36.7907813,532,1516,2230,259
20466,7119,3750,3,Personal,17,7,50067,17,7,50091,17,7,51773,17,7,53274,17,7,56159,13,29.0,-1.3438225,36.6664253,-1.3881391,36.7367636,647,2885,24,3183
20467,22830,2237,3,Business,1,5,56763,1,5,58676,1,5,59775,1,5,60250,1,5,61484,3,30.6,-1.266571,36.801406,-1.2574088,36.799712,720,1234,1913,1574
20468,27367,2066,3,Business,13,1,32966,13,1,32974,13,1,33313,13,1,33988,13,1,36894,11,15.2,-1.316961,36.820337,-1.2580991,36.7941519,329,2906,8,1014
20469,7592,1329,3,Business,27,1,58704,27,1,58768,27,1,59340,27,1,59611,27,1,62582,21,23.25888921888938,-1.273056,36.811298,-1.2995252,36.6871615,829,2971,64,843
20470,1739,3574,1,Personal,5,3,48985,5,3,49034,5,3,49805,5,3,50230,5,3,51063,6,23.6,-1.2876575,36.8282355,-1.257309,36.8060084,726,833,49,1196
20471,14660,1796,3,Business,14,4,55102,14,4,55279,14,4,55289,14,4,57049,14,4,58814,13,27.4,-1.303596,36.778378,-1.331619,36.847976,669,1765,177,1770
20472,17645,868,3,Business,13,6,49739,13,6,49754,13,6,49796,13,6,50910,13,6,51521,4,27.5,-1.2600926,36.8088685,-1.265715,36.823815,72,611,15,1156
20473,22069,3647,3,Business,22,5,52981,22,5,53097,22,5,53530,22,5,54051,22,5,54740,5,31.0,-1.272639,36.794723,-1.2800978,36.7769171,576,689,116,954
20474,27297,637,2,Business,4,2,46912,4,2,47106,4,2,48470,4,2,48657,4,2,51927,12,19.0,-1.2651218,36.8228765,-1.2577289,36.7410772,754,3270,194,1551
20475,17887,2069,3,Business,27,3,41101,27,3,41112,27,3,41314,27,3,41667,27,3,43436,16,25.8,-1.303596,36.778378,-1.228911,36.881876,306,1769,11,555
20476,15455,3287,3,Business,15,2,38531,15,2,38592,15,2,39154,15,2,39489,15,2,41757,11,24.3,-1.2452664,36.8028541,-1.2969741,36.7856612,56,2268,61,897
20477,22370,246,3,Business,28,1,42615,28,1,43603,28,1,44460,28,1,47047,28,1,48291,23,22.7,-1.311342,36.913268,-1.2584143,36.8048002,832,1244,988,3444
20478,13373,393,3,Business,12,2,46174,12,2,46181,12,2,46190,12,2,49130,12,2,49133,14,26.9,-1.3167113,36.8301563,-1.306378,36.7519845,239,3,7,2949
20479,20702,1245,3,Business,15,2,53888,15,2,55207,15,2,55771,15,2,56512,15,2,59165,18,24.4,-1.300921,36.828195,-1.177202,36.8351183,14,2653,1319,1305
20480,6022,136,3,Business,21,2,43558,21,2,43622,21,2,44200,21,2,44720,21,2,46211,17,22.3,-1.2629838,36.8086926,-1.3254522,36.7216584,404,1491,64,1098
20481,21155,3669,3,Business,24,4,43810,24,4,43877,24,4,44610,24,4,44678,24,4,46221,6,24.3,-1.2615888,36.7928732,-1.286553,36.8273374,511,1543,67,801
20482,18678,246,3,Business,24,3,45611,24,3,45673,24,3,46063,24,3,46248,24,3,49556,6,19.7,-1.2584143,36.8048002,-1.2876659,36.8046788,660,3308,62,575
20483,6092,136,3,Business,5,3,32566,5,3,32584,5,3,32901,5,3,33436,5,3,34971,12,18.5,-1.2738338,36.782403,-1.3326173,36.7146233,74,1535,18,852
20484,21857,653,3,Business,24,1,45385,24,1,45402,24,1,45948,24,1,46079,24,1,47235,5,22.5,-1.279395,36.825364,-1.303105,36.819135,148,1156,17,677
20485,20012,138,3,Business,27,3,55663,27,3,55945,27,3,59013,27,3,59281,27,3,61327,7,29.7,-1.2615888,36.7928732,-1.2813012,36.8323962,855,2046,282,3336
20486,4384,2763,3,Business,16,5,53587,16,5,62681,16,5,62774,16,5,63039,16,5,63800,8,26.4,-1.2551895,36.7822034,-1.3038156,36.8122733,774,761,9094,358
20487,18597,1882,3,Business,20,3,31886,20,3,31918,20,3,32680,20,3,34375,20,3,35115,6,21.0,-1.2956882,36.7861845,-1.2591019,36.800577,125,740,32,2457
20488,5860,1500,3,Business,30,2,56617,30,2,60555,30,2,62155,30,2,62971,30,2,63245,2,23.25888921888938,-1.2638185,36.7930057,-1.2567464,36.7915273,132,274,3938,2416
20489,8902,2463,2,Personal,18,5,52599,18,5,52698,18,5,53677,18,5,54071,18,5,56236,14,24.5,-1.3082165,36.8320031,-1.2368654,36.7534908,791,2165,99,1373
20490,13658,814,3,Business,10,4,47969,10,4,48009,10,4,48308,10,4,48418,10,4,52782,20,23.25888921888938,-1.2579304,36.8019667,-1.3303979,36.9138183,865,4364,40,409
20491,5543,1131,3,Business,26,5,65840,26,5,65963,26,5,66620,26,5,66751,26,5,67469,8,23.25888921888938,-1.225322,36.80855,-1.207546,36.7913976,7,718,123,788
20492,19850,2277,3,Business,20,5,50639,20,5,50669,20,5,51380,20,5,52834,20,5,53873,9,20.6,-1.2585521,36.7945765,-1.3030546,36.8101808,379,1039,30,2165
20493,4896,830,3,Business,21,5,58346,21,5,58362,21,5,59544,21,5,59811,21,5,64459,20,22.8,-1.2551895,36.7822034,-1.3523738,36.7266216,38,4648,16,1449
20494,10354,1402,3,Business,4,2,44870,4,2,47294,4,2,48145,4,2,49057,4,2,50039,11,22.5,-1.2285835,36.8826468,-1.2813012,36.8323962,291,982,2424,1763
20495,16955,1500,3,Business,22,3,27906,22,3,27945,22,3,28945,22,3,29977,22,3,31012,8,18.6,-1.3004062,36.829741,-1.2638185,36.7930057,2,1035,39,2032
20496,2277,1544,3,Business,10,1,42011,10,1,43509,10,1,44373,10,1,45731,10,1,47279,7,23.4,-1.2924639,36.7795798,-1.2885029,36.825605,853,1548,1498,2222
20497,21749,1051,3,Business,11,4,43095,11,4,43274,11,4,44756,11,4,45796,11,4,46840,8,25.4,-1.2963097,36.7688221,-1.28523,36.8248292,855,1044,179,2522
20498,17549,1075,3,Business,8,5,45294,8,5,45322,8,5,45366,8,5,45924,8,5,46566,3,24.2,-1.2527958,36.8003131,-1.2551895,36.7822034,539,642,28,602
20499,5544,150,3,Business,4,3,43005,4,3,43062,4,3,43341,4,3,44139,4,3,46069,8,17.1,-1.3039695,36.7838267,-1.2661264,36.8030359,917,1930,57,1077
20500,1772,393,3,Business,9,4,37211,9,4,37225,9,4,37230,9,4,38223,9,4,40244,14,23.25888921888938,-1.3167113,36.8301563,-1.2991441,36.7528804,349,2021,14,998
20501,1090,2956,3,Business,15,3,35751,15,3,36002,15,3,36285,15,3,36446,15,3,39283,6,23.25888921888938,-1.2584143,36.8048002,-1.2854151,36.8233848,921,2837,251,444
20502,26818,2803,1,Business,24,1,50915,24,1,50954,24,1,52233,24,1,53338,24,1,54026,3,23.25888921888938,-1.2765736,36.8513646,-1.2689599,36.8398401,851,688,39,2384
20503,5016,3184,3,Business,13,2,52739,13,2,52749,13,2,53505,13,2,55075,13,2,58086,15,26.4,-1.2877831,36.8146624,-1.3396256,36.8863135,330,3011,10,2326
20504,16850,1628,3,Personal,7,5,47114,7,5,47206,7,5,48178,7,5,48990,7,5,51233,14,23.25888921888938,-1.3376959,36.7605707,-1.2963097,36.7688221,868,2243,92,1784
20505,5218,2794,3,Personal,3,4,57263,3,4,57301,3,4,57496,3,4,57986,3,4,58453,4,25.9,-1.2733047,36.8109744,-1.2598849,36.8219979,247,467,38,685
20506,27516,540,3,Business,14,2,52485,14,2,52562,14,2,52690,14,2,53938,14,2,54784,8,23.25888921888938,-1.2551895,36.7822034,-1.2934638,36.7668028,291,846,77,1376
20507,25968,633,3,Business,27,3,57703,27,3,57760,27,3,58213,27,3,58586,27,3,59069,4,29.2,-1.3077869,36.8443207,-1.3004062,36.829741,85,483,57,826
20508,6521,3494,3,Personal,24,1,45439,24,1,45449,24,1,45474,24,1,48632,24,1,49750,10,22.3,-1.2892959,36.8378671,-1.2963097,36.7688221,179,1118,10,3183
20509,12990,1578,3,Business,28,3,55952,28,3,64165,28,3,64834,28,3,65530,28,3,67195,10,23.0,-1.225322,36.80855,-1.28878,36.8168312,511,1665,8213,1365
20510,12243,635,3,Business,8,1,42916,8,1,42947,8,1,43270,8,1,44647,8,1,47325,10,28.0,-1.3081376,36.8329772,-1.2602337,36.7990548,923,2678,31,1700
20511,13656,393,3,Business,25,4,29877,25,4,29915,25,4,29925,25,4,34161,25,4,36575,14,16.5,-1.3177547,36.8303703,-1.306378,36.7519845,608,2414,38,4246
20512,16419,3186,3,Business,12,2,52468,12,2,52596,12,2,53642,12,2,53916,12,2,57035,7,23.25888921888938,-1.2980229,36.78865,-1.2581837,36.8017056,831,3119,128,1320
20513,5635,2587,3,Business,24,3,45865,24,3,46639,24,3,47634,24,3,47850,24,3,49098,6,20.0,-1.2551895,36.7822034,-1.28878,36.8168312,764,1248,774,1211
20514,8435,20,3,Business,21,3,48619,21,3,48904,21,3,49676,21,3,51214,21,3,54912,27,23.0,-1.413547,36.9550764,-1.2628638,36.8070399,449,3698,285,2310
20515,8347,2677,3,Business,21,1,51075,21,1,51090,21,1,51298,21,1,53186,21,1,53291,14,27.7,-1.3228003,36.8306435,-1.306378,36.7519845,436,105,15,2096
20516,2948,3674,3,Business,8,5,34087,8,5,34122,8,5,34807,8,5,35465,8,5,36284,6,20.5,-1.2551895,36.7822034,-1.2750415,36.7965813,862,819,35,1343
20517,18705,2200,3,Business,26,1,35893,26,1,41265,26,1,41473,26,1,42545,26,1,44123,8,23.1,-1.3014461,36.7661381,-1.290894,36.822971,711,1578,5372,1280
20518,8682,323,3,Business,22,3,40373,22,3,40388,22,3,40847,22,3,42865,22,3,48061,20,23.0,-1.2571472,36.7950633,-1.3632162,36.9108253,19,5196,15,2477
20519,24890,933,2,Personal,31,4,61123,31,4,61134,31,4,61462,31,4,61604,31,4,64070,24,22.5,-1.2137756,36.7996657,-1.3217539,36.8734832,103,2466,11,470
20520,5887,59,3,Business,6,3,45284,6,3,46590,6,3,49078,6,3,51617,6,3,51632,5,21.7,-1.290894,36.822971,-1.2599389,36.8074963,606,15,1306,5027
20521,15353,1724,3,Business,6,4,43202,6,4,43235,6,4,44134,6,4,44398,6,4,45437,4,19.7,-1.2551895,36.7822034,-1.266294,36.8057971,161,1039,33,1163
20522,7637,1336,3,Business,28,2,59538,28,2,59871,28,2,60192,28,2,60469,28,2,61131,3,21.7,-1.290894,36.822971,-1.2878913,36.8089253,448,662,333,598
20523,20233,1245,3,Business,22,5,51724,22,5,53262,22,5,55369,22,5,55824,22,5,57742,18,31.1,-1.3198615,36.7110323,-1.300921,36.828195,628,1918,1538,2562
20524,5642,909,3,Business,30,2,47116,30,2,50659,30,2,51171,30,2,52161,30,2,52689,7,27.5,-1.225322,36.80855,-1.2527958,36.8003131,101,528,3543,1502
20525,17351,1724,3,Business,7,3,47191,7,3,48188,7,3,49229,7,3,50318,7,3,51535,12,28.5,-1.2941648,36.7977315,-1.32189,36.8589727,744,1217,997,2130
20526,18984,1815,3,Business,4,4,37376,4,4,37477,4,4,38015,4,4,38106,4,4,40451,9,23.25888921888938,-1.2661264,36.8030359,-1.3197323,36.8120386,751,2345,101,629
20527,23353,246,3,Business,6,3,56065,6,3,56668,6,3,56675,6,3,57524,6,3,61850,19,22.0,-1.2584143,36.8048002,-1.311342,36.913268,345,4326,603,856
20528,11911,393,3,Business,11,5,46511,11,5,46520,11,5,46659,11,5,46851,11,5,48735,14,20.8,-1.3167113,36.8301563,-1.306378,36.7519845,523,1884,9,331
20529,4799,1503,3,Personal,26,3,31844,26,3,31939,26,3,32979,26,3,33652,26,3,34825,7,18.9,-1.2671296,36.8125772,-1.2854174,36.7951152,882,1173,95,1713
20530,3141,3674,3,Business,18,5,58463,18,5,58494,18,5,58718,18,5,58842,18,5,60372,5,27.2,-1.2551895,36.7822034,-1.2615048,36.8116724,326,1530,31,348
20531,25418,246,3,Business,29,1,42945,29,1,43374,29,1,43520,29,1,43927,29,1,44552,7,23.25888921888938,-1.2584143,36.8048002,-1.2697662,36.7595857,107,625,429,553
20532,12708,393,3,Business,21,5,50943,21,5,50968,21,5,50979,21,5,51790,21,5,53582,14,24.8,-1.3167113,36.8301563,-1.306378,36.7519845,10,1792,25,822
20533,21985,2330,3,Business,17,5,51369,17,5,51400,17,5,51790,17,5,52152,17,5,54543,17,23.25888921888938,-1.2987264,36.8831224,-1.2326041,36.8009029,907,2391,31,752
20534,27111,1469,3,Business,23,4,45594,23,4,45640,23,4,46013,23,4,46833,23,4,48544,13,23.1,-1.2571472,36.7950633,-1.2343236,36.8861,490,1711,46,1193
20535,21120,1271,3,Business,8,1,36898,8,1,36906,8,1,38078,8,1,38489,8,1,40467,18,24.4,-1.2600932,36.8041689,-1.3244885,36.897792,937,1978,8,1583
20536,7225,3647,3,Business,4,1,48240,4,1,48373,4,1,48999,4,1,49352,4,1,50303,8,23.25888921888938,-1.272639,36.794723,-1.2653185,36.8358841,607,951,133,979
20537,15973,2767,3,Business,30,2,50659,30,2,50674,30,2,51397,30,2,52174,30,2,53428,10,27.6,-1.3039057,36.7928391,-1.257773,36.795486,655,1254,15,1500
20538,16724,2077,2,Personal,16,1,30398,16,1,30495,16,1,32405,16,1,32835,16,1,34779,18,14.6,-1.2701385,36.8235208,-1.2565206,36.6917289,581,1944,97,2340
20539,6075,2869,3,Business,21,4,32780,21,4,32883,21,4,33522,21,4,34125,21,4,36581,11,21.8,-1.2675238,36.8127148,-1.3025826,36.7670807,424,2456,103,1242
20540,23318,60,3,Business,6,4,59740,6,4,59758,6,4,60060,6,4,60475,6,4,62091,8,21.9,-1.2663631,36.8163329,-1.2296618,36.8438272,76,1616,18,717
20541,17885,3475,1,Personal,13,7,28758,13,7,29362,13,7,30100,13,7,31121,13,7,32210,12,19.9,-1.3230485,36.839476,-1.26578,36.781,805,1089,604,1759
20542,14914,3264,3,Business,10,5,55850,10,5,55967,10,5,56617,10,5,56697,10,5,60510,19,23.25888921888938,-1.2551895,36.7822034,-1.1845436,36.8282795,690,3813,117,730
20543,18994,3283,3,Business,17,4,59780,17,4,61253,17,4,62372,17,4,62840,17,4,63978,13,26.0,-1.2296618,36.8438272,-1.2628473,36.781805,52,1138,1473,1587
20544,24051,2956,3,Business,4,2,49212,4,2,49288,4,2,49817,4,2,50100,4,2,51382,3,22.7,-1.2584143,36.8048002,-1.2551895,36.7822034,155,1282,76,812
20545,24620,3711,3,Business,13,4,46716,13,4,47514,13,4,49176,13,4,50008,13,4,51334,9,22.3,-1.279395,36.825364,-1.3025826,36.7670807,580,1326,798,2494
20546,20335,1500,3,Business,30,2,39022,30,2,39056,30,2,39641,30,2,41769,30,2,45394,11,23.25888921888938,-1.3077869,36.8443207,-1.2638185,36.7930057,436,3625,34,2713
20547,16943,2159,3,Business,9,5,34574,9,5,34994,9,5,35720,9,5,36900,9,5,39569,7,20.1,-1.2839186,36.8222431,-1.304735,36.7846054,512,2669,420,1906
20548,9918,2803,3,Business,4,5,38031,4,5,39786,4,5,44759,4,5,45089,4,5,46258,3,17.2,-1.2765736,36.8513646,-1.2677415,36.8348418,48,1169,1755,5303
20549,13100,379,1,Personal,9,4,30826,9,4,30879,9,4,31561,9,4,31805,9,4,33837,9,17.1,-1.2831463,36.7636022,-1.2655332,36.8094648,322,2032,53,926
20550,7378,2523,3,Business,13,1,53186,13,1,53221,13,1,53229,13,1,56028,13,1,57294,12,19.5,-1.2551895,36.7822034,-1.2416156,36.8736721,101,1266,35,2807
20551,5371,640,3,Business,6,1,33257,6,1,33288,6,1,34092,6,1,34210,6,1,36379,2,14.9,-1.2946581,36.7792921,-1.304033,36.7848695,722,2169,31,922
20552,14806,3004,1,Personal,8,7,59897,8,7,59928,8,7,60276,8,7,60512,8,7,61786,10,20.8,-1.2601903,36.8066946,-1.2325082,36.7304696,478,1274,31,584
20553,15430,517,3,Business,17,6,38859,17,6,40145,17,6,40888,17,6,41177,17,6,42283,10,24.0,-1.3177547,36.8303703,-1.2574219,36.7927073,854,1106,1286,1032
20554,13133,1544,3,Business,24,3,55707,24,3,57547,24,3,58930,24,3,59841,24,3,61289,6,23.25888921888938,-1.2792869,36.8226482,-1.3169998,36.8297525,448,1448,1840,2294
20555,14064,793,3,Personal,25,1,44720,25,1,44769,25,1,46977,25,1,47954,25,1,50274,12,27.0,-1.2837255,36.8220797,-1.2651574,36.7474347,26,2320,49,3185
20556,24715,393,3,Business,15,1,44391,15,1,44402,15,1,44406,15,1,45438,15,1,45440,4,23.25888921888938,-1.3167113,36.8301563,-1.3004062,36.829741,619,2,11,1036
20557,3874,1474,1,Personal,18,1,66492,18,1,68075,18,1,68474,18,1,72115,18,1,74839,13,23.25888921888938,-1.2912419,36.8775284,-1.2786894,36.8032321,890,2724,1583,4040
20558,8041,393,3,Business,14,5,44049,14,5,45446,14,5,45478,14,5,47523,14,5,48947,11,21.3,-1.3167113,36.8301563,-1.2574219,36.7927073,619,1424,1397,2077
20559,27904,281,2,Personal,22,5,59229,22,5,61397,22,5,62198,22,5,62751,22,5,64388,8,23.25888921888938,-1.3014461,36.7661381,-1.2666441,36.7420196,449,1637,2168,1354
20560,25841,3599,3,Business,25,2,36344,25,2,39597,25,2,40626,25,2,43169,25,2,43876,13,23.7,-1.3302996,36.8707935,-1.335477,36.9308297,179,707,3253,3572
20561,21262,246,3,Business,30,5,62116,30,5,62131,30,5,62641,30,5,62771,30,5,63524,2,21.9,-1.2584143,36.8048002,-1.2571472,36.7950633,879,753,15,640
20562,8666,3283,3,Business,21,4,55193,21,4,55913,21,4,56791,21,4,57490,21,4,58699,13,26.3,-1.2296618,36.8438272,-1.2628473,36.781805,801,1209,720,1577
20563,22585,1448,3,Business,8,3,54029,8,3,54048,8,3,54623,8,3,54702,8,3,56217,12,25.8,-1.2615888,36.7928732,-1.3215394,36.836621,726,1515,19,654
20564,17957,2125,2,Personal,29,2,61043,29,2,61087,29,2,61417,29,2,62702,29,2,64919,17,22.5,-1.3055016,36.7844071,-1.2237053,36.817472,116,2217,44,1615
20565,18283,3245,3,Business,13,2,58038,13,2,58849,13,2,59437,13,2,60501,13,2,63404,8,23.5,-1.257309,36.8060084,-1.2224213,36.8165253,101,2903,811,1652
20566,19694,2601,3,Personal,29,3,61684,29,3,61729,29,3,62018,29,3,62555,29,3,64003,6,21.2,-1.2963097,36.7688221,-1.2896715,36.7254189,176,1448,45,826
20567,22344,3282,2,Personal,30,1,43875,30,1,43893,30,1,45102,30,1,45394,30,1,46453,8,22.8,-1.2864674,36.820262,-1.290059,36.7703475,414,1059,18,1501
20568,18285,1500,3,Business,13,4,30633,13,4,30674,13,4,30677,13,4,32074,13,4,32321,8,18.5,-1.3004062,36.829741,-1.2638185,36.7930057,472,247,41,1400
20569,17110,2271,3,Business,18,2,44782,18,2,44805,18,2,44828,18,2,45846,18,2,47675,14,23.25888921888938,-1.272828,36.816608,-1.293515,36.897607,937,1829,23,1041
20570,20871,1776,3,Personal,6,4,49380,6,4,49470,6,4,50726,6,4,51110,6,4,52543,9,21.2,-1.2535486,36.7933541,-1.2622285,36.8534706,131,1433,90,1640
20571,2877,3599,3,Business,3,5,50313,3,5,50785,3,5,53309,3,5,53569,3,5,55846,14,23.25888921888938,-1.3302996,36.8707935,-1.2538731,36.7850223,675,2277,472,2784
20572,170,431,1,Personal,5,5,47509,5,5,47855,5,5,49879,5,5,50125,5,5,51515,8,26.5,-1.3108368,36.8226308,-1.257537,36.843066,844,1390,346,2270
20573,4175,635,3,Business,17,5,35687,17,5,37034,17,5,39791,17,5,40768,17,5,42337,17,17.8,-1.177202,36.8351183,-1.2599563,36.7993439,86,1569,1347,3734
20574,20331,3408,2,Personal,17,5,39691,17,5,39728,17,5,39845,17,5,40080,17,5,40948,6,17.7,-1.2854453,36.8188363,-1.2941024,36.79578,812,868,37,352
20575,24045,1244,3,Business,25,1,42101,25,1,42115,25,1,42318,25,1,42792,25,1,45198,7,27.0,-1.2628473,36.781805,-1.303596,36.778378,383,2406,14,677
20576,11423,1976,3,Business,21,1,36069,21,1,36110,21,1,36491,21,1,36912,21,1,37865,6,22.6,-1.257028,36.7810435,-1.2905152,36.7834982,881,953,41,802
20577,15063,868,3,Business,1,5,37388,1,5,44452,1,5,44820,1,5,45632,1,5,47647,8,26.6,-1.303596,36.778378,-1.265715,36.823815,691,2015,7064,1180
20578,2939,2344,3,Business,6,4,40736,6,4,41111,6,4,41214,6,4,41660,6,4,45146,8,24.0,-1.2551895,36.7822034,-1.3050332,36.8100437,510,3486,375,549
20579,14460,2200,3,Business,29,6,36759,29,6,36833,29,6,37333,29,6,38248,29,6,39324,6,25.2,-1.2584143,36.8048002,-1.290894,36.822971,817,1076,74,1415
20580,24553,540,3,Business,2,5,47908,2,5,47917,2,5,47962,2,5,48085,2,5,49822,11,23.7,-1.2551895,36.7822034,-1.312469,36.815177,70,1737,9,168
20581,5409,3222,3,Business,13,1,51042,13,1,51070,13,1,51125,13,1,51502,13,1,53138,10,23.25888921888938,-1.2551895,36.7822034,-1.2287282,36.8115304,607,1636,28,432
20582,19549,3602,3,Business,1,3,31345,1,3,31471,1,3,33195,1,3,33520,1,3,36035,8,23.25888921888938,-1.2963097,36.7688221,-1.2672045,36.7172069,935,2515,126,2049
20583,4292,2801,3,Business,18,1,51611,18,1,51718,18,1,51965,18,1,52964,18,1,54808,14,29.3,-1.2595422,36.7871178,-1.3104506,36.8687235,242,1844,107,1246
20584,1313,1209,3,Business,24,3,45449,24,3,45486,24,3,45912,24,3,45988,24,3,46536,6,23.25888921888938,-1.3004062,36.829741,-1.3228003,36.8306435,206,548,37,502
20585,2254,1502,3,Business,28,4,35906,28,4,35926,28,4,37907,28,4,38057,28,4,39748,17,28.0,-1.2232123,36.8932547,-1.2551895,36.7822034,260,1691,20,2131
20586,17255,835,3,Business,16,3,38944,16,3,38951,16,3,39401,16,3,40414,16,3,42329,23,23.0,-1.2953892,36.7581624,-1.3700383,36.9190174,238,1915,7,1463
20587,4951,1329,3,Business,21,3,58171,21,3,62169,21,3,62565,21,3,63164,21,3,64448,6,23.25888921888938,-1.273056,36.811298,-1.3005349,36.7873912,268,1284,3998,995
20588,6643,190,3,Business,17,3,51981,17,3,51999,17,3,52337,17,3,52694,17,3,53263,8,23.25888921888938,-1.3270347,36.8667362,-1.332624,36.913187,373,569,18,695
20589,8536,435,3,Business,21,2,52624,21,2,52684,21,2,52940,21,2,53547,21,2,55336,8,25.0,-1.2844012,36.7773253,-1.300921,36.828195,16,1789,60,863
20590,27929,904,3,Business,29,4,34177,29,4,34224,29,4,34696,29,4,34976,29,4,36428,7,18.7,-1.2925845,36.8112269,-1.2665558,36.8056479,338,1452,47,752
20591,22072,2514,3,Business,19,1,42138,19,1,42271,19,1,43802,19,1,44597,19,1,45138,2,24.9,-1.2764851,36.8007126,-1.266294,36.8057971,932,541,133,2326
20592,18156,3001,3,Business,25,4,49341,25,4,49481,25,4,49784,25,4,50376,25,4,51858,7,23.25888921888938,-1.2795216,36.7706752,-1.269534,36.80697,572,1482,140,895
20593,14199,3560,3,Business,23,6,48614,23,6,48637,23,6,49154,23,6,49271,23,6,49468,1,28.2,-1.28878,36.8168312,-1.279395,36.825364,102,197,23,634
20594,16944,2289,3,Business,2,3,53769,2,3,53804,2,3,54513,2,3,54731,2,3,55310,5,23.5,-1.255956,36.789867,-1.2764851,36.8007126,676,579,35,927
20595,17841,1245,3,Business,19,3,48810,19,3,49340,19,3,50092,19,3,53365,19,3,55015,17,24.6,-1.300921,36.828195,-1.3198615,36.7110323,82,1650,530,4025
20596,22356,2030,3,Business,25,4,52014,25,4,52432,25,4,53110,25,4,54061,25,4,55670,3,20.9,-1.257309,36.8060084,-1.2753109,36.8130185,112,1609,418,1629
20597,16109,3557,3,Business,28,3,53587,28,3,53649,28,3,54147,28,3,55220,28,3,55918,3,23.25888921888938,-1.269534,36.80697,-1.2546732,36.8086796,911,698,62,1571
20598,4620,391,3,Business,12,3,42150,12,3,42445,12,3,43091,12,3,45012,12,3,45141,5,19.5,-1.300921,36.828195,-1.2784063,36.8222933,921,129,295,2567
20599,6375,659,2,Personal,3,3,71755,3,3,71783,3,3,72071,3,3,72782,3,3,74057,3,19.3,-1.2852584,36.8043641,-1.2812305,36.7791109,578,1275,28,999
20600,22609,1927,3,Business,22,5,48600,22,5,48885,22,5,51136,22,5,51549,22,5,53512,15,31.1,-1.3472066,36.7692638,-1.2949439,36.7604214,118,1963,285,2664
20601,14793,3496,3,Business,13,4,55692,13,4,56911,13,4,57741,13,4,58369,13,4,59499,8,22.6,-1.300921,36.828195,-1.2516391,36.8114886,247,1130,1219,1458
20602,6893,1734,3,Personal,7,1,48766,7,1,49097,7,1,49103,7,1,49854,7,1,50318,3,20.6,-1.2821883,36.8269611,-1.298529,36.816482,923,464,331,757
20603,14846,3291,3,Business,9,3,52981,9,3,53055,9,3,53175,9,3,53738,9,3,53817,2,25.4,-1.2673935,36.8030328,-1.2600926,36.8088685,105,79,74,683
20604,41,3109,2,Personal,11,3,63125,11,3,63221,11,3,63757,11,3,64165,11,3,65313,6,19.9,-1.2884404,36.7736747,-1.2693522,36.7973993,148,1148,96,944
20605,6166,2069,3,Business,20,1,45036,20,1,48850,20,1,49224,20,1,50543,20,1,52701,16,23.25888921888938,-1.303596,36.778378,-1.228911,36.881876,519,2158,3814,1693
20606,18515,718,3,Business,4,1,55297,4,1,55304,4,1,55698,4,1,55772,4,1,60356,23,23.25888921888938,-1.2551895,36.7822034,-1.352856,36.6606475,885,4584,7,468
20607,3118,2658,3,Business,29,4,63703,29,4,63730,29,4,64620,29,4,64695,29,4,66895,12,20.8,-1.2891922,36.825189,-1.2711571,36.9017288,622,2200,27,965
20608,21717,3291,3,Business,19,6,32030,19,6,32053,19,6,32621,19,6,33315,19,6,34290,5,21.4,-1.2628473,36.781805,-1.2600926,36.8088685,512,975,23,1262
20609,19945,2956,3,Business,26,2,34710,26,2,34778,26,2,35266,26,2,35521,26,2,38945,6,21.6,-1.2584143,36.8048002,-1.2931121,36.8224572,378,3424,68,743
20610,15029,1363,3,Business,31,4,49789,31,4,49940,31,4,49967,31,4,51627,31,4,53300,3,28.7,-1.3004062,36.829741,-1.2887216,36.8087323,267,1673,151,1687
20611,11598,2514,3,Business,25,4,36611,25,4,37071,25,4,37414,25,4,37755,25,4,38554,3,16.4,-1.266294,36.8057971,-1.28593,36.8151111,289,799,460,684
20612,9320,248,3,Business,14,5,42337,14,5,42540,14,5,43226,14,5,43383,14,5,45240,12,21.6,-1.304735,36.7846054,-1.3227037,36.8470872,454,1857,203,843
20613,6224,749,1,Personal,4,6,52603,4,6,53353,4,6,54642,4,6,55316,4,6,56524,6,22.9,-1.2795197,36.8168287,-1.2773014,36.7773015,19,1208,750,1963
20614,8866,2212,3,Business,9,4,32947,9,4,32959,9,4,33523,9,4,34087,9,4,35791,14,23.25888921888938,-1.2571472,36.7950633,-1.3291155,36.8861,96,1704,12,1128
20615,14198,265,3,Business,4,4,38582,4,4,38661,4,4,38884,4,4,39919,4,4,41050,8,23.25888921888938,-1.300921,36.828195,-1.2940853,36.7866665,848,1131,79,1258
20616,8076,517,3,Business,22,3,56329,22,3,56392,22,3,56399,22,3,56829,22,3,56835,4,24.1,-1.3228003,36.8306435,-1.3004062,36.829741,619,6,63,437
20617,21008,346,3,Business,15,3,58680,15,3,58796,15,3,59225,15,3,61563,15,3,61572,3,24.9,-1.28878,36.8168312,-1.2909536,36.8407162,411,9,116,2767
20618,25086,2112,3,Business,21,1,53853,21,1,53859,21,1,53865,21,1,54586,21,1,55855,14,21.7,-1.22556,36.80813,-1.2156006,36.8916865,771,1269,6,727
20619,395,3711,3,Business,19,3,68230,19,3,69849,19,3,69853,19,3,70929,19,3,72188,10,19.7,-1.2584143,36.8048002,-1.3025826,36.7670807,517,1259,1619,1080
20620,6,3550,1,Personal,3,5,52668,3,5,55761,3,5,56584,3,5,57838,3,5,58345,4,25.0,-1.3003914,36.7340157,-1.2998202,36.7643997,636,507,3093,2077
20621,22420,3017,3,Business,25,5,66198,25,5,66297,25,5,66823,25,5,67175,25,5,67611,4,21.1,-1.299313,36.7831488,-1.3023678,36.7976564,886,436,99,878
20622,5433,3688,3,Business,24,1,42760,24,1,42804,24,1,43227,24,1,43824,24,1,46410,5,22.9,-1.2551895,36.7822034,-1.2684319,36.8165853,260,2586,44,1020
20623,13586,186,3,Business,22,1,57232,22,1,57308,22,1,57757,22,1,58159,22,1,60296,20,26.0,-1.2571472,36.7950633,-1.3700383,36.9190174,178,2137,76,851
20624,22019,1642,3,Business,20,1,48807,20,1,49705,20,1,49712,20,1,50498,20,1,51327,5,23.25888921888938,-1.2808159,36.8160545,-1.2728069,36.7962362,79,829,898,793
20625,5994,1594,3,Business,22,1,43044,22,1,43118,22,1,43207,22,1,43665,22,1,45278,13,23.25888921888938,-1.2584143,36.8048002,-1.2156006,36.8916865,245,1613,74,547
20626,9837,868,3,Business,10,1,44934,10,1,45077,10,1,45083,10,1,46025,10,1,47249,7,18.7,-1.2628473,36.781805,-1.2663631,36.8163329,864,1224,143,948
20627,573,3291,3,Business,8,6,40207,8,6,40390,8,6,40397,8,6,41318,8,6,42261,5,20.0,-1.2783849,36.8163445,-1.2600926,36.8088685,698,943,183,928
20628,14485,246,3,Business,21,1,50696,21,1,50724,21,1,51129,21,1,51392,21,1,51890,3,27.4,-1.2584143,36.8048002,-1.2551895,36.7822034,205,498,28,668
20629,7469,186,3,Business,4,3,48939,4,3,48950,4,3,49044,4,3,49489,4,3,51678,24,18.2,-1.3700383,36.9190174,-1.2579304,36.8019667,791,2189,11,539
20630,12883,706,3,Business,12,5,52028,12,5,52539,12,5,53849,12,5,55071,12,5,56045,6,27.2,-1.3239488,36.8316835,-1.3083266,36.8494756,299,974,511,2532
20631,21501,393,3,Business,1,1,31058,1,1,31070,1,1,31081,1,1,34682,1,1,34691,5,18.2,-1.3177547,36.8303703,-1.3077869,36.8443207,10,9,12,3612
20632,149,1154,3,Business,6,3,42484,6,3,42500,6,3,42635,6,3,43482,6,3,45039,20,23.25888921888938,-1.2917868,36.7872675,-1.3700383,36.9190174,932,1557,16,982
20633,18040,3031,3,Personal,30,3,35330,30,3,35339,30,3,36459,30,3,36855,30,3,40525,19,17.4,-1.2614838,36.7530984,-1.2803022,36.8830972,761,3670,9,1516
20634,6396,2102,3,Business,9,2,59970,9,2,60029,9,2,61374,9,2,62061,9,2,63790,14,27.7,-1.3250048,36.8697188,-1.2613768,36.8019418,613,1729,59,2032
20635,9720,2801,3,Business,24,5,62716,24,5,62741,24,5,63317,24,5,63498,24,5,65120,8,20.2,-1.2674274,36.7870827,-1.2951355,36.768931,930,1622,25,757
20636,8298,2066,3,Business,22,3,56559,22,3,57016,22,3,58113,22,3,58200,22,3,58839,5,25.9,-1.316961,36.820337,-1.3007714,36.8001722,754,639,457,1184
20637,23619,3355,3,Business,27,2,36350,27,2,39114,27,2,39969,27,2,41018,27,2,42210,4,23.9,-1.291768,36.8297208,-1.3052491,36.8223899,510,1192,2764,1904
20638,1588,1689,1,Personal,28,2,47767,28,2,47867,28,2,48393,28,2,48931,28,2,50437,7,19.3,-1.2890254,36.7990753,-1.2616841,36.801999,88,1506,100,1064
20639,2204,1633,1,Personal,29,6,59131,29,6,59312,29,6,59846,29,6,60393,29,6,62192,6,23.6,-1.2671296,36.8125772,-1.292008,36.802784,86,1799,181,1081
20640,28232,3247,3,Business,10,1,39167,10,1,39233,10,1,39908,10,1,40105,10,1,41901,18,23.5,-1.2571472,36.7950633,-1.2578249,36.6803272,353,1796,66,872
20641,17098,2216,3,Business,30,2,33259,30,2,33294,30,2,33711,30,2,34033,30,2,34536,4,23.25888921888938,-1.2551895,36.7822034,-1.2737013,36.8069122,245,503,35,739
20642,7995,302,3,Business,15,5,66444,15,5,66509,15,5,67272,15,5,67391,15,5,68499,8,27.6,-1.2649605,36.7981777,-1.2930664,36.78495,541,1108,65,882
20643,15793,2330,3,Business,10,1,48367,10,1,50287,10,1,50612,10,1,50715,10,1,51660,7,18.1,-1.2212612,36.8440033,-1.2336843,36.8007259,740,945,1920,428
20644,16326,2803,3,Business,2,5,36181,2,5,36299,2,5,37277,2,5,37348,2,5,38370,3,18.2,-1.2765736,36.8513646,-1.2689599,36.8398401,237,1022,118,1049
20645,21044,1926,3,Business,28,4,49153,28,4,49274,28,4,49398,28,4,50322,28,4,51230,3,30.1,-1.2752846,36.8027022,-1.2571472,36.7950633,647,908,121,1048
20646,25699,3470,3,Business,30,5,57663,30,5,59604,30,5,60202,30,5,60427,30,5,61248,5,22.1,-1.28878,36.8168312,-1.2591019,36.800577,522,821,1941,823
20647,3783,3647,3,Business,23,2,54118,23,2,55166,23,2,55743,23,2,56030,23,2,57436,4,23.25888921888938,-1.272639,36.794723,-1.2674482,36.8076994,155,1406,1048,864
20648,101,3674,3,Business,29,1,53058,29,1,53248,29,1,53373,29,1,53746,29,1,54479,4,24.2,-1.2551895,36.7822034,-1.2651643,36.8072214,287,733,190,498
20649,9794,6,3,Personal,21,1,36302,21,1,36372,21,1,37132,21,1,38450,21,1,40023,9,25.3,-1.307059,36.8489195,-1.2720652,36.8217122,627,1573,70,2078
20650,21859,2523,3,Business,19,3,39827,19,3,49309,19,3,49334,19,3,49415,19,3,52162,8,24.5,-1.2551895,36.7822034,-1.2901228,36.8234237,237,2747,9482,106
20651,21728,64,1,Personal,27,1,54209,27,1,54256,27,1,54764,27,1,56102,27,1,56856,5,23.25888921888938,-1.301159,36.7847573,-1.2965924,36.8179314,86,754,47,1846
20652,13538,2523,3,Business,19,2,35290,19,2,35303,19,2,37313,19,2,38002,19,2,39662,19,23.25888921888938,-1.2551895,36.7822034,-1.2219026,36.9176696,100,1660,13,2699
20653,15275,346,3,Business,11,5,37029,11,5,37160,11,5,39579,11,5,39843,11,5,41781,18,21.2,-1.3065979,36.7186349,-1.28878,36.8168312,725,1938,131,2683
20654,1644,1683,3,Business,4,3,58915,4,3,59785,4,3,60187,4,3,60439,4,3,61462,4,23.25888921888938,-1.2765334,36.8015051,-1.2675332,36.808561,103,1023,870,654
20655,14762,882,1,Personal,4,5,41536,4,5,42626,4,5,43040,4,5,43510,4,5,44974,6,22.3,-1.2862659,36.8264616,-1.2538731,36.7850223,531,1464,1090,884
20656,21983,1207,3,Business,5,1,40207,5,1,40225,5,1,40720,5,1,41706,5,1,42563,13,24.7,-1.207546,36.7913976,-1.2351541,36.8748505,101,857,18,1481
20657,17021,3624,1,Personal,4,2,24798,4,2,24810,4,2,25542,4,2,27084,4,2,28721,14,14.3,-1.2091559,36.7753704,-1.26559,36.8027,720,1637,12,2274
20658,28086,3234,1,Business,16,4,35457,16,4,35474,16,4,35854,16,4,36511,16,4,39066,34,15.6,-1.3025043,36.7535329,-1.3886344,36.9372718,249,2555,17,1037
20659,24036,2119,3,Personal,19,3,42658,19,3,43328,19,3,46496,19,3,46584,19,3,47316,4,22.4,-1.280572,36.826162,-1.2706041,36.8303142,456,732,670,3256
20660,19747,230,1,Personal,19,2,64202,19,2,64239,19,2,66609,19,2,66978,19,2,67254,2,19.6,-1.2880229,36.7892191,-1.2952784,36.7793271,260,276,37,2739
20661,14566,2200,3,Business,30,2,47723,30,2,53487,30,2,54222,30,2,55586,30,2,58103,9,27.4,-1.2859912,36.8756811,-1.290894,36.822971,399,2517,5764,2099
20662,14820,111,3,Business,10,4,39382,10,4,39464,10,4,39545,10,4,40208,10,4,41794,7,24.8,-1.2551895,36.7822034,-1.2804664,36.7701111,536,1586,82,744
20663,16877,3355,3,Business,23,5,48574,23,5,49040,23,5,50601,23,5,50687,23,5,51081,3,26.2,-1.3052491,36.8223899,-1.3207146,36.8305771,848,394,466,1647
20664,3374,3688,3,Business,6,3,46930,6,3,46964,6,3,48292,6,3,49677,6,3,50319,6,27.6,-1.2736466,36.8164042,-1.2551895,36.7822034,959,642,34,2713
20665,14525,550,1,Personal,17,3,38392,17,3,38429,17,3,38476,17,3,38917,17,3,39841,7,25.6,-1.2622591,36.7992934,-1.2927668,36.789071,215,924,37,488
20666,18399,393,3,Business,3,5,43936,3,5,43963,3,5,43972,3,5,45224,3,5,47356,14,23.25888921888938,-1.3167113,36.8301563,-1.2991441,36.7528804,349,2132,27,1261
20667,3942,1245,3,Business,21,4,45546,21,4,45574,21,4,46355,21,4,50870,21,4,54251,17,31.0,-1.300921,36.828195,-1.3198615,36.7110323,728,3381,28,5296
20668,11367,3215,3,Personal,9,4,49522,9,4,53063,9,4,53977,9,4,54041,9,4,55308,7,23.25888921888938,-1.2454036,36.7866654,-1.2884146,36.8107668,953,1267,3541,978
20669,6111,2776,3,Personal,1,5,34768,1,5,34778,1,5,35670,1,5,36729,1,5,38717,15,17.5,-1.2143842,36.8122348,-1.2748221,36.7817865,633,1988,10,1951
20670,21618,1693,3,Business,30,5,44294,30,5,44303,30,5,44635,30,5,44774,30,5,45462,4,23.8,-1.2574088,36.799712,-1.2657456,36.8087424,50,688,9,471
20671,20010,1147,2,Personal,31,4,61224,31,4,62303,31,4,62312,31,4,63631,31,4,64237,4,22.1,-1.2781868,36.8236786,-1.26211,36.7964663,100,606,1079,1328
20672,12286,2066,3,Business,4,2,45843,4,2,45891,4,2,46138,4,2,46276,4,2,47740,5,18.9,-1.316961,36.820337,-1.285382,36.8162878,402,1464,48,385
20673,15711,2230,3,Personal,11,4,44451,11,4,44549,11,4,45670,11,4,46090,11,4,48076,7,23.9,-1.2450649,36.7869245,-1.2858997,36.8138634,844,1986,98,1541
20674,9238,2299,1,Personal,5,4,47155,5,4,47920,5,4,50995,5,4,51363,5,4,53034,8,22.2,-1.2248308,36.8012573,-1.2689785,36.8082713,131,1671,765,3443
20675,6503,1719,3,Business,29,1,60273,29,1,60313,29,1,60816,29,1,61579,29,1,63588,14,23.4,-1.3032946,36.8222045,-1.2330694,36.745451,648,2009,40,1266
20676,22214,1341,3,Business,9,4,35451,9,4,35479,9,4,36152,9,4,36661,9,4,37899,18,23.25888921888938,-1.228911,36.881876,-1.331619,36.847976,8,1238,28,1182
20677,24785,914,3,Business,24,3,36557,24,3,36613,24,3,37899,24,3,38207,24,3,39970,6,23.25888921888938,-1.2670213,36.7994482,-1.298194,36.800998,441,1763,56,1594
20678,9198,868,3,Business,12,6,35058,12,6,35070,12,6,35517,12,6,35764,12,6,36953,7,23.25888921888938,-1.2628473,36.781805,-1.265715,36.823815,379,1189,12,694
20679,4416,2982,3,Business,2,4,44206,2,4,45400,2,4,45916,2,4,48299,2,4,50610,18,23.25888921888938,-1.300921,36.828195,-1.177202,36.8351183,538,2311,1194,2899
20680,21352,835,3,Business,15,5,49814,15,5,50077,15,5,51364,15,5,51518,15,5,54043,20,17.9,-1.300722,36.7882234,-1.3700383,36.9190174,154,2525,263,1441
20681,12226,1341,3,Business,24,3,50128,24,3,51642,24,3,52160,24,3,52767,24,3,54941,17,23.25888921888938,-1.22978,36.836215,-1.331619,36.847976,75,2174,1514,1125
20682,17884,391,3,Business,7,1,53180,7,1,53215,7,1,54399,7,1,55249,7,1,57140,13,20.6,-1.300921,36.828195,-1.3477328,36.7447075,742,1891,35,2034
20683,13378,1927,3,Business,21,2,50511,21,2,50554,21,2,52029,21,2,52976,21,2,54376,12,25.2,-1.279395,36.825364,-1.3472066,36.7692638,341,1400,43,2422
20684,9467,3647,3,Business,20,1,36270,20,1,36342,20,1,37273,20,1,37749,20,1,38802,8,19.1,-1.272639,36.794723,-1.257569,36.842164,829,1053,72,1407
20685,16967,633,3,Business,14,1,52089,14,1,52117,14,1,52123,14,1,52539,14,1,53122,4,25.9,-1.3077869,36.8443207,-1.3004062,36.829741,39,583,28,422
20686,3338,2190,3,Business,4,2,49496,4,2,49762,4,2,51201,4,2,51826,4,2,55081,9,22.3,-1.301953,36.788458,-1.2513025,36.8094419,502,3255,266,2064
20687,6589,157,3,Business,29,1,33363,29,1,33375,29,1,34342,29,1,34632,29,1,36920,18,23.25888921888938,-1.225322,36.80855,-1.2257343,36.8933543,953,2288,12,1257
20688,20751,393,3,Business,25,1,52234,25,1,52253,25,1,52808,25,1,53379,25,1,53843,4,30.1,-1.3167113,36.8301563,-1.3004062,36.829741,25,464,19,1126
20689,10467,970,3,Business,8,3,45868,8,3,45891,8,3,46329,8,3,46544,8,3,47836,5,23.25888921888938,-1.2551895,36.7822034,-1.2728069,36.7962362,216,1292,23,653
20690,22389,547,1,Personal,3,5,39554,3,5,39653,3,5,41264,3,5,41956,3,5,43807,4,21.6,-1.2652108,36.8056075,-1.2916556,36.8262516,700,1851,99,2303
20691,11329,2763,3,Business,31,5,36983,31,5,37074,31,5,38416,31,5,39395,31,5,40913,12,21.8,-1.3014461,36.7661381,-1.2991616,36.8424509,855,1518,91,2321
20692,17570,2412,3,Business,27,4,45327,27,4,45348,27,4,45630,27,4,46358,27,4,47699,14,22.9,-1.2297202,36.8819507,-1.2551895,36.7822034,754,1341,21,1010
20693,12392,1544,3,Business,3,4,31258,3,4,31320,3,4,32349,3,4,32956,3,4,34406,9,17.2,-1.2874632,36.8243956,-1.2222127,36.8432808,549,1450,62,1636
20694,1359,2423,3,Business,4,1,34090,4,1,34535,4,1,34539,4,1,34904,4,1,36387,7,21.9,-1.2551895,36.7822034,-1.2814031,36.8201647,576,1483,445,369
20695,8685,867,3,Business,19,3,55840,19,3,55918,19,3,55927,19,3,57221,19,3,58241,6,24.3,-1.3004062,36.829741,-1.3228003,36.8306435,518,1020,78,1303
20696,25603,2489,2,Personal,3,5,50887,3,5,51001,3,5,51931,3,5,52174,3,5,53309,8,25.0,-1.2801014,36.8210423,-1.3272104,36.8528418,812,1135,114,1173
20697,4873,3686,3,Business,16,4,34339,16,4,34403,16,4,34514,16,4,37340,16,4,38490,8,23.25888921888938,-1.2551895,36.7822034,-1.305349,36.829708,291,1150,64,2937
20698,24794,3153,3,Personal,18,2,40690,18,2,40754,18,2,41028,18,2,41362,18,2,43021,10,23.25888921888938,-1.268171,36.809199,-1.3031813,36.7576089,4,1659,64,608
20699,24126,1961,3,Business,10,1,47849,10,1,47875,10,1,47881,10,1,51649,10,1,51656,19,18.5,-1.2663631,36.8163329,-1.3188359,36.7038526,864,7,26,3774
20700,7684,3175,3,Business,15,4,42626,15,4,42647,15,4,42977,15,4,43083,15,4,44775,12,24.3,-1.2681004,36.7952081,-1.2101621,36.7878594,432,1692,21,436
20701,26395,1342,3,Business,20,4,65364,20,4,65374,20,4,65389,20,4,65840,20,4,68217,18,25.1,-1.3025826,36.7670807,-1.2248308,36.8012573,105,2377,10,466
20702,14720,3372,3,Business,26,6,35668,26,6,35690,26,6,36416,26,6,36583,26,6,37250,4,18.6,-1.304033,36.7848695,-1.2872751,36.7889153,735,667,22,893
20703,9959,3222,3,Business,7,2,40806,7,2,40921,7,2,43154,7,2,43588,7,2,47294,13,23.25888921888938,-1.2551895,36.7822034,-1.3184737,36.862645,570,3706,115,2667
20704,4320,567,3,Business,20,4,60221,20,4,61047,20,4,61285,20,4,61826,20,4,62703,6,22.8,-1.2982678,36.7578839,-1.2745551,36.7979797,574,877,826,779
20705,5943,1405,3,Business,29,3,49498,29,3,49593,29,3,51411,29,3,56575,29,3,56577,21,20.9,-1.2535486,36.7933541,-1.3478563,36.8935824,652,2,95,6982
20706,12181,2763,3,Business,12,3,44910,12,3,45187,12,3,45536,12,3,45795,12,3,46529,4,19.4,-1.2551895,36.7822034,-1.2696908,36.81519,290,734,277,608
20707,13582,1389,3,Business,7,4,47312,7,4,47324,7,4,47522,7,4,48109,7,4,49732,14,27.8,-1.2232123,36.8932547,-1.207546,36.7913976,147,1623,12,785
20708,23791,346,3,Business,8,5,56836,8,5,58059,8,5,59339,8,5,59474,8,5,60231,6,30.4,-1.28878,36.8168312,-1.304023,36.788389,378,757,1223,1415
20709,21657,1845,3,Business,6,4,29425,6,4,29641,6,4,34248,6,4,34582,6,4,35567,1,19.0,-1.2917868,36.7872675,-1.3004846,36.7901591,451,985,216,4941
20710,22813,246,3,Business,20,4,46812,20,4,46832,20,4,46955,20,4,47260,20,4,48603,17,22.0,-1.2156006,36.8916865,-1.2584143,36.8048002,598,1343,20,428
20711,19445,2801,3,Business,27,2,55412,27,2,55462,27,2,56449,27,2,56687,27,2,58476,10,25.5,-1.2595422,36.7871178,-1.303187,36.8241957,498,1789,50,1225
20712,26091,2523,3,Business,23,5,34236,23,5,34622,23,5,35633,23,5,35837,23,5,38399,18,20.3,-1.2551895,36.7822034,-1.3382857,36.8870715,131,2562,386,1215
20713,22755,1850,3,Business,9,4,31876,9,4,32478,9,4,33532,9,4,33732,9,4,35878,8,17.3,-1.2551895,36.7822034,-1.2995101,36.8185828,882,2146,602,1254
20714,1740,3370,3,Business,31,5,45555,31,5,46129,31,5,46964,31,5,48007,31,5,49108,7,21.9,-1.2818812,36.8268142,-1.2551895,36.7822034,20,1101,574,1878
20715,20714,2066,3,Business,5,2,44118,5,2,44236,5,2,46727,5,2,47757,5,2,49908,9,25.6,-1.3210189,36.8410551,-1.2768326,36.8073804,701,2151,118,3521
20716,17973,246,3,Business,5,3,56230,5,3,56278,5,3,56807,5,3,57254,5,3,57681,2,25.1,-1.2527958,36.8003131,-1.2584143,36.8048002,259,427,48,976
20717,25887,1075,3,Business,5,3,61353,5,3,63235,5,3,63877,5,3,64046,5,3,65498,10,22.5,-1.3014461,36.7661381,-1.2527958,36.8003131,685,1452,1882,811
20718,6278,242,3,Business,23,3,36258,23,3,36903,23,3,37622,23,3,38199,23,3,39774,10,21.9,-1.2553615,36.7895376,-1.3173869,36.8112044,808,1575,645,1296
20719,2703,1976,3,Business,30,2,41196,30,2,41336,30,2,42763,30,2,43267,30,2,45841,9,22.2,-1.2812601,36.7340272,-1.257028,36.7810435,240,2574,140,1931
20720,22361,558,2,Personal,28,5,30834,28,5,30936,28,5,31895,28,5,33828,28,5,35942,15,20.7,-1.3322618,36.8045412,-1.3189979,36.7104076,532,2114,102,2892
20721,14583,3283,3,Business,25,1,45643,25,1,45662,25,1,46408,25,1,47546,25,1,48246,6,25.6,-1.272828,36.816608,-1.2628473,36.781805,459,700,19,1884
20722,1711,552,3,Business,23,2,44063,23,2,44129,23,2,45889,23,2,45977,23,2,48115,17,18.2,-1.279395,36.825364,-1.3632162,36.9108253,329,2138,66,1848
20723,11168,1343,1,Personal,25,3,62581,25,3,62617,25,3,63094,25,3,64665,25,3,65912,9,17.6,-1.2699442,36.8206553,-1.2917966,36.7730221,427,1247,36,2048
20724,9816,712,2,Personal,19,2,54007,19,2,54035,19,2,54290,19,2,54561,19,2,55868,10,18.3,-1.2850107,36.810614,-1.238874,36.807889,478,1307,28,526
20725,13384,1796,3,Business,26,2,50344,26,2,50370,26,2,51689,26,2,54267,26,2,54272,15,29.7,-1.2628473,36.781805,-1.331619,36.847976,268,5,26,3897
20726,17971,246,3,Business,24,1,43156,24,1,43164,24,1,44900,24,1,47238,24,1,47340,2,22.4,-1.2551895,36.7822034,-1.2584143,36.8048002,647,102,8,4074
20727,7486,2701,3,Business,29,4,40576,29,4,41582,29,4,42064,29,4,42267,29,4,43485,5,21.5,-1.2765736,36.8513646,-1.3083777,36.8590077,69,1218,1006,685
20728,9914,1500,3,Business,8,1,31602,8,1,31630,8,1,31920,8,1,33107,8,1,34138,8,21.7,-1.3004062,36.829741,-1.2638185,36.7930057,507,1031,28,1477
20729,13939,2587,3,Business,31,4,55698,31,4,56864,31,4,57623,31,4,57731,31,4,59011,8,28.6,-1.28878,36.8168312,-1.3215394,36.836621,276,1280,1166,867
20730,10246,3283,3,Business,5,6,37596,5,6,37659,5,6,39718,5,6,41715,5,6,42839,13,22.3,-1.331619,36.847976,-1.2628473,36.781805,48,1124,63,4056
20731,14994,3724,1,Personal,30,3,33635,30,3,33747,30,3,35151,30,3,35506,30,3,37114,10,17.4,-1.3205294,36.8197262,-1.2571422,36.8015627,208,1608,112,1759
20732,10239,2174,3,Business,23,6,37845,23,6,37867,23,6,37870,23,6,40108,23,6,41218,22,23.25888921888938,-1.2482781,36.884092,-1.3470009,36.7619454,86,1110,22,2241
20733,27974,3141,2,Personal,10,5,47113,10,5,47143,10,5,48078,10,5,49314,10,5,51670,18,21.8,-1.2696183,36.8021778,-1.3103985,36.9114173,791,2356,30,2171
20734,13059,3295,3,Business,22,3,45731,22,3,45802,22,3,45837,22,3,46891,22,3,48167,13,23.0,-1.2571472,36.7950633,-1.3104734,36.7363698,564,1276,71,1089
20735,20707,2066,3,Business,17,5,44545,17,5,44567,17,5,44762,17,5,45210,17,5,45919,6,17.7,-1.316961,36.820337,-1.2790803,36.8156909,857,709,22,643
20736,21723,346,3,Business,21,4,44242,21,4,44605,21,4,44624,21,4,45348,21,4,46257,5,25.1,-1.2765736,36.8513646,-1.28878,36.8168312,31,909,363,743
20737,26329,830,3,Business,5,5,45584,5,5,45600,5,5,46091,5,5,46619,5,5,47431,3,23.8,-1.2527958,36.8003131,-1.2551895,36.7822034,857,812,16,1019
20738,26078,2279,3,Business,27,1,57082,27,1,57108,27,1,57385,27,1,57675,27,1,58936,7,23.25888921888938,-1.2897368,36.8226783,-1.2571472,36.7950633,698,1261,26,567
20739,12290,1280,3,Business,2,4,50283,2,4,50299,2,4,50942,2,4,51913,2,4,51915,3,23.25888921888938,-1.2551895,36.7822034,-1.265338,36.8088155,193,2,16,1614
20740,928,2383,3,Business,9,2,32054,9,2,32085,9,2,33039,9,2,33723,9,2,34474,5,20.6,-1.2696819,36.8028694,-1.2608993,36.799246,520,751,31,1638
20741,15142,865,3,Business,14,2,32499,14,2,32555,14,2,33308,14,2,33507,14,2,36209,22,23.25888921888938,-1.2456412,36.7955298,-1.3442152,36.9199984,155,2702,56,952
20742,22003,3291,3,Business,6,6,45020,6,6,45078,6,6,45567,6,6,46442,6,6,47721,8,26.8,-1.2999309,36.8307998,-1.2600926,36.8088685,206,1279,58,1364
20743,13049,2008,3,Business,19,2,58089,19,2,58292,19,2,59621,19,2,60107,19,2,60108,3,28.1,-1.2508229,36.7895263,-1.2714767,36.8138291,411,1,203,1815
20744,13551,393,3,Business,7,5,43457,7,5,43488,7,5,44158,7,5,45087,7,5,46720,11,23.25888921888938,-1.3228003,36.8306435,-1.2638185,36.7930057,591,1633,31,1599
20745,3891,928,3,Business,2,4,54155,2,4,54493,2,4,54497,2,4,56753,2,4,56928,7,23.25888921888938,-1.2551895,36.7822034,-1.290724,36.81947,61,175,338,2260
20746,25157,1075,3,Business,4,5,56703,4,5,56711,4,5,57429,4,5,57585,4,5,58084,1,23.25888921888938,-1.2649605,36.7981777,-1.2527958,36.8003131,361,499,8,874
20747,1379,127,1,Personal,24,7,38435,24,7,38611,24,7,39251,24,7,39907,24,7,41359,12,23.25888921888938,-1.3068736,36.887004,-1.311943,36.8331134,890,1452,176,1296
20748,23094,1072,1,Personal,11,1,53440,11,1,53688,11,1,54073,11,1,54159,11,1,54739,3,23.2,-1.261849,36.808254,-1.2790653,36.7907262,379,580,248,471
20749,3323,2587,3,Business,18,4,52243,18,4,52296,18,4,53752,18,4,55213,18,4,58585,8,23.25888921888938,-1.3014461,36.7661381,-1.28878,36.8168312,338,3372,53,2917
20750,3229,1777,3,Personal,24,4,52189,24,4,52246,24,4,53085,24,4,53205,24,4,54321,8,22.5,-1.2493274,36.7529258,-1.288406,36.760079,334,1116,57,959
20751,10435,136,3,Business,18,4,51259,18,4,51270,18,4,52525,18,4,52844,18,4,55004,15,23.25888921888938,-1.3254522,36.7216584,-1.2870705,36.8256017,435,2160,11,1574
20752,27325,3558,2,Personal,10,2,33444,10,2,33695,10,2,34249,10,2,34589,10,2,36842,8,16.5,-1.2763916,36.8246826,-1.2905046,36.7828277,726,2253,251,894
20753,3319,1601,1,Personal,22,5,36773,22,5,36791,22,5,37777,22,5,37919,22,5,38528,5,16.3,-1.255956,36.772901,-1.2613754,36.795771,103,609,18,1128
20754,24534,3647,3,Business,28,3,49905,28,3,49955,28,3,50875,28,3,51443,28,3,54746,21,23.25888921888938,-1.272639,36.794723,-1.1848195,36.915472,295,3303,50,1488
20755,23961,1471,3,Business,14,5,62577,14,5,64847,14,5,65699,14,5,67346,14,5,69148,13,21.6,-1.2297202,36.8819507,-1.3037387,36.8175661,384,1802,2270,2499
20756,8524,1280,3,Business,28,4,56541,28,4,56650,28,4,57450,28,4,57596,28,4,58380,5,29.9,-1.2551895,36.7822034,-1.265981,36.7936121,329,784,109,946
20757,3223,3647,3,Business,2,2,57375,2,2,57427,2,2,58206,2,2,58930,2,2,60404,14,26.3,-1.272639,36.794723,-1.2363092,36.8823617,754,1474,52,1503
20758,337,136,3,Business,20,3,39004,20,3,40019,20,3,40273,20,3,40392,20,3,44293,8,27.1,-1.3254522,36.7216584,-1.3009676,36.7657189,337,3901,1015,373
20759,4684,2154,3,Business,23,3,41427,23,3,41480,23,3,41656,23,3,41931,23,3,43587,6,23.25888921888938,-1.279395,36.825364,-1.2765736,36.8513646,758,1656,53,451
20760,3810,3434,3,Business,4,1,55024,4,1,55082,4,1,56005,4,1,56424,4,1,58565,10,22.8,-1.2963097,36.7688221,-1.304969,36.846623,200,2141,58,1342
20761,7997,970,3,Business,29,2,48496,29,2,48563,29,2,49112,29,2,49247,29,2,50139,7,26.8,-1.2551895,36.7822034,-1.2795549,36.7627011,333,892,67,684
20762,2914,1569,2,Personal,7,5,53533,7,5,53562,7,5,54041,7,5,54234,7,5,56209,19,24.9,-1.2627937,36.8156957,-1.314193,36.916132,74,1975,29,672
20763,17538,1570,3,Personal,30,1,49017,30,1,49064,30,1,49659,30,1,50662,30,1,51788,7,20.6,-1.2793831,36.7617573,-1.2697141,36.7981777,124,1126,47,1598
20764,24562,59,3,Business,18,4,38442,18,4,39453,18,4,40508,18,4,41700,18,4,43428,6,23.25888921888938,-1.3147074,36.811722,-1.290894,36.822971,76,1728,1011,2247
20765,22255,928,3,Business,15,1,41964,15,1,41990,15,1,42397,15,1,42921,15,1,45463,8,23.25888921888938,-1.2551895,36.7822034,-1.2958383,36.8073162,565,2542,26,931
20766,19980,3689,3,Business,6,2,33464,6,2,33659,6,2,33877,6,2,34159,6,2,35345,10,19.9,-1.2527958,36.8003131,-1.2934638,36.7668028,279,1186,195,500
20767,24930,1880,3,Business,26,4,52879,26,4,52906,26,4,54992,26,4,55584,26,4,59358,2,21.9,-1.2571472,36.7950633,-1.2672588,36.8000252,519,3774,27,2678
20768,27057,2200,3,Business,12,2,51078,12,2,51116,12,2,51201,12,2,51803,12,2,52676,4,23.25888921888938,-1.290894,36.822971,-1.2668734,36.8054026,156,873,38,687
20769,11588,393,3,Business,22,3,41645,22,3,41688,22,3,44208,22,3,45470,22,3,47144,10,23.2,-1.3177547,36.8303703,-1.2574219,36.7927073,56,1674,43,3782
20770,9881,2956,3,Business,23,4,59634,23,4,59652,23,4,59839,23,4,60044,23,4,60510,3,20.1,-1.2584143,36.8048002,-1.2551895,36.7822034,726,466,18,392
20771,2090,3634,2,Personal,11,2,61797,11,2,62084,11,2,62776,11,2,63456,11,2,65788,14,23.5,-1.3178263,36.7141818,-1.2696341,36.791664,268,2332,287,1372
20772,25111,2330,3,Business,3,3,49728,3,3,49917,3,3,51139,3,3,51852,3,3,52982,10,28.2,-1.3015197,36.7658456,-1.2536275,36.7987932,576,1130,189,1935
20773,21812,2801,3,Business,24,1,41964,24,1,42004,24,1,43090,24,1,43171,24,1,44166,7,22.3,-1.2595422,36.7871178,-1.281577,36.7938293,38,995,40,1167
20774,14217,3591,3,Personal,15,6,42272,15,6,42777,15,6,44921,15,6,45356,15,6,46709,10,19.1,-1.3165524,36.7080859,-1.3653687,36.7337644,226,1353,505,2579
20775,3045,1397,3,Business,15,5,37881,15,5,38844,15,5,39472,15,5,39815,15,5,43046,27,26.5,-1.413547,36.9550764,-1.2628638,36.8070399,932,3231,963,971
20776,8830,302,3,Business,13,2,73327,13,2,73359,13,2,73979,13,2,74441,13,2,75554,7,20.4,-1.2649605,36.7981777,-1.2895725,36.775179,413,1113,32,1082
20777,5153,686,1,Personal,9,2,38114,9,2,38141,9,2,38315,9,2,39793,9,2,42393,21,22.0,-1.366466,36.91584,-1.2615349,36.8068294,848,2600,27,1652
20778,12332,979,3,Personal,8,1,50376,8,1,50435,8,1,50559,8,1,52335,8,1,53843,14,29.4,-1.2635089,36.7887337,-1.3204931,36.7043102,291,1508,59,1900
20779,21208,1792,3,Business,9,3,37978,9,3,38026,9,3,39130,9,3,39498,9,3,42492,19,25.3,-1.3094447,36.9107706,-1.2809121,36.7852524,237,2994,48,1472
20780,853,868,3,Business,29,6,44808,29,6,44828,29,6,44939,29,6,46208,29,6,46915,4,24.2,-1.2600926,36.8088685,-1.265715,36.823815,427,707,20,1380
20781,10378,2195,1,Business,1,3,37805,1,3,37820,1,3,38633,1,3,39364,1,3,39378,3,19.7,-1.331619,36.847976,-1.3313643,36.8577422,890,14,15,1544
20782,9678,706,3,Business,18,2,55899,18,2,55953,18,2,55962,18,2,57785,18,2,57788,5,25.8,-1.295723,36.822692,-1.3077869,36.8443207,848,3,54,1832
20783,4784,1964,3,Personal,11,5,40862,11,5,40930,11,5,41796,11,5,41978,11,5,42718,7,21.1,-1.317772,36.824446,-1.32671,36.8600138,130,740,68,1048
20784,1259,3184,3,Business,28,5,41195,28,5,41225,28,5,41957,28,5,42462,28,5,43896,17,25.0,-1.3396256,36.8863135,-1.2682179,36.8009289,345,1434,30,1237
20785,8829,419,3,Business,20,1,49517,20,1,49529,20,1,49612,20,1,49965,20,1,50990,6,21.5,-1.2571472,36.7950633,-1.3001813,36.811122,45,1025,12,436
20786,17921,633,3,Business,22,5,51049,22,5,51094,22,5,51813,22,5,52391,22,5,53684,9,30.8,-1.2638185,36.7930057,-1.3004062,36.829741,682,1293,45,1297
20787,13621,2330,3,Business,20,4,40540,20,4,40678,20,4,41459,20,4,41610,20,4,42567,7,22.4,-1.2921463,36.8029626,-1.2642903,36.8002137,275,957,138,932
20788,2962,3109,2,Personal,6,3,48646,6,3,48745,6,3,49163,6,3,49244,6,3,50834,5,21.6,-1.2553615,36.7895376,-1.2726359,36.7896003,322,1590,99,499
20789,13173,2175,3,Business,24,4,50656,24,4,50712,24,4,52543,24,4,52793,24,4,53912,5,28.1,-1.2551895,36.7822034,-1.2790175,36.8151778,268,1119,56,2081
20790,3085,435,3,Business,14,5,46624,14,5,46643,14,5,46888,14,5,47361,14,5,47839,3,22.1,-1.300921,36.828195,-1.3176092,36.8142275,178,478,19,718
20791,16707,2175,3,Business,17,3,63323,17,3,63357,17,3,63928,17,3,64264,17,3,65532,8,23.25888921888938,-1.2551895,36.7822034,-1.2824911,36.8218042,953,1268,34,907
20792,22262,3647,3,Business,24,5,54020,24,5,54084,24,5,54935,24,5,55384,24,5,57817,18,23.0,-1.272639,36.794723,-1.3532484,36.7249576,217,2433,64,1300
20793,7182,517,3,Business,3,4,29324,3,4,29973,3,4,31374,3,4,31937,3,4,33457,11,20.6,-1.3167113,36.8301563,-1.2574219,36.7927073,436,1520,649,1964
20794,18127,2997,1,Personal,2,4,33857,2,4,33873,2,4,34652,2,4,35037,2,4,35963,7,13.4,-1.2849815,36.7767751,-1.2551895,36.7822034,754,926,16,1164
20795,16454,627,3,Business,10,5,59413,10,5,59763,10,5,60949,10,5,61176,10,5,63204,9,23.25888921888938,-1.2551895,36.7822034,-1.225322,36.80855,422,2028,350,1413
20796,11081,3177,3,Business,18,4,36343,18,4,37456,18,4,38180,18,4,38443,18,4,40264,9,23.25888921888938,-1.301953,36.788458,-1.2566689,36.7796952,299,1821,1113,987
20797,23746,2066,3,Business,24,6,51599,24,6,51693,24,6,52486,24,6,54372,24,6,55779,11,26.9,-1.3210189,36.8410551,-1.250476,36.802013,622,1407,94,2679
20798,10129,1245,3,Business,5,2,39800,5,2,39813,5,2,41214,5,2,42586,5,2,46333,27,25.3,-1.300921,36.828195,-1.364732,36.658943,127,3747,13,2773
20799,23174,3669,3,Business,12,1,49761,12,1,51012,12,1,51040,12,1,51741,12,1,53951,6,27.0,-1.279395,36.825364,-1.2615888,36.7928732,606,2210,1251,729
20800,26125,313,2,Personal,3,2,28953,3,2,28965,3,2,29883,3,2,30234,3,2,33331,17,15.4,-1.3339943,36.7263409,-1.2811695,36.8200313,844,3097,12,1269
20801,11488,1336,3,Business,10,1,51087,10,1,54095,10,1,55122,10,1,55435,10,1,56246,2,18.9,-1.2885029,36.825605,-1.281546,36.819875,812,811,3008,1340
20802,23323,3222,3,Business,10,5,32345,10,5,32481,10,5,32928,10,5,32991,10,5,34276,8,23.25888921888938,-1.2551895,36.7822034,-1.2998903,36.8179213,70,1285,136,510
20803,7223,1098,1,Personal,27,7,39795,27,7,39812,27,7,41099,27,7,41654,27,7,43576,12,20.3,-1.2128897,36.8910107,-1.1653207,36.9415164,858,1922,17,1842
20804,14021,1502,1,Business,1,5,44708,1,5,44732,1,5,46091,1,5,46400,1,5,48299,20,22.3,-1.285611,36.9047023,-1.3467389,36.7690312,397,1899,24,1668
20805,3337,972,3,Business,1,4,38999,1,4,39266,1,4,40099,1,4,40173,1,4,41007,5,23.25888921888938,-1.2862033,36.8152966,-1.3016653,36.8323628,936,834,267,907
20806,16241,2523,3,Business,4,4,56104,4,4,56145,4,4,56620,4,4,57853,4,4,59294,8,24.8,-1.2551895,36.7822034,-1.2821378,36.7740428,412,1441,41,1708
20807,12619,3080,3,Business,22,3,42294,22,3,42318,22,3,42381,22,3,42753,22,3,44631,18,22.9,-1.2551895,36.7822034,-1.3343129,36.8854175,576,1878,24,435
20808,13980,788,3,Business,26,5,40932,26,5,49578,26,5,50362,26,5,50644,26,5,52983,14,23.25888921888938,-1.28878,36.8168312,-1.225322,36.80855,148,2339,8646,1066
20809,7537,53,3,Business,5,2,36944,5,2,37334,5,2,40668,5,2,42900,5,2,43001,5,25.6,-1.2770708,36.8231093,-1.3004062,36.829741,436,101,390,5566
20810,2560,1724,3,Business,28,4,61652,28,4,61692,28,4,61697,28,4,63024,28,4,64572,11,27.9,-1.32189,36.8589727,-1.2941648,36.7977315,647,1548,40,1332
20811,23359,1195,3,Business,11,1,56889,11,1,57073,11,1,57077,11,1,57463,11,1,58041,4,28.7,-1.3228003,36.8306435,-1.3004062,36.829741,619,578,184,390
20812,6753,1940,1,Personal,5,6,34821,5,6,34845,5,6,35963,5,6,36559,5,6,37166,4,19.1,-1.2473038,36.7884707,-1.2670196,36.8077002,219,607,24,1714
20813,2335,1850,3,Business,18,1,44706,18,1,44766,18,1,45693,18,1,46038,18,1,47194,2,26.9,-1.2551895,36.7822034,-1.2584143,36.8048002,215,1156,60,1272
20814,3858,3689,3,Business,7,5,59128,7,5,59988,7,5,60471,7,5,60675,7,5,63047,7,22.9,-1.2527958,36.8003131,-1.225322,36.80855,382,2372,860,687
20815,11091,2219,3,Business,23,2,49305,23,2,49467,23,2,49713,23,2,49954,23,2,51213,6,23.25888921888938,-1.2946359,36.8352718,-1.3272104,36.8528418,654,1259,162,487
20816,10328,1471,3,Business,14,4,32061,14,4,32085,14,4,33094,14,4,33371,14,4,36647,4,17.9,-1.2551895,36.7822034,-1.2752846,36.8027022,747,3276,24,1286
20817,18857,3557,3,Business,12,2,49832,12,2,49847,12,2,51722,12,2,53431,12,2,53434,5,23.25888921888938,-1.2895261,36.8164407,-1.2546732,36.8086796,314,3,15,3584
20818,17302,1350,3,Personal,22,6,46031,22,6,46115,22,6,46589,22,6,47247,22,6,48154,6,23.2,-1.2962832,36.7849683,-1.3094838,36.8206907,205,907,84,1132
20819,26401,1618,1,Personal,11,4,43274,11,4,44037,11,4,45924,11,4,46051,11,4,47970,10,23.9,-1.2797071,36.8224077,-1.2810437,36.9042365,532,1919,763,2014
20820,20625,2200,3,Business,6,2,55113,6,2,58859,6,2,60178,6,2,61140,6,2,64822,7,23.25888921888938,-1.290894,36.822971,-1.2546732,36.7923244,925,3682,3746,2281
20821,9528,1471,3,Business,15,5,45116,15,5,45265,15,5,46710,15,5,47624,15,5,49751,15,26.5,-1.3194518,36.869396,-1.2551895,36.7822034,697,2127,149,2359
20822,11048,393,3,Business,30,5,34714,30,5,35723,30,5,35744,30,5,36789,30,5,38522,14,18.9,-1.3177547,36.8303703,-1.306378,36.7519845,619,1733,1009,1066
20823,21011,3121,3,Personal,30,4,53653,30,4,53712,30,4,54250,30,4,54459,30,4,54729,2,23.25888921888938,-1.2685707,36.8064961,-1.2753109,36.8130185,96,270,59,747
20824,8747,246,3,Business,15,2,44164,15,2,44400,15,2,45026,15,2,45504,15,2,46417,7,23.0,-1.2864963,36.8252086,-1.264272,36.7978791,100,913,236,1104
20825,5724,3771,3,Personal,17,3,51512,17,3,51829,17,3,52808,17,3,56156,17,3,57835,6,28.5,-1.273808,36.8402896,-1.2768326,36.8073804,432,1679,317,4327
20826,2843,1927,3,Business,1,5,63470,1,5,63550,1,5,65705,1,5,66338,1,5,69127,25,26.6,-1.2232123,36.8932547,-1.3472066,36.7692638,19,2789,80,2788
20827,5454,1926,3,Business,6,6,46589,6,6,47002,6,6,47978,6,6,48113,6,6,49353,14,24.4,-1.3044764,36.8843623,-1.2156006,36.8916865,31,1240,413,1111
20828,17955,393,3,Business,18,5,37721,18,5,40250,18,5,40780,18,5,44629,18,5,44652,14,21.5,-1.3177547,36.8303703,-1.306378,36.7519845,927,23,2529,4379
20829,22440,607,2,Personal,9,1,57915,9,1,57940,9,1,58444,9,1,58728,9,1,59372,3,21.3,-1.2981354,36.7759988,-1.2858511,36.7946184,312,644,25,788
20830,18067,53,3,Business,28,4,54130,28,4,54265,28,4,55135,28,4,55321,28,4,56253,7,29.8,-1.2638185,36.7930057,-1.2770708,36.8231093,448,932,135,1056
20831,6237,2310,3,Business,29,2,54764,29,2,54771,29,2,55802,29,2,56244,29,2,58720,14,23.6,-1.2591019,36.800577,-1.2859912,36.8756811,755,2476,7,1473
20832,25708,53,3,Business,10,5,42815,10,5,42911,10,5,43822,10,5,45321,10,5,46490,5,23.25888921888938,-1.3004062,36.829741,-1.2770708,36.8231093,448,1169,96,2410
20833,13408,3683,3,Business,10,4,40868,10,4,41152,10,4,41784,10,4,42542,10,4,43257,7,23.25888921888938,-1.2897368,36.8226783,-1.2579304,36.8019667,900,715,284,1390
20834,10936,3577,2,Personal,14,2,44302,14,2,44319,14,2,45191,14,2,45413,14,2,47699,12,21.6,-1.2731241,36.7992818,-1.3314048,36.8229367,857,2286,17,1094
20835,2783,439,3,Business,3,1,54862,3,1,56593,3,1,56969,3,1,57748,3,1,59005,4,23.6,-1.2613768,36.8019418,-1.2778316,36.7922222,407,1257,1731,1155
20836,5265,248,3,Business,26,4,43041,26,4,43047,26,4,44131,26,4,44550,26,4,45380,3,19.1,-1.304735,36.7846054,-1.2929747,36.7646358,229,830,6,1503
20837,16871,718,3,Business,27,2,43702,27,2,44262,27,2,44893,27,2,45001,27,2,46829,11,23.9,-1.2551895,36.7822034,-1.3250103,36.8388817,905,1828,560,739
20838,25103,1304,3,Business,30,2,47205,30,2,48144,30,2,48401,30,2,50974,30,2,52914,9,27.5,-1.2864674,36.820262,-1.3332749,36.8708147,469,1940,939,2830
20839,5968,2931,3,Business,28,4,48071,28,4,48141,28,4,48708,28,4,49017,28,4,50239,8,30.0,-1.2452664,36.8028541,-1.29817,36.8001417,383,1222,70,876
20840,22770,2330,3,Business,22,3,62599,22,3,62642,22,3,63228,22,3,64126,22,3,65543,10,24.2,-1.3339536,36.7181,-1.294597,36.7742999,362,1417,43,1484
20841,15398,2154,3,Business,13,1,39056,13,1,39120,13,1,39174,13,1,41046,13,1,41451,6,17.0,-1.3052491,36.8223899,-1.2765736,36.8513646,179,405,64,1926
20842,19047,2066,3,Business,9,4,51433,9,4,51452,9,4,51726,9,4,51847,9,4,52509,5,26.0,-1.316961,36.820337,-1.2996681,36.8068413,865,662,19,395
20843,26110,627,3,Business,26,5,54634,26,5,54645,26,5,54664,26,5,55050,26,5,55582,6,23.25888921888938,-1.2551895,36.7822034,-1.2729292,36.7679079,438,532,11,405
20844,2089,1724,3,Business,10,4,44118,10,4,44180,10,4,44319,10,4,44984,10,4,46560,8,24.7,-1.2551895,36.7822034,-1.291282,36.798229,720,1576,62,804
20845,17914,1195,3,Business,26,2,58502,26,2,58575,26,2,60073,26,2,60631,26,2,61669,7,29.6,-1.3228003,36.8306435,-1.3012842,36.8561033,448,1038,73,2056
20846,4596,2112,3,Business,29,2,56103,29,2,56117,29,2,56597,29,2,57423,29,2,58948,14,23.8,-1.2524976,36.8062935,-1.2156006,36.8916865,543,1525,14,1306
20847,11887,3295,3,Business,10,5,43768,10,5,44082,10,5,44803,10,5,44893,10,5,45922,8,23.25888921888938,-1.2571472,36.7950633,-1.2966323,36.7875842,953,1029,314,811
20848,15026,1874,3,Business,15,4,54369,15,4,54419,15,4,55235,15,4,55604,15,4,57560,12,27.7,-1.2571472,36.7950633,-1.31553,36.863732,935,1956,50,1185
20849,2585,868,3,Business,6,1,54922,6,1,54981,6,1,55553,6,1,56400,6,1,57489,9,24.5,-1.331619,36.847976,-1.265715,36.823815,116,1089,59,1419
20850,228,1500,3,Business,7,4,39173,7,4,39247,7,4,40285,7,4,40584,7,4,42760,8,27.6,-1.3004062,36.829741,-1.2638185,36.7930057,436,2176,74,1337
20851,27025,3651,3,Business,25,2,42668,25,2,42676,25,2,43778,25,2,44376,25,2,45039,2,24.0,-1.2571472,36.7950633,-1.2662728,36.8151265,116,663,8,1700
20852,6981,1081,3,Business,22,2,44365,22,2,44396,22,2,44885,22,2,45037,22,2,45571,4,23.8,-1.2944363,36.7983424,-1.2963097,36.7688221,845,534,31,641
20853,24363,3452,1,Personal,11,5,51603,11,5,51799,11,5,51919,11,5,52171,11,5,53531,9,22.7,-1.2815826,36.8205195,-1.2592902,36.7634987,101,1360,196,372
20854,11259,3283,3,Business,28,2,45942,28,2,45974,28,2,48108,28,2,49128,28,2,50072,5,23.6,-1.2600926,36.8088685,-1.2628473,36.781805,732,944,32,3154
20855,24153,3222,3,Business,27,2,37881,27,2,41487,27,2,41673,27,2,41814,27,2,43097,8,24.0,-1.2551895,36.7822034,-1.295156,36.8094306,532,1283,3606,327
20856,3440,3291,3,Business,7,5,51355,7,5,51388,7,5,52178,7,5,52768,7,5,53665,4,23.25888921888938,-1.265715,36.823815,-1.2600926,36.8088685,309,897,33,1380
20857,7799,517,3,Business,29,2,51866,29,2,51877,29,2,51893,29,2,51991,29,2,53729,14,26.9,-1.3167113,36.8301563,-1.306378,36.7519845,523,1738,11,114
20858,5727,3470,3,Business,26,1,56753,26,1,57167,26,1,57643,26,1,58066,26,1,58755,5,22.1,-1.2584143,36.8048002,-1.28878,36.8168312,583,689,414,899
20859,10605,3249,2,Personal,10,5,57982,10,5,57994,10,5,58877,10,5,59638,10,5,62323,20,21.0,-1.3168075,36.8626441,-1.2593592,36.7775322,248,2685,12,1644
20860,22048,2008,3,Business,11,4,55336,11,4,55822,11,4,57616,11,4,58012,11,4,59062,9,27.0,-1.2508229,36.7895263,-1.3121752,36.8083282,829,1050,486,2190
20861,27653,640,3,Business,15,3,53444,15,3,53647,15,3,54674,15,3,55165,15,3,56924,6,26.0,-1.2857524,36.8196806,-1.2969741,36.7856612,158,1759,203,1518
20862,24737,635,3,Business,4,2,42862,4,2,42908,4,2,43013,4,2,43638,4,2,44320,6,18.7,-1.2975039,36.8110959,-1.2599563,36.7993439,216,682,46,730
20863,8209,2057,2,Personal,15,1,37768,15,1,47549,15,1,48141,15,1,48447,15,1,49626,11,23.25888921888938,-1.2976368,36.7519827,-1.2630521,36.8068019,933,1179,9781,898
20864,3540,3291,3,Business,10,5,37427,10,5,37534,10,5,39857,10,5,40551,10,5,42569,18,19.1,-1.342789,36.8967244,-1.2600926,36.8088685,414,2018,107,3017
20865,5999,2548,3,Business,23,3,38886,23,3,38900,23,3,39026,23,3,39547,23,3,45263,16,23.25888921888938,-1.3031652,36.8466816,-1.3435722,36.7514095,231,5716,14,647
20866,23976,2330,3,Business,7,4,58784,7,4,58803,7,4,59012,7,4,59440,7,4,61067,10,27.6,-1.3040812,36.7924217,-1.3192789,36.7112991,487,1627,19,637
20867,19716,2985,2,Personal,4,5,30973,4,5,30995,4,5,33062,4,5,33510,4,5,37974,18,19.3,-1.226855,36.8857626,-1.3018775,36.7856016,771,4464,22,2515
20868,754,265,3,Business,12,2,50971,12,2,51985,12,2,52816,12,2,53958,12,2,55561,16,27.2,-1.3882008,36.7699445,-1.300921,36.828195,858,1603,1014,1973
20869,12479,302,3,Business,30,4,60242,30,4,60766,30,4,62528,30,4,63074,30,4,65902,10,20.4,-1.2649605,36.7981777,-1.3273625,36.8300883,447,2828,524,2308
20870,26940,943,2,Personal,14,5,46189,14,5,46608,14,5,48075,14,5,48599,14,5,50436,7,24.5,-1.3143165,36.8480382,-1.2841214,36.8293514,844,1837,419,1991
20871,13648,1051,3,Business,25,5,60856,25,5,60862,25,5,60865,25,5,60942,25,5,61685,2,26.8,-1.2963097,36.7688221,-1.2969741,36.7856612,24,743,6,80
20872,13657,3404,3,Business,29,4,45091,29,4,45326,29,4,45988,29,4,47884,29,4,48983,5,21.6,-1.2584143,36.8048002,-1.279395,36.825364,744,1099,235,2558
20873,25458,393,3,Business,20,3,59938,20,3,59960,20,3,60045,20,3,62029,20,3,63089,4,27.9,-1.3167113,36.8301563,-1.3004062,36.829741,303,1060,22,2069
20874,16497,2066,3,Business,28,7,48959,28,7,48970,28,7,50181,28,7,50412,28,7,52789,21,23.25888921888938,-1.3210189,36.8410551,-1.207546,36.7913976,68,2377,11,1442
20875,16567,3149,3,Business,4,5,47083,4,5,47098,4,5,47326,4,5,47975,4,5,49511,13,17.2,-1.2574219,36.7927073,-1.3228003,36.8306435,237,1536,15,877
20876,27453,1298,1,Personal,5,4,32629,5,4,32643,5,4,33056,5,4,33826,5,4,35145,10,23.25888921888938,-1.2633494,36.7959696,-1.308819,36.8421201,379,1319,14,1183
20877,26688,3247,3,Business,6,2,53070,6,2,53282,6,2,53552,6,2,53935,6,2,54342,2,27.6,-1.2571472,36.7950633,-1.2690931,36.8065779,541,407,212,653
20878,21393,3283,3,Business,27,3,41568,27,3,41636,27,3,42230,27,3,43541,27,3,46184,19,25.8,-1.293515,36.897607,-1.2628473,36.781805,292,2643,68,1905
20879,12771,478,3,Business,7,1,27354,7,1,28383,7,1,29402,7,1,30400,7,1,31893,6,21.6,-1.2551895,36.7822034,-1.2897368,36.8226783,72,1493,1029,2017
20880,19919,533,3,Business,3,3,46456,3,3,46512,3,3,47214,3,3,47402,3,3,48156,6,27.5,-1.2765492,36.7669809,-1.2551895,36.7822034,576,754,56,890
20881,25331,1341,3,Business,25,6,35572,25,6,35598,25,6,35730,25,6,36265,25,6,36889,7,23.25888921888938,-1.307143,36.825009,-1.331619,36.847976,591,624,26,667
20882,18361,3032,3,Business,19,3,35532,19,3,35549,19,3,35978,19,3,36866,19,3,39310,18,19.5,-1.2571472,36.7950633,-1.3398006,36.717935,858,2444,17,1317
20883,17412,496,3,Business,12,3,58542,12,3,58564,12,3,59002,12,3,59146,12,3,60831,12,26.3,-1.2551895,36.7822034,-1.3269776,36.8055554,283,1685,22,582
20884,13674,635,3,Business,13,3,34507,13,3,34587,13,3,35008,13,3,38240,13,3,39579,7,24.9,-1.300921,36.828195,-1.2585521,36.7945765,483,1339,80,3653
20885,3560,283,3,Business,30,1,35023,30,1,35761,30,1,36803,30,1,37110,30,1,38351,4,16.3,-1.2804227,36.8250375,-1.2624632,36.8405321,229,1241,738,1349
20886,21428,1715,3,Business,22,3,37151,22,3,37183,22,3,37891,22,3,38511,22,3,39336,3,22.9,-1.2747111,36.8083983,-1.253966,36.7987692,213,825,32,1328
20887,17045,1245,3,Business,8,6,42225,8,6,42274,8,6,43107,8,6,44022,8,6,46035,9,19.8,-1.300921,36.828195,-1.2885713,36.7649818,739,2013,49,1748
20888,3880,3203,3,Business,25,3,51430,25,3,51438,25,3,51921,25,3,52301,25,3,53908,16,17.6,-1.2628473,36.781805,-1.228911,36.881876,399,1607,8,863
20889,5179,206,2,Personal,15,1,55784,15,1,55796,15,1,56597,15,1,56956,15,1,58777,20,23.25888921888938,-1.2596241,36.762407,-1.1864337,36.8400838,116,1821,12,1160
20890,6124,2330,3,Business,8,1,62473,8,1,62524,8,1,63470,8,1,63708,8,1,66017,7,29.2,-1.233018,36.8004477,-1.2645318,36.7981775,613,2309,51,1184
20891,8115,2676,3,Business,1,5,35813,1,5,35860,1,5,37044,1,5,38514,1,5,39248,2,28.8,-1.304033,36.7848695,-1.2963097,36.7688221,343,734,47,2654
20892,23388,706,3,Business,2,3,52534,2,3,53000,2,3,54127,2,3,54222,2,3,55644,4,26.1,-1.3077869,36.8443207,-1.2958261,36.8304671,858,1422,466,1222
20893,16322,970,3,Business,7,5,55415,7,5,56319,7,5,56948,7,5,57166,7,5,59376,19,23.25888921888938,-1.2551895,36.7822034,-1.3459625,36.9073925,155,2210,904,847
20894,6336,2691,3,Business,19,4,33928,19,4,33938,19,4,34229,19,4,35317,19,4,36233,6,14.7,-1.2571472,36.7950633,-1.2857671,36.7875614,379,916,10,1379
20895,26552,3080,3,Business,7,5,37803,7,5,37811,7,5,38404,7,5,38835,7,5,41082,18,25.2,-1.2551895,36.7822034,-1.3389279,36.7092201,449,2247,8,1024
20896,15463,3264,3,Business,22,2,44176,22,2,44211,22,2,44602,22,2,44739,22,2,45681,8,23.9,-1.2551895,36.7822034,-1.2862436,36.791017,259,942,35,528
20897,7747,617,3,Personal,27,3,39513,27,3,39571,27,3,39951,27,3,40841,27,3,43484,12,23.25888921888938,-1.3222627,36.8234096,-1.251921,36.828379,865,2643,58,1270
20898,15325,785,1,Personal,10,4,45364,10,4,45403,10,4,46295,10,4,46536,10,4,47134,3,23.25888921888938,-1.2672588,36.8000252,-1.2592428,36.7894541,409,598,39,1133
20899,24637,2587,3,Business,29,1,47703,29,1,47764,29,1,48011,29,1,48346,29,1,50873,5,23.25888921888938,-1.28878,36.8168312,-1.2614176,36.8213992,101,2527,61,582
20900,26876,391,3,Business,1,5,40359,1,5,40407,1,5,40991,1,5,41139,1,5,42872,18,26.5,-1.2867454,36.8259017,-1.3878505,36.7692885,237,1733,48,732
20901,16738,3186,3,Business,15,5,50870,15,5,53521,15,5,54172,15,5,54280,15,5,56329,5,27.8,-1.2980229,36.78865,-1.2874648,36.8271985,548,2049,2651,759
20902,9708,3621,3,Business,17,5,44674,17,5,44934,17,5,46052,17,5,46266,17,5,47106,5,23.25888921888938,-1.2836583,36.7886014,-1.2945922,36.8255247,158,840,260,1332
20903,26010,3689,3,Business,8,5,64793,8,5,64808,8,5,64991,8,5,65630,8,5,66695,7,25.4,-1.2527958,36.8003131,-1.225322,36.80855,383,1065,15,822
20904,14271,3647,3,Business,27,2,42684,27,2,42768,27,2,44109,27,2,44432,27,2,45257,4,23.6,-1.272639,36.794723,-1.2627937,36.8156957,467,825,84,1664
20905,1685,2554,3,Business,19,3,51987,19,3,53230,19,3,53609,19,3,54675,19,3,54680,6,24.4,-1.2861765,36.8209086,-1.2867836,36.7832522,404,5,1243,1445
20906,15670,2383,3,Business,10,4,55061,10,4,55110,10,4,55979,10,4,56372,10,4,60771,20,25.4,-1.2539424,36.8060772,-1.3124537,36.925365,956,4399,49,1262
20907,19821,53,3,Business,4,6,37728,4,6,37807,4,6,37823,4,6,39652,4,6,40385,5,23.25888921888938,-1.3004062,36.829741,-1.2770708,36.8231093,538,733,79,1845
20908,20458,426,3,Business,7,5,43696,7,5,43717,7,5,48004,7,5,48878,7,5,50832,14,24.9,-1.2968083,36.7870975,-1.3323107,36.8692616,328,1954,21,5161
20909,9529,1244,3,Business,21,1,38026,21,1,38040,21,1,38321,21,1,39146,21,1,40135,9,25.7,-1.2600926,36.8088685,-1.303596,36.778378,607,989,14,1106
20910,5341,779,1,Personal,5,6,42852,5,6,42983,5,6,44869,5,6,45894,5,6,47144,8,22.3,-1.2714948,36.8166789,-1.3127304,36.8189817,753,1250,131,2911
20911,1216,265,3,Business,13,1,36491,13,1,36585,13,1,37763,13,1,41804,13,1,45209,9,23.25888921888938,-1.2955042,36.7714687,-1.300921,36.828195,451,3405,94,5219
20912,3792,3331,3,Business,23,4,47343,23,4,47354,23,4,47576,23,4,47818,23,4,48462,4,18.7,-1.2551895,36.7822034,-1.2728947,36.8079426,415,644,11,464
20913,10118,2763,3,Business,4,1,52293,4,1,52486,4,1,53247,4,1,53825,4,1,57167,13,23.25888921888938,-1.2551895,36.7822034,-1.3110966,36.856707,44,3342,193,1339
20914,21955,375,3,Business,29,3,58234,29,3,58473,29,3,59659,29,3,60341,29,3,62979,8,18.9,-1.2551895,36.7822034,-1.2939132,36.8081606,498,2638,239,1868
20915,23171,3291,3,Business,23,6,45812,23,6,45835,23,6,46548,23,6,47022,23,6,48511,12,23.25888921888938,-1.331619,36.847976,-1.2600926,36.8088685,910,1489,23,1187
20916,13908,3686,3,Business,18,3,36340,18,3,36414,18,3,37261,18,3,37412,18,3,38838,9,14.5,-1.2551895,36.7822034,-1.2857117,36.7968296,131,1426,74,998
20917,4305,2344,3,Business,4,1,59009,4,1,59093,4,1,59142,4,1,59733,4,1,60805,8,25.9,-1.298529,36.816482,-1.2551895,36.7822034,715,1072,84,640
20918,16205,3647,3,Business,30,5,49528,30,5,49630,30,5,50504,30,5,50890,30,5,53263,11,24.7,-1.272639,36.794723,-1.234958,36.8104235,40,2373,102,1260
20919,25451,3017,3,Business,15,5,39728,15,5,40107,15,5,40502,15,5,40587,15,5,41422,7,20.1,-1.299313,36.7831488,-1.3077027,36.8163543,680,835,379,480
20920,4763,1363,3,Business,29,4,53247,29,4,53325,29,4,54161,29,4,54530,29,4,56341,10,24.9,-1.3004062,36.829741,-1.2592947,36.7698085,279,1811,78,1205
20921,11936,3496,3,Business,3,3,56261,3,3,56272,3,3,56518,3,3,57710,3,3,60588,12,26.7,-1.300921,36.828195,-1.2638504,36.918938,848,2878,11,1438
20922,25609,2830,1,Personal,15,1,25655,15,1,25668,15,1,26179,15,1,26360,15,1,28304,12,16.7,-1.2636863,36.7538933,-1.2549476,36.8269576,726,1944,13,692
20923,4389,3689,3,Business,8,4,56115,8,4,56173,8,4,57222,8,4,57978,8,4,61839,2,27.3,-1.2571472,36.7950633,-1.2527958,36.8003131,434,3861,58,1805
20924,21072,71,3,Business,10,6,39491,10,6,39506,10,6,39930,10,6,40439,10,6,42023,13,24.1,-1.339046,36.762596,-1.2891922,36.825189,110,1584,15,933
20925,22727,346,3,Business,28,4,58664,28,4,59390,28,4,60774,28,4,65336,28,4,65358,12,25.8,-1.2859912,36.8756811,-1.28878,36.8168312,436,22,726,5946
20926,1957,3686,3,Business,2,4,39425,2,4,39459,2,4,39646,2,4,39853,2,4,40716,3,23.25888921888938,-1.2551895,36.7822034,-1.2672588,36.8000252,695,863,34,394
20927,17488,1408,1,Personal,24,1,46678,24,1,46694,24,1,47520,24,1,47718,24,1,49094,8,22.3,-1.293886,36.7596951,-1.277247,36.8207518,328,1376,16,1024
20928,21253,972,3,Business,15,5,51834,15,5,51840,15,5,51852,15,5,53228,15,5,54763,13,22.7,-1.2862033,36.8152966,-1.2953535,36.9012626,886,1535,6,1388
20929,8630,3426,3,Business,31,3,31858,31,3,31889,31,3,32242,31,3,32989,31,3,35298,11,19.0,-1.3014461,36.7661381,-1.2905979,36.8442582,761,2309,31,1100
20930,21780,1880,3,Business,14,5,34578,14,5,37855,14,5,38235,14,5,39825,14,5,41870,6,21.6,-1.2571472,36.7950633,-1.2917253,36.7800652,383,2045,3277,1970
20931,2547,1344,1,Personal,31,5,61499,31,5,61551,31,5,61827,31,5,62013,31,5,63288,9,19.7,-1.2567464,36.7915273,-1.2963097,36.7688221,131,1275,52,462
20932,17150,2174,3,Business,15,2,36290,15,2,36294,15,2,36306,15,2,41111,15,2,42761,16,24.2,-1.2482781,36.884092,-1.1668055,36.8304448,82,1650,4,4817
20933,27045,404,1,Personal,21,4,57963,21,4,59489,21,4,59951,21,4,61157,21,4,61867,5,20.1,-1.331669,36.879235,-1.3124015,36.9225064,890,710,1526,1668
20934,15308,1544,3,Business,25,6,42811,25,6,43519,25,6,45619,25,6,45769,25,6,49040,8,23.25888921888938,-1.2794301,36.816247,-1.3037415,36.8564954,921,3271,708,2250
20935,2447,3283,3,Business,22,3,53884,22,3,53921,22,3,54578,22,3,54933,22,3,55723,6,25.5,-1.272828,36.816608,-1.2628473,36.781805,857,790,37,1012
20936,2135,1368,3,Business,26,2,54754,26,2,54855,26,2,56019,26,2,56168,26,2,57411,7,31.1,-1.2571472,36.7950633,-1.2968917,36.7990526,545,1243,101,1313
20937,27135,706,3,Business,25,5,28532,25,5,28598,25,5,29941,25,5,30237,25,5,32019,15,17.2,-1.2991441,36.7528804,-1.3077869,36.8443207,105,1782,66,1639
20938,987,1471,3,Business,18,1,53216,18,1,53522,18,1,55551,18,1,56966,18,1,58973,12,30.8,-1.2571472,36.7950633,-1.3078335,36.8670353,686,2007,306,3444
20939,12364,3538,2,Personal,19,2,57605,19,2,57624,19,2,57812,19,2,58148,19,2,59334,17,18.3,-1.2697141,36.7981777,-1.224119,36.8916459,408,1186,19,524
20940,17249,3372,3,Business,25,1,58384,25,1,58404,25,1,58743,25,1,58983,25,1,59895,4,23.25888921888938,-1.2969741,36.7856612,-1.2872751,36.7889153,474,912,20,579
20941,5709,3661,3,Business,24,1,36963,24,1,36985,24,1,37457,24,1,37765,24,1,39606,15,15.4,-1.2134646,36.8755266,-1.3090727,36.8315262,813,1841,22,780
20942,24185,1578,3,Business,11,2,52495,11,2,53059,11,2,55291,11,2,56217,11,2,56232,2,22.3,-1.290894,36.822971,-1.28878,36.8168312,692,15,564,3158
20943,4903,2978,3,Business,16,3,40242,16,3,40249,16,3,40299,16,3,41157,16,3,41690,7,22.6,-1.2551895,36.7822034,-1.276751,36.7776926,56,533,7,908
20944,3295,3599,3,Business,13,1,45540,13,1,46323,13,1,46907,13,1,47507,13,1,48949,12,23.25888921888938,-1.3302996,36.8707935,-1.2738936,36.8035805,222,1442,783,1184
20945,9450,1787,3,Business,2,5,57449,2,5,57940,2,5,58266,2,5,59034,2,5,60198,10,24.9,-1.2283403,36.8822756,-1.2684319,36.8165853,704,1164,491,1094
20946,27040,868,3,Business,28,2,34461,28,2,34498,28,2,34647,28,2,35373,28,2,35997,5,18.5,-1.2600926,36.8088685,-1.265715,36.823815,576,624,37,875
20947,22901,283,3,Business,28,3,46893,28,3,47759,28,3,48632,28,3,49232,28,3,51063,5,23.25888921888938,-1.2804227,36.8250375,-1.2985749,36.8088,222,1831,866,1473
20948,23332,2982,3,Business,27,4,45859,27,4,45892,27,4,45913,27,4,46404,27,4,48837,18,23.2,-1.300921,36.828195,-1.177202,36.8351183,31,2433,33,512
20949,18677,635,3,Business,27,6,44039,27,6,44306,27,6,45443,27,6,46705,27,6,47753,8,23.25888921888938,-1.300921,36.828195,-1.2599563,36.7993439,167,1048,267,2399
20950,5626,868,3,Business,5,5,39662,5,5,39685,5,5,40154,5,5,41296,5,5,41805,4,24.6,-1.266837,36.799249,-1.265715,36.823815,484,509,23,1611
20951,7693,136,3,Business,18,5,62822,18,5,62958,18,5,64010,18,5,64539,18,5,66474,9,22.4,-1.2962832,36.7849683,-1.260232,36.807334,742,1935,136,1581
20952,4733,1760,1,Personal,7,4,66156,7,4,66189,7,4,66654,7,4,67125,7,4,67735,1,17.6,-1.264865,36.810488,-1.2593049,36.8029373,434,610,33,936
20953,981,393,3,Business,11,1,49862,11,1,49875,11,1,50487,11,1,50948,11,1,53417,14,27.8,-1.3167113,36.8301563,-1.306378,36.7519845,571,2469,13,1073
20954,20880,1725,3,Business,8,5,65024,8,5,65094,8,5,65903,8,5,66213,8,5,66623,2,20.0,-1.2652108,36.8056075,-1.2644742,36.8083457,100,410,70,1119
20955,22091,3080,1,Business,1,5,49218,1,5,49236,1,5,49600,1,5,50192,1,5,51688,9,24.4,-1.255956,36.772901,-1.2388687,36.7529026,956,1496,18,956
20956,14898,1576,3,Business,7,1,49983,7,1,50025,7,1,50366,7,1,50640,7,1,52147,7,20.7,-1.3100609,36.8205365,-1.2677588,36.8169359,742,1507,42,615
20957,24081,3194,3,Business,24,4,44397,24,4,44419,24,4,44742,24,4,45587,24,4,46923,6,24.6,-1.2551895,36.7822034,-1.280753,36.8191175,336,1336,22,1168
20958,8034,1146,3,Business,15,3,60792,15,3,60821,15,3,61814,15,3,62913,15,3,63996,7,25.0,-1.3167113,36.8301563,-1.3083266,36.8494756,76,1083,29,2092
20959,1468,1955,3,Business,23,2,47234,23,2,47250,23,2,48630,23,2,48979,23,2,51152,19,19.2,-1.347383,36.8790012,-1.2571472,36.7950633,532,2173,16,1729
20960,20512,2041,1,Business,8,5,47298,8,5,48067,8,5,50881,8,5,52077,8,5,53820,11,21.7,-1.225322,36.80855,-1.290894,36.822971,379,1743,769,4010
20961,27935,3001,3,Business,22,4,71857,22,4,73712,22,4,74708,22,4,75509,22,4,76541,5,20.6,-1.2701316,36.7824436,-1.2894456,36.7780947,427,1032,1855,1797
20962,5616,136,3,Business,17,3,36527,17,3,36543,17,3,36863,17,3,37335,17,3,39759,18,23.25888921888938,-1.3165104,36.7077726,-1.2531983,36.8069669,99,2424,16,792
20963,21025,3647,3,Business,23,3,55631,23,3,55639,23,3,55727,23,3,56190,23,3,57458,6,27.3,-1.272639,36.794723,-1.2628638,36.8070399,865,1268,8,551
20964,23295,2587,3,Business,26,3,47907,26,3,47914,26,3,48068,26,3,48644,26,3,49318,6,23.9,-1.28878,36.8168312,-1.2646084,36.8028645,726,674,7,730
20965,17657,2523,3,Business,29,3,53380,29,3,53398,29,3,53420,29,3,53753,29,3,58510,16,18.8,-1.2551895,36.7822034,-1.2156006,36.8916865,629,4757,18,355
20966,8305,517,3,Business,9,6,39921,9,6,39937,9,6,39942,9,6,40575,9,6,41724,4,24.7,-1.3167113,36.8301563,-1.3004062,36.829741,311,1149,16,638
20967,12122,1075,3,Business,15,5,52871,15,5,52976,15,5,53001,15,5,53743,15,5,54458,1,28.1,-1.2649605,36.7981777,-1.2527958,36.8003131,210,715,105,767
20968,7142,3017,3,Business,4,5,50650,4,5,51670,4,5,51906,4,5,52173,4,5,52828,6,24.3,-1.2915271,36.782702,-1.2658315,36.809049,865,655,1020,503
20969,14392,3149,3,Business,21,4,47297,21,4,47383,21,4,48324,21,4,49050,21,4,49834,6,30.9,-1.3077869,36.8443207,-1.3167113,36.8301563,855,784,86,1667
20970,530,113,1,Business,22,3,47100,22,3,47140,22,3,47369,22,3,47820,22,3,49542,8,23.0,-1.2844653,36.8206676,-1.2963097,36.7688221,414,1722,40,680
20971,7992,1407,1,Personal,2,1,33792,2,1,33837,2,1,35496,2,1,35703,2,1,37327,12,16.5,-1.3081599,36.7787704,-1.324009,36.8458827,74,1624,45,1866
20972,11260,2512,3,Personal,31,2,47961,31,2,48009,31,2,48088,31,2,49187,31,2,49903,2,22.3,-1.2583748,36.8011466,-1.2538731,36.7850223,536,716,48,1178
20973,14154,1329,3,Business,30,5,38138,30,5,38184,30,5,38469,30,5,38864,30,5,41620,17,23.5,-1.273056,36.811298,-1.3242283,36.701819,4,2756,46,680
20974,20030,1642,3,Business,4,1,54231,4,1,54676,4,1,56913,4,1,61351,4,1,61353,7,27.8,-1.28523,36.8248292,-1.2726506,36.7960153,61,2,445,6675
20975,16594,633,3,Business,15,5,50364,15,5,50383,15,5,50387,15,5,51069,15,5,51071,4,17.9,-1.2770708,36.8231093,-1.3004062,36.829741,10,2,19,686
20976,2339,2733,3,Business,7,5,56022,7,5,56363,7,5,56692,7,5,56897,7,5,59195,7,23.25888921888938,-1.30484,36.8300956,-1.2963097,36.7688221,863,2298,341,534
20977,19212,60,3,Business,17,3,55395,17,3,55452,17,3,56284,17,3,56811,17,3,57716,8,23.25888921888938,-1.272828,36.816608,-1.2296618,36.8438272,166,905,57,1359
20978,23455,1329,3,Business,30,2,62422,30,2,63244,30,2,64056,30,2,64220,30,2,66586,12,23.25888921888938,-1.273056,36.811298,-1.2672045,36.7172069,937,2366,822,976
20979,2056,2734,1,Personal,17,1,57242,17,1,57284,17,1,58139,17,1,58273,17,1,59043,7,28.3,-1.2713865,36.8058221,-1.3012014,36.8043289,857,770,42,989
20980,18959,517,3,Business,8,6,44084,8,6,44169,8,6,46087,8,6,46481,8,6,46947,4,20.0,-1.3228003,36.8306435,-1.3004062,36.829741,448,466,85,2312
20981,7768,517,3,Business,13,2,30508,13,2,34056,13,2,35508,13,2,36102,13,2,39615,10,19.7,-1.3177547,36.8303703,-1.2574219,36.7927073,593,3513,3548,2046
20982,23501,758,3,Business,24,4,50460,24,4,50493,24,4,50705,24,4,51308,24,4,53309,14,28.4,-1.2917868,36.7872675,-1.3194518,36.869396,620,2001,33,815
20983,17535,1557,3,Business,21,5,45219,21,5,45293,21,5,46563,21,5,46678,21,5,47457,4,22.9,-1.2694178,36.8126928,-1.2551895,36.7822034,866,779,74,1385
20984,27492,3647,3,Business,18,4,44925,18,4,44965,18,4,45054,18,4,45404,18,4,47043,13,23.25888921888938,-1.272639,36.794723,-1.3326173,36.7146233,770,1639,40,439
20985,10423,2523,3,Business,20,2,46280,20,2,51663,20,2,51807,20,2,52654,20,2,53551,7,24.2,-1.2551895,36.7822034,-1.2989287,36.8163082,848,897,5383,991
20986,14526,893,3,Business,13,3,43618,13,3,44340,13,3,45579,13,3,46193,13,3,47105,5,23.25888921888938,-1.2732604,36.823046,-1.2594474,36.8089122,76,912,722,1853
20987,26689,3194,3,Business,4,2,50466,4,2,50512,4,2,50631,4,2,50889,4,2,51889,4,22.5,-1.2551895,36.7822034,-1.2651643,36.8072214,868,1000,46,377
20988,20693,72,1,Personal,3,1,45098,3,1,45122,3,1,46140,3,1,46541,3,1,48812,11,20.6,-1.3033794,36.7979256,-1.3227037,36.8470872,238,2271,24,1419
20989,20088,3152,3,Personal,15,6,53506,15,6,53513,15,6,54272,15,6,54632,15,6,58664,24,23.3,-1.2975439,36.756396,-1.306416,36.9168202,200,4032,7,1119
20990,7062,2836,1,Personal,5,3,49207,5,3,49228,5,3,49320,5,3,52902,5,3,53759,7,23.6,-1.2883572,36.8446699,-1.3205164,36.8098882,179,857,21,3674
20991,24912,2866,3,Business,1,4,55284,1,4,55617,1,4,56220,1,4,56809,1,4,58827,8,23.25888921888938,-1.3052491,36.8223899,-1.2551895,36.7822034,498,2018,333,1192
20992,23379,1850,3,Business,18,1,48297,18,1,48369,18,1,50417,18,1,51457,18,1,54529,8,29.5,-1.2551895,36.7822034,-1.290894,36.822971,942,3072,72,3088
20993,4000,1073,3,Business,24,2,52699,24,2,52714,24,2,53180,24,2,54138,24,2,55351,11,18.6,-1.2559294,36.788465,-1.2941509,36.7947974,616,1213,15,1424
20994,26046,2067,1,Personal,18,1,41293,18,1,41592,18,1,42327,18,1,42841,18,1,44048,10,23.25888921888938,-1.2579224,36.7920879,-1.304033,36.7848695,937,1207,299,1249
20995,12671,136,3,Business,8,1,42998,8,1,43157,8,1,43815,8,1,43913,8,1,45842,14,27.8,-1.3254522,36.7216584,-1.2963367,36.8094235,628,1929,159,756
20996,22317,3635,1,Business,12,3,63103,12,3,63166,12,3,63191,12,3,65145,12,3,66626,12,24.2,-1.2615888,36.7928732,-1.2095044,36.7832064,272,1481,63,1979
20997,15498,1283,3,Personal,26,6,62127,26,6,62167,26,6,63229,26,6,63670,26,6,65095,8,21.9,-1.286431,36.818411,-1.2948887,36.7683938,755,1425,40,1503
20998,10097,2803,3,Business,8,5,52417,8,5,52629,8,5,53835,8,5,54011,8,5,54668,3,27.3,-1.2765736,36.8513646,-1.2689599,36.8398401,72,657,212,1382
20999,13810,635,3,Business,13,3,40012,13,3,40119,13,3,42414,13,3,42614,13,3,43490,5,23.25888921888938,-1.2602337,36.7990548,-1.2793503,36.8039715,732,876,107,2495
21000,5886,136,3,Business,20,2,45523,20,2,45692,20,2,46163,20,2,46391,20,2,46785,1,20.0,-1.2534301,36.8000983,-1.2652979,36.8000399,823,394,169,699
21001,14556,733,3,Business,8,1,49534,8,1,49541,8,1,49912,8,1,50749,8,1,52940,23,29.5,-1.2551895,36.7822034,-1.3452448,36.9101666,786,2191,7,1208
21002,2650,1575,3,Personal,26,4,57448,26,4,57458,26,4,57705,26,4,61569,26,4,62780,12,19.4,-1.263987,36.798891,-1.2646374,36.7235671,74,1211,10,4111
21003,142,3398,3,Business,19,3,46111,19,3,46119,19,3,46123,19,3,47146,19,3,48503,22,23.25888921888938,-1.3169591,36.7000029,-1.4076398,36.6741513,813,1357,8,1027
21004,7744,753,3,Business,21,1,50282,21,1,50292,21,1,50444,21,1,52148,21,1,53657,27,27.6,-1.3285517,36.9018,-1.3297531,36.7063699,881,1509,10,1856
21005,4845,1329,3,Business,4,5,51253,4,5,51475,4,5,51477,4,5,54139,4,5,55117,6,23.25888921888938,-1.273056,36.811298,-1.2886399,36.7924548,813,978,222,2664
21006,16376,53,3,Business,13,4,44186,13,4,44324,13,4,45566,13,4,46272,13,4,48167,8,21.9,-1.3167113,36.8301563,-1.2770708,36.8231093,766,1895,138,1948
21007,11688,1584,3,Business,26,5,33494,26,5,35318,26,5,37902,26,5,39065,26,5,39993,7,23.25888921888938,-1.2771155,36.82668,-1.2969741,36.7856612,88,928,1824,3747
21008,3656,1422,1,Business,31,2,51949,31,2,52026,31,2,52795,31,2,53220,31,2,55289,5,22.1,-1.3094746,36.8326881,-1.2897793,36.8185788,857,2069,77,1194
21009,16655,2030,3,Business,8,2,37554,8,2,38790,8,2,39563,8,2,40608,8,2,42195,12,23.3,-1.1612808,36.9563278,-1.2156006,36.8916865,819,1587,1236,1818
21010,4323,419,3,Business,7,3,37132,7,3,37320,7,3,38460,7,3,38890,7,3,39796,6,25.1,-1.2571472,36.7950633,-1.289882,36.8105888,550,906,188,1570
21011,8914,516,3,Business,24,5,45115,24,5,45204,24,5,46254,24,5,46963,24,5,49313,5,21.6,-1.2571472,36.7950633,-1.2540684,36.8239518,167,2350,89,1759
21012,6061,393,3,Business,5,2,51581,5,2,51790,5,2,52448,5,2,53739,5,2,55605,11,27.4,-1.3167113,36.8301563,-1.2638185,36.7930057,901,1866,209,1949
21013,4735,3291,3,Business,12,3,52994,12,3,53155,12,3,53522,12,3,54110,12,3,55047,5,21.1,-1.2628473,36.781805,-1.2600926,36.8088685,290,937,161,955
21014,20092,1205,3,Business,24,3,54844,24,3,54874,24,3,55679,24,3,55911,24,3,56689,3,18.3,-1.257309,36.8060084,-1.2657148,36.8151464,727,778,30,1037
21015,18720,286,3,Business,6,4,41418,6,4,44103,6,4,44440,6,4,45508,6,4,49396,7,23.9,-1.2551895,36.7822034,-1.2962967,36.8020231,518,3888,2685,1405
21016,17762,3560,3,Business,18,5,36077,18,5,36150,18,5,37513,18,5,38509,18,5,40770,11,19.9,-1.225322,36.80855,-1.279395,36.825364,253,2261,73,2359
21017,1998,2195,3,Business,29,1,57591,29,1,57650,29,1,59037,29,1,60784,29,1,61762,11,23.25888921888938,-1.2783849,36.8163445,-1.228911,36.881876,815,978,59,3134
21018,24140,3201,3,Business,15,1,60057,15,1,60077,15,1,61206,15,1,62072,15,1,62718,3,23.25888921888938,-1.2584143,36.8048002,-1.2551895,36.7822034,557,646,20,1995
21019,4955,1874,3,Business,23,5,40481,23,5,40724,23,5,41260,23,5,41650,23,5,42433,8,24.0,-1.2571472,36.7950633,-1.3015435,36.7904968,337,783,243,926
21020,7063,2423,3,Business,30,3,32884,30,3,33076,30,3,33688,30,3,34135,30,3,35536,8,19.8,-1.2551895,36.7822034,-1.2945074,36.8083195,343,1401,192,1059
21021,11873,2069,3,Business,23,2,46688,23,2,46712,23,2,48213,23,2,49438,23,2,50035,6,23.25888921888938,-1.22978,36.836215,-1.228911,36.881876,8,597,24,2726
21022,17626,635,3,Business,8,4,50299,8,4,50329,8,4,51011,8,4,52011,8,4,56107,13,27.5,-1.3016417,36.8271679,-1.2296129,36.7641955,123,4096,30,1682
21023,17491,2676,3,Business,4,1,40382,4,1,40701,4,1,41796,4,1,42083,4,1,44489,15,26.5,-1.2261913,36.8368117,-1.2963097,36.7688221,52,2406,319,1382
21024,25951,640,3,Business,28,4,53474,28,4,53516,28,4,54404,28,4,54701,28,4,55392,3,27.2,-1.2969741,36.7856612,-1.287079,36.7811277,205,691,42,1185
21025,8000,1245,3,Business,8,5,59778,8,5,61038,8,5,61457,8,5,62169,8,5,64301,19,28.2,-1.2602337,36.7990548,-1.3447331,36.7240764,427,2132,1260,1131
21026,3196,1792,3,Business,28,3,50156,28,3,50493,28,3,51679,28,3,51841,28,3,53115,4,23.25888921888938,-1.2809121,36.7852524,-1.2892529,36.7740575,477,1274,337,1348
21027,1749,1882,3,Business,6,3,66645,6,3,66670,6,3,67452,6,3,67550,6,3,69129,14,23.25888921888938,-1.2268871,36.8073946,-1.2956882,36.7861845,607,1579,25,880
21028,18024,302,3,Business,24,7,75055,24,7,75075,24,7,76018,24,7,76197,24,7,77356,2,23.25888921888938,-1.2649605,36.7981777,-1.2598002,36.7963379,332,1159,20,1122
21029,409,2801,3,Business,25,3,35065,25,3,35077,25,3,35299,25,3,35637,25,3,37317,11,13.5,-1.2595422,36.7871178,-1.307726,36.839117,951,1680,12,560
21030,26311,1209,3,Business,23,2,51217,23,2,51242,23,2,51283,23,2,52682,23,2,52917,5,23.25888921888938,-1.2770708,36.8231093,-1.3004062,36.829741,70,235,25,1440
21031,15422,1816,1,Business,28,2,40667,28,2,40795,28,2,42711,28,2,43391,28,2,46105,15,17.5,-1.314962,36.865528,-1.296684,36.770172,228,2714,128,2596
21032,2785,1291,3,Personal,25,4,63208,25,4,63290,25,4,63641,25,4,64109,25,4,66651,7,23.25888921888938,-1.2864836,36.8278866,-1.2963097,36.7688221,148,2542,82,819
21033,12984,1500,3,Business,4,4,32954,4,4,32971,4,4,33572,4,4,34570,4,4,35562,6,21.9,-1.2770708,36.8231093,-1.2638185,36.7930057,119,992,17,1599
21034,3989,517,3,Business,27,6,37252,27,6,37588,27,6,38378,27,6,39985,27,6,39987,4,23.25888921888938,-1.3167113,36.8301563,-1.3004062,36.829741,309,2,336,2397
21035,23000,2982,3,Business,4,1,33364,4,1,33380,4,1,33503,4,1,35121,4,1,37723,18,21.7,-1.300921,36.828195,-1.177202,36.8351183,332,2602,16,1741
21036,10217,2878,3,Personal,16,3,49346,16,3,49373,16,3,50623,16,3,53018,16,3,55439,13,25.5,-1.2529599,36.7609473,-1.2974381,36.78212655,290,2421,27,3645
21037,1142,2330,3,Business,27,1,47889,27,1,48847,27,1,49502,27,1,49801,27,1,51130,22,23.3,-1.1926151,36.9347904,-1.2645318,36.7981775,8,1329,958,954
21038,1700,2090,2,Personal,19,4,36197,19,4,36217,19,4,36476,19,4,37985,19,4,39897,19,20.1,-1.2912668,36.7656703,-1.3714408,36.7581931,895,1912,20,1768
21039,6744,1007,3,Personal,15,1,61572,15,1,61603,15,1,62337,15,1,62825,15,1,63422,3,23.25888921888938,-1.2943445,36.7515778,-1.2935549,36.7703935,907,597,31,1222
21040,14983,2828,3,Business,18,1,41285,18,1,41392,18,1,42251,18,1,45078,18,1,46110,7,23.25888921888938,-1.2889576,36.8183358,-1.2615888,36.7928732,744,1032,107,3686
21041,1607,741,3,Business,18,5,34775,18,5,36041,18,5,37328,18,5,39951,18,5,41337,6,21.2,-1.283362,36.8260149,-1.3043961,36.7861511,196,1386,1266,3910
21042,1668,1502,3,Business,15,4,33811,15,4,33945,15,4,34874,15,4,35944,15,4,37981,20,19.4,-1.2232123,36.8932547,-1.3257473,36.8592068,561,2037,134,1999
21043,3995,2956,3,Business,9,5,51205,9,5,51363,9,5,51983,9,5,52221,9,5,54682,13,26.0,-1.2584143,36.8048002,-1.2859912,36.8756811,646,2461,158,858
21044,12118,3647,3,Business,29,3,46992,29,3,47033,29,3,47170,29,3,48526,29,3,48529,1,23.25888921888938,-1.272639,36.794723,-1.2709841,36.7824523,855,3,41,1493
21045,868,1169,1,Personal,2,2,52676,2,2,52756,2,2,53008,2,2,53537,2,2,54762,8,26.1,-1.2918246,36.801585,-1.3104734,36.7363698,597,1225,80,781
21046,8552,2271,3,Business,12,4,57358,12,4,57744,12,4,58297,12,4,58792,12,4,61091,14,21.9,-1.272828,36.816608,-1.293515,36.897607,806,2299,386,1048
21047,15575,1346,3,Business,29,2,52315,29,2,52363,29,2,53125,29,2,53303,29,2,54020,2,27.0,-1.2917868,36.7872675,-1.2985749,36.8088,860,717,48,940
21048,16074,2069,3,Business,28,3,47489,28,3,47512,28,3,48199,28,3,50171,28,3,52896,17,23.25888921888938,-1.331619,36.847976,-1.228911,36.881876,237,2725,23,2659
21049,22879,1502,3,Business,15,4,41604,15,4,41636,15,4,41647,15,4,42377,15,4,45500,13,24.6,-1.2232123,36.8932547,-1.28878,36.8168312,633,3123,32,741
21050,16346,1687,3,Business,17,4,41979,17,4,41991,17,4,42363,17,4,42646,17,4,43353,4,25.2,-1.2626574,36.8014034,-1.28164,36.816867,365,707,12,655
21051,19872,2330,1,Business,25,2,73664,25,2,73678,25,2,74077,25,2,74322,25,2,75394,6,21.5,-1.30176,36.765658,-1.2915247,36.8055757,148,1072,14,644
21052,10093,1927,3,Business,19,2,40864,19,2,40907,19,2,42849,19,2,42926,19,2,44366,13,27.4,-1.2765736,36.8513646,-1.3472066,36.7692638,61,1440,43,2019
21053,12054,867,3,Business,23,4,42824,23,4,42884,23,4,43288,23,4,43373,23,4,47125,10,23.4,-1.3004062,36.829741,-1.2991441,36.7528804,582,3752,60,489
21054,21374,60,3,Business,16,4,40640,16,4,40648,16,4,40670,16,4,42043,16,4,42365,8,14.7,-1.272828,36.816608,-1.2296618,36.8438272,406,322,8,1395
21055,19387,941,1,Personal,8,1,45828,8,1,46382,8,1,46678,8,1,47563,8,1,48874,8,24.4,-1.2807298,36.8299116,-1.3288576,36.8465936,662,1311,554,1181
21056,15106,3647,3,Business,16,2,58707,16,2,58806,16,2,59974,16,2,60766,16,2,61725,6,25.1,-1.272639,36.794723,-1.2957807,36.7713953,536,959,99,1960
21057,20634,1642,3,Business,12,2,42940,12,2,45057,12,2,45334,12,2,47004,12,2,47664,5,20.9,-1.288269,36.8182753,-1.2728069,36.7962362,217,660,2117,1947
21058,24610,249,1,Personal,6,5,37179,6,5,37197,6,5,37802,6,5,38749,6,5,40912,20,20.3,-1.345742,36.761259,-1.2959669,36.8958092,412,2163,18,1552
21059,4901,776,1,Personal,31,4,41601,31,4,41684,31,4,41867,31,4,42458,31,4,42470,1,21.8,-1.2665774,36.8069908,-1.273333,36.8122251,51,12,83,774
21060,2987,3012,1,Personal,1,1,51200,1,1,51210,1,1,51613,1,1,52828,1,1,53175,3,25.8,-1.2571472,36.7950633,-1.2561416,36.7882386,647,347,10,1618
21061,1876,1768,3,Personal,20,4,55941,20,4,60039,20,4,60657,20,4,60928,20,4,63025,6,22.9,-1.2750257,36.8157165,-1.2983805,36.8198439,82,2097,4098,889
21062,25587,2330,3,Business,24,5,53322,24,5,53608,24,5,55492,24,5,57454,24,5,58255,5,22.8,-1.294597,36.7742999,-1.3040812,36.7924217,277,801,286,3846
21063,3235,292,1,Personal,24,1,27256,24,1,27348,24,1,28755,24,1,28957,24,1,30161,7,15.7,-1.3173869,36.8112044,-1.2917868,36.7872675,722,1204,92,1609
21064,25173,2309,2,Personal,12,5,35538,12,5,35618,12,5,36309,12,5,36864,12,5,37781,8,18.5,-1.2561398,36.8194374,-1.233018,36.8004477,453,917,80,1246
21065,20998,81,3,Business,21,4,38059,21,4,38128,21,4,38174,21,4,40286,21,4,40291,4,21.9,-1.2641496,36.7914139,-1.261177,36.801916,354,5,69,2158
21066,13004,2677,3,Business,16,2,46225,16,2,46327,16,2,47150,16,2,47567,16,2,49527,14,23.25888921888938,-1.3077869,36.8443207,-1.2991441,36.7528804,712,1960,102,1240
21067,26832,661,3,Business,12,4,45325,12,4,45372,12,4,46968,12,4,47813,12,4,48378,4,18.9,-1.2963097,36.7688221,-1.2950044,36.7512209,140,565,47,2441
21068,7510,2941,1,Personal,8,2,35666,8,2,35688,8,2,36516,8,2,36987,8,2,39021,13,23.25888921888938,-1.3108368,36.8226308,-1.2283331,36.8562419,340,2034,22,1299
21069,2661,2436,3,Business,27,2,57018,27,2,57477,27,2,58432,27,2,58574,27,2,60432,10,25.8,-1.2551895,36.7822034,-1.2363748,36.8177502,453,1858,459,1097
21070,416,3689,3,Business,26,6,44570,26,6,44700,26,6,45977,26,6,46369,26,6,47159,5,22.5,-1.279395,36.825364,-1.2601709,36.8002238,752,790,130,1669
21071,9814,3650,3,Business,12,2,41227,12,2,41678,12,2,42284,12,2,42501,12,2,43534,7,28.1,-1.2848376,36.8027622,-1.3088186,36.8352514,779,1033,451,823
21072,11449,3175,3,Business,5,2,42966,5,2,42992,5,2,43966,5,2,44029,5,2,47489,15,21.5,-1.2612417,36.7958868,-1.3038645,36.8684596,574,3460,26,1037
21073,1865,1439,3,Business,22,5,51335,22,5,51354,22,5,51574,22,5,51799,22,5,52666,5,27.3,-1.2962487,36.7772971,-1.2821752,36.7338676,354,867,19,445
21074,27467,1526,3,Personal,31,4,59410,31,4,62116,31,4,63909,31,4,64301,31,4,67579,29,27.7,-1.1837692,36.9428521,-1.2886166,36.7836803,75,3278,2706,2185
21075,13389,115,3,Business,14,5,59024,14,5,59241,14,5,60970,14,5,61169,14,5,65641,21,21.7,-1.281854,36.8246889,-1.2773974,36.9678677,436,4472,217,1928
21076,18061,1329,3,Business,9,6,61667,9,6,61728,9,6,62406,9,6,62506,9,6,63689,4,23.25888921888938,-1.273056,36.811298,-1.284835,36.8152125,605,1183,61,778
21077,8188,575,1,Personal,8,5,34774,8,5,35171,8,5,36109,8,5,36368,8,5,38115,6,15.1,-1.285769,36.760073,-1.2976559,36.7914147,742,1747,397,1197
21078,1476,1502,3,Business,16,3,46995,16,3,47016,16,3,47637,16,3,48309,16,3,51185,14,22.6,-1.3052491,36.8223899,-1.2232123,36.8932547,408,2876,21,1293
21079,13781,1363,3,Business,12,1,52304,12,1,52420,12,1,53059,12,1,53336,12,1,54977,10,26.9,-1.3004062,36.829741,-1.2529484,36.8651347,708,1641,116,916
21080,26331,2021,3,Business,25,1,37175,25,1,37183,25,1,37533,25,1,37842,25,1,38916,18,23.25888921888938,-1.2945552,36.8397497,-1.3510811,36.894806,238,1074,8,659
21081,23804,3718,3,Business,10,1,38078,10,1,38929,10,1,39720,10,1,41989,10,1,42822,5,23.5,-1.2972835,36.809687,-1.2650027,36.8126242,50,833,851,3060
21082,17418,269,3,Business,24,1,43530,24,1,43579,24,1,44163,24,1,45909,24,1,47824,14,22.7,-1.2615888,36.7928732,-1.3226302,36.8719901,858,1915,49,2330
21083,8603,718,3,Business,17,5,52276,17,5,52301,17,5,52310,17,5,52607,17,5,54180,12,23.25888921888938,-1.2551895,36.7822034,-1.3037415,36.8564954,79,1573,25,306
21084,3856,1882,3,Business,8,2,56200,8,2,57220,8,2,57412,8,2,57550,8,2,59263,3,25.3,-1.2588775,36.8079744,-1.2663778,36.8076024,932,1713,1020,330
21085,24557,393,3,Business,25,1,41853,25,1,41868,25,1,41872,25,1,43047,25,1,43052,4,27.1,-1.3167113,36.8301563,-1.3004062,36.829741,25,5,15,1179
21086,2209,2412,3,Business,16,4,41993,16,4,42040,16,4,43455,16,4,44148,16,4,45473,9,14.7,-1.2810586,36.8838294,-1.2297202,36.8819507,249,1325,47,2108
21087,10380,928,3,Business,28,4,41713,28,4,41801,28,4,42199,28,4,42267,28,4,43995,7,28.1,-1.2551895,36.7822034,-1.2961143,36.815843,831,1728,88,466
21088,9153,2532,3,Business,17,5,55880,17,5,55923,17,5,56221,17,5,56666,17,5,58225,8,23.25888921888938,-1.2551895,36.7822034,-1.2967702,36.8040381,868,1559,43,743
21089,18744,71,3,Business,22,4,51736,22,4,56171,22,4,57273,22,4,57586,22,4,60508,9,26.4,-1.2891922,36.825189,-1.2551895,36.7822034,554,2922,4435,1415
21090,26764,627,3,Business,6,4,34842,6,4,34887,6,4,35136,6,4,35432,6,4,36582,3,16.3,-1.2551895,36.7822034,-1.2671943,36.807601,205,1150,45,545
21091,4167,1500,3,Business,9,5,33796,9,5,35519,9,5,35527,9,5,35847,9,5,37055,9,20.4,-1.2574219,36.7927073,-1.3004062,36.829741,208,1208,1723,328
21092,4506,2931,3,Business,26,2,43656,26,2,46736,26,2,47728,26,2,48626,26,2,50648,20,26.2,-1.3433181,36.9138018,-1.272798,36.8124195,222,2022,3080,1890
21093,15086,3494,3,Personal,17,5,44134,17,5,44172,17,5,44872,17,5,45604,17,5,46654,7,17.6,-1.2848174,36.826163,-1.2963097,36.7688221,754,1050,38,1432
21094,10558,2350,1,Personal,30,1,33285,30,1,33318,30,1,33609,30,1,34544,30,1,35361,9,16.5,-1.2552938,36.7578876,-1.2745107,36.7974503,574,817,33,1226
21095,24714,1471,3,Business,13,3,48239,13,3,48273,13,3,49322,13,3,50236,13,3,51633,10,27.0,-1.2551895,36.7822034,-1.3126476,36.831455,206,1397,34,1963
21096,8442,2043,1,Personal,3,1,40492,3,1,40538,3,1,41257,3,1,41639,3,1,42154,5,20.7,-1.3099145,36.8022774,-1.2946581,36.7792921,465,515,46,1101
21097,27731,1904,1,Personal,16,1,48498,16,1,48597,16,1,48708,16,1,48883,16,1,50746,9,22.6,-1.3257473,36.8592068,-1.2904049,36.8055154,88,1863,99,286
21098,15578,2174,3,Business,30,5,35483,30,5,35492,30,5,35576,30,5,35971,30,5,37618,10,19.1,-1.2482781,36.884092,-1.2868078,36.8219396,53,1647,9,479
21099,8242,3661,3,Business,4,1,43526,4,1,46967,4,1,47566,4,1,48089,4,1,50770,15,26.8,-1.2134646,36.8755266,-1.3090727,36.8315262,510,2681,3441,1122
21100,26383,3701,3,Business,7,5,32178,7,5,32332,7,5,33395,7,5,33548,7,5,34244,8,20.7,-1.2684239,36.7952462,-1.2593606,36.7777895,362,696,154,1216
21101,21938,2174,3,Business,27,1,48872,27,1,48872,27,1,48962,27,1,52590,27,1,52594,11,23.1,-1.2482781,36.884092,-1.261795,36.822333,86,4,0,3718
21102,11520,3517,3,Business,8,3,55139,8,3,55239,8,3,55276,8,3,55765,8,3,61615,9,23.25888921888938,-1.300921,36.828195,-1.2996819,36.7782517,19,5850,100,526
21103,6938,1346,3,Business,18,4,50604,18,4,50637,18,4,51313,18,4,51750,18,4,53054,6,23.25888921888938,-1.2695287,36.7981777,-1.2917868,36.7872675,523,1304,33,1113
21104,20027,1202,3,Personal,1,1,53080,1,1,53162,1,1,54477,1,1,54661,1,1,55644,7,25.6,-1.2850644,36.8343657,-1.312261,36.794658,88,983,82,1499
21105,27247,302,3,Business,16,6,69879,16,6,69909,16,6,70506,16,6,72484,16,6,72511,9,23.25888921888938,-1.2649605,36.7981777,-1.3112325,36.8146321,314,27,30,2575
21106,19762,2174,3,Business,16,4,55654,16,4,55660,16,4,55715,16,4,56195,16,4,58124,16,18.8,-1.2482781,36.884092,-1.2979242,36.7902416,946,1929,6,535
21107,13294,3517,3,Business,24,3,49433,24,3,49524,24,3,50283,24,3,51705,24,3,53574,15,18.2,-1.300921,36.828195,-1.3882008,36.7699445,581,1869,91,2181
21108,23078,1346,3,Business,10,3,49858,10,3,49891,10,3,51707,10,3,51888,10,3,52926,6,30.6,-1.2917868,36.7872675,-1.2695287,36.7981777,263,1038,33,1997
21109,23217,2989,3,Business,12,4,46659,12,4,46795,12,4,49666,12,4,50796,12,4,54907,21,21.8,-1.2248308,36.8012573,-1.3404187,36.7614685,519,4111,136,4001
21110,19082,391,3,Business,24,5,57081,24,5,58644,24,5,58994,24,5,62063,24,5,64038,5,20.2,-1.3064419,36.8373494,-1.2867454,36.8259017,567,1975,1563,3419
21111,9301,758,3,Business,5,2,58777,5,2,59002,5,2,60008,5,2,60163,5,2,61234,2,23.25888921888938,-1.2917868,36.7872675,-1.2978908,36.7963215,953,1071,225,1161
21112,25324,1849,3,Business,8,5,53815,8,5,53839,8,5,53852,8,5,55289,8,5,56737,12,27.4,-1.290894,36.822971,-1.2156006,36.8916865,330,1448,24,1450
21113,16809,1453,3,Business,5,2,32537,5,2,32613,5,2,32955,5,2,34271,5,2,35456,8,17.5,-1.2273427,36.7994683,-1.2591019,36.800577,865,1185,76,1658
21114,3936,1966,3,Business,12,2,52182,12,2,52292,12,2,53173,12,2,54022,12,2,56258,21,23.25888921888938,-1.3700383,36.9190174,-1.2917868,36.7872675,99,2236,110,1730
21115,15796,3283,3,Business,27,1,51692,27,1,51717,27,1,52658,27,1,53220,27,1,54198,7,23.0,-1.303596,36.778378,-1.2628473,36.781805,441,978,25,1503
21116,20087,2956,3,Business,16,4,33662,16,4,33674,16,4,33701,16,4,34135,16,4,36744,15,15.4,-1.2584143,36.8048002,-1.3020824,36.8944672,882,2609,12,461
21117,16272,2457,3,Business,26,5,48251,26,5,51673,26,5,52991,26,5,53158,26,5,54091,6,23.25888921888938,-1.2551895,36.7822034,-1.2811505,36.8145398,253,933,3422,1485
21118,9248,3291,3,Business,15,1,48855,15,1,48911,15,1,49413,15,1,50555,15,1,52048,12,23.25888921888938,-1.331619,36.847976,-1.2600926,36.8088685,532,1493,56,1644
21119,7217,2216,3,Business,26,4,35344,26,4,36113,26,4,36132,26,4,36685,26,4,37870,7,15.2,-1.2551895,36.7822034,-1.2989934,36.8136694,101,1185,769,572
21120,24702,1768,3,Personal,3,4,37627,3,4,37642,3,4,38011,3,4,38287,3,4,39838,22,23.4,-1.2750257,36.8157165,-1.1683312,36.95548,237,1551,15,645
21121,19120,1908,1,Personal,6,1,58270,6,1,58308,6,1,58828,6,1,59778,6,1,62241,11,22.2,-1.2877907,36.830065,-1.29241,36.90652,347,2463,38,1470
21122,5378,3641,3,Business,12,1,43215,12,1,43448,12,1,43679,12,1,44022,12,1,45191,8,23.8,-1.2551895,36.7822034,-1.2998903,36.8179213,518,1169,233,574
21123,6266,3718,3,Business,9,2,35931,9,2,35957,9,2,37168,9,2,37311,9,2,41208,19,17.6,-1.2650027,36.8126242,-1.3339943,36.7263409,948,3897,26,1354
21124,18452,3171,3,Personal,11,1,42058,11,1,42083,11,1,42533,11,1,42594,11,1,45813,4,26.4,-1.2807406,36.8308915,-1.2913246,36.8019522,378,3219,25,511
21125,6392,1850,3,Business,24,3,53766,24,3,53875,24,3,53895,24,3,54293,24,3,55570,6,23.25888921888938,-1.2551895,36.7822034,-1.2785434,36.8215327,709,1277,109,418
21126,2398,2306,3,Business,26,2,40898,26,2,40907,26,2,42354,26,2,42501,26,2,45268,19,27.4,-1.2271998,36.8084905,-1.3241108,36.8692908,6,2767,9,1594
21127,8071,139,3,Personal,24,4,50812,24,4,50876,24,4,52205,24,4,54063,24,4,54610,4,28.5,-1.300722,36.816865,-1.2923412,36.7951972,783,547,64,3187
21128,13253,2344,3,Business,14,3,43781,14,3,44519,14,3,45039,14,3,45177,14,3,46859,7,24.5,-1.2551895,36.7822034,-1.2875845,36.8135104,88,1682,738,658
21129,9591,1874,3,Business,14,4,54346,14,4,55456,14,4,57074,14,4,57297,14,4,61103,12,28.1,-1.2571472,36.7950633,-1.238805,36.884373,824,3806,1110,1841
21130,14738,2216,3,Business,1,1,35893,1,1,35907,1,1,36008,1,1,36490,1,1,40088,10,21.4,-1.2551895,36.7822034,-1.2363748,36.8177502,177,3598,14,583
21131,2419,2580,1,Personal,4,5,51794,4,5,52004,4,5,52819,4,5,53004,4,5,55322,9,24.2,-1.2793148,36.8148394,-1.3051189,36.7560948,671,2318,210,1000
21132,20470,1927,3,Business,20,1,56628,20,1,56645,20,1,56843,20,1,58337,20,1,59494,10,23.25888921888938,-1.3472066,36.7692638,-1.3260023,36.6886989,815,1157,17,1692
21133,6742,3557,3,Business,23,3,39182,23,3,39273,23,3,39812,23,3,41395,23,3,42193,9,23.25888921888938,-1.2929747,36.7646358,-1.2546732,36.8086796,247,798,91,2122
21134,10811,496,3,Business,7,2,39939,7,2,40063,7,2,41745,7,2,42149,7,2,44376,20,23.25888921888938,-1.1740894,36.8249762,-1.2551895,36.7822034,279,2227,124,2086
21135,5506,3517,3,Business,1,1,48010,1,1,48092,1,1,49152,1,1,50362,1,1,51173,8,23.25888921888938,-1.300921,36.828195,-1.332175,36.8819641,127,811,82,2270
21136,27292,3291,3,Business,25,1,34444,25,1,34493,25,1,34792,25,1,35466,25,1,36196,5,20.9,-1.2628473,36.781805,-1.2600926,36.8088685,831,730,49,973
21137,23327,2330,3,Business,29,3,45392,29,3,45407,29,3,45557,29,3,45834,29,3,47153,19,23.25888921888938,-1.2642903,36.8002137,-1.1926151,36.9347904,96,1319,15,427
21138,13505,3648,3,Personal,5,2,36249,5,2,36353,5,2,36733,5,2,38605,5,2,40249,16,23.5,-1.2987276,36.8176337,-1.3566495,36.7482787,34,1644,104,2252
21139,24609,3621,3,Business,11,2,44968,11,2,45188,11,2,45737,11,2,45866,11,2,46563,5,19.3,-1.2836583,36.7886014,-1.3050332,36.8100437,826,697,220,678
21140,11979,1051,3,Business,23,3,49125,23,3,49129,23,3,49164,23,3,49358,23,3,51006,14,27.4,-1.2963097,36.7688221,-1.2500309,36.6690476,786,1648,4,229
21141,9523,868,3,Business,2,6,41639,2,6,42259,2,6,42933,2,6,43941,2,6,44612,7,23.7,-1.2628473,36.781805,-1.265715,36.823815,752,671,620,1682
21142,26852,242,3,Business,29,5,35086,29,5,35365,29,5,36477,29,5,37572,29,5,38605,4,23.25888921888938,-1.2551895,36.7822034,-1.2697141,36.7981777,159,1033,279,2207
21143,20131,2982,3,Business,30,4,49971,30,4,50021,30,4,50507,30,4,56025,30,4,59021,18,23.25888921888938,-1.300921,36.828195,-1.177202,36.8351183,340,2996,50,6004
21144,1741,877,2,Personal,13,7,69633,13,7,69642,13,7,70196,13,7,70749,13,7,71174,4,19.0,-1.2580765,36.8024166,-1.2407613,36.7807351,103,425,9,1107
21145,10836,2212,3,Business,31,5,55012,31,5,55360,31,5,57504,31,5,57769,31,5,59059,5,24.8,-1.2571472,36.7950633,-1.2896399,36.8124498,817,1290,348,2409
21146,19532,2509,3,Business,6,3,60710,6,3,60753,6,3,61254,6,3,61833,6,3,66099,20,23.25888921888938,-1.2571472,36.7950633,-1.3700383,36.9190174,579,4266,43,1080
21147,14305,590,3,Business,8,1,34658,8,1,34791,8,1,35516,8,1,35895,8,1,36520,3,19.9,-1.257773,36.795486,-1.2620835,36.809074,770,625,133,1104
21148,10221,2346,1,Personal,30,6,55978,30,6,56320,30,6,57243,30,6,57520,30,6,59005,8,24.2,-1.3054537,36.8284768,-1.2813742,36.8558927,212,1485,342,1200
21149,14896,2216,3,Business,15,1,42732,15,1,42749,15,1,42974,15,1,43088,15,1,44046,7,23.25888921888938,-1.2551895,36.7822034,-1.2896399,36.8124498,958,958,17,339
21150,5639,265,3,Business,21,1,56083,21,1,56110,21,1,56831,21,1,57342,21,1,60140,9,21.6,-1.300921,36.828195,-1.2566637,36.8088577,280,2798,27,1232
21151,4804,2200,3,Business,31,5,63300,31,5,64516,31,5,65422,31,5,65628,31,5,67290,4,23.6,-1.2765736,36.8513646,-1.290894,36.822971,20,1662,1216,1112
21152,23599,2701,3,Business,13,3,53046,13,3,56566,13,3,56616,13,3,58490,13,3,61156,16,23.5,-1.3562374,36.9042954,-1.279395,36.825364,223,2666,3520,1924
21153,20055,913,3,Personal,30,3,68816,30,3,68848,30,3,68853,30,3,69386,30,3,70453,7,27.2,-1.3039695,36.7838267,-1.2707179,36.7979713,925,1067,32,538
21154,11182,3613,3,Business,21,4,53130,21,4,53207,21,4,53761,21,4,54770,21,4,55723,7,31.1,-1.2830057,36.8175478,-1.2733622,36.7704045,336,953,77,1563
21155,17802,496,3,Business,19,1,54074,19,1,54679,19,1,55035,19,1,55368,19,1,56279,6,25.0,-1.2551895,36.7822034,-1.280753,36.8191175,456,911,605,689
21156,8857,2030,3,Business,5,5,36501,5,5,36587,5,5,38427,5,5,38503,5,5,41447,13,24.4,-1.2963097,36.7688221,-1.3263105,36.8622904,599,2944,86,1916
21157,17974,1502,3,Business,12,2,31936,12,2,31954,12,2,33390,12,2,33476,12,2,35381,17,15.9,-1.2156006,36.8916865,-1.2551895,36.7822034,808,1905,18,1522
21158,6318,3222,3,Business,18,2,34313,18,2,34378,18,2,35263,18,2,35345,18,2,37113,6,19.8,-1.2551895,36.7822034,-1.2479362,36.772759,651,1768,65,967
21159,10451,2735,3,Personal,20,4,30518,20,4,30529,20,4,31759,20,4,31984,20,4,37418,21,18.6,-1.25896,36.8016691,-1.3434862,36.6895464,395,5434,11,1455
21160,18270,2634,3,Business,31,4,39768,31,4,42390,31,4,45853,31,4,46115,31,4,47647,13,26.6,-1.26816,36.91508,-1.2482465,36.8889062,589,1532,2622,3725
21161,7105,111,3,Business,19,2,45765,19,2,45789,19,2,45797,19,2,46099,19,2,47599,13,26.5,-1.2551895,36.7822034,-1.3233955,36.8562944,518,1500,24,310
21162,16682,2053,1,Personal,8,2,55683,8,2,56285,8,2,58094,8,2,58616,8,2,60313,9,23.2,-1.2934216,36.7965683,-1.255956,36.789867,937,1697,602,2331
21163,13672,3036,3,Personal,29,5,29740,29,5,29800,29,5,30391,29,5,30808,29,5,31334,2,23.25888921888938,-1.2925792,36.79069,-1.2976363,36.7815901,334,526,60,1008
21164,18594,3599,3,Business,22,4,41475,22,4,42551,22,4,43851,22,4,45810,22,4,47855,21,22.5,-1.3302996,36.8707935,-1.3156678,36.713569,240,2045,1076,3259
21165,11770,265,3,Business,24,3,35394,24,3,35423,24,3,35518,24,3,36325,24,3,38199,10,16.8,-1.300921,36.828195,-1.2990817,36.7654866,519,1874,29,902
21166,20700,1209,3,Business,10,4,58938,10,4,60218,10,4,60565,10,4,61090,10,4,61878,5,22.3,-1.3004062,36.829741,-1.3083266,36.8494756,623,788,1280,872
21167,24433,3426,3,Business,26,5,56470,26,5,58403,26,5,59163,26,5,59580,26,5,60773,10,23.25888921888938,-1.2584143,36.8048002,-1.3014461,36.7661381,743,1193,1933,1177
21168,2978,570,3,Business,18,2,40265,18,2,40325,18,2,40989,18,2,41145,18,2,44286,6,23.25888921888938,-1.2551895,36.7822034,-1.2866012,36.8195691,150,3141,60,820
21169,20893,3291,3,Business,23,5,55308,23,5,55506,23,5,55689,23,5,56431,23,5,57522,11,26.4,-1.2296618,36.8438272,-1.2600926,36.8088685,913,1091,198,925
21170,18149,1922,3,Personal,22,3,36245,22,3,36269,22,3,37908,22,3,38245,22,3,39984,12,23.3,-1.2443975,36.7757308,-1.2960687,36.8167909,959,1739,24,1976
21171,6137,2195,3,Business,17,5,46098,17,5,46180,17,5,46864,17,5,47941,17,5,49077,9,23.25888921888938,-1.265715,36.823815,-1.228911,36.881876,907,1136,82,1761
21172,1410,218,1,Personal,9,4,42289,9,4,42359,9,4,43026,9,4,43391,9,4,44472,4,23.6,-1.2914681,36.8012887,-1.2795261,36.8260185,882,1081,70,1032
21173,12385,1850,3,Business,31,5,57940,31,5,59148,31,5,59541,31,5,60072,31,5,60665,4,23.9,-1.2571472,36.7950633,-1.2816664,36.8226716,491,593,1208,924
21174,26365,2523,3,Business,15,3,61243,15,3,61253,15,3,61323,15,3,61614,15,3,64732,28,25.1,-1.2551895,36.7822034,-1.4073185,36.9556349,709,3118,10,361
21175,17484,928,3,Business,22,3,53458,22,3,54950,22,3,57735,22,3,58898,22,3,60288,8,24.4,-1.2878913,36.8089253,-1.2551895,36.7822034,448,1390,1492,3948
21176,24677,3326,3,Business,23,3,57344,23,3,57356,23,3,57360,23,3,57422,23,3,58595,9,27.5,-1.304344,36.812274,-1.2551895,36.7822034,31,1173,12,66
21177,6901,2956,3,Business,26,2,35844,26,2,35879,26,2,36905,26,2,36985,26,2,37989,7,21.8,-1.225322,36.80855,-1.2584143,36.8048002,318,1004,35,1106
21178,297,2335,3,Business,14,3,53087,14,3,53097,14,3,53294,14,3,53366,14,3,55207,21,25.6,-1.3562374,36.9042954,-1.2551895,36.7822034,833,1841,10,269
21179,3444,1500,3,Business,24,4,39659,24,4,39720,24,4,40322,24,4,40529,24,4,41712,11,24.4,-1.3077869,36.8443207,-1.2574219,36.7927073,523,1183,61,809
21180,18952,635,3,Business,21,2,35214,21,2,35242,21,2,35250,21,2,37742,21,2,37998,10,23.25888921888938,-1.3081376,36.8329772,-1.2602337,36.7990548,403,256,28,2500
21181,7229,3194,3,Business,26,3,36963,26,3,36973,26,3,37042,26,3,38537,26,3,39203,8,23.9,-1.2551895,36.7822034,-1.2854174,36.7951152,116,666,10,1564
21182,11816,590,3,Business,22,5,38528,22,5,38879,22,5,40260,22,5,40587,22,5,43783,24,28.3,-1.3343055,36.7329632,-1.2296129,36.7641955,958,3196,351,1708
21183,9070,3521,3,Business,9,2,47400,9,2,47420,9,2,47856,9,2,47976,9,2,48853,2,26.8,-1.2701354,36.8072167,-1.2696908,36.81519,88,877,20,556
21184,22213,237,3,Business,7,5,57348,7,5,62644,7,5,62938,7,5,63096,7,5,63797,5,23.2,-1.2551895,36.7822034,-1.2812416,36.8192411,523,701,5296,452
21185,25722,59,3,Business,21,3,36894,21,3,42256,21,3,42384,21,3,43272,21,3,44242,7,22.2,-1.290894,36.822971,-1.2551895,36.7822034,726,970,5362,1016
21186,26544,2145,3,Personal,12,3,43990,12,3,44243,12,3,45027,12,3,45420,12,3,46655,6,19.3,-1.2752846,36.8027022,-1.2926564,36.7873181,868,1235,253,1177
21187,12532,478,3,Business,6,1,50436,6,1,50492,6,1,52019,6,1,52463,6,1,54178,18,23.25888921888938,-1.2174537,36.8801909,-1.2551895,36.7822034,691,1715,56,1971
21188,1396,868,3,Business,4,2,39882,4,2,39950,4,2,40353,4,2,40946,4,2,41222,3,18.9,-1.2783849,36.8163445,-1.265715,36.823815,676,276,68,996
21189,16829,391,3,Business,12,3,37181,12,3,38139,12,3,38811,12,3,39641,12,3,41009,5,19.5,-1.300921,36.828195,-1.2867454,36.8259017,365,1368,958,1502
21190,16563,3432,3,Business,25,1,62024,25,1,62140,25,1,63315,25,1,64349,25,1,66713,13,27.5,-1.2672588,36.8000252,-1.338217,36.784572,459,2364,116,2209
21191,16262,1231,3,Business,1,4,50977,1,4,51027,1,4,53513,1,4,53588,1,4,56395,13,23.25888921888938,-1.2821422,36.8161565,-1.2156006,36.8916865,736,2807,50,2561
21192,11670,1146,3,Business,23,2,45677,23,2,45712,23,2,45859,23,2,47111,23,2,48082,7,23.25888921888938,-1.3167113,36.8301563,-1.3083266,36.8494756,571,971,35,1399
21193,4988,875,1,Personal,12,6,60496,12,6,60591,12,6,61608,12,6,62842,12,6,64613,10,23.5,-1.2865677,36.8253346,-1.300106,36.7584546,103,1771,95,2251
21194,865,1245,3,Business,15,1,61329,15,1,61372,15,1,61693,15,1,62115,15,1,64413,16,23.25888921888938,-1.2602337,36.7990548,-1.3198615,36.7110323,177,2298,43,743
21195,9932,3582,3,Business,2,6,47314,2,6,48340,2,6,49931,2,6,50076,2,6,52401,17,29.0,-1.2384056,36.8718698,-1.2765492,36.7669809,34,2325,1026,1736
21196,8834,2001,3,Personal,20,3,57278,20,3,57309,20,3,57529,20,3,58808,20,3,58817,3,28.6,-1.2584143,36.8048002,-1.2752846,36.8027022,953,9,31,1499
21197,22892,1796,3,Business,13,6,36814,13,6,36821,13,6,37204,13,6,38007,13,6,38777,7,26.0,-1.307143,36.825009,-1.331619,36.847976,155,770,7,1186
21198,2831,2956,3,Business,7,4,61576,7,4,61629,7,4,63017,7,4,64252,7,4,67205,20,29.2,-1.2860183,36.8975338,-1.2584143,36.8048002,697,2953,53,2623
21199,6174,2524,1,Personal,4,3,34299,4,3,34313,4,3,34739,4,3,35115,4,3,36495,13,15.0,-1.2500304,36.8741673,-1.2792095,36.7948725,347,1380,14,802
21200,9836,718,3,Business,26,2,51587,26,2,51601,26,2,51869,26,2,52915,26,2,55043,12,30.9,-1.2551895,36.7822034,-1.320157,36.830887,177,2128,14,1314
